date,country,soe,arrivals,arrivals_male,arrivals_female
2020-01-01,ABW,Kedah,0,0,0
2020-01-01,ABW,Pulau Pinang,0,0,0
2020-01-01,AFG,Johor,2,0,2
2020-01-01,AFG,Kedah,1,1,0
2020-01-01,AFG,Perlis,0,0,0
2020-01-01,AFG,Pulau Pinang,0,0,0
2020-01-01,AFG,Sarawak,0,0,0
2020-01-01,AFG,Selangor,180,161,19
2020-01-01,AGO,Johor,0,0,0
2020-01-01,AGO,Kedah,0,0,0
2020-01-01,AGO,Sabah,0,0,0
2020-01-01,AGO,Selangor,9,6,3
2020-01-01,AIA,Selangor,0,0,0
2020-01-01,ALB,Johor,35,17,18
2020-01-01,ALB,Kedah,6,4,2
2020-01-01,ALB,Perak,1,1,0
2020-01-01,ALB,Perlis,1,1,0
2020-01-01,ALB,Pulau Pinang,2,0,2
2020-01-01,ALB,Sabah,1,1,0
2020-01-01,ALB,Sarawak,1,1,0
2020-01-01,ALB,Selangor,62,31,31
2020-01-01,AND,Johor,0,0,0
2020-01-01,AND,Kedah,0,0,0
2020-01-01,AND,Perlis,0,0,0
2020-01-01,AND,Pulau Pinang,0,0,0
2020-01-01,AND,Selangor,5,3,2
2020-01-01,ANT,Selangor,0,0,0
2020-01-01,ARE,Johor,22,14,8
2020-01-01,ARE,Kedah,4,3,1
2020-01-01,ARE,Kelantan,0,0,0
2020-01-01,ARE,Perak,0,0,0
2020-01-01,ARE,Perlis,0,0,0
2020-01-01,ARE,Pulau Pinang,4,3,1
2020-01-01,ARE,Sabah,0,0,0
2020-01-01,ARE,Sarawak,0,0,0
2020-01-01,ARE,Selangor,371,252,119
2020-01-01,ARG,Johor,221,133,88
2020-01-01,ARG,Kedah,304,148,156
2020-01-01,ARG,Kelantan,5,2,3
2020-01-01,ARG,Melaka,0,0,0
2020-01-01,ARG,Perak,0,0,0
2020-01-01,ARG,Perlis,20,11,9
2020-01-01,ARG,Pulau Pinang,5,2,3
2020-01-01,ARG,Sabah,3,1,2
2020-01-01,ARG,Sarawak,1,1,0
2020-01-01,ARG,Selangor,908,464,444
2020-01-01,ARG,W.P. Labuan,0,0,0
2020-01-01,ARM,Johor,5,2,3
2020-01-01,ARM,Kedah,3,1,2
2020-01-01,ARM,Kelantan,1,1,0
2020-01-01,ARM,Perak,2,0,2
2020-01-01,ARM,Perlis,0,0,0
2020-01-01,ARM,Pulau Pinang,1,1,0
2020-01-01,ARM,Sabah,0,0,0
2020-01-01,ARM,Sarawak,0,0,0
2020-01-01,ARM,Selangor,79,22,57
2020-01-01,ATA,Selangor,0,0,0
2020-01-01,ATG,Johor,6,3,3
2020-01-01,ATG,Kedah,0,0,0
2020-01-01,ATG,Pulau Pinang,0,0,0
2020-01-01,ATG,Sarawak,0,0,0
2020-01-01,ATG,Selangor,22,12,10
2020-01-01,AUS,Johor,8923,4980,3943
2020-01-01,AUS,Kedah,1138,636,502
2020-01-01,AUS,Kelantan,21,15,6
2020-01-01,AUS,Melaka,10,7,3
2020-01-01,AUS,Negeri Sembilan,0,0,0
2020-01-01,AUS,Pahang,52,23,29
2020-01-01,AUS,Perak,282,156,126
2020-01-01,AUS,Perlis,115,64,51
2020-01-01,AUS,Pulau Pinang,2617,1339,1278
2020-01-01,AUS,Sabah,908,464,444
2020-01-01,AUS,Sarawak,956,535,421
2020-01-01,AUS,Selangor,36952,20700,16252
2020-01-01,AUS,Terengganu,0,0,0
2020-01-01,AUS,W.P. Labuan,24,17,7
2020-01-01,AUT,Johor,242,159,83
2020-01-01,AUT,Kedah,170,97,73
2020-01-01,AUT,Kelantan,8,7,1
2020-01-01,AUT,Melaka,0,0,0
2020-01-01,AUT,Negeri Sembilan,0,0,0
2020-01-01,AUT,Pahang,0,0,0
2020-01-01,AUT,Perak,8,7,1
2020-01-01,AUT,Perlis,28,19,9
2020-01-01,AUT,Pulau Pinang,75,57,18
2020-01-01,AUT,Sabah,26,15,11
2020-01-01,AUT,Sarawak,18,13,5
2020-01-01,AUT,Selangor,904,585,319
2020-01-01,AUT,Terengganu,0,0,0
2020-01-01,AUT,W.P. Labuan,1,1,0
2020-01-01,AZE,Johor,6,5,1
2020-01-01,AZE,Kedah,9,8,1
2020-01-01,AZE,Kelantan,0,0,0
2020-01-01,AZE,Melaka,2,1,1
2020-01-01,AZE,Perlis,0,0,0
2020-01-01,AZE,Pulau Pinang,0,0,0
2020-01-01,AZE,Sabah,3,2,1
2020-01-01,AZE,Sarawak,3,1,2
2020-01-01,AZE,Selangor,159,89,70
2020-01-01,AZE,W.P. Labuan,1,1,0
2020-01-01,BDI,Pulau Pinang,0,0,0
2020-01-01,BDI,Sarawak,0,0,0
2020-01-01,BDI,Selangor,2,2,0
2020-01-01,BEL,Johor,265,171,94
2020-01-01,BEL,Kedah,140,80,60
2020-01-01,BEL,Kelantan,5,3,2
2020-01-01,BEL,Melaka,0,0,0
2020-01-01,BEL,Negeri Sembilan,0,0,0
2020-01-01,BEL,Pahang,0,0,0
2020-01-01,BEL,Perak,2,0,2
2020-01-01,BEL,Perlis,14,8,6
2020-01-01,BEL,Pulau Pinang,76,53,23
2020-01-01,BEL,Sabah,17,12,5
2020-01-01,BEL,Sarawak,15,12,3
2020-01-01,BEL,Selangor,1243,812,431
2020-01-01,BEL,W.P. Labuan,2,2,0
2020-01-01,BEN,Johor,0,0,0
2020-01-01,BEN,Kedah,0,0,0
2020-01-01,BEN,Perak,0,0,0
2020-01-01,BEN,Pulau Pinang,0,0,0
2020-01-01,BEN,Sabah,1,1,0
2020-01-01,BEN,Sarawak,0,0,0
2020-01-01,BEN,Selangor,6,5,1
2020-01-01,BFA,Perak,0,0,0
2020-01-01,BFA,Pulau Pinang,0,0,0
2020-01-01,BFA,Selangor,5,5,0
2020-01-01,BGD,Johor,5428,4954,474
2020-01-01,BGD,Kedah,72,35,37
2020-01-01,BGD,Kelantan,1,1,0
2020-01-01,BGD,Melaka,17,17,0
2020-01-01,BGD,Negeri Sembilan,0,0,0
2020-01-01,BGD,Pahang,1,1,0
2020-01-01,BGD,Perak,0,0,0
2020-01-01,BGD,Perlis,0,0,0
2020-01-01,BGD,Pulau Pinang,81,74,7
2020-01-01,BGD,Sabah,14,7,7
2020-01-01,BGD,Sarawak,167,151,16
2020-01-01,BGD,Selangor,21150,17904,3246
2020-01-01,BGD,W.P. Labuan,24,24,0
2020-01-01,BGR,Johor,73,49,24
2020-01-01,BGR,Kedah,68,32,36
2020-01-01,BGR,Kelantan,0,0,0
2020-01-01,BGR,Pahang,0,0,0
2020-01-01,BGR,Perak,0,0,0
2020-01-01,BGR,Perlis,1,1,0
2020-01-01,BGR,Pulau Pinang,2,1,1
2020-01-01,BGR,Sabah,3,2,1
2020-01-01,BGR,Sarawak,1,1,0
2020-01-01,BGR,Selangor,495,252,243
2020-01-01,BGR,W.P. Labuan,2,1,1
2020-01-01,BHR,Johor,7,4,3
2020-01-01,BHR,Kedah,5,3,2
2020-01-01,BHR,Kelantan,1,1,0
2020-01-01,BHR,Perlis,0,0,0
2020-01-01,BHR,Pulau Pinang,0,0,0
2020-01-01,BHR,Sabah,0,0,0
2020-01-01,BHR,Sarawak,4,4,0
2020-01-01,BHR,Selangor,454,260,194
2020-01-01,BHS,Johor,1,0,1
2020-01-01,BHS,Kedah,0,0,0
2020-01-01,BHS,Perak,0,0,0
2020-01-01,BHS,Sabah,1,1,0
2020-01-01,BHS,Sarawak,0,0,0
2020-01-01,BHS,Selangor,5,2,3
2020-01-01,BIH,Johor,9,4,5
2020-01-01,BIH,Kedah,10,6,4
2020-01-01,BIH,Perlis,0,0,0
2020-01-01,BIH,Pulau Pinang,3,3,0
2020-01-01,BIH,Sabah,0,0,0
2020-01-01,BIH,Sarawak,2,2,0
2020-01-01,BIH,Selangor,85,44,41
2020-01-01,BLR,Johor,19,10,9
2020-01-01,BLR,Kedah,42,19,23
2020-01-01,BLR,Kelantan,2,1,1
2020-01-01,BLR,Pahang,0,0,0
2020-01-01,BLR,Perak,0,0,0
2020-01-01,BLR,Perlis,0,0,0
2020-01-01,BLR,Pulau Pinang,16,8,8
2020-01-01,BLR,Sabah,10,7,3
2020-01-01,BLR,Sarawak,3,1,2
2020-01-01,BLR,Selangor,423,189,234
2020-01-01,BLR,W.P. Labuan,0,0,0
2020-01-01,BLZ,Johor,3,1,2
2020-01-01,BLZ,Pulau Pinang,0,0,0
2020-01-01,BLZ,Sarawak,0,0,0
2020-01-01,BLZ,Selangor,7,4,3
2020-01-01,BMU,Selangor,0,0,0
2020-01-01,BOL,Johor,6,2,4
2020-01-01,BOL,Kedah,0,0,0
2020-01-01,BOL,Melaka,0,0,0
2020-01-01,BOL,Perak,2,0,2
2020-01-01,BOL,Perlis,0,0,0
2020-01-01,BOL,Pulau Pinang,0,0,0
2020-01-01,BOL,Sabah,0,0,0
2020-01-01,BOL,Sarawak,0,0,0
2020-01-01,BOL,Selangor,30,15,15
2020-01-01,BRA,Johor,293,173,120
2020-01-01,BRA,Kedah,163,72,91
2020-01-01,BRA,Kelantan,1,0,1
2020-01-01,BRA,Melaka,0,0,0
2020-01-01,BRA,Pahang,0,0,0
2020-01-01,BRA,Perak,6,4,2
2020-01-01,BRA,Perlis,10,4,6
2020-01-01,BRA,Pulau Pinang,18,12,6
2020-01-01,BRA,Sabah,17,8,9
2020-01-01,BRA,Sarawak,17,9,8
2020-01-01,BRA,Selangor,1480,828,652
2020-01-01,BRA,W.P. Labuan,0,0,0
2020-01-01,BRB,Johor,1,1,0
2020-01-01,BRB,Kedah,0,0,0
2020-01-01,BRB,Perlis,0,0,0
2020-01-01,BRB,Pulau Pinang,0,0,0
2020-01-01,BRB,Selangor,10,3,7
2020-01-01,BRN,Johor,496,231,265
2020-01-01,BRN,Kedah,13,9,4
2020-01-01,BRN,Kelantan,10,6,4
2020-01-01,BRN,Melaka,0,0,0
2020-01-01,BRN,Pahang,0,0,0
2020-01-01,BRN,Perak,3,2,1
2020-01-01,BRN,Perlis,13,9,4
2020-01-01,BRN,Pulau Pinang,10,4,6
2020-01-01,BRN,Sabah,1023,499,524
2020-01-01,BRN,Sarawak,77835,43927,33908
2020-01-01,BRN,Selangor,6217,3079,3138
2020-01-01,BRN,W.P. Labuan,2881,1815,1066
2020-01-01,BTN,Johor,8,6,2
2020-01-01,BTN,Kedah,1,1,0
2020-01-01,BTN,Perak,0,0,0
2020-01-01,BTN,Perlis,0,0,0
2020-01-01,BTN,Pulau Pinang,2,0,2
2020-01-01,BTN,Sabah,0,0,0
2020-01-01,BTN,Sarawak,0,0,0
2020-01-01,BTN,Selangor,66,48,18
2020-01-01,BWA,Johor,2,2,0
2020-01-01,BWA,Kedah,0,0,0
2020-01-01,BWA,Perlis,0,0,0
2020-01-01,BWA,Pulau Pinang,0,0,0
2020-01-01,BWA,Sabah,0,0,0
2020-01-01,BWA,Sarawak,2,2,0
2020-01-01,BWA,Selangor,25,10,15
2020-01-01,CAF,Kedah,0,0,0
2020-01-01,CAF,Selangor,0,0,0
2020-01-01,CAN,Johor,2001,1124,877
2020-01-01,CAN,Kedah,320,178,142
2020-01-01,CAN,Kelantan,15,9,6
2020-01-01,CAN,Melaka,2,1,1
2020-01-01,CAN,Negeri Sembilan,0,0,0
2020-01-01,CAN,Pahang,0,0,0
2020-01-01,CAN,Perak,22,15,7
2020-01-01,CAN,Perlis,59,38,21
2020-01-01,CAN,Pulau Pinang,489,262,227
2020-01-01,CAN,Sabah,273,143,130
2020-01-01,CAN,Sarawak,544,303,241
2020-01-01,CAN,Selangor,5740,3274,2466
2020-01-01,CAN,Terengganu,0,0,0
2020-01-01,CAN,W.P. Labuan,13,11,2
2020-01-01,CCK,Selangor,0,0,0
2020-01-01,CHE,Johor,426,264,162
2020-01-01,CHE,Kedah,288,159,129
2020-01-01,CHE,Kelantan,11,4,7
2020-01-01,CHE,Melaka,2,1,1
2020-01-01,CHE,Negeri Sembilan,0,0,0
2020-01-01,CHE,Pahang,1,1,0
2020-01-01,CHE,Perak,17,10,7
2020-01-01,CHE,Perlis,62,44,18
2020-01-01,CHE,Pulau Pinang,151,84,67
2020-01-01,CHE,Sabah,35,22,13
2020-01-01,CHE,Sarawak,33,17,16
2020-01-01,CHE,Selangor,1413,893,520
2020-01-01,CHE,W.P. Labuan,7,6,1
2020-01-01,CHL,Johor,57,26,31
2020-01-01,CHL,Kedah,54,30,24
2020-01-01,CHL,Kelantan,1,1,0
2020-01-01,CHL,Melaka,0,0,0
2020-01-01,CHL,Pahang,0,0,0
2020-01-01,CHL,Perak,0,0,0
2020-01-01,CHL,Perlis,7,3,4
2020-01-01,CHL,Pulau Pinang,19,6,13
2020-01-01,CHL,Sabah,1,0,1
2020-01-01,CHL,Sarawak,1,0,1
2020-01-01,CHL,Selangor,366,190,176
2020-01-01,CHN,Johor,92472,38137,54335
2020-01-01,CHN,Kedah,5069,2188,2881
2020-01-01,CHN,Kelantan,26,11,15
2020-01-01,CHN,Melaka,2,0,2
2020-01-01,CHN,Pahang,43,21,22
2020-01-01,CHN,Perak,236,89,147
2020-01-01,CHN,Perlis,136,72,64
2020-01-01,CHN,Pulau Pinang,10906,5180,5726
2020-01-01,CHN,Sabah,12574,5703,6871
2020-01-01,CHN,Sarawak,1192,446,746
2020-01-01,CHN,Selangor,163242,75519,87723
2020-01-01,CHN,Terengganu,0,0,0
2020-01-01,CHN,W.P. Labuan,60,30,30
2020-01-01,CIV,Johor,0,0,0
2020-01-01,CIV,Kedah,1,1,0
2020-01-01,CIV,Pulau Pinang,1,1,0
2020-01-01,CIV,Sabah,0,0,0
2020-01-01,CIV,Sarawak,0,0,0
2020-01-01,CIV,Selangor,36,27,9
2020-01-01,CMR,Johor,3,3,0
2020-01-01,CMR,Kedah,0,0,0
2020-01-01,CMR,Pulau Pinang,0,0,0
2020-01-01,CMR,Sabah,0,0,0
2020-01-01,CMR,Sarawak,1,1,0
2020-01-01,CMR,Selangor,33,23,10
2020-01-01,COD,Johor,0,0,0
2020-01-01,COD,Pulau Pinang,0,0,0
2020-01-01,COD,Sarawak,0,0,0
2020-01-01,COD,Selangor,9,4,5
2020-01-01,COG,Johor,1,1,0
2020-01-01,COG,Kedah,0,0,0
2020-01-01,COG,Selangor,2,2,0
2020-01-01,COK,Selangor,0,0,0
2020-01-01,COL,Johor,28,17,11
2020-01-01,COL,Kedah,0,0,0
2020-01-01,COL,Perak,0,0,0
2020-01-01,COL,Pulau Pinang,2,0,2
2020-01-01,COL,Sabah,0,0,0
2020-01-01,COL,Sarawak,0,0,0
2020-01-01,COL,Selangor,217,114,103
2020-01-01,COL,W.P. Labuan,0,0,0
2020-01-01,COM,Johor,0,0,0
2020-01-01,COM,Kedah,1,0,1
2020-01-01,COM,Selangor,19,13,6
2020-01-01,CPV,Johor,1,0,1
2020-01-01,CPV,Kedah,0,0,0
2020-01-01,CPV,Pulau Pinang,0,0,0
2020-01-01,CPV,Sabah,0,0,0
2020-01-01,CPV,Selangor,3,2,1
2020-01-01,CRI,Johor,9,6,3
2020-01-01,CRI,Kedah,1,1,0
2020-01-01,CRI,Perak,1,0,1
2020-01-01,CRI,Perlis,0,0,0
2020-01-01,CRI,Pulau Pinang,2,1,1
2020-01-01,CRI,Sabah,1,0,1
2020-01-01,CRI,Sarawak,0,0,0
2020-01-01,CRI,Selangor,73,44,29
2020-01-01,CUB,Johor,7,7,0
2020-01-01,CUB,Kedah,0,0,0
2020-01-01,CUB,Perlis,0,0,0
2020-01-01,CUB,Pulau Pinang,1,1,0
2020-01-01,CUB,Sabah,0,0,0
2020-01-01,CUB,Sarawak,0,0,0
2020-01-01,CUB,Selangor,40,21,19
2020-01-01,CYP,Johor,15,9,6
2020-01-01,CYP,Kedah,7,3,4
2020-01-01,CYP,Perak,0,0,0
2020-01-01,CYP,Perlis,0,0,0
2020-01-01,CYP,Pulau Pinang,4,2,2
2020-01-01,CYP,Sabah,0,0,0
2020-01-01,CYP,Sarawak,1,0,1
2020-01-01,CYP,Selangor,61,37,24
2020-01-01,CZE,Johor,163,99,64
2020-01-01,CZE,Kedah,492,251,241
2020-01-01,CZE,Kelantan,3,2,1
2020-01-01,CZE,Melaka,2,2,0
2020-01-01,CZE,Negeri Sembilan,0,0,0
2020-01-01,CZE,Perak,0,0,0
2020-01-01,CZE,Perlis,18,12,6
2020-01-01,CZE,Pulau Pinang,89,43,46
2020-01-01,CZE,Sabah,30,18,12
2020-01-01,CZE,Sarawak,15,8,7
2020-01-01,CZE,Selangor,966,559,407
2020-01-01,CZE,W.P. Labuan,5,4,1
2020-01-01,DEU,Johor,2320,1507,813
2020-01-01,DEU,Kedah,1336,695,641
2020-01-01,DEU,Kelantan,39,31,8
2020-01-01,DEU,Melaka,3,2,1
2020-01-01,DEU,Negeri Sembilan,1,1,0
2020-01-01,DEU,Pahang,12,7,5
2020-01-01,DEU,Perak,34,25,9
2020-01-01,DEU,Perlis,255,166,89
2020-01-01,DEU,Pulau Pinang,550,378,172
2020-01-01,DEU,Sabah,143,100,43
2020-01-01,DEU,Sarawak,241,156,85
2020-01-01,DEU,Selangor,6725,4268,2457
2020-01-01,DEU,Terengganu,0,0,0
2020-01-01,DEU,W.P. Labuan,14,9,5
2020-01-01,DJI,Johor,0,0,0
2020-01-01,DJI,Selangor,9,3,6
2020-01-01,DMA,Johor,9,7,2
2020-01-01,DMA,Kedah,0,0,0
2020-01-01,DMA,Pulau Pinang,0,0,0
2020-01-01,DMA,Sabah,6,5,1
2020-01-01,DMA,Sarawak,1,1,0
2020-01-01,DMA,Selangor,41,33,8
2020-01-01,DMA,W.P. Labuan,0,0,0
2020-01-01,DNK,Johor,349,236,113
2020-01-01,DNK,Kedah,416,205,211
2020-01-01,DNK,Kelantan,2,2,0
2020-01-01,DNK,Melaka,1,1,0
2020-01-01,DNK,Negeri Sembilan,0,0,0
2020-01-01,DNK,Pahang,0,0,0
2020-01-01,DNK,Perak,20,12,8
2020-01-01,DNK,Perlis,20,12,8
2020-01-01,DNK,Pulau Pinang,148,89,59
2020-01-01,DNK,Sabah,44,27,17
2020-01-01,DNK,Sarawak,16,10,6
2020-01-01,DNK,Selangor,1755,1049,706
2020-01-01,DNK,W.P. Labuan,1,1,0
2020-01-01,DOM,Johor,2,1,1
2020-01-01,DOM,Kedah,0,0,0
2020-01-01,DOM,Perak,0,0,0
2020-01-01,DOM,Perlis,1,1,0
2020-01-01,DOM,Pulau Pinang,0,0,0
2020-01-01,DOM,Sabah,1,1,0
2020-01-01,DOM,Sarawak,0,0,0
2020-01-01,DOM,Selangor,19,10,9
2020-01-01,DZA,Johor,27,23,4
2020-01-01,DZA,Kedah,18,12,6
2020-01-01,DZA,Kelantan,0,0,0
2020-01-01,DZA,Melaka,0,0,0
2020-01-01,DZA,Perak,0,0,0
2020-01-01,DZA,Perlis,3,1,2
2020-01-01,DZA,Pulau Pinang,9,6,3
2020-01-01,DZA,Sabah,1,1,0
2020-01-01,DZA,Sarawak,6,3,3
2020-01-01,DZA,Selangor,719,524,195
2020-01-01,DZA,W.P. Labuan,0,0,0
2020-01-01,ECU,Johor,26,9,17
2020-01-01,ECU,Kedah,2,1,1
2020-01-01,ECU,Perak,0,0,0
2020-01-01,ECU,Perlis,0,0,0
2020-01-01,ECU,Pulau Pinang,0,0,0
2020-01-01,ECU,Sabah,0,0,0
2020-01-01,ECU,Sarawak,2,0,2
2020-01-01,ECU,Selangor,77,38,39
2020-01-01,EGY,Johor,244,184,60
2020-01-01,EGY,Kedah,33,14,19
2020-01-01,EGY,Kelantan,4,4,0
2020-01-01,EGY,Melaka,0,0,0
2020-01-01,EGY,Pahang,0,0,0
2020-01-01,EGY,Perak,0,0,0
2020-01-01,EGY,Perlis,0,0,0
2020-01-01,EGY,Pulau Pinang,9,8,1
2020-01-01,EGY,Sabah,5,4,1
2020-01-01,EGY,Sarawak,87,53,34
2020-01-01,EGY,Selangor,2697,1661,1036
2020-01-01,EGY,Terengganu,0,0,0
2020-01-01,EGY,W.P. Labuan,0,0,0
2020-01-01,ERI,Johor,0,0,0
2020-01-01,ERI,Pulau Pinang,0,0,0
2020-01-01,ERI,Sabah,0,0,0
2020-01-01,ERI,Selangor,31,20,11
2020-01-01,ESP,Johor,490,291,199
2020-01-01,ESP,Kedah,358,180,178
2020-01-01,ESP,Kelantan,6,5,1
2020-01-01,ESP,Melaka,2,1,1
2020-01-01,ESP,Negeri Sembilan,0,0,0
2020-01-01,ESP,Pahang,1,1,0
2020-01-01,ESP,Perak,6,4,2
2020-01-01,ESP,Perlis,34,19,15
2020-01-01,ESP,Pulau Pinang,71,43,28
2020-01-01,ESP,Sabah,44,24,20
2020-01-01,ESP,Sarawak,35,19,16
2020-01-01,ESP,Selangor,2140,1298,842
2020-01-01,ESP,W.P. Labuan,8,6,2
2020-01-01,EST,Johor,91,47,44
2020-01-01,EST,Kedah,107,56,51
2020-01-01,EST,Kelantan,0,0,0
2020-01-01,EST,Pahang,0,0,0
2020-01-01,EST,Perak,3,2,1
2020-01-01,EST,Perlis,1,1,0
2020-01-01,EST,Pulau Pinang,6,4,2
2020-01-01,EST,Sabah,16,10,6
2020-01-01,EST,Sarawak,4,3,1
2020-01-01,EST,Selangor,254,135,119
2020-01-01,EST,W.P. Labuan,0,0,0
2020-01-01,ETH,Johor,5,4,1
2020-01-01,ETH,Kedah,0,0,0
2020-01-01,ETH,Pulau Pinang,0,0,0
2020-01-01,ETH,Sarawak,2,0,2
2020-01-01,ETH,Selangor,41,25,16
2020-01-01,FIN,Johor,335,208,127
2020-01-01,FIN,Kedah,476,209,267
2020-01-01,FIN,Kelantan,3,1,2
2020-01-01,FIN,Melaka,0,0,0
2020-01-01,FIN,Negeri Sembilan,0,0,0
2020-01-01,FIN,Pahang,0,0,0
2020-01-01,FIN,Perak,3,2,1
2020-01-01,FIN,Perlis,19,11,8
2020-01-01,FIN,Pulau Pinang,129,76,53
2020-01-01,FIN,Sabah,24,15,9
2020-01-01,FIN,Sarawak,16,9,7
2020-01-01,FIN,Selangor,1417,756,661
2020-01-01,FIN,W.P. Labuan,2,1,1
2020-01-01,FJI,Johor,77,37,40
2020-01-01,FJI,Kedah,4,0,4
2020-01-01,FJI,Kelantan,0,0,0
2020-01-01,FJI,Perak,0,0,0
2020-01-01,FJI,Perlis,4,0,4
2020-01-01,FJI,Pulau Pinang,1,1,0
2020-01-01,FJI,Sabah,0,0,0
2020-01-01,FJI,Sarawak,0,0,0
2020-01-01,FJI,Selangor,151,84,67
2020-01-01,FRA,Johor,1957,1214,743
2020-01-01,FRA,Kedah,1149,671,478
2020-01-01,FRA,Kelantan,50,38,12
2020-01-01,FRA,Melaka,2,2,0
2020-01-01,FRA,Negeri Sembilan,1,1,0
2020-01-01,FRA,Pahang,12,5,7
2020-01-01,FRA,Perak,29,20,9
2020-01-01,FRA,Perlis,142,88,54
2020-01-01,FRA,Pulau Pinang,508,299,209
2020-01-01,FRA,Sabah,135,71,64
2020-01-01,FRA,Sarawak,100,68,32
2020-01-01,FRA,Selangor,8663,5373,3290
2020-01-01,FRA,Terengganu,0,0,0
2020-01-01,FRA,W.P. Labuan,5,3,2
2020-01-01,FSM,Johor,1,1,0
2020-01-01,FSM,Pulau Pinang,1,0,1
2020-01-01,FSM,Selangor,1,1,0
2020-01-01,GAB,Johor,1,1,0
2020-01-01,GAB,Pulau Pinang,0,0,0
2020-01-01,GAB,Sarawak,0,0,0
2020-01-01,GAB,Selangor,3,1,2
2020-01-01,GBR,Johor,5448,3473,1975
2020-01-01,GBR,Kedah,2148,1206,942
2020-01-01,GBR,Kelantan,37,31,6
2020-01-01,GBR,Melaka,5,5,0
2020-01-01,GBR,Negeri Sembilan,0,0,0
2020-01-01,GBR,Pahang,18,13,5
2020-01-01,GBR,Perak,75,50,25
2020-01-01,GBR,Perlis,289,186,103
2020-01-01,GBR,Pulau Pinang,1412,841,571
2020-01-01,GBR,Sabah,581,327,254
2020-01-01,GBR,Sarawak,1261,822,439
2020-01-01,GBR,Selangor,20246,12997,7249
2020-01-01,GBR,Terengganu,0,0,0
2020-01-01,GBR,W.P. Labuan,119,74,45
2020-01-01,GEO,Johor,3,2,1
2020-01-01,GEO,Kedah,4,1,3
2020-01-01,GEO,Melaka,1,1,0
2020-01-01,GEO,Perak,0,0,0
2020-01-01,GEO,Perlis,0,0,0
2020-01-01,GEO,Pulau Pinang,3,2,1
2020-01-01,GEO,Sabah,0,0,0
2020-01-01,GEO,Sarawak,0,0,0
2020-01-01,GEO,Selangor,46,24,22
2020-01-01,GHA,Johor,14,11,3
2020-01-01,GHA,Kedah,0,0,0
2020-01-01,GHA,Kelantan,1,1,0
2020-01-01,GHA,Pulau Pinang,1,1,0
2020-01-01,GHA,Sabah,0,0,0
2020-01-01,GHA,Sarawak,2,2,0
2020-01-01,GHA,Selangor,82,50,32
2020-01-01,GIB,Johor,0,0,0
2020-01-01,GIB,Sarawak,0,0,0
2020-01-01,GIN,Johor,14,14,0
2020-01-01,GIN,Kedah,0,0,0
2020-01-01,GIN,Kelantan,1,1,0
2020-01-01,GIN,Perlis,0,0,0
2020-01-01,GIN,Pulau Pinang,0,0,0
2020-01-01,GIN,Sabah,0,0,0
2020-01-01,GIN,Sarawak,2,1,1
2020-01-01,GIN,Selangor,81,70,11
2020-01-01,GLP,Selangor,0,0,0
2020-01-01,GMB,Johor,11,6,5
2020-01-01,GMB,Kedah,0,0,0
2020-01-01,GMB,Kelantan,2,2,0
2020-01-01,GMB,Pulau Pinang,0,0,0
2020-01-01,GMB,Sabah,0,0,0
2020-01-01,GMB,Sarawak,0,0,0
2020-01-01,GMB,Selangor,67,52,15
2020-01-01,GNB,Johor,2,2,0
2020-01-01,GNB,Selangor,3,3,0
2020-01-01,GNQ,Johor,0,0,0
2020-01-01,GNQ,Selangor,7,4,3
2020-01-01,GRC,Johor,65,53,12
2020-01-01,GRC,Kedah,41,21,20
2020-01-01,GRC,Kelantan,1,1,0
2020-01-01,GRC,Melaka,4,3,1
2020-01-01,GRC,Negeri Sembilan,0,0,0
2020-01-01,GRC,Pahang,0,0,0
2020-01-01,GRC,Perak,3,1,2
2020-01-01,GRC,Perlis,7,4,3
2020-01-01,GRC,Pulau Pinang,7,6,1
2020-01-01,GRC,Sabah,2,2,0
2020-01-01,GRC,Sarawak,8,4,4
2020-01-01,GRC,Selangor,258,183,75
2020-01-01,GRD,Johor,12,10,2
2020-01-01,GRD,Kedah,0,0,0
2020-01-01,GRD,Pulau Pinang,1,1,0
2020-01-01,GRD,Sabah,0,0,0
2020-01-01,GRD,Sarawak,0,0,0
2020-01-01,GRD,Selangor,25,15,10
2020-01-01,GRL,Johor,0,0,0
2020-01-01,GRL,Selangor,0,0,0
2020-01-01,GTM,Johor,0,0,0
2020-01-01,GTM,Kedah,0,0,0
2020-01-01,GTM,Pahang,1,0,1
2020-01-01,GTM,Perak,0,0,0
2020-01-01,GTM,Pulau Pinang,0,0,0
2020-01-01,GTM,Sabah,0,0,0
2020-01-01,GTM,Sarawak,0,0,0
2020-01-01,GTM,Selangor,26,15,11
2020-01-01,GTM,W.P. Labuan,0,0,0
2020-01-01,GUY,Johor,2,2,0
2020-01-01,GUY,Kedah,0,0,0
2020-01-01,GUY,Pulau Pinang,0,0,0
2020-01-01,GUY,Sarawak,0,0,0
2020-01-01,GUY,Selangor,8,4,4
2020-01-01,HKG,Johor,0,0,0
2020-01-01,HKG,Kedah,0,0,0
2020-01-01,HKG,Kelantan,0,0,0
2020-01-01,HKG,Pahang,0,0,0
2020-01-01,HKG,Perak,25,13,12
2020-01-01,HKG,Perlis,0,0,0
2020-01-01,HKG,Pulau Pinang,0,0,0
2020-01-01,HKG,Sabah,3,1,2
2020-01-01,HKG,Sarawak,7,5,2
2020-01-01,HKG,Selangor,0,0,0
2020-01-01,HKG,Terengganu,0,0,0
2020-01-01,HMD,Johor,0,0,0
2020-01-01,HND,Johor,10,4,6
2020-01-01,HND,Kedah,2,1,1
2020-01-01,HND,Perak,0,0,0
2020-01-01,HND,Pulau Pinang,0,0,0
2020-01-01,HND,Sabah,1,1,0
2020-01-01,HND,Sarawak,0,0,0
2020-01-01,HND,Selangor,21,13,8
2020-01-01,HRV,Johor,72,44,28
2020-01-01,HRV,Kedah,26,17,9
2020-01-01,HRV,Kelantan,0,0,0
2020-01-01,HRV,Melaka,0,0,0
2020-01-01,HRV,Pahang,1,1,0
2020-01-01,HRV,Perak,1,0,1
2020-01-01,HRV,Perlis,1,1,0
2020-01-01,HRV,Pulau Pinang,8,7,1
2020-01-01,HRV,Sabah,0,0,0
2020-01-01,HRV,Sarawak,9,8,1
2020-01-01,HRV,Selangor,340,207,133
2020-01-01,HTI,Johor,0,0,0
2020-01-01,HTI,Kedah,0,0,0
2020-01-01,HTI,Kelantan,0,0,0
2020-01-01,HTI,Perak,0,0,0
2020-01-01,HTI,Pulau Pinang,0,0,0
2020-01-01,HTI,Sabah,0,0,0
2020-01-01,HTI,Selangor,5,4,1
2020-01-01,HUN,Johor,93,56,37
2020-01-01,HUN,Kedah,281,148,133
2020-01-01,HUN,Kelantan,1,0,1
2020-01-01,HUN,Pahang,0,0,0
2020-01-01,HUN,Perak,0,0,0
2020-01-01,HUN,Perlis,6,3,3
2020-01-01,HUN,Pulau Pinang,77,46,31
2020-01-01,HUN,Sabah,20,12,8
2020-01-01,HUN,Sarawak,19,14,5
2020-01-01,HUN,Selangor,1067,555,512
2020-01-01,HUN,W.P. Labuan,0,0,0
2020-01-01,IDN,Johor,146428,75004,71424
2020-01-01,IDN,Kedah,5574,2183,3391
2020-01-01,IDN,Kelantan,195,91,104
2020-01-01,IDN,Melaka,5852,2696,3156
2020-01-01,IDN,Negeri Sembilan,3379,2169,1210
2020-01-01,IDN,Pahang,24,12,12
2020-01-01,IDN,Perak,228,78,150
2020-01-01,IDN,Perlis,648,307,341
2020-01-01,IDN,Pulau Pinang,25021,8736,16285
2020-01-01,IDN,Sabah,4962,2523,2439
2020-01-01,IDN,Sarawak,43648,25764,17884
2020-01-01,IDN,Selangor,137859,65764,72095
2020-01-01,IDN,Terengganu,0,0,0
2020-01-01,IDN,W.P. Labuan,134,87,47
2020-01-01,IND,Johor,25250,18364,6886
2020-01-01,IND,Kedah,953,553,400
2020-01-01,IND,Kelantan,22,20,2
2020-01-01,IND,Melaka,20,16,4
2020-01-01,IND,Negeri Sembilan,1,1,0
2020-01-01,IND,Pahang,16,15,1
2020-01-01,IND,Perak,357,248,109
2020-01-01,IND,Perlis,30,27,3
2020-01-01,IND,Pulau Pinang,736,524,212
2020-01-01,IND,Sabah,102,64,38
2020-01-01,IND,Sarawak,1989,1666,323
2020-01-01,IND,Selangor,69072,48859,20213
2020-01-01,IND,Terengganu,0,0,0
2020-01-01,IND,W.P. Labuan,118,107,11
2020-01-01,IOT,Pulau Pinang,0,0,0
2020-01-01,IOT,Selangor,0,0,0
2020-01-01,IRL,Johor,323,214,109
2020-01-01,IRL,Kedah,128,74,54
2020-01-01,IRL,Kelantan,3,3,0
2020-01-01,IRL,Negeri Sembilan,0,0,0
2020-01-01,IRL,Pahang,2,2,0
2020-01-01,IRL,Perak,8,7,1
2020-01-01,IRL,Perlis,17,9,8
2020-01-01,IRL,Pulau Pinang,132,89,43
2020-01-01,IRL,Sabah,36,23,13
2020-01-01,IRL,Sarawak,35,22,13
2020-01-01,IRL,Selangor,1463,921,542
2020-01-01,IRL,Terengganu,0,0,0
2020-01-01,IRL,W.P. Labuan,4,4,0
2020-01-01,IRN,Johor,443,245,198
2020-01-01,IRN,Kedah,20,15,5
2020-01-01,IRN,Kelantan,1,1,0
2020-01-01,IRN,Perak,0,0,0
2020-01-01,IRN,Perlis,1,1,0
2020-01-01,IRN,Pulau Pinang,3,2,1
2020-01-01,IRN,Sabah,10,6,4
2020-01-01,IRN,Sarawak,8,7,1
2020-01-01,IRN,Selangor,4149,2272,1877
2020-01-01,IRN,W.P. Labuan,1,1,0
2020-01-01,IRQ,Johor,95,64,31
2020-01-01,IRQ,Kedah,10,7,3
2020-01-01,IRQ,Kelantan,0,0,0
2020-01-01,IRQ,Melaka,0,0,0
2020-01-01,IRQ,Pahang,0,0,0
2020-01-01,IRQ,Perak,0,0,0
2020-01-01,IRQ,Perlis,0,0,0
2020-01-01,IRQ,Pulau Pinang,9,7,2
2020-01-01,IRQ,Sabah,2,2,0
2020-01-01,IRQ,Sarawak,0,0,0
2020-01-01,IRQ,Selangor,1635,1185,450
2020-01-01,ISL,Johor,7,4,3
2020-01-01,ISL,Kedah,6,4,2
2020-01-01,ISL,Kelantan,0,0,0
2020-01-01,ISL,Perak,0,0,0
2020-01-01,ISL,Perlis,4,1,3
2020-01-01,ISL,Pulau Pinang,1,1,0
2020-01-01,ISL,Sabah,1,1,0
2020-01-01,ISL,Sarawak,3,2,1
2020-01-01,ISL,Selangor,104,57,47
2020-01-01,ISL,W.P. Labuan,0,0,0
2020-01-01,ISR,Pulau Pinang,0,0,0
2020-01-01,ITA,Johor,696,498,198
2020-01-01,ITA,Kedah,1186,613,573
2020-01-01,ITA,Kelantan,10,9,1
2020-01-01,ITA,Melaka,1,1,0
2020-01-01,ITA,Negeri Sembilan,2,2,0
2020-01-01,ITA,Pahang,0,0,0
2020-01-01,ITA,Perak,14,12,2
2020-01-01,ITA,Perlis,47,35,12
2020-01-01,ITA,Pulau Pinang,157,98,59
2020-01-01,ITA,Sabah,53,33,20
2020-01-01,ITA,Sarawak,35,23,12
2020-01-01,ITA,Selangor,3411,2241,1170
2020-01-01,ITA,W.P. Labuan,2,0,2
2020-01-01,JAM,Johor,5,0,5
2020-01-01,JAM,Kedah,1,0,1
2020-01-01,JAM,Perak,0,0,0
2020-01-01,JAM,Pulau Pinang,0,0,0
2020-01-01,JAM,Sabah,0,0,0
2020-01-01,JAM,Sarawak,0,0,0
2020-01-01,JAM,Selangor,40,11,29
2020-01-01,JAM,W.P. Labuan,0,0,0
2020-01-01,JOR,Johor,74,28,46
2020-01-01,JOR,Kedah,33,17,16
2020-01-01,JOR,Kelantan,1,1,0
2020-01-01,JOR,Melaka,0,0,0
2020-01-01,JOR,Perlis,1,1,0
2020-01-01,JOR,Pulau Pinang,24,7,17
2020-01-01,JOR,Sabah,9,8,1
2020-01-01,JOR,Sarawak,2,2,0
2020-01-01,JOR,Selangor,1227,751,476
2020-01-01,JOR,W.P. Labuan,0,0,0
2020-01-01,JPN,Johor,9179,5771,3408
2020-01-01,JPN,Kedah,892,477,415
2020-01-01,JPN,Kelantan,18,17,1
2020-01-01,JPN,Melaka,2,2,0
2020-01-01,JPN,Negeri Sembilan,0,0,0
2020-01-01,JPN,Pahang,17,12,5
2020-01-01,JPN,Perak,74,51,23
2020-01-01,JPN,Perlis,123,86,37
2020-01-01,JPN,Pulau Pinang,1891,1286,605
2020-01-01,JPN,Sabah,899,424,475
2020-01-01,JPN,Sarawak,317,225,92
2020-01-01,JPN,Selangor,30603,18965,11638
2020-01-01,JPN,W.P. Labuan,14,10,4
2020-01-01,KAZ,Johor,69,28,41
2020-01-01,KAZ,Kedah,475,213,262
2020-01-01,KAZ,Kelantan,3,0,3
2020-01-01,KAZ,Melaka,0,0,0
2020-01-01,KAZ,Perak,0,0,0
2020-01-01,KAZ,Perlis,9,4,5
2020-01-01,KAZ,Pulau Pinang,12,5,7
2020-01-01,KAZ,Sabah,2,2,0
2020-01-01,KAZ,Sarawak,10,5,5
2020-01-01,KAZ,Selangor,3602,1509,2093
2020-01-01,KAZ,W.P. Labuan,1,0,1
2020-01-01,KEN,Johor,139,62,77
2020-01-01,KEN,Kedah,2,2,0
2020-01-01,KEN,Kelantan,0,0,0
2020-01-01,KEN,Perak,0,0,0
2020-01-01,KEN,Perlis,2,1,1
2020-01-01,KEN,Pulau Pinang,4,2,2
2020-01-01,KEN,Sabah,0,0,0
2020-01-01,KEN,Sarawak,2,2,0
2020-01-01,KEN,Selangor,386,209,177
2020-01-01,KGZ,Johor,25,16,9
2020-01-01,KGZ,Kedah,37,17,20
2020-01-01,KGZ,Kelantan,0,0,0
2020-01-01,KGZ,Perak,0,0,0
2020-01-01,KGZ,Perlis,3,0,3
2020-01-01,KGZ,Pulau Pinang,3,1,2
2020-01-01,KGZ,Sabah,2,1,1
2020-01-01,KGZ,Sarawak,0,0,0
2020-01-01,KGZ,Selangor,717,334,383
2020-01-01,KHM,Johor,2942,1236,1706
2020-01-01,KHM,Kedah,209,121,88
2020-01-01,KHM,Kelantan,1111,831,280
2020-01-01,KHM,Melaka,0,0,0
2020-01-01,KHM,Negeri Sembilan,0,0,0
2020-01-01,KHM,Pahang,0,0,0
2020-01-01,KHM,Perak,24,18,6
2020-01-01,KHM,Perlis,801,629,172
2020-01-01,KHM,Pulau Pinang,4,0,4
2020-01-01,KHM,Sabah,2,1,1
2020-01-01,KHM,Sarawak,29,15,14
2020-01-01,KHM,Selangor,4784,2186,2598
2020-01-01,KHM,W.P. Labuan,0,0,0
2020-01-01,KIR,Johor,4,4,0
2020-01-01,KIR,Sabah,0,0,0
2020-01-01,KIR,Selangor,1,1,0
2020-01-01,KNA,Johor,10,7,3
2020-01-01,KNA,Kedah,0,0,0
2020-01-01,KNA,Perlis,0,0,0
2020-01-01,KNA,Pulau Pinang,4,2,2
2020-01-01,KNA,Sabah,1,1,0
2020-01-01,KNA,Selangor,48,34,14
2020-01-01,KNA,W.P. Labuan,0,0,0
2020-01-01,KOR,Johor,29631,13776,15855
2020-01-01,KOR,Kedah,548,266,282
2020-01-01,KOR,Kelantan,7,5,2
2020-01-01,KOR,Melaka,1,1,0
2020-01-01,KOR,Negeri Sembilan,7,4,3
2020-01-01,KOR,Pahang,19,9,10
2020-01-01,KOR,Perak,17,8,9
2020-01-01,KOR,Perlis,111,80,31
2020-01-01,KOR,Pulau Pinang,765,379,386
2020-01-01,KOR,Sabah,33316,14024,19292
2020-01-01,KOR,Sarawak,425,258,167
2020-01-01,KOR,Selangor,33486,16434,17052
2020-01-01,KOR,Terengganu,0,0,0
2020-01-01,KOR,W.P. Labuan,24,16,8
2020-01-01,KWT,Johor,174,71,103
2020-01-01,KWT,Kedah,6,3,3
2020-01-01,KWT,Kelantan,0,0,0
2020-01-01,KWT,Perak,0,0,0
2020-01-01,KWT,Perlis,0,0,0
2020-01-01,KWT,Pulau Pinang,9,2,7
2020-01-01,KWT,Sabah,0,0,0
2020-01-01,KWT,Sarawak,0,0,0
2020-01-01,KWT,Selangor,1032,540,492
2020-01-01,KWT,W.P. Labuan,0,0,0
2020-01-01,LAO,Johor,228,72,156
2020-01-01,LAO,Kedah,1165,87,1078
2020-01-01,LAO,Kelantan,209,78,131
2020-01-01,LAO,Melaka,0,0,0
2020-01-01,LAO,Perak,16,0,16
2020-01-01,LAO,Perlis,533,134,399
2020-01-01,LAO,Pulau Pinang,10,2,8
2020-01-01,LAO,Sabah,1,0,1
2020-01-01,LAO,Sarawak,0,0,0
2020-01-01,LAO,Selangor,462,159,303
2020-01-01,LAO,W.P. Labuan,0,0,0
2020-01-01,LBN,Johor,20,13,7
2020-01-01,LBN,Kedah,2,2,0
2020-01-01,LBN,Kelantan,0,0,0
2020-01-01,LBN,Pahang,0,0,0
2020-01-01,LBN,Perak,0,0,0
2020-01-01,LBN,Perlis,0,0,0
2020-01-01,LBN,Pulau Pinang,4,1,3
2020-01-01,LBN,Sabah,0,0,0
2020-01-01,LBN,Sarawak,1,1,0
2020-01-01,LBN,Selangor,258,160,98
2020-01-01,LBN,W.P. Labuan,0,0,0
2020-01-01,LBR,Johor,5,5,0
2020-01-01,LBR,Kedah,0,0,0
2020-01-01,LBR,Sabah,0,0,0
2020-01-01,LBR,Sarawak,0,0,0
2020-01-01,LBR,Selangor,10,8,2
2020-01-01,LBY,Johor,22,14,8
2020-01-01,LBY,Kedah,2,2,0
2020-01-01,LBY,Perlis,0,0,0
2020-01-01,LBY,Pulau Pinang,7,3,4
2020-01-01,LBY,Sabah,1,1,0
2020-01-01,LBY,Sarawak,1,0,1
2020-01-01,LBY,Selangor,867,637,230
2020-01-01,LCA,Johor,4,2,2
2020-01-01,LCA,Kedah,0,0,0
2020-01-01,LCA,Pulau Pinang,0,0,0
2020-01-01,LCA,Sarawak,0,0,0
2020-01-01,LCA,Selangor,14,12,2
2020-01-01,LIE,Johor,4,4,0
2020-01-01,LIE,Kedah,2,2,0
2020-01-01,LIE,Perlis,0,0,0
2020-01-01,LIE,Pulau Pinang,1,1,0
2020-01-01,LIE,Sabah,0,0,0
2020-01-01,LIE,Sarawak,0,0,0
2020-01-01,LIE,Selangor,7,4,3
2020-01-01,LKA,Johor,1199,841,358
2020-01-01,LKA,Kedah,17,11,6
2020-01-01,LKA,Kelantan,0,0,0
2020-01-01,LKA,Melaka,0,0,0
2020-01-01,LKA,Pahang,1,1,0
2020-01-01,LKA,Perak,4,3,1
2020-01-01,LKA,Perlis,0,0,0
2020-01-01,LKA,Pulau Pinang,50,33,17
2020-01-01,LKA,Sabah,0,0,0
2020-01-01,LKA,Sarawak,20,16,4
2020-01-01,LKA,Selangor,3454,2153,1301
2020-01-01,LKA,W.P. Labuan,1,0,1
2020-01-01,LSO,Johor,0,0,0
2020-01-01,LSO,Kedah,0,0,0
2020-01-01,LSO,Pulau Pinang,0,0,0
2020-01-01,LSO,Sarawak,0,0,0
2020-01-01,LSO,Selangor,6,4,2
2020-01-01,LTU,Johor,91,41,50
2020-01-01,LTU,Kedah,48,25,23
2020-01-01,LTU,Kelantan,2,1,1
2020-01-01,LTU,Pahang,0,0,0
2020-01-01,LTU,Perak,0,0,0
2020-01-01,LTU,Perlis,12,9,3
2020-01-01,LTU,Pulau Pinang,3,0,3
2020-01-01,LTU,Sabah,9,6,3
2020-01-01,LTU,Sarawak,10,5,5
2020-01-01,LTU,Selangor,344,175,169
2020-01-01,LTU,W.P. Labuan,0,0,0
2020-01-01,LUX,Johor,11,8,3
2020-01-01,LUX,Kedah,2,1,1
2020-01-01,LUX,Kelantan,0,0,0
2020-01-01,LUX,Perak,0,0,0
2020-01-01,LUX,Perlis,1,1,0
2020-01-01,LUX,Pulau Pinang,2,1,1
2020-01-01,LUX,Sabah,0,0,0
2020-01-01,LUX,Sarawak,0,0,0
2020-01-01,LUX,Selangor,38,23,15
2020-01-01,LVA,Johor,61,27,34
2020-01-01,LVA,Kedah,44,21,23
2020-01-01,LVA,Kelantan,0,0,0
2020-01-01,LVA,Pahang,0,0,0
2020-01-01,LVA,Perak,0,0,0
2020-01-01,LVA,Perlis,3,3,0
2020-01-01,LVA,Pulau Pinang,6,4,2
2020-01-01,LVA,Sabah,68,29,39
2020-01-01,LVA,Sarawak,1,1,0
2020-01-01,LVA,Selangor,254,119,135
2020-01-01,LVA,W.P. Labuan,0,0,0
2020-01-01,MAC,Johor,0,0,0
2020-01-01,MAC,Pahang,0,0,0
2020-01-01,MAC,Perak,0,0,0
2020-01-01,MAC,Selangor,0,0,0
2020-01-01,MAC,W.P. Labuan,0,0,0
2020-01-01,MAR,Johor,59,49,10
2020-01-01,MAR,Kedah,17,14,3
2020-01-01,MAR,Kelantan,1,1,0
2020-01-01,MAR,Melaka,0,0,0
2020-01-01,MAR,Pahang,0,0,0
2020-01-01,MAR,Perak,0,0,0
2020-01-01,MAR,Perlis,0,0,0
2020-01-01,MAR,Pulau Pinang,6,2,4
2020-01-01,MAR,Sabah,5,2,3
2020-01-01,MAR,Sarawak,7,5,2
2020-01-01,MAR,Selangor,858,438,420
2020-01-01,MAR,W.P. Labuan,0,0,0
2020-01-01,MCO,Johor,1,0,1
2020-01-01,MCO,Kedah,0,0,0
2020-01-01,MCO,Sabah,0,0,0
2020-01-01,MCO,Selangor,2,1,1
2020-01-01,MDA,Johor,3,2,1
2020-01-01,MDA,Kedah,11,6,5
2020-01-01,MDA,Kelantan,2,1,1
2020-01-01,MDA,Negeri Sembilan,0,0,0
2020-01-01,MDA,Perlis,0,0,0
2020-01-01,MDA,Pulau Pinang,2,0,2
2020-01-01,MDA,Sabah,9,5,4
2020-01-01,MDA,Sarawak,0,0,0
2020-01-01,MDA,Selangor,32,10,22
2020-01-01,MDG,Johor,18,9,9
2020-01-01,MDG,Kedah,3,1,2
2020-01-01,MDG,Perak,0,0,0
2020-01-01,MDG,Perlis,0,0,0
2020-01-01,MDG,Pulau Pinang,0,0,0
2020-01-01,MDG,Sabah,0,0,0
2020-01-01,MDG,Sarawak,0,0,0
2020-01-01,MDG,Selangor,55,32,23
2020-01-01,MDV,Johor,295,144,151
2020-01-01,MDV,Kedah,1,1,0
2020-01-01,MDV,Kelantan,0,0,0
2020-01-01,MDV,Perak,0,0,0
2020-01-01,MDV,Perlis,2,1,1
2020-01-01,MDV,Pulau Pinang,2,1,1
2020-01-01,MDV,Sabah,0,0,0
2020-01-01,MDV,Sarawak,0,0,0
2020-01-01,MDV,Selangor,2241,1185,1056
2020-01-01,MEX,Johor,151,78,73
2020-01-01,MEX,Kedah,11,3,8
2020-01-01,MEX,Kelantan,0,0,0
2020-01-01,MEX,Pahang,0,0,0
2020-01-01,MEX,Perak,2,1,1
2020-01-01,MEX,Perlis,1,1,0
2020-01-01,MEX,Pulau Pinang,27,17,10
2020-01-01,MEX,Sabah,3,2,1
2020-01-01,MEX,Sarawak,8,6,2
2020-01-01,MEX,Selangor,554,313,241
2020-01-01,MEX,W.P. Labuan,0,0,0
2020-01-01,MHL,Johor,0,0,0
2020-01-01,MHL,Kedah,0,0,0
2020-01-01,MHL,Perak,0,0,0
2020-01-01,MHL,Pulau Pinang,0,0,0
2020-01-01,MHL,Sabah,0,0,0
2020-01-01,MHL,Selangor,1,1,0
2020-01-01,MKD,Johor,10,5,5
2020-01-01,MKD,Kedah,2,2,0
2020-01-01,MKD,Perak,0,0,0
2020-01-01,MKD,Pulau Pinang,0,0,0
2020-01-01,MKD,Sabah,2,1,1
2020-01-01,MKD,Sarawak,1,1,0
2020-01-01,MKD,Selangor,22,16,6
2020-01-01,MLI,Johor,0,0,0
2020-01-01,MLI,Sabah,0,0,0
2020-01-01,MLI,Selangor,11,8,3
2020-01-01,MLT,Johor,9,7,2
2020-01-01,MLT,Kedah,3,3,0
2020-01-01,MLT,Kelantan,0,0,0
2020-01-01,MLT,Perak,2,0,2
2020-01-01,MLT,Perlis,0,0,0
2020-01-01,MLT,Pulau Pinang,0,0,0
2020-01-01,MLT,Sabah,1,1,0
2020-01-01,MLT,Sarawak,0,0,0
2020-01-01,MLT,Selangor,47,31,16
2020-01-01,MLT,W.P. Labuan,2,1,1
2020-01-01,MMR,Johor,5305,1824,3481
2020-01-01,MMR,Kedah,12,6,6
2020-01-01,MMR,Kelantan,3,1,2
2020-01-01,MMR,Negeri Sembilan,0,0,0
2020-01-01,MMR,Pahang,2,1,1
2020-01-01,MMR,Perak,14,3,11
2020-01-01,MMR,Perlis,5,0,5
2020-01-01,MMR,Pulau Pinang,310,168,142
2020-01-01,MMR,Sabah,8,0,8
2020-01-01,MMR,Sarawak,121,63,58
2020-01-01,MMR,Selangor,10964,8342,2622
2020-01-01,MMR,Terengganu,0,0,0
2020-01-01,MMR,W.P. Labuan,0,0,0
2020-01-01,MNE,Johor,1,1,0
2020-01-01,MNE,Kedah,0,0,0
2020-01-01,MNE,Pulau Pinang,1,1,0
2020-01-01,MNE,Sabah,0,0,0
2020-01-01,MNE,Sarawak,0,0,0
2020-01-01,MNE,Selangor,22,17,5
2020-01-01,MNG,Johor,273,118,155
2020-01-01,MNG,Kedah,14,2,12
2020-01-01,MNG,Kelantan,0,0,0
2020-01-01,MNG,Perak,0,0,0
2020-01-01,MNG,Perlis,1,0,1
2020-01-01,MNG,Pulau Pinang,9,7,2
2020-01-01,MNG,Sabah,10,5,5
2020-01-01,MNG,Sarawak,5,5,0
2020-01-01,MNG,Selangor,607,249,358
2020-01-01,MNP,Selangor,2,2,0
2020-01-01,MOZ,Johor,0,0,0
2020-01-01,MOZ,Kedah,0,0,0
2020-01-01,MOZ,Perak,1,1,0
2020-01-01,MOZ,Pulau Pinang,0,0,0
2020-01-01,MOZ,Sabah,1,1,0
2020-01-01,MOZ,Sarawak,0,0,0
2020-01-01,MOZ,Selangor,86,51,35
2020-01-01,MRT,Johor,1,1,0
2020-01-01,MRT,Kedah,1,1,0
2020-01-01,MRT,Pulau Pinang,0,0,0
2020-01-01,MRT,Sabah,0,0,0
2020-01-01,MRT,Sarawak,0,0,0
2020-01-01,MRT,Selangor,34,22,12
2020-01-01,MUS,Johor,305,158,147
2020-01-01,MUS,Kedah,2,1,1
2020-01-01,MUS,Kelantan,0,0,0
2020-01-01,MUS,Pahang,0,0,0
2020-01-01,MUS,Perak,0,0,0
2020-01-01,MUS,Perlis,1,0,1
2020-01-01,MUS,Pulau Pinang,3,1,2
2020-01-01,MUS,Sabah,4,3,1
2020-01-01,MUS,Sarawak,0,0,0
2020-01-01,MUS,Selangor,1261,623,638
2020-01-01,MWI,Johor,0,0,0
2020-01-01,MWI,Pulau Pinang,0,0,0
2020-01-01,MWI,Sabah,0,0,0
2020-01-01,MWI,Sarawak,0,0,0
2020-01-01,MWI,Selangor,37,15,22
2020-01-01,MYT,Selangor,1,0,1
2020-01-01,NAM,Johor,2,1,1
2020-01-01,NAM,Kedah,1,0,1
2020-01-01,NAM,Perak,0,0,0
2020-01-01,NAM,Perlis,0,0,0
2020-01-01,NAM,Pulau Pinang,0,0,0
2020-01-01,NAM,Sabah,0,0,0
2020-01-01,NAM,Sarawak,0,0,0
2020-01-01,NAM,Selangor,25,7,18
2020-01-01,NCL,Selangor,0,0,0
2020-01-01,NER,Johor,0,0,0
2020-01-01,NER,Sabah,0,0,0
2020-01-01,NER,Selangor,7,6,1
2020-01-01,NGA,Johor,31,23,8
2020-01-01,NGA,Kedah,2,2,0
2020-01-01,NGA,Perlis,1,1,0
2020-01-01,NGA,Pulau Pinang,9,7,2
2020-01-01,NGA,Sabah,0,0,0
2020-01-01,NGA,Sarawak,5,3,2
2020-01-01,NGA,Selangor,790,625,165
2020-01-01,NIC,Johor,5,3,2
2020-01-01,NIC,Kedah,0,0,0
2020-01-01,NIC,Pulau Pinang,1,1,0
2020-01-01,NIC,Sabah,0,0,0
2020-01-01,NIC,Selangor,6,1,5
2020-01-01,NLD,Johor,1035,663,372
2020-01-01,NLD,Kedah,559,284,275
2020-01-01,NLD,Kelantan,7,6,1
2020-01-01,NLD,Melaka,1,1,0
2020-01-01,NLD,Negeri Sembilan,0,0,0
2020-01-01,NLD,Pahang,1,1,0
2020-01-01,NLD,Perak,24,14,10
2020-01-01,NLD,Perlis,74,46,28
2020-01-01,NLD,Pulau Pinang,280,177,103
2020-01-01,NLD,Sabah,71,41,30
2020-01-01,NLD,Sarawak,228,154,74
2020-01-01,NLD,Selangor,4862,3023,1839
2020-01-01,NLD,Terengganu,0,0,0
2020-01-01,NLD,W.P. Labuan,9,7,2
2020-01-01,NOR,Johor,244,150,94
2020-01-01,NOR,Kedah,232,122,110
2020-01-01,NOR,Kelantan,0,0,0
2020-01-01,NOR,Melaka,0,0,0
2020-01-01,NOR,Pahang,4,2,2
2020-01-01,NOR,Perak,2,2,0
2020-01-01,NOR,Perlis,12,9,3
2020-01-01,NOR,Pulau Pinang,63,39,24
2020-01-01,NOR,Sabah,14,11,3
2020-01-01,NOR,Sarawak,32,22,10
2020-01-01,NOR,Selangor,1148,679,469
2020-01-01,NOR,W.P. Labuan,2,2,0
2020-01-01,NPL,Johor,1993,1713,280
2020-01-01,NPL,Kedah,20,16,4
2020-01-01,NPL,Pahang,0,0,0
2020-01-01,NPL,Perak,0,0,0
2020-01-01,NPL,Perlis,1,1,0
2020-01-01,NPL,Pulau Pinang,75,72,3
2020-01-01,NPL,Sabah,1,1,0
2020-01-01,NPL,Sarawak,211,152,59
2020-01-01,NPL,Selangor,11790,11056,734
2020-01-01,NPL,W.P. Labuan,126,105,21
2020-01-01,NRU,Johor,0,0,0
2020-01-01,NRU,Pulau Pinang,0,0,0
2020-01-01,NRU,Selangor,1,1,0
2020-01-01,NZL,Johor,1294,731,563
2020-01-01,NZL,Kedah,173,102,71
2020-01-01,NZL,Kelantan,7,4,3
2020-01-01,NZL,Melaka,5,2,3
2020-01-01,NZL,Negeri Sembilan,0,0,0
2020-01-01,NZL,Pahang,2,2,0
2020-01-01,NZL,Perak,32,21,11
2020-01-01,NZL,Perlis,38,26,12
2020-01-01,NZL,Pulau Pinang,286,160,126
2020-01-01,NZL,Sabah,103,60,43
2020-01-01,NZL,Sarawak,235,128,107
2020-01-01,NZL,Selangor,4014,2286,1728
2020-01-01,NZL,Terengganu,0,0,0
2020-01-01,NZL,W.P. Labuan,5,4,1
2020-01-01,OMN,Johor,71,47,24
2020-01-01,OMN,Kedah,15,9,6
2020-01-01,OMN,Kelantan,0,0,0
2020-01-01,OMN,Melaka,0,0,0
2020-01-01,OMN,Perak,0,0,0
2020-01-01,OMN,Perlis,4,4,0
2020-01-01,OMN,Pulau Pinang,17,8,9
2020-01-01,OMN,Sabah,0,0,0
2020-01-01,OMN,Sarawak,19,9,10
2020-01-01,OMN,Selangor,2213,1245,968
2020-01-01,PAK,Johor,984,729,255
2020-01-01,PAK,Kedah,150,100,50
2020-01-01,PAK,Kelantan,11,11,0
2020-01-01,PAK,Melaka,0,0,0
2020-01-01,PAK,Negeri Sembilan,0,0,0
2020-01-01,PAK,Pahang,0,0,0
2020-01-01,PAK,Perak,8,7,1
2020-01-01,PAK,Perlis,13,13,0
2020-01-01,PAK,Pulau Pinang,61,48,13
2020-01-01,PAK,Sabah,17,12,5
2020-01-01,PAK,Sarawak,360,326,34
2020-01-01,PAK,Selangor,12658,10329,2329
2020-01-01,PAK,W.P. Labuan,12,12,0
2020-01-01,PAN,Johor,13,9,4
2020-01-01,PAN,Kedah,1,0,1
2020-01-01,PAN,Perak,0,0,0
2020-01-01,PAN,Perlis,0,0,0
2020-01-01,PAN,Pulau Pinang,2,2,0
2020-01-01,PAN,Sabah,3,2,1
2020-01-01,PAN,Sarawak,0,0,0
2020-01-01,PAN,Selangor,53,25,28
2020-01-01,PER,Johor,44,21,23
2020-01-01,PER,Kedah,15,6,9
2020-01-01,PER,Kelantan,1,1,0
2020-01-01,PER,Pahang,0,0,0
2020-01-01,PER,Perak,0,0,0
2020-01-01,PER,Perlis,1,0,1
2020-01-01,PER,Pulau Pinang,1,0,1
2020-01-01,PER,Sabah,1,0,1
2020-01-01,PER,Sarawak,0,0,0
2020-01-01,PER,Selangor,159,85,74
2020-01-01,PER,W.P. Labuan,0,0,0
2020-01-01,PHL,Johor,21386,6642,14744
2020-01-01,PHL,Kedah,1217,415,802
2020-01-01,PHL,Kelantan,50,19,31
2020-01-01,PHL,Melaka,0,0,0
2020-01-01,PHL,Negeri Sembilan,1,0,1
2020-01-01,PHL,Pahang,9,5,4
2020-01-01,PHL,Perak,77,24,53
2020-01-01,PHL,Perlis,169,59,110
2020-01-01,PHL,Pulau Pinang,430,180,250
2020-01-01,PHL,Sabah,2502,1221,1281
2020-01-01,PHL,Sarawak,3771,1536,2235
2020-01-01,PHL,Selangor,16643,6462,10181
2020-01-01,PHL,Terengganu,0,0,0
2020-01-01,PHL,W.P. Labuan,195,83,112
2020-01-01,PLW,Johor,0,0,0
2020-01-01,PLW,Pulau Pinang,0,0,0
2020-01-01,PLW,Selangor,0,0,0
2020-01-01,PNG,Johor,21,15,6
2020-01-01,PNG,Kedah,0,0,0
2020-01-01,PNG,Kelantan,1,0,1
2020-01-01,PNG,Perak,0,0,0
2020-01-01,PNG,Pulau Pinang,1,0,1
2020-01-01,PNG,Sabah,1,1,0
2020-01-01,PNG,Sarawak,3,1,2
2020-01-01,PNG,Selangor,82,43,39
2020-01-01,POL,Johor,828,397,431
2020-01-01,POL,Kedah,554,274,280
2020-01-01,POL,Kelantan,5,1,4
2020-01-01,POL,Melaka,1,1,0
2020-01-01,POL,Negeri Sembilan,1,1,0
2020-01-01,POL,Pahang,0,0,0
2020-01-01,POL,Perak,3,1,2
2020-01-01,POL,Perlis,75,40,35
2020-01-01,POL,Pulau Pinang,108,59,49
2020-01-01,POL,Sabah,65,25,40
2020-01-01,POL,Sarawak,41,17,24
2020-01-01,POL,Selangor,2079,1071,1008
2020-01-01,POL,Terengganu,0,0,0
2020-01-01,POL,W.P. Labuan,3,2,1
2020-01-01,PRK,Selangor,3,3,0
2020-01-01,PRT,Johor,199,104,95
2020-01-01,PRT,Kedah,155,72,83
2020-01-01,PRT,Kelantan,1,1,0
2020-01-01,PRT,Melaka,0,0,0
2020-01-01,PRT,Pahang,0,0,0
2020-01-01,PRT,Perak,3,2,1
2020-01-01,PRT,Perlis,14,7,7
2020-01-01,PRT,Pulau Pinang,20,11,9
2020-01-01,PRT,Sabah,27,12,15
2020-01-01,PRT,Sarawak,11,6,5
2020-01-01,PRT,Selangor,646,356,290
2020-01-01,PRT,W.P. Labuan,1,1,0
2020-01-01,PRY,Johor,4,2,2
2020-01-01,PRY,Kedah,0,0,0
2020-01-01,PRY,Perak,0,0,0
2020-01-01,PRY,Perlis,0,0,0
2020-01-01,PRY,Pulau Pinang,0,0,0
2020-01-01,PRY,Sabah,0,0,0
2020-01-01,PRY,Sarawak,0,0,0
2020-01-01,PRY,Selangor,6,1,5
2020-01-01,PSE,Johor,4,1,3
2020-01-01,PSE,Kedah,17,10,7
2020-01-01,PSE,Kelantan,0,0,0
2020-01-01,PSE,Melaka,0,0,0
2020-01-01,PSE,Perak,0,0,0
2020-01-01,PSE,Perlis,0,0,0
2020-01-01,PSE,Pulau Pinang,5,3,2
2020-01-01,PSE,Sabah,2,2,0
2020-01-01,PSE,Sarawak,1,1,0
2020-01-01,PSE,Selangor,518,377,141
2020-01-01,QAT,Johor,5,3,2
2020-01-01,QAT,Kedah,9,4,5
2020-01-01,QAT,Perlis,0,0,0
2020-01-01,QAT,Pulau Pinang,2,1,1
2020-01-01,QAT,Sabah,0,0,0
2020-01-01,QAT,Sarawak,1,1,0
2020-01-01,QAT,Selangor,122,88,34
2020-01-01,REU,Johor,0,0,0
2020-01-01,REU,Sarawak,0,0,0
2020-01-01,ROU,Johor,204,115,89
2020-01-01,ROU,Kedah,275,128,147
2020-01-01,ROU,Kelantan,2,2,0
2020-01-01,ROU,Negeri Sembilan,2,2,0
2020-01-01,ROU,Pahang,0,0,0
2020-01-01,ROU,Perak,2,2,0
2020-01-01,ROU,Perlis,3,0,3
2020-01-01,ROU,Pulau Pinang,33,21,12
2020-01-01,ROU,Sabah,11,5,6
2020-01-01,ROU,Sarawak,10,4,6
2020-01-01,ROU,Selangor,1053,533,520
2020-01-01,ROU,W.P. Labuan,2,1,1
2020-01-01,RUS,Johor,538,307,231
2020-01-01,RUS,Kedah,1788,849,939
2020-01-01,RUS,Kelantan,93,45,48
2020-01-01,RUS,Melaka,4,4,0
2020-01-01,RUS,Negeri Sembilan,0,0,0
2020-01-01,RUS,Pahang,6,4,2
2020-01-01,RUS,Perak,6,4,2
2020-01-01,RUS,Perlis,284,151,133
2020-01-01,RUS,Pulau Pinang,151,83,68
2020-01-01,RUS,Sabah,213,86,127
2020-01-01,RUS,Sarawak,64,38,26
2020-01-01,RUS,Selangor,11045,5134,5911
2020-01-01,RUS,W.P. Labuan,9,5,4
2020-01-01,RWA,Johor,0,0,0
2020-01-01,RWA,Kedah,0,0,0
2020-01-01,RWA,Pulau Pinang,0,0,0
2020-01-01,RWA,Selangor,13,5,8
2020-01-01,SAU,Johor,316,151,165
2020-01-01,SAU,Kedah,72,32,40
2020-01-01,SAU,Kelantan,5,2,3
2020-01-01,SAU,Melaka,0,0,0
2020-01-01,SAU,Perak,2,1,1
2020-01-01,SAU,Perlis,1,1,0
2020-01-01,SAU,Pulau Pinang,52,26,26
2020-01-01,SAU,Sabah,2,2,0
2020-01-01,SAU,Sarawak,10,9,1
2020-01-01,SAU,Selangor,19141,9733,9408
2020-01-01,SAU,W.P. Labuan,0,0,0
2020-01-01,SDN,Johor,6,6,0
2020-01-01,SDN,Kedah,1,1,0
2020-01-01,SDN,Kelantan,0,0,0
2020-01-01,SDN,Perlis,2,1,1
2020-01-01,SDN,Pulau Pinang,2,1,1
2020-01-01,SDN,Sabah,1,1,0
2020-01-01,SDN,Sarawak,4,4,0
2020-01-01,SDN,Selangor,1503,877,626
2020-01-01,SDN,W.P. Labuan,0,0,0
2020-01-01,SEN,Johor,11,7,4
2020-01-01,SEN,Kedah,1,1,0
2020-01-01,SEN,Kelantan,0,0,0
2020-01-01,SEN,Perak,0,0,0
2020-01-01,SEN,Perlis,0,0,0
2020-01-01,SEN,Pulau Pinang,0,0,0
2020-01-01,SEN,Sabah,0,0,0
2020-01-01,SEN,Sarawak,0,0,0
2020-01-01,SEN,Selangor,59,46,13
2020-01-01,SGP,Johor,1209142,702096,507046
2020-01-01,SGP,Kedah,2162,1276,886
2020-01-01,SGP,Kelantan,373,182,191
2020-01-01,SGP,Melaka,38,28,10
2020-01-01,SGP,Negeri Sembilan,0,0,0
2020-01-01,SGP,Pahang,471,239,232
2020-01-01,SGP,Perak,4672,2349,2323
2020-01-01,SGP,Perlis,260,157,103
2020-01-01,SGP,Pulau Pinang,9240,4852,4388
2020-01-01,SGP,Sabah,1800,950,850
2020-01-01,SGP,Sarawak,3672,2056,1616
2020-01-01,SGP,Selangor,33173,19025,14148
2020-01-01,SGP,Terengganu,0,0,0
2020-01-01,SGP,W.P. Labuan,31,27,4
2020-01-01,SGS,Johor,0,0,0
2020-01-01,SGS,Sabah,0,0,0
2020-01-01,SGS,Selangor,0,0,0
2020-01-01,SHN,Sarawak,0,0,0
2020-01-01,SLB,Johor,5,5,0
2020-01-01,SLB,Perlis,0,0,0
2020-01-01,SLB,Pulau Pinang,0,0,0
2020-01-01,SLB,Sabah,0,0,0
2020-01-01,SLB,Sarawak,18,6,12
2020-01-01,SLB,Selangor,12,4,8
2020-01-01,SLB,W.P. Labuan,0,0,0
2020-01-01,SLE,Johor,2,1,1
2020-01-01,SLE,Kedah,0,0,0
2020-01-01,SLE,Perak,0,0,0
2020-01-01,SLE,Pulau Pinang,0,0,0
2020-01-01,SLE,Sabah,0,0,0
2020-01-01,SLE,Selangor,52,33,19
2020-01-01,SLV,Johor,1,0,1
2020-01-01,SLV,Kedah,1,0,1
2020-01-01,SLV,Perak,0,0,0
2020-01-01,SLV,Perlis,0,0,0
2020-01-01,SLV,Pulau Pinang,1,0,1
2020-01-01,SLV,Sabah,2,1,1
2020-01-01,SLV,Selangor,19,8,11
2020-01-01,SLV,W.P. Labuan,0,0,0
2020-01-01,SMR,Johor,0,0,0
2020-01-01,SMR,Selangor,3,2,1
2020-01-01,SOM,Johor,6,6,0
2020-01-01,SOM,Kedah,2,2,0
2020-01-01,SOM,Kelantan,0,0,0
2020-01-01,SOM,Perlis,1,0,1
2020-01-01,SOM,Sabah,0,0,0
2020-01-01,SOM,Sarawak,0,0,0
2020-01-01,SOM,Selangor,343,194,149
2020-01-01,SRB,Johor,18,11,7
2020-01-01,SRB,Kedah,12,6,6
2020-01-01,SRB,Kelantan,0,0,0
2020-01-01,SRB,Pahang,0,0,0
2020-01-01,SRB,Perak,0,0,0
2020-01-01,SRB,Perlis,0,0,0
2020-01-01,SRB,Pulau Pinang,1,1,0
2020-01-01,SRB,Sabah,7,4,3
2020-01-01,SRB,Sarawak,0,0,0
2020-01-01,SRB,Selangor,153,85,68
2020-01-01,SSD,Johor,0,0,0
2020-01-01,SSD,Kedah,1,1,0
2020-01-01,SSD,Sarawak,1,1,0
2020-01-01,SSD,Selangor,31,22,9
2020-01-01,SSD,W.P. Labuan,1,1,0
2020-01-01,STP,Selangor,8,3,5
2020-01-01,SUR,Johor,6,3,3
2020-01-01,SUR,Kedah,0,0,0
2020-01-01,SUR,Kelantan,0,0,0
2020-01-01,SUR,Perak,1,0,1
2020-01-01,SUR,Perlis,0,0,0
2020-01-01,SUR,Pulau Pinang,0,0,0
2020-01-01,SUR,Sabah,0,0,0
2020-01-01,SUR,Sarawak,1,1,0
2020-01-01,SUR,Selangor,7,5,2
2020-01-01,SVK,Johor,34,19,15
2020-01-01,SVK,Kedah,242,126,116
2020-01-01,SVK,Kelantan,1,1,0
2020-01-01,SVK,Negeri Sembilan,0,0,0
2020-01-01,SVK,Pahang,1,0,1
2020-01-01,SVK,Perak,1,0,1
2020-01-01,SVK,Perlis,3,1,2
2020-01-01,SVK,Pulau Pinang,13,6,7
2020-01-01,SVK,Sabah,16,10,6
2020-01-01,SVK,Sarawak,7,4,3
2020-01-01,SVK,Selangor,571,311,260
2020-01-01,SVK,W.P. Labuan,2,2,0
2020-01-01,SVN,Johor,25,15,10
2020-01-01,SVN,Kedah,30,19,11
2020-01-01,SVN,Kelantan,0,0,0
2020-01-01,SVN,Perak,0,0,0
2020-01-01,SVN,Perlis,3,2,1
2020-01-01,SVN,Pulau Pinang,3,2,1
2020-01-01,SVN,Sabah,2,1,1
2020-01-01,SVN,Sarawak,4,3,1
2020-01-01,SVN,Selangor,138,81,57
2020-01-01,SVN,W.P. Labuan,0,0,0
2020-01-01,SWE,Johor,491,277,214
2020-01-01,SWE,Kedah,1241,609,632
2020-01-01,SWE,Kelantan,15,12,3
2020-01-01,SWE,Melaka,0,0,0
2020-01-01,SWE,Negeri Sembilan,0,0,0
2020-01-01,SWE,Pahang,3,1,2
2020-01-01,SWE,Perak,8,6,2
2020-01-01,SWE,Perlis,32,22,10
2020-01-01,SWE,Pulau Pinang,172,107,65
2020-01-01,SWE,Sabah,33,20,13
2020-01-01,SWE,Sarawak,19,11,8
2020-01-01,SWE,Selangor,2777,1614,1163
2020-01-01,SWE,W.P. Labuan,1,1,0
2020-01-01,SWZ,Johor,1,0,1
2020-01-01,SWZ,Kedah,0,0,0
2020-01-01,SWZ,Pulau Pinang,0,0,0
2020-01-01,SWZ,Sabah,0,0,0
2020-01-01,SWZ,Selangor,9,4,5
2020-01-01,SYC,Johor,17,9,8
2020-01-01,SYC,Kedah,0,0,0
2020-01-01,SYC,Pulau Pinang,0,0,0
2020-01-01,SYC,Sabah,0,0,0
2020-01-01,SYC,Sarawak,4,3,1
2020-01-01,SYC,Selangor,149,72,77
2020-01-01,SYR,Johor,23,16,7
2020-01-01,SYR,Kedah,11,6,5
2020-01-01,SYR,Kelantan,0,0,0
2020-01-01,SYR,Pahang,8,8,0
2020-01-01,SYR,Perlis,0,0,0
2020-01-01,SYR,Pulau Pinang,3,3,0
2020-01-01,SYR,Sabah,2,2,0
2020-01-01,SYR,Sarawak,2,1,1
2020-01-01,SYR,Selangor,1021,660,361
2020-01-01,SYR,W.P. Labuan,0,0,0
2020-01-01,TCA,Perlis,0,0,0
2020-01-01,TCD,Johor,2,1,1
2020-01-01,TCD,Kedah,0,0,0
2020-01-01,TCD,Perlis,0,0,0
2020-01-01,TCD,Selangor,25,19,6
2020-01-01,TGO,Johor,2,2,0
2020-01-01,TGO,Perak,0,0,0
2020-01-01,TGO,Pulau Pinang,0,0,0
2020-01-01,TGO,Selangor,14,12,2
2020-01-01,THA,Johor,5760,1637,4123
2020-01-01,THA,Kedah,47467,17473,29994
2020-01-01,THA,Kelantan,37479,19581,17898
2020-01-01,THA,Melaka,5,4,1
2020-01-01,THA,Negeri Sembilan,0,0,0
2020-01-01,THA,Pahang,0,0,0
2020-01-01,THA,Perak,14561,6674,7887
2020-01-01,THA,Perlis,47565,27702,19863
2020-01-01,THA,Pulau Pinang,1053,407,646
2020-01-01,THA,Sabah,56,15,41
2020-01-01,THA,Sarawak,660,263,397
2020-01-01,THA,Selangor,10453,4338,6115
2020-01-01,THA,Terengganu,0,0,0
2020-01-01,THA,W.P. Labuan,14,2,12
2020-01-01,TJK,Johor,2,1,1
2020-01-01,TJK,Kedah,3,3,0
2020-01-01,TJK,Perlis,0,0,0
2020-01-01,TJK,Pulau Pinang,1,0,1
2020-01-01,TJK,Sabah,2,2,0
2020-01-01,TJK,Selangor,142,96,46
2020-01-01,TKL,Selangor,2,2,0
2020-01-01,TKM,Johor,4,2,2
2020-01-01,TKM,Kedah,0,0,0
2020-01-01,TKM,Kelantan,0,0,0
2020-01-01,TKM,Perlis,0,0,0
2020-01-01,TKM,Pulau Pinang,0,0,0
2020-01-01,TKM,Sabah,5,2,3
2020-01-01,TKM,Sarawak,0,0,0
2020-01-01,TKM,Selangor,225,128,97
2020-01-01,TLS,Johor,4,2,2
2020-01-01,TLS,Kedah,0,0,0
2020-01-01,TLS,Perlis,0,0,0
2020-01-01,TLS,Pulau Pinang,10,5,5
2020-01-01,TLS,Sabah,0,0,0
2020-01-01,TLS,Sarawak,2,1,1
2020-01-01,TLS,Selangor,105,53,52
2020-01-01,TON,Johor,1,1,0
2020-01-01,TON,Pulau Pinang,1,0,1
2020-01-01,TON,Sarawak,1,0,1
2020-01-01,TON,Selangor,10,7,3
2020-01-01,TTO,Johor,17,13,4
2020-01-01,TTO,Kedah,0,0,0
2020-01-01,TTO,Pahang,0,0,0
2020-01-01,TTO,Pulau Pinang,2,1,1
2020-01-01,TTO,Sabah,0,0,0
2020-01-01,TTO,Sarawak,1,1,0
2020-01-01,TTO,Selangor,32,18,14
2020-01-01,TUN,Johor,15,12,3
2020-01-01,TUN,Kedah,19,11,8
2020-01-01,TUN,Kelantan,0,0,0
2020-01-01,TUN,Melaka,0,0,0
2020-01-01,TUN,Perak,0,0,0
2020-01-01,TUN,Perlis,0,0,0
2020-01-01,TUN,Pulau Pinang,3,2,1
2020-01-01,TUN,Sabah,2,0,2
2020-01-01,TUN,Sarawak,2,1,1
2020-01-01,TUN,Selangor,363,194,169
2020-01-01,TUN,W.P. Labuan,0,0,0
2020-01-01,TUR,Johor,301,206,95
2020-01-01,TUR,Kedah,88,65,23
2020-01-01,TUR,Kelantan,6,6,0
2020-01-01,TUR,Melaka,1,1,0
2020-01-01,TUR,Negeri Sembilan,0,0,0
2020-01-01,TUR,Pahang,2,0,2
2020-01-01,TUR,Perak,0,0,0
2020-01-01,TUR,Perlis,8,7,1
2020-01-01,TUR,Pulau Pinang,13,8,5
2020-01-01,TUR,Sabah,13,10,3
2020-01-01,TUR,Sarawak,30,23,7
2020-01-01,TUR,Selangor,1359,877,482
2020-01-01,TUR,W.P. Labuan,0,0,0
2020-01-01,TUV,Selangor,0,0,0
2020-01-01,TWN,Johor,9852,4268,5584
2020-01-01,TWN,Kedah,184,78,106
2020-01-01,TWN,Kelantan,6,4,2
2020-01-01,TWN,Melaka,12,5,7
2020-01-01,TWN,Negeri Sembilan,0,0,0
2020-01-01,TWN,Pahang,318,154,164
2020-01-01,TWN,Perak,32,10,22
2020-01-01,TWN,Perlis,29,16,13
2020-01-01,TWN,Pulau Pinang,3817,1903,1914
2020-01-01,TWN,Sabah,3684,1751,1933
2020-01-01,TWN,Sarawak,362,145,217
2020-01-01,TWN,Selangor,21324,10163,11161
2020-01-01,TWN,W.P. Labuan,11,4,7
2020-01-01,TZA,Johor,48,31,17
2020-01-01,TZA,Kedah,1,1,0
2020-01-01,TZA,Perak,0,0,0
2020-01-01,TZA,Perlis,0,0,0
2020-01-01,TZA,Pulau Pinang,0,0,0
2020-01-01,TZA,Sabah,0,0,0
2020-01-01,TZA,Sarawak,1,0,1
2020-01-01,TZA,Selangor,272,142,130
2020-01-01,UGA,Johor,52,17,35
2020-01-01,UGA,Kedah,1,0,1
2020-01-01,UGA,Perak,0,0,0
2020-01-01,UGA,Perlis,0,0,0
2020-01-01,UGA,Pulau Pinang,1,0,1
2020-01-01,UGA,Sabah,1,0,1
2020-01-01,UGA,Sarawak,0,0,0
2020-01-01,UGA,Selangor,132,63,69
2020-01-01,UKR,Johor,115,66,49
2020-01-01,UKR,Kedah,489,232,257
2020-01-01,UKR,Kelantan,18,12,6
2020-01-01,UKR,Melaka,0,0,0
2020-01-01,UKR,Negeri Sembilan,1,1,0
2020-01-01,UKR,Pahang,3,3,0
2020-01-01,UKR,Perak,1,1,0
2020-01-01,UKR,Perlis,38,21,17
2020-01-01,UKR,Pulau Pinang,49,21,28
2020-01-01,UKR,Sabah,35,12,23
2020-01-01,UKR,Sarawak,30,20,10
2020-01-01,UKR,Selangor,2165,1037,1128
2020-01-01,UKR,W.P. Labuan,7,4,3
2020-01-01,URY,Johor,8,3,5
2020-01-01,URY,Kedah,3,1,2
2020-01-01,URY,Kelantan,0,0,0
2020-01-01,URY,Perak,0,0,0
2020-01-01,URY,Perlis,2,1,1
2020-01-01,URY,Pulau Pinang,1,1,0
2020-01-01,URY,Sabah,0,0,0
2020-01-01,URY,Sarawak,0,0,0
2020-01-01,URY,Selangor,81,40,41
2020-01-01,URY,W.P. Labuan,0,0,0
2020-01-01,USA,Johor,5788,3284,2504
2020-01-01,USA,Kedah,800,429,371
2020-01-01,USA,Kelantan,32,21,11
2020-01-01,USA,Melaka,1,1,0
2020-01-01,USA,Negeri Sembilan,0,0,0
2020-01-01,USA,Pahang,14,5,9
2020-01-01,USA,Perak,101,57,44
2020-01-01,USA,Perlis,128,80,48
2020-01-01,USA,Pulau Pinang,2264,1332,932
2020-01-01,USA,Sabah,528,285,243
2020-01-01,USA,Sarawak,439,266,173
2020-01-01,USA,Selangor,19067,10998,8069
2020-01-01,USA,Terengganu,0,0,0
2020-01-01,USA,W.P. Labuan,18,12,6
2020-01-01,UZB,Johor,99,69,30
2020-01-01,UZB,Kedah,114,39,75
2020-01-01,UZB,Kelantan,5,4,1
2020-01-01,UZB,Perak,0,0,0
2020-01-01,UZB,Perlis,1,0,1
2020-01-01,UZB,Pulau Pinang,24,11,13
2020-01-01,UZB,Sabah,7,7,0
2020-01-01,UZB,Sarawak,1,1,0
2020-01-01,UZB,Selangor,2055,1226,829
2020-01-01,VAT,Johor,1,1,0
2020-01-01,VAT,Sarawak,0,0,0
2020-01-01,VAT,Selangor,2,2,0
2020-01-01,VCT,Johor,1,0,1
2020-01-01,VCT,Kedah,0,0,0
2020-01-01,VCT,Pulau Pinang,0,0,0
2020-01-01,VCT,Sarawak,0,0,0
2020-01-01,VCT,Selangor,0,0,0
2020-01-01,VEN,Johor,22,13,9
2020-01-01,VEN,Kedah,4,3,1
2020-01-01,VEN,Kelantan,1,1,0
2020-01-01,VEN,Melaka,1,0,1
2020-01-01,VEN,Perak,1,0,1
2020-01-01,VEN,Perlis,0,0,0
2020-01-01,VEN,Pulau Pinang,4,3,1
2020-01-01,VEN,Sabah,5,4,1
2020-01-01,VEN,Sarawak,8,5,3
2020-01-01,VEN,Selangor,98,55,43
2020-01-01,VEN,W.P. Labuan,0,0,0
2020-01-01,VNM,Johor,13125,4305,8820
2020-01-01,VNM,Kedah,581,55,526
2020-01-01,VNM,Kelantan,20,6,14
2020-01-01,VNM,Melaka,4,0,4
2020-01-01,VNM,Negeri Sembilan,2,2,0
2020-01-01,VNM,Pahang,1,0,1
2020-01-01,VNM,Perak,80,17,63
2020-01-01,VNM,Perlis,147,24,123
2020-01-01,VNM,Pulau Pinang,946,248,698
2020-01-01,VNM,Sabah,41,17,24
2020-01-01,VNM,Sarawak,421,101,320
2020-01-01,VNM,Selangor,17898,6592,11306
2020-01-01,VNM,Terengganu,0,0,0
2020-01-01,VNM,W.P. Labuan,12,9,3
2020-01-01,VUT,Johor,40,28,12
2020-01-01,VUT,Kedah,1,1,0
2020-01-01,VUT,Pulau Pinang,7,5,2
2020-01-01,VUT,Sabah,1,1,0
2020-01-01,VUT,Sarawak,0,0,0
2020-01-01,VUT,Selangor,66,52,14
2020-01-01,WSM,Johor,0,0,0
2020-01-01,WSM,Sarawak,0,0,0
2020-01-01,WSM,Selangor,5,4,1
2020-01-01,XXX,Johor,253,134,119
2020-01-01,XXX,Kedah,16,5,11
2020-01-01,XXX,Kelantan,0,0,0
2020-01-01,XXX,Melaka,1,0,1
2020-01-01,XXX,Pahang,0,0,0
2020-01-01,XXX,Perak,9,6,3
2020-01-01,XXX,Perlis,5,5,0
2020-01-01,XXX,Pulau Pinang,103,56,47
2020-01-01,XXX,Sabah,43,21,22
2020-01-01,XXX,Sarawak,95,68,27
2020-01-01,XXX,Selangor,824,501,323
2020-01-01,XXX,W.P. Labuan,3,3,0
2020-01-01,YEM,Johor,54,35,19
2020-01-01,YEM,Kedah,3,3,0
2020-01-01,YEM,Kelantan,0,0,0
2020-01-01,YEM,Melaka,8,6,2
2020-01-01,YEM,Pahang,0,0,0
2020-01-01,YEM,Perak,0,0,0
2020-01-01,YEM,Perlis,0,0,0
2020-01-01,YEM,Pulau Pinang,5,5,0
2020-01-01,YEM,Sabah,0,0,0
2020-01-01,YEM,Sarawak,3,1,2
2020-01-01,YEM,Selangor,2339,1610,729
2020-01-01,YEM,W.P. Labuan,0,0,0
2020-01-01,ZAF,Johor,485,278,207
2020-01-01,ZAF,Kedah,116,67,49
2020-01-01,ZAF,Kelantan,15,5,10
2020-01-01,ZAF,Melaka,2,0,2
2020-01-01,ZAF,Pahang,2,1,1
2020-01-01,ZAF,Perak,1,1,0
2020-01-01,ZAF,Perlis,23,11,12
2020-01-01,ZAF,Pulau Pinang,64,33,31
2020-01-01,ZAF,Sabah,20,10,10
2020-01-01,ZAF,Sarawak,63,42,21
2020-01-01,ZAF,Selangor,1869,986,883
2020-01-01,ZAF,Terengganu,0,0,0
2020-01-01,ZAF,W.P. Labuan,16,7,9
2020-01-01,ZAR,Selangor,0,0,0
2020-01-01,ZMB,Johor,8,5,3
2020-01-01,ZMB,Kedah,0,0,0
2020-01-01,ZMB,Perak,0,0,0
2020-01-01,ZMB,Perlis,0,0,0
2020-01-01,ZMB,Pulau Pinang,3,1,2
2020-01-01,ZMB,Sabah,0,0,0
2020-01-01,ZMB,Sarawak,0,0,0
2020-01-01,ZMB,Selangor,102,52,50
2020-01-01,ZWE,Johor,21,13,8
2020-01-01,ZWE,Kedah,0,0,0
2020-01-01,ZWE,Kelantan,2,2,0
2020-01-01,ZWE,Perak,0,0,0
2020-01-01,ZWE,Perlis,1,1,0
2020-01-01,ZWE,Pulau Pinang,1,1,0
2020-01-01,ZWE,Sabah,4,2,2
2020-01-01,ZWE,Sarawak,1,0,1
2020-01-01,ZWE,Selangor,192,100,92
2020-02-01,ABW,Kedah,0,0,0
2020-02-01,ABW,Pulau Pinang,0,0,0
2020-02-01,AFG,Johor,2,1,1
2020-02-01,AFG,Kedah,3,3,0
2020-02-01,AFG,Perlis,0,0,0
2020-02-01,AFG,Pulau Pinang,0,0,0
2020-02-01,AFG,Sarawak,0,0,0
2020-02-01,AFG,Selangor,249,187,62
2020-02-01,AGO,Johor,0,0,0
2020-02-01,AGO,Kedah,0,0,0
2020-02-01,AGO,Sabah,0,0,0
2020-02-01,AGO,Selangor,8,6,2
2020-02-01,AIA,Selangor,0,0,0
2020-02-01,ALB,Johor,28,15,13
2020-02-01,ALB,Kedah,0,0,0
2020-02-01,ALB,Perak,0,0,0
2020-02-01,ALB,Perlis,0,0,0
2020-02-01,ALB,Pulau Pinang,0,0,0
2020-02-01,ALB,Sabah,0,0,0
2020-02-01,ALB,Sarawak,0,0,0
2020-02-01,ALB,Selangor,29,15,14
2020-02-01,AND,Johor,0,0,0
2020-02-01,AND,Kedah,0,0,0
2020-02-01,AND,Perlis,0,0,0
2020-02-01,AND,Pulau Pinang,0,0,0
2020-02-01,AND,Selangor,9,5,4
2020-02-01,ANT,Selangor,0,0,0
2020-02-01,ARE,Johor,7,5,2
2020-02-01,ARE,Kedah,5,3,2
2020-02-01,ARE,Kelantan,0,0,0
2020-02-01,ARE,Perak,0,0,0
2020-02-01,ARE,Perlis,0,0,0
2020-02-01,ARE,Pulau Pinang,2,0,2
2020-02-01,ARE,Sabah,1,1,0
2020-02-01,ARE,Sarawak,1,1,0
2020-02-01,ARE,Selangor,236,171,65
2020-02-01,ARG,Johor,87,43,44
2020-02-01,ARG,Kedah,122,62,60
2020-02-01,ARG,Kelantan,3,1,2
2020-02-01,ARG,Melaka,0,0,0
2020-02-01,ARG,Perak,0,0,0
2020-02-01,ARG,Perlis,4,3,1
2020-02-01,ARG,Pulau Pinang,7,4,3
2020-02-01,ARG,Sabah,10,5,5
2020-02-01,ARG,Sarawak,5,3,2
2020-02-01,ARG,Selangor,586,323,263
2020-02-01,ARG,W.P. Labuan,0,0,0
2020-02-01,ARM,Johor,5,2,3
2020-02-01,ARM,Kedah,3,2,1
2020-02-01,ARM,Kelantan,0,0,0
2020-02-01,ARM,Perak,0,0,0
2020-02-01,ARM,Perlis,0,0,0
2020-02-01,ARM,Pulau Pinang,0,0,0
2020-02-01,ARM,Sabah,0,0,0
2020-02-01,ARM,Sarawak,0,0,0
2020-02-01,ARM,Selangor,61,34,27
2020-02-01,ATA,Selangor,1,0,1
2020-02-01,ATG,Johor,0,0,0
2020-02-01,ATG,Kedah,0,0,0
2020-02-01,ATG,Pulau Pinang,0,0,0
2020-02-01,ATG,Sarawak,0,0,0
2020-02-01,ATG,Selangor,13,8,5
2020-02-01,AUS,Johor,3385,2170,1215
2020-02-01,AUS,Kedah,470,271,199
2020-02-01,AUS,Kelantan,24,10,14
2020-02-01,AUS,Melaka,3,2,1
2020-02-01,AUS,Negeri Sembilan,0,0,0
2020-02-01,AUS,Pahang,21,11,10
2020-02-01,AUS,Perak,123,72,51
2020-02-01,AUS,Perlis,66,40,26
2020-02-01,AUS,Pulau Pinang,1270,711,559
2020-02-01,AUS,Sabah,390,183,207
2020-02-01,AUS,Sarawak,402,260,142
2020-02-01,AUS,Selangor,16651,10384,6267
2020-02-01,AUS,Terengganu,0,0,0
2020-02-01,AUS,W.P. Labuan,13,8,5
2020-02-01,AUT,Johor,205,138,67
2020-02-01,AUT,Kedah,168,94,74
2020-02-01,AUT,Kelantan,11,10,1
2020-02-01,AUT,Melaka,1,1,0
2020-02-01,AUT,Negeri Sembilan,0,0,0
2020-02-01,AUT,Pahang,0,0,0
2020-02-01,AUT,Perak,14,9,5
2020-02-01,AUT,Perlis,32,18,14
2020-02-01,AUT,Pulau Pinang,54,32,22
2020-02-01,AUT,Sabah,20,10,10
2020-02-01,AUT,Sarawak,17,11,6
2020-02-01,AUT,Selangor,1106,656,450
2020-02-01,AUT,Terengganu,0,0,0
2020-02-01,AUT,W.P. Labuan,1,0,1
2020-02-01,AZE,Johor,3,1,2
2020-02-01,AZE,Kedah,6,3,3
2020-02-01,AZE,Kelantan,0,0,0
2020-02-01,AZE,Melaka,0,0,0
2020-02-01,AZE,Perlis,0,0,0
2020-02-01,AZE,Pulau Pinang,0,0,0
2020-02-01,AZE,Sabah,0,0,0
2020-02-01,AZE,Sarawak,1,0,1
2020-02-01,AZE,Selangor,90,56,34
2020-02-01,AZE,W.P. Labuan,0,0,0
2020-02-01,BDI,Pulau Pinang,0,0,0
2020-02-01,BDI,Sarawak,0,0,0
2020-02-01,BDI,Selangor,1,0,1
2020-02-01,BEL,Johor,242,171,71
2020-02-01,BEL,Kedah,160,84,76
2020-02-01,BEL,Kelantan,8,6,2
2020-02-01,BEL,Melaka,1,1,0
2020-02-01,BEL,Negeri Sembilan,2,1,1
2020-02-01,BEL,Pahang,1,0,1
2020-02-01,BEL,Perak,7,6,1
2020-02-01,BEL,Perlis,30,19,11
2020-02-01,BEL,Pulau Pinang,62,35,27
2020-02-01,BEL,Sabah,23,13,10
2020-02-01,BEL,Sarawak,15,7,8
2020-02-01,BEL,Selangor,1206,803,403
2020-02-01,BEL,W.P. Labuan,3,2,1
2020-02-01,BEN,Johor,3,1,2
2020-02-01,BEN,Kedah,0,0,0
2020-02-01,BEN,Perak,0,0,0
2020-02-01,BEN,Pulau Pinang,0,0,0
2020-02-01,BEN,Sabah,0,0,0
2020-02-01,BEN,Sarawak,0,0,0
2020-02-01,BEN,Selangor,4,2,2
2020-02-01,BFA,Perak,0,0,0
2020-02-01,BFA,Pulau Pinang,0,0,0
2020-02-01,BFA,Selangor,7,7,0
2020-02-01,BGD,Johor,1625,1366,259
2020-02-01,BGD,Kedah,11,6,5
2020-02-01,BGD,Kelantan,1,0,1
2020-02-01,BGD,Melaka,0,0,0
2020-02-01,BGD,Negeri Sembilan,0,0,0
2020-02-01,BGD,Pahang,0,0,0
2020-02-01,BGD,Perak,0,0,0
2020-02-01,BGD,Perlis,0,0,0
2020-02-01,BGD,Pulau Pinang,90,80,10
2020-02-01,BGD,Sabah,9,9,0
2020-02-01,BGD,Sarawak,158,134,24
2020-02-01,BGD,Selangor,17763,15754,2009
2020-02-01,BGD,W.P. Labuan,11,11,0
2020-02-01,BGR,Johor,36,24,12
2020-02-01,BGR,Kedah,66,37,29
2020-02-01,BGR,Kelantan,0,0,0
2020-02-01,BGR,Pahang,4,4,0
2020-02-01,BGR,Perak,4,4,0
2020-02-01,BGR,Perlis,0,0,0
2020-02-01,BGR,Pulau Pinang,5,3,2
2020-02-01,BGR,Sabah,3,1,2
2020-02-01,BGR,Sarawak,0,0,0
2020-02-01,BGR,Selangor,369,211,158
2020-02-01,BGR,W.P. Labuan,0,0,0
2020-02-01,BHR,Johor,17,8,9
2020-02-01,BHR,Kedah,0,0,0
2020-02-01,BHR,Kelantan,0,0,0
2020-02-01,BHR,Perlis,0,0,0
2020-02-01,BHR,Pulau Pinang,0,0,0
2020-02-01,BHR,Sabah,1,1,0
2020-02-01,BHR,Sarawak,4,4,0
2020-02-01,BHR,Selangor,72,48,24
2020-02-01,BHS,Johor,1,1,0
2020-02-01,BHS,Kedah,0,0,0
2020-02-01,BHS,Perak,0,0,0
2020-02-01,BHS,Sabah,1,0,1
2020-02-01,BHS,Sarawak,0,0,0
2020-02-01,BHS,Selangor,3,3,0
2020-02-01,BIH,Johor,5,3,2
2020-02-01,BIH,Kedah,7,2,5
2020-02-01,BIH,Perlis,2,2,0
2020-02-01,BIH,Pulau Pinang,1,0,1
2020-02-01,BIH,Sabah,0,0,0
2020-02-01,BIH,Sarawak,0,0,0
2020-02-01,BIH,Selangor,67,37,30
2020-02-01,BLR,Johor,13,7,6
2020-02-01,BLR,Kedah,32,15,17
2020-02-01,BLR,Kelantan,3,1,2
2020-02-01,BLR,Pahang,0,0,0
2020-02-01,BLR,Perak,0,0,0
2020-02-01,BLR,Perlis,4,2,2
2020-02-01,BLR,Pulau Pinang,2,0,2
2020-02-01,BLR,Sabah,2,2,0
2020-02-01,BLR,Sarawak,4,1,3
2020-02-01,BLR,Selangor,444,207,237
2020-02-01,BLR,W.P. Labuan,0,0,0
2020-02-01,BLZ,Johor,1,1,0
2020-02-01,BLZ,Pulau Pinang,0,0,0
2020-02-01,BLZ,Sarawak,0,0,0
2020-02-01,BLZ,Selangor,6,3,3
2020-02-01,BMU,Selangor,0,0,0
2020-02-01,BOL,Johor,0,0,0
2020-02-01,BOL,Kedah,1,0,1
2020-02-01,BOL,Melaka,0,0,0
2020-02-01,BOL,Perak,0,0,0
2020-02-01,BOL,Perlis,0,0,0
2020-02-01,BOL,Pulau Pinang,0,0,0
2020-02-01,BOL,Sabah,0,0,0
2020-02-01,BOL,Sarawak,0,0,0
2020-02-01,BOL,Selangor,21,12,9
2020-02-01,BRA,Johor,153,88,65
2020-02-01,BRA,Kedah,75,38,37
2020-02-01,BRA,Kelantan,0,0,0
2020-02-01,BRA,Melaka,0,0,0
2020-02-01,BRA,Pahang,0,0,0
2020-02-01,BRA,Perak,5,3,2
2020-02-01,BRA,Perlis,10,4,6
2020-02-01,BRA,Pulau Pinang,25,15,10
2020-02-01,BRA,Sabah,11,8,3
2020-02-01,BRA,Sarawak,12,3,9
2020-02-01,BRA,Selangor,1114,627,487
2020-02-01,BRA,W.P. Labuan,0,0,0
2020-02-01,BRB,Johor,2,1,1
2020-02-01,BRB,Kedah,0,0,0
2020-02-01,BRB,Perlis,0,0,0
2020-02-01,BRB,Pulau Pinang,0,0,0
2020-02-01,BRB,Selangor,6,1,5
2020-02-01,BRN,Johor,167,70,97
2020-02-01,BRN,Kedah,6,3,3
2020-02-01,BRN,Kelantan,4,2,2
2020-02-01,BRN,Melaka,0,0,0
2020-02-01,BRN,Pahang,0,0,0
2020-02-01,BRN,Perak,1,1,0
2020-02-01,BRN,Perlis,6,1,5
2020-02-01,BRN,Pulau Pinang,5,5,0
2020-02-01,BRN,Sabah,474,254,220
2020-02-01,BRN,Sarawak,58473,34982,23491
2020-02-01,BRN,Selangor,4037,2042,1995
2020-02-01,BRN,W.P. Labuan,1556,1064,492
2020-02-01,BTN,Johor,6,6,0
2020-02-01,BTN,Kedah,2,2,0
2020-02-01,BTN,Perak,0,0,0
2020-02-01,BTN,Perlis,0,0,0
2020-02-01,BTN,Pulau Pinang,2,1,1
2020-02-01,BTN,Sabah,0,0,0
2020-02-01,BTN,Sarawak,1,1,0
2020-02-01,BTN,Selangor,32,18,14
2020-02-01,BWA,Johor,5,0,5
2020-02-01,BWA,Kedah,0,0,0
2020-02-01,BWA,Perlis,0,0,0
2020-02-01,BWA,Pulau Pinang,0,0,0
2020-02-01,BWA,Sabah,0,0,0
2020-02-01,BWA,Sarawak,0,0,0
2020-02-01,BWA,Selangor,15,9,6
2020-02-01,CAF,Kedah,0,0,0
2020-02-01,CAF,Selangor,1,1,0
2020-02-01,CAN,Johor,1156,696,460
2020-02-01,CAN,Kedah,288,169,119
2020-02-01,CAN,Kelantan,16,9,7
2020-02-01,CAN,Melaka,0,0,0
2020-02-01,CAN,Negeri Sembilan,0,0,0
2020-02-01,CAN,Pahang,2,2,0
2020-02-01,CAN,Perak,31,16,15
2020-02-01,CAN,Perlis,84,51,33
2020-02-01,CAN,Pulau Pinang,361,212,149
2020-02-01,CAN,Sabah,183,102,81
2020-02-01,CAN,Sarawak,383,233,150
2020-02-01,CAN,Selangor,4474,2676,1798
2020-02-01,CAN,Terengganu,0,0,0
2020-02-01,CAN,W.P. Labuan,15,10,5
2020-02-01,CCK,Selangor,0,0,0
2020-02-01,CHE,Johor,401,240,161
2020-02-01,CHE,Kedah,279,140,139
2020-02-01,CHE,Kelantan,10,8,2
2020-02-01,CHE,Melaka,1,1,0
2020-02-01,CHE,Negeri Sembilan,0,0,0
2020-02-01,CHE,Pahang,4,2,2
2020-02-01,CHE,Perak,12,9,3
2020-02-01,CHE,Perlis,51,29,22
2020-02-01,CHE,Pulau Pinang,135,84,51
2020-02-01,CHE,Sabah,51,25,26
2020-02-01,CHE,Sarawak,48,27,21
2020-02-01,CHE,Selangor,1420,866,554
2020-02-01,CHE,W.P. Labuan,7,5,2
2020-02-01,CHL,Johor,36,23,13
2020-02-01,CHL,Kedah,58,27,31
2020-02-01,CHL,Kelantan,2,1,1
2020-02-01,CHL,Melaka,0,0,0
2020-02-01,CHL,Pahang,0,0,0
2020-02-01,CHL,Perak,1,1,0
2020-02-01,CHL,Perlis,7,3,4
2020-02-01,CHL,Pulau Pinang,9,3,6
2020-02-01,CHL,Sabah,6,2,4
2020-02-01,CHL,Sarawak,2,2,0
2020-02-01,CHL,Selangor,471,217,254
2020-02-01,CHN,Johor,8884,3906,4978
2020-02-01,CHN,Kedah,749,298,451
2020-02-01,CHN,Kelantan,10,6,4
2020-02-01,CHN,Melaka,6,3,3
2020-02-01,CHN,Pahang,6,3,3
2020-02-01,CHN,Perak,255,89,166
2020-02-01,CHN,Perlis,126,54,72
2020-02-01,CHN,Pulau Pinang,2571,1330,1241
2020-02-01,CHN,Sabah,772,370,402
2020-02-01,CHN,Sarawak,446,147,299
2020-02-01,CHN,Selangor,57021,32622,24399
2020-02-01,CHN,Terengganu,0,0,0
2020-02-01,CHN,W.P. Labuan,19,10,9
2020-02-01,CIV,Johor,0,0,0
2020-02-01,CIV,Kedah,0,0,0
2020-02-01,CIV,Pulau Pinang,0,0,0
2020-02-01,CIV,Sabah,0,0,0
2020-02-01,CIV,Sarawak,0,0,0
2020-02-01,CIV,Selangor,12,6,6
2020-02-01,CMR,Johor,1,1,0
2020-02-01,CMR,Kedah,0,0,0
2020-02-01,CMR,Pulau Pinang,2,0,2
2020-02-01,CMR,Sabah,1,1,0
2020-02-01,CMR,Sarawak,2,2,0
2020-02-01,CMR,Selangor,25,17,8
2020-02-01,COD,Johor,0,0,0
2020-02-01,COD,Pulau Pinang,1,1,0
2020-02-01,COD,Sarawak,0,0,0
2020-02-01,COD,Selangor,9,8,1
2020-02-01,COG,Johor,0,0,0
2020-02-01,COG,Kedah,0,0,0
2020-02-01,COG,Selangor,3,1,2
2020-02-01,COK,Selangor,0,0,0
2020-02-01,COL,Johor,7,5,2
2020-02-01,COL,Kedah,3,1,2
2020-02-01,COL,Perak,0,0,0
2020-02-01,COL,Pulau Pinang,3,3,0
2020-02-01,COL,Sabah,4,3,1
2020-02-01,COL,Sarawak,0,0,0
2020-02-01,COL,Selangor,120,57,63
2020-02-01,COL,W.P. Labuan,0,0,0
2020-02-01,COM,Johor,0,0,0
2020-02-01,COM,Kedah,0,0,0
2020-02-01,COM,Selangor,18,14,4
2020-02-01,CPV,Johor,2,2,0
2020-02-01,CPV,Kedah,0,0,0
2020-02-01,CPV,Pulau Pinang,0,0,0
2020-02-01,CPV,Sabah,0,0,0
2020-02-01,CPV,Selangor,3,2,1
2020-02-01,CRI,Johor,5,3,2
2020-02-01,CRI,Kedah,1,0,1
2020-02-01,CRI,Perak,0,0,0
2020-02-01,CRI,Perlis,0,0,0
2020-02-01,CRI,Pulau Pinang,1,0,1
2020-02-01,CRI,Sabah,0,0,0
2020-02-01,CRI,Sarawak,0,0,0
2020-02-01,CRI,Selangor,68,47,21
2020-02-01,CUB,Johor,6,6,0
2020-02-01,CUB,Kedah,0,0,0
2020-02-01,CUB,Perlis,0,0,0
2020-02-01,CUB,Pulau Pinang,0,0,0
2020-02-01,CUB,Sabah,0,0,0
2020-02-01,CUB,Sarawak,0,0,0
2020-02-01,CUB,Selangor,31,18,13
2020-02-01,CYP,Johor,11,6,5
2020-02-01,CYP,Kedah,0,0,0
2020-02-01,CYP,Perak,0,0,0
2020-02-01,CYP,Perlis,0,0,0
2020-02-01,CYP,Pulau Pinang,3,1,2
2020-02-01,CYP,Sabah,3,2,1
2020-02-01,CYP,Sarawak,0,0,0
2020-02-01,CYP,Selangor,58,34,24
2020-02-01,CZE,Johor,236,122,114
2020-02-01,CZE,Kedah,636,320,316
2020-02-01,CZE,Kelantan,4,4,0
2020-02-01,CZE,Melaka,0,0,0
2020-02-01,CZE,Negeri Sembilan,0,0,0
2020-02-01,CZE,Perak,0,0,0
2020-02-01,CZE,Perlis,13,7,6
2020-02-01,CZE,Pulau Pinang,109,47,62
2020-02-01,CZE,Sabah,51,25,26
2020-02-01,CZE,Sarawak,44,24,20
2020-02-01,CZE,Selangor,1050,585,465
2020-02-01,CZE,W.P. Labuan,8,5,3
2020-02-01,DEU,Johor,2021,1274,747
2020-02-01,DEU,Kedah,1216,611,605
2020-02-01,DEU,Kelantan,41,26,15
2020-02-01,DEU,Melaka,5,2,3
2020-02-01,DEU,Negeri Sembilan,0,0,0
2020-02-01,DEU,Pahang,6,4,2
2020-02-01,DEU,Perak,78,52,26
2020-02-01,DEU,Perlis,247,137,110
2020-02-01,DEU,Pulau Pinang,562,376,186
2020-02-01,DEU,Sabah,254,133,121
2020-02-01,DEU,Sarawak,283,174,109
2020-02-01,DEU,Selangor,7642,4704,2938
2020-02-01,DEU,Terengganu,0,0,0
2020-02-01,DEU,W.P. Labuan,31,24,7
2020-02-01,DJI,Johor,0,0,0
2020-02-01,DJI,Selangor,24,15,9
2020-02-01,DMA,Johor,3,2,1
2020-02-01,DMA,Kedah,0,0,0
2020-02-01,DMA,Pulau Pinang,1,1,0
2020-02-01,DMA,Sabah,0,0,0
2020-02-01,DMA,Sarawak,0,0,0
2020-02-01,DMA,Selangor,40,32,8
2020-02-01,DMA,W.P. Labuan,1,1,0
2020-02-01,DNK,Johor,352,222,130
2020-02-01,DNK,Kedah,472,209,263
2020-02-01,DNK,Kelantan,2,1,1
2020-02-01,DNK,Melaka,2,2,0
2020-02-01,DNK,Negeri Sembilan,0,0,0
2020-02-01,DNK,Pahang,0,0,0
2020-02-01,DNK,Perak,0,0,0
2020-02-01,DNK,Perlis,24,19,5
2020-02-01,DNK,Pulau Pinang,190,86,104
2020-02-01,DNK,Sabah,105,64,41
2020-02-01,DNK,Sarawak,39,20,19
2020-02-01,DNK,Selangor,1816,1042,774
2020-02-01,DNK,W.P. Labuan,7,4,3
2020-02-01,DOM,Johor,3,2,1
2020-02-01,DOM,Kedah,0,0,0
2020-02-01,DOM,Perak,0,0,0
2020-02-01,DOM,Perlis,0,0,0
2020-02-01,DOM,Pulau Pinang,1,1,0
2020-02-01,DOM,Sabah,0,0,0
2020-02-01,DOM,Sarawak,1,1,0
2020-02-01,DOM,Selangor,30,19,11
2020-02-01,DZA,Johor,26,25,1
2020-02-01,DZA,Kedah,29,21,8
2020-02-01,DZA,Kelantan,0,0,0
2020-02-01,DZA,Melaka,0,0,0
2020-02-01,DZA,Perak,0,0,0
2020-02-01,DZA,Perlis,0,0,0
2020-02-01,DZA,Pulau Pinang,12,7,5
2020-02-01,DZA,Sabah,0,0,0
2020-02-01,DZA,Sarawak,6,2,4
2020-02-01,DZA,Selangor,843,604,239
2020-02-01,DZA,W.P. Labuan,0,0,0
2020-02-01,ECU,Johor,9,7,2
2020-02-01,ECU,Kedah,2,0,2
2020-02-01,ECU,Perak,0,0,0
2020-02-01,ECU,Perlis,0,0,0
2020-02-01,ECU,Pulau Pinang,0,0,0
2020-02-01,ECU,Sabah,0,0,0
2020-02-01,ECU,Sarawak,6,1,5
2020-02-01,ECU,Selangor,63,32,31
2020-02-01,EGY,Johor,193,170,23
2020-02-01,EGY,Kedah,15,9,6
2020-02-01,EGY,Kelantan,3,3,0
2020-02-01,EGY,Melaka,0,0,0
2020-02-01,EGY,Pahang,0,0,0
2020-02-01,EGY,Perak,0,0,0
2020-02-01,EGY,Perlis,2,2,0
2020-02-01,EGY,Pulau Pinang,7,6,1
2020-02-01,EGY,Sabah,5,2,3
2020-02-01,EGY,Sarawak,43,36,7
2020-02-01,EGY,Selangor,2590,1764,826
2020-02-01,EGY,Terengganu,0,0,0
2020-02-01,EGY,W.P. Labuan,4,4,0
2020-02-01,ERI,Johor,0,0,0
2020-02-01,ERI,Pulau Pinang,0,0,0
2020-02-01,ERI,Sabah,2,1,1
2020-02-01,ERI,Selangor,29,20,9
2020-02-01,ESP,Johor,330,215,115
2020-02-01,ESP,Kedah,254,117,137
2020-02-01,ESP,Kelantan,10,6,4
2020-02-01,ESP,Melaka,1,1,0
2020-02-01,ESP,Negeri Sembilan,0,0,0
2020-02-01,ESP,Pahang,0,0,0
2020-02-01,ESP,Perak,6,4,2
2020-02-01,ESP,Perlis,35,21,14
2020-02-01,ESP,Pulau Pinang,67,40,27
2020-02-01,ESP,Sabah,61,38,23
2020-02-01,ESP,Sarawak,54,29,25
2020-02-01,ESP,Selangor,2058,1246,812
2020-02-01,ESP,W.P. Labuan,7,3,4
2020-02-01,EST,Johor,59,29,30
2020-02-01,EST,Kedah,115,56,59
2020-02-01,EST,Kelantan,0,0,0
2020-02-01,EST,Pahang,0,0,0
2020-02-01,EST,Perak,0,0,0
2020-02-01,EST,Perlis,3,2,1
2020-02-01,EST,Pulau Pinang,6,3,3
2020-02-01,EST,Sabah,5,2,3
2020-02-01,EST,Sarawak,10,4,6
2020-02-01,EST,Selangor,515,250,265
2020-02-01,EST,W.P. Labuan,0,0,0
2020-02-01,ETH,Johor,2,2,0
2020-02-01,ETH,Kedah,0,0,0
2020-02-01,ETH,Pulau Pinang,0,0,0
2020-02-01,ETH,Sarawak,0,0,0
2020-02-01,ETH,Selangor,37,24,13
2020-02-01,FIN,Johor,241,136,105
2020-02-01,FIN,Kedah,459,207,252
2020-02-01,FIN,Kelantan,4,2,2
2020-02-01,FIN,Melaka,0,0,0
2020-02-01,FIN,Negeri Sembilan,0,0,0
2020-02-01,FIN,Pahang,0,0,0
2020-02-01,FIN,Perak,1,1,0
2020-02-01,FIN,Perlis,13,9,4
2020-02-01,FIN,Pulau Pinang,134,71,63
2020-02-01,FIN,Sabah,41,21,20
2020-02-01,FIN,Sarawak,20,11,9
2020-02-01,FIN,Selangor,1584,849,735
2020-02-01,FIN,W.P. Labuan,1,1,0
2020-02-01,FJI,Johor,27,15,12
2020-02-01,FJI,Kedah,3,2,1
2020-02-01,FJI,Kelantan,0,0,0
2020-02-01,FJI,Perak,0,0,0
2020-02-01,FJI,Perlis,0,0,0
2020-02-01,FJI,Pulau Pinang,3,3,0
2020-02-01,FJI,Sabah,1,0,1
2020-02-01,FJI,Sarawak,1,1,0
2020-02-01,FJI,Selangor,77,48,29
2020-02-01,FRA,Johor,2063,1231,832
2020-02-01,FRA,Kedah,1396,726,670
2020-02-01,FRA,Kelantan,83,58,25
2020-02-01,FRA,Melaka,5,4,1
2020-02-01,FRA,Negeri Sembilan,0,0,0
2020-02-01,FRA,Pahang,41,21,20
2020-02-01,FRA,Perak,23,16,7
2020-02-01,FRA,Perlis,122,79,43
2020-02-01,FRA,Pulau Pinang,548,322,226
2020-02-01,FRA,Sabah,173,105,68
2020-02-01,FRA,Sarawak,143,91,52
2020-02-01,FRA,Selangor,9806,5882,3924
2020-02-01,FRA,Terengganu,0,0,0
2020-02-01,FRA,W.P. Labuan,11,9,2
2020-02-01,FSM,Johor,0,0,0
2020-02-01,FSM,Pulau Pinang,0,0,0
2020-02-01,FSM,Selangor,0,0,0
2020-02-01,GAB,Johor,0,0,0
2020-02-01,GAB,Pulau Pinang,0,0,0
2020-02-01,GAB,Sarawak,0,0,0
2020-02-01,GAB,Selangor,6,4,2
2020-02-01,GBR,Johor,4194,2809,1385
2020-02-01,GBR,Kedah,1699,906,793
2020-02-01,GBR,Kelantan,72,55,17
2020-02-01,GBR,Melaka,2,2,0
2020-02-01,GBR,Negeri Sembilan,0,0,0
2020-02-01,GBR,Pahang,19,14,5
2020-02-01,GBR,Perak,89,55,34
2020-02-01,GBR,Perlis,367,228,139
2020-02-01,GBR,Pulau Pinang,1616,946,670
2020-02-01,GBR,Sabah,639,340,299
2020-02-01,GBR,Sarawak,1159,757,402
2020-02-01,GBR,Selangor,18590,11608,6982
2020-02-01,GBR,Terengganu,0,0,0
2020-02-01,GBR,W.P. Labuan,74,48,26
2020-02-01,GEO,Johor,10,7,3
2020-02-01,GEO,Kedah,13,10,3
2020-02-01,GEO,Melaka,0,0,0
2020-02-01,GEO,Perak,0,0,0
2020-02-01,GEO,Perlis,0,0,0
2020-02-01,GEO,Pulau Pinang,3,1,2
2020-02-01,GEO,Sabah,0,0,0
2020-02-01,GEO,Sarawak,0,0,0
2020-02-01,GEO,Selangor,31,22,9
2020-02-01,GHA,Johor,2,2,0
2020-02-01,GHA,Kedah,0,0,0
2020-02-01,GHA,Kelantan,0,0,0
2020-02-01,GHA,Pulau Pinang,0,0,0
2020-02-01,GHA,Sabah,0,0,0
2020-02-01,GHA,Sarawak,0,0,0
2020-02-01,GHA,Selangor,52,41,11
2020-02-01,GIB,Johor,0,0,0
2020-02-01,GIB,Sarawak,0,0,0
2020-02-01,GIN,Johor,8,8,0
2020-02-01,GIN,Kedah,0,0,0
2020-02-01,GIN,Kelantan,0,0,0
2020-02-01,GIN,Perlis,0,0,0
2020-02-01,GIN,Pulau Pinang,0,0,0
2020-02-01,GIN,Sabah,1,1,0
2020-02-01,GIN,Sarawak,0,0,0
2020-02-01,GIN,Selangor,56,45,11
2020-02-01,GLP,Selangor,0,0,0
2020-02-01,GMB,Johor,0,0,0
2020-02-01,GMB,Kedah,1,0,1
2020-02-01,GMB,Kelantan,0,0,0
2020-02-01,GMB,Pulau Pinang,3,2,1
2020-02-01,GMB,Sabah,0,0,0
2020-02-01,GMB,Sarawak,1,1,0
2020-02-01,GMB,Selangor,53,44,9
2020-02-01,GNB,Johor,2,2,0
2020-02-01,GNB,Selangor,0,0,0
2020-02-01,GNQ,Johor,0,0,0
2020-02-01,GNQ,Selangor,1,0,1
2020-02-01,GRC,Johor,39,30,9
2020-02-01,GRC,Kedah,23,16,7
2020-02-01,GRC,Kelantan,0,0,0
2020-02-01,GRC,Melaka,0,0,0
2020-02-01,GRC,Negeri Sembilan,0,0,0
2020-02-01,GRC,Pahang,3,3,0
2020-02-01,GRC,Perak,0,0,0
2020-02-01,GRC,Perlis,5,5,0
2020-02-01,GRC,Pulau Pinang,7,7,0
2020-02-01,GRC,Sabah,2,1,1
2020-02-01,GRC,Sarawak,15,11,4
2020-02-01,GRC,Selangor,267,191,76
2020-02-01,GRD,Johor,7,5,2
2020-02-01,GRD,Kedah,0,0,0
2020-02-01,GRD,Pulau Pinang,1,1,0
2020-02-01,GRD,Sabah,0,0,0
2020-02-01,GRD,Sarawak,0,0,0
2020-02-01,GRD,Selangor,7,4,3
2020-02-01,GRL,Johor,0,0,0
2020-02-01,GRL,Selangor,0,0,0
2020-02-01,GTM,Johor,2,1,1
2020-02-01,GTM,Kedah,1,1,0
2020-02-01,GTM,Pahang,0,0,0
2020-02-01,GTM,Perak,0,0,0
2020-02-01,GTM,Pulau Pinang,0,0,0
2020-02-01,GTM,Sabah,1,0,1
2020-02-01,GTM,Sarawak,0,0,0
2020-02-01,GTM,Selangor,13,9,4
2020-02-01,GTM,W.P. Labuan,0,0,0
2020-02-01,GUY,Johor,0,0,0
2020-02-01,GUY,Kedah,1,0,1
2020-02-01,GUY,Pulau Pinang,0,0,0
2020-02-01,GUY,Sarawak,0,0,0
2020-02-01,GUY,Selangor,4,2,2
2020-02-01,HKG,Johor,3,0,3
2020-02-01,HKG,Kedah,0,0,0
2020-02-01,HKG,Kelantan,0,0,0
2020-02-01,HKG,Pahang,0,0,0
2020-02-01,HKG,Perak,20,12,8
2020-02-01,HKG,Perlis,0,0,0
2020-02-01,HKG,Pulau Pinang,0,0,0
2020-02-01,HKG,Sabah,0,0,0
2020-02-01,HKG,Sarawak,7,4,3
2020-02-01,HKG,Selangor,0,0,0
2020-02-01,HKG,Terengganu,0,0,0
2020-02-01,HMD,Johor,0,0,0
2020-02-01,HND,Johor,8,3,5
2020-02-01,HND,Kedah,0,0,0
2020-02-01,HND,Perak,0,0,0
2020-02-01,HND,Pulau Pinang,1,1,0
2020-02-01,HND,Sabah,0,0,0
2020-02-01,HND,Sarawak,1,1,0
2020-02-01,HND,Selangor,13,11,2
2020-02-01,HRV,Johor,30,29,1
2020-02-01,HRV,Kedah,18,10,8
2020-02-01,HRV,Kelantan,0,0,0
2020-02-01,HRV,Melaka,0,0,0
2020-02-01,HRV,Pahang,10,9,1
2020-02-01,HRV,Perak,0,0,0
2020-02-01,HRV,Perlis,3,2,1
2020-02-01,HRV,Pulau Pinang,3,2,1
2020-02-01,HRV,Sabah,5,2,3
2020-02-01,HRV,Sarawak,3,3,0
2020-02-01,HRV,Selangor,248,165,83
2020-02-01,HTI,Johor,0,0,0
2020-02-01,HTI,Kedah,0,0,0
2020-02-01,HTI,Kelantan,0,0,0
2020-02-01,HTI,Perak,0,0,0
2020-02-01,HTI,Pulau Pinang,0,0,0
2020-02-01,HTI,Sabah,0,0,0
2020-02-01,HTI,Selangor,10,8,2
2020-02-01,HUN,Johor,59,39,20
2020-02-01,HUN,Kedah,388,190,198
2020-02-01,HUN,Kelantan,4,3,1
2020-02-01,HUN,Pahang,0,0,0
2020-02-01,HUN,Perak,0,0,0
2020-02-01,HUN,Perlis,5,2,3
2020-02-01,HUN,Pulau Pinang,44,20,24
2020-02-01,HUN,Sabah,9,5,4
2020-02-01,HUN,Sarawak,10,9,1
2020-02-01,HUN,Selangor,1119,568,551
2020-02-01,HUN,W.P. Labuan,2,1,1
2020-02-01,IDN,Johor,105615,60705,44910
2020-02-01,IDN,Kedah,2058,885,1173
2020-02-01,IDN,Kelantan,231,164,67
2020-02-01,IDN,Melaka,3134,1430,1704
2020-02-01,IDN,Negeri Sembilan,3252,2145,1107
2020-02-01,IDN,Pahang,14,12,2
2020-02-01,IDN,Perak,134,57,77
2020-02-01,IDN,Perlis,351,179,172
2020-02-01,IDN,Pulau Pinang,21871,8620,13251
2020-02-01,IDN,Sabah,4181,2264,1917
2020-02-01,IDN,Sarawak,28788,17818,10970
2020-02-01,IDN,Selangor,108102,52727,55375
2020-02-01,IDN,Terengganu,1,1,0
2020-02-01,IDN,W.P. Labuan,95,68,27
2020-02-01,IND,Johor,13646,10636,3010
2020-02-01,IND,Kedah,510,315,195
2020-02-01,IND,Kelantan,15,10,5
2020-02-01,IND,Melaka,20,19,1
2020-02-01,IND,Negeri Sembilan,0,0,0
2020-02-01,IND,Pahang,22,14,8
2020-02-01,IND,Perak,276,176,100
2020-02-01,IND,Perlis,30,18,12
2020-02-01,IND,Pulau Pinang,467,335,132
2020-02-01,IND,Sabah,96,81,15
2020-02-01,IND,Sarawak,1505,1340,165
2020-02-01,IND,Selangor,55552,42134,13418
2020-02-01,IND,Terengganu,0,0,0
2020-02-01,IND,W.P. Labuan,57,48,9
2020-02-01,IOT,Pulau Pinang,0,0,0
2020-02-01,IOT,Selangor,0,0,0
2020-02-01,IRL,Johor,238,152,86
2020-02-01,IRL,Kedah,97,50,47
2020-02-01,IRL,Kelantan,1,1,0
2020-02-01,IRL,Negeri Sembilan,0,0,0
2020-02-01,IRL,Pahang,1,0,1
2020-02-01,IRL,Perak,6,4,2
2020-02-01,IRL,Perlis,22,15,7
2020-02-01,IRL,Pulau Pinang,87,53,34
2020-02-01,IRL,Sabah,37,17,20
2020-02-01,IRL,Sarawak,31,18,13
2020-02-01,IRL,Selangor,1126,705,421
2020-02-01,IRL,Terengganu,0,0,0
2020-02-01,IRL,W.P. Labuan,1,1,0
2020-02-01,IRN,Johor,483,246,237
2020-02-01,IRN,Kedah,11,8,3
2020-02-01,IRN,Kelantan,0,0,0
2020-02-01,IRN,Perak,0,0,0
2020-02-01,IRN,Perlis,3,2,1
2020-02-01,IRN,Pulau Pinang,3,2,1
2020-02-01,IRN,Sabah,6,3,3
2020-02-01,IRN,Sarawak,5,3,2
2020-02-01,IRN,Selangor,3439,1887,1552
2020-02-01,IRN,W.P. Labuan,0,0,0
2020-02-01,IRQ,Johor,14,10,4
2020-02-01,IRQ,Kedah,0,0,0
2020-02-01,IRQ,Kelantan,0,0,0
2020-02-01,IRQ,Melaka,0,0,0
2020-02-01,IRQ,Pahang,0,0,0
2020-02-01,IRQ,Perak,0,0,0
2020-02-01,IRQ,Perlis,0,0,0
2020-02-01,IRQ,Pulau Pinang,9,4,5
2020-02-01,IRQ,Sabah,1,1,0
2020-02-01,IRQ,Sarawak,0,0,0
2020-02-01,IRQ,Selangor,1563,1052,511
2020-02-01,ISL,Johor,2,2,0
2020-02-01,ISL,Kedah,2,2,0
2020-02-01,ISL,Kelantan,0,0,0
2020-02-01,ISL,Perak,0,0,0
2020-02-01,ISL,Perlis,0,0,0
2020-02-01,ISL,Pulau Pinang,1,0,1
2020-02-01,ISL,Sabah,10,5,5
2020-02-01,ISL,Sarawak,3,2,1
2020-02-01,ISL,Selangor,75,40,35
2020-02-01,ISL,W.P. Labuan,5,3,2
2020-02-01,ISR,Pulau Pinang,0,0,0
2020-02-01,ITA,Johor,465,347,118
2020-02-01,ITA,Kedah,625,362,263
2020-02-01,ITA,Kelantan,19,16,3
2020-02-01,ITA,Melaka,2,2,0
2020-02-01,ITA,Negeri Sembilan,0,0,0
2020-02-01,ITA,Pahang,1,0,1
2020-02-01,ITA,Perak,11,7,4
2020-02-01,ITA,Perlis,57,41,16
2020-02-01,ITA,Pulau Pinang,89,62,27
2020-02-01,ITA,Sabah,70,44,26
2020-02-01,ITA,Sarawak,68,47,21
2020-02-01,ITA,Selangor,2963,2055,908
2020-02-01,ITA,W.P. Labuan,2,1,1
2020-02-01,JAM,Johor,4,2,2
2020-02-01,JAM,Kedah,0,0,0
2020-02-01,JAM,Perak,0,0,0
2020-02-01,JAM,Pulau Pinang,1,1,0
2020-02-01,JAM,Sabah,1,1,0
2020-02-01,JAM,Sarawak,0,0,0
2020-02-01,JAM,Selangor,22,9,13
2020-02-01,JAM,W.P. Labuan,0,0,0
2020-02-01,JOR,Johor,28,8,20
2020-02-01,JOR,Kedah,39,24,15
2020-02-01,JOR,Kelantan,0,0,0
2020-02-01,JOR,Melaka,0,0,0
2020-02-01,JOR,Perlis,2,2,0
2020-02-01,JOR,Pulau Pinang,22,13,9
2020-02-01,JOR,Sabah,1,0,1
2020-02-01,JOR,Sarawak,1,1,0
2020-02-01,JOR,Selangor,829,584,245
2020-02-01,JOR,W.P. Labuan,0,0,0
2020-02-01,JPN,Johor,7273,4928,2345
2020-02-01,JPN,Kedah,280,140,140
2020-02-01,JPN,Kelantan,10,9,1
2020-02-01,JPN,Melaka,5,4,1
2020-02-01,JPN,Negeri Sembilan,0,0,0
2020-02-01,JPN,Pahang,6,5,1
2020-02-01,JPN,Perak,55,35,20
2020-02-01,JPN,Perlis,118,99,19
2020-02-01,JPN,Pulau Pinang,1378,996,382
2020-02-01,JPN,Sabah,1123,555,568
2020-02-01,JPN,Sarawak,237,172,65
2020-02-01,JPN,Selangor,30796,18629,12167
2020-02-01,JPN,W.P. Labuan,31,16,15
2020-02-01,KAZ,Johor,38,15,23
2020-02-01,KAZ,Kedah,80,35,45
2020-02-01,KAZ,Kelantan,7,3,4
2020-02-01,KAZ,Melaka,1,1,0
2020-02-01,KAZ,Perak,1,0,1
2020-02-01,KAZ,Perlis,3,3,0
2020-02-01,KAZ,Pulau Pinang,3,2,1
2020-02-01,KAZ,Sabah,11,6,5
2020-02-01,KAZ,Sarawak,3,0,3
2020-02-01,KAZ,Selangor,2340,994,1346
2020-02-01,KAZ,W.P. Labuan,1,1,0
2020-02-01,KEN,Johor,30,16,14
2020-02-01,KEN,Kedah,2,0,2
2020-02-01,KEN,Kelantan,0,0,0
2020-02-01,KEN,Perak,0,0,0
2020-02-01,KEN,Perlis,1,0,1
2020-02-01,KEN,Pulau Pinang,3,2,1
2020-02-01,KEN,Sabah,1,1,0
2020-02-01,KEN,Sarawak,3,2,1
2020-02-01,KEN,Selangor,313,169,144
2020-02-01,KGZ,Johor,15,13,2
2020-02-01,KGZ,Kedah,9,7,2
2020-02-01,KGZ,Kelantan,0,0,0
2020-02-01,KGZ,Perak,0,0,0
2020-02-01,KGZ,Perlis,0,0,0
2020-02-01,KGZ,Pulau Pinang,5,2,3
2020-02-01,KGZ,Sabah,2,2,0
2020-02-01,KGZ,Sarawak,0,0,0
2020-02-01,KGZ,Selangor,329,146,183
2020-02-01,KHM,Johor,1507,603,904
2020-02-01,KHM,Kedah,167,82,85
2020-02-01,KHM,Kelantan,1617,1336,281
2020-02-01,KHM,Melaka,0,0,0
2020-02-01,KHM,Negeri Sembilan,2,2,0
2020-02-01,KHM,Pahang,0,0,0
2020-02-01,KHM,Perak,27,23,4
2020-02-01,KHM,Perlis,600,439,161
2020-02-01,KHM,Pulau Pinang,9,3,6
2020-02-01,KHM,Sabah,0,0,0
2020-02-01,KHM,Sarawak,22,5,17
2020-02-01,KHM,Selangor,4005,2113,1892
2020-02-01,KHM,W.P. Labuan,0,0,0
2020-02-01,KIR,Johor,1,1,0
2020-02-01,KIR,Sabah,0,0,0
2020-02-01,KIR,Selangor,2,1,1
2020-02-01,KNA,Johor,6,5,1
2020-02-01,KNA,Kedah,0,0,0
2020-02-01,KNA,Perlis,0,0,0
2020-02-01,KNA,Pulau Pinang,4,1,3
2020-02-01,KNA,Sabah,0,0,0
2020-02-01,KNA,Selangor,36,30,6
2020-02-01,KNA,W.P. Labuan,0,0,0
2020-02-01,KOR,Johor,7227,3977,3250
2020-02-01,KOR,Kedah,271,138,133
2020-02-01,KOR,Kelantan,6,5,1
2020-02-01,KOR,Melaka,1,0,1
2020-02-01,KOR,Negeri Sembilan,0,0,0
2020-02-01,KOR,Pahang,4,1,3
2020-02-01,KOR,Perak,11,4,7
2020-02-01,KOR,Perlis,87,61,26
2020-02-01,KOR,Pulau Pinang,262,142,120
2020-02-01,KOR,Sabah,14366,6032,8334
2020-02-01,KOR,Sarawak,306,183,123
2020-02-01,KOR,Selangor,13031,7279,5752
2020-02-01,KOR,Terengganu,1,1,0
2020-02-01,KOR,W.P. Labuan,23,17,6
2020-02-01,KWT,Johor,5,4,1
2020-02-01,KWT,Kedah,2,2,0
2020-02-01,KWT,Kelantan,0,0,0
2020-02-01,KWT,Perak,0,0,0
2020-02-01,KWT,Perlis,0,0,0
2020-02-01,KWT,Pulau Pinang,3,2,1
2020-02-01,KWT,Sabah,0,0,0
2020-02-01,KWT,Sarawak,0,0,0
2020-02-01,KWT,Selangor,185,126,59
2020-02-01,KWT,W.P. Labuan,0,0,0
2020-02-01,LAO,Johor,128,38,90
2020-02-01,LAO,Kedah,1129,86,1043
2020-02-01,LAO,Kelantan,759,654,105
2020-02-01,LAO,Melaka,0,0,0
2020-02-01,LAO,Perak,11,0,11
2020-02-01,LAO,Perlis,423,136,287
2020-02-01,LAO,Pulau Pinang,13,3,10
2020-02-01,LAO,Sabah,1,0,1
2020-02-01,LAO,Sarawak,4,0,4
2020-02-01,LAO,Selangor,395,136,259
2020-02-01,LAO,W.P. Labuan,0,0,0
2020-02-01,LBN,Johor,8,5,3
2020-02-01,LBN,Kedah,3,2,1
2020-02-01,LBN,Kelantan,1,1,0
2020-02-01,LBN,Pahang,0,0,0
2020-02-01,LBN,Perak,0,0,0
2020-02-01,LBN,Perlis,0,0,0
2020-02-01,LBN,Pulau Pinang,6,3,3
2020-02-01,LBN,Sabah,2,2,0
2020-02-01,LBN,Sarawak,1,1,0
2020-02-01,LBN,Selangor,225,167,58
2020-02-01,LBN,W.P. Labuan,0,0,0
2020-02-01,LBR,Johor,0,0,0
2020-02-01,LBR,Kedah,0,0,0
2020-02-01,LBR,Sabah,0,0,0
2020-02-01,LBR,Sarawak,0,0,0
2020-02-01,LBR,Selangor,4,3,1
2020-02-01,LBY,Johor,5,3,2
2020-02-01,LBY,Kedah,3,2,1
2020-02-01,LBY,Perlis,0,0,0
2020-02-01,LBY,Pulau Pinang,4,4,0
2020-02-01,LBY,Sabah,3,3,0
2020-02-01,LBY,Sarawak,2,0,2
2020-02-01,LBY,Selangor,673,496,177
2020-02-01,LCA,Johor,2,2,0
2020-02-01,LCA,Kedah,0,0,0
2020-02-01,LCA,Pulau Pinang,0,0,0
2020-02-01,LCA,Sarawak,0,0,0
2020-02-01,LCA,Selangor,8,7,1
2020-02-01,LIE,Johor,2,1,1
2020-02-01,LIE,Kedah,0,0,0
2020-02-01,LIE,Perlis,0,0,0
2020-02-01,LIE,Pulau Pinang,0,0,0
2020-02-01,LIE,Sabah,0,0,0
2020-02-01,LIE,Sarawak,1,1,0
2020-02-01,LIE,Selangor,4,4,0
2020-02-01,LKA,Johor,661,487,174
2020-02-01,LKA,Kedah,9,5,4
2020-02-01,LKA,Kelantan,0,0,0
2020-02-01,LKA,Melaka,0,0,0
2020-02-01,LKA,Pahang,1,1,0
2020-02-01,LKA,Perak,2,1,1
2020-02-01,LKA,Perlis,0,0,0
2020-02-01,LKA,Pulau Pinang,24,18,6
2020-02-01,LKA,Sabah,3,3,0
2020-02-01,LKA,Sarawak,16,13,3
2020-02-01,LKA,Selangor,2922,1964,958
2020-02-01,LKA,W.P. Labuan,0,0,0
2020-02-01,LSO,Johor,0,0,0
2020-02-01,LSO,Kedah,0,0,0
2020-02-01,LSO,Pulau Pinang,0,0,0
2020-02-01,LSO,Sarawak,0,0,0
2020-02-01,LSO,Selangor,5,2,3
2020-02-01,LTU,Johor,132,62,70
2020-02-01,LTU,Kedah,45,23,22
2020-02-01,LTU,Kelantan,0,0,0
2020-02-01,LTU,Pahang,0,0,0
2020-02-01,LTU,Perak,10,1,9
2020-02-01,LTU,Perlis,3,3,0
2020-02-01,LTU,Pulau Pinang,8,5,3
2020-02-01,LTU,Sabah,13,7,6
2020-02-01,LTU,Sarawak,8,3,5
2020-02-01,LTU,Selangor,399,210,189
2020-02-01,LTU,W.P. Labuan,2,2,0
2020-02-01,LUX,Johor,9,4,5
2020-02-01,LUX,Kedah,4,0,4
2020-02-01,LUX,Kelantan,0,0,0
2020-02-01,LUX,Perak,1,1,0
2020-02-01,LUX,Perlis,0,0,0
2020-02-01,LUX,Pulau Pinang,1,1,0
2020-02-01,LUX,Sabah,1,1,0
2020-02-01,LUX,Sarawak,0,0,0
2020-02-01,LUX,Selangor,41,26,15
2020-02-01,LVA,Johor,105,41,64
2020-02-01,LVA,Kedah,21,6,15
2020-02-01,LVA,Kelantan,0,0,0
2020-02-01,LVA,Pahang,0,0,0
2020-02-01,LVA,Perak,0,0,0
2020-02-01,LVA,Perlis,6,5,1
2020-02-01,LVA,Pulau Pinang,11,7,4
2020-02-01,LVA,Sabah,1,0,1
2020-02-01,LVA,Sarawak,3,1,2
2020-02-01,LVA,Selangor,191,89,102
2020-02-01,LVA,W.P. Labuan,0,0,0
2020-02-01,MAC,Johor,0,0,0
2020-02-01,MAC,Pahang,0,0,0
2020-02-01,MAC,Perak,0,0,0
2020-02-01,MAC,Selangor,0,0,0
2020-02-01,MAC,W.P. Labuan,0,0,0
2020-02-01,MAR,Johor,54,36,18
2020-02-01,MAR,Kedah,23,9,14
2020-02-01,MAR,Kelantan,5,4,1
2020-02-01,MAR,Melaka,0,0,0
2020-02-01,MAR,Pahang,0,0,0
2020-02-01,MAR,Perak,1,0,1
2020-02-01,MAR,Perlis,2,2,0
2020-02-01,MAR,Pulau Pinang,7,2,5
2020-02-01,MAR,Sabah,6,4,2
2020-02-01,MAR,Sarawak,3,1,2
2020-02-01,MAR,Selangor,870,474,396
2020-02-01,MAR,W.P. Labuan,0,0,0
2020-02-01,MCO,Johor,0,0,0
2020-02-01,MCO,Kedah,1,1,0
2020-02-01,MCO,Sabah,0,0,0
2020-02-01,MCO,Selangor,5,1,4
2020-02-01,MDA,Johor,5,2,3
2020-02-01,MDA,Kedah,7,4,3
2020-02-01,MDA,Kelantan,1,0,1
2020-02-01,MDA,Negeri Sembilan,0,0,0
2020-02-01,MDA,Perlis,0,0,0
2020-02-01,MDA,Pulau Pinang,1,0,1
2020-02-01,MDA,Sabah,0,0,0
2020-02-01,MDA,Sarawak,0,0,0
2020-02-01,MDA,Selangor,33,17,16
2020-02-01,MDG,Johor,5,1,4
2020-02-01,MDG,Kedah,0,0,0
2020-02-01,MDG,Perak,0,0,0
2020-02-01,MDG,Perlis,0,0,0
2020-02-01,MDG,Pulau Pinang,2,1,1
2020-02-01,MDG,Sabah,2,1,1
2020-02-01,MDG,Sarawak,0,0,0
2020-02-01,MDG,Selangor,29,16,13
2020-02-01,MDV,Johor,46,35,11
2020-02-01,MDV,Kedah,1,1,0
2020-02-01,MDV,Kelantan,0,0,0
2020-02-01,MDV,Perak,0,0,0
2020-02-01,MDV,Perlis,0,0,0
2020-02-01,MDV,Pulau Pinang,4,2,2
2020-02-01,MDV,Sabah,1,1,0
2020-02-01,MDV,Sarawak,0,0,0
2020-02-01,MDV,Selangor,1320,755,565
2020-02-01,MEX,Johor,75,41,34
2020-02-01,MEX,Kedah,8,4,4
2020-02-01,MEX,Kelantan,1,1,0
2020-02-01,MEX,Pahang,0,0,0
2020-02-01,MEX,Perak,0,0,0
2020-02-01,MEX,Perlis,4,3,1
2020-02-01,MEX,Pulau Pinang,8,5,3
2020-02-01,MEX,Sabah,6,2,4
2020-02-01,MEX,Sarawak,4,1,3
2020-02-01,MEX,Selangor,396,203,193
2020-02-01,MEX,W.P. Labuan,1,1,0
2020-02-01,MHL,Johor,0,0,0
2020-02-01,MHL,Kedah,0,0,0
2020-02-01,MHL,Perak,0,0,0
2020-02-01,MHL,Pulau Pinang,0,0,0
2020-02-01,MHL,Sabah,0,0,0
2020-02-01,MHL,Selangor,4,2,2
2020-02-01,MKD,Johor,20,12,8
2020-02-01,MKD,Kedah,2,2,0
2020-02-01,MKD,Perak,0,0,0
2020-02-01,MKD,Pulau Pinang,0,0,0
2020-02-01,MKD,Sabah,0,0,0
2020-02-01,MKD,Sarawak,0,0,0
2020-02-01,MKD,Selangor,48,30,18
2020-02-01,MLI,Johor,1,1,0
2020-02-01,MLI,Sabah,0,0,0
2020-02-01,MLI,Selangor,5,5,0
2020-02-01,MLT,Johor,4,3,1
2020-02-01,MLT,Kedah,10,7,3
2020-02-01,MLT,Kelantan,0,0,0
2020-02-01,MLT,Perak,0,0,0
2020-02-01,MLT,Perlis,0,0,0
2020-02-01,MLT,Pulau Pinang,2,2,0
2020-02-01,MLT,Sabah,2,1,1
2020-02-01,MLT,Sarawak,0,0,0
2020-02-01,MLT,Selangor,36,25,11
2020-02-01,MLT,W.P. Labuan,0,0,0
2020-02-01,MMR,Johor,2196,755,1441
2020-02-01,MMR,Kedah,38,32,6
2020-02-01,MMR,Kelantan,2,0,2
2020-02-01,MMR,Negeri Sembilan,0,0,0
2020-02-01,MMR,Pahang,5,4,1
2020-02-01,MMR,Perak,7,1,6
2020-02-01,MMR,Perlis,4,0,4
2020-02-01,MMR,Pulau Pinang,349,270,79
2020-02-01,MMR,Sabah,6,4,2
2020-02-01,MMR,Sarawak,45,32,13
2020-02-01,MMR,Selangor,10268,7840,2428
2020-02-01,MMR,Terengganu,0,0,0
2020-02-01,MMR,W.P. Labuan,5,3,2
2020-02-01,MNE,Johor,5,5,0
2020-02-01,MNE,Kedah,0,0,0
2020-02-01,MNE,Pulau Pinang,0,0,0
2020-02-01,MNE,Sabah,3,2,1
2020-02-01,MNE,Sarawak,0,0,0
2020-02-01,MNE,Selangor,20,10,10
2020-02-01,MNG,Johor,56,19,37
2020-02-01,MNG,Kedah,20,2,18
2020-02-01,MNG,Kelantan,0,0,0
2020-02-01,MNG,Perak,0,0,0
2020-02-01,MNG,Perlis,3,0,3
2020-02-01,MNG,Pulau Pinang,2,0,2
2020-02-01,MNG,Sabah,2,0,2
2020-02-01,MNG,Sarawak,2,1,1
2020-02-01,MNG,Selangor,215,93,122
2020-02-01,MNP,Selangor,0,0,0
2020-02-01,MOZ,Johor,0,0,0
2020-02-01,MOZ,Kedah,0,0,0
2020-02-01,MOZ,Perak,0,0,0
2020-02-01,MOZ,Pulau Pinang,0,0,0
2020-02-01,MOZ,Sabah,0,0,0
2020-02-01,MOZ,Sarawak,0,0,0
2020-02-01,MOZ,Selangor,18,13,5
2020-02-01,MRT,Johor,0,0,0
2020-02-01,MRT,Kedah,0,0,0
2020-02-01,MRT,Pulau Pinang,0,0,0
2020-02-01,MRT,Sabah,0,0,0
2020-02-01,MRT,Sarawak,0,0,0
2020-02-01,MRT,Selangor,26,25,1
2020-02-01,MUS,Johor,57,38,19
2020-02-01,MUS,Kedah,1,0,1
2020-02-01,MUS,Kelantan,0,0,0
2020-02-01,MUS,Pahang,0,0,0
2020-02-01,MUS,Perak,0,0,0
2020-02-01,MUS,Perlis,0,0,0
2020-02-01,MUS,Pulau Pinang,6,3,3
2020-02-01,MUS,Sabah,1,1,0
2020-02-01,MUS,Sarawak,1,1,0
2020-02-01,MUS,Selangor,543,271,272
2020-02-01,MWI,Johor,1,1,0
2020-02-01,MWI,Pulau Pinang,1,1,0
2020-02-01,MWI,Sabah,0,0,0
2020-02-01,MWI,Sarawak,0,0,0
2020-02-01,MWI,Selangor,20,14,6
2020-02-01,MYT,Selangor,0,0,0
2020-02-01,NAM,Johor,2,1,1
2020-02-01,NAM,Kedah,0,0,0
2020-02-01,NAM,Perak,0,0,0
2020-02-01,NAM,Perlis,0,0,0
2020-02-01,NAM,Pulau Pinang,0,0,0
2020-02-01,NAM,Sabah,0,0,0
2020-02-01,NAM,Sarawak,0,0,0
2020-02-01,NAM,Selangor,19,9,10
2020-02-01,NCL,Selangor,0,0,0
2020-02-01,NER,Johor,0,0,0
2020-02-01,NER,Sabah,0,0,0
2020-02-01,NER,Selangor,5,3,2
2020-02-01,NGA,Johor,19,19,0
2020-02-01,NGA,Kedah,0,0,0
2020-02-01,NGA,Perlis,0,0,0
2020-02-01,NGA,Pulau Pinang,13,10,3
2020-02-01,NGA,Sabah,0,0,0
2020-02-01,NGA,Sarawak,9,8,1
2020-02-01,NGA,Selangor,763,658,105
2020-02-01,NIC,Johor,0,0,0
2020-02-01,NIC,Kedah,0,0,0
2020-02-01,NIC,Pulau Pinang,0,0,0
2020-02-01,NIC,Sabah,1,0,1
2020-02-01,NIC,Selangor,9,7,2
2020-02-01,NLD,Johor,844,551,293
2020-02-01,NLD,Kedah,405,188,217
2020-02-01,NLD,Kelantan,7,3,4
2020-02-01,NLD,Melaka,9,5,4
2020-02-01,NLD,Negeri Sembilan,0,0,0
2020-02-01,NLD,Pahang,1,1,0
2020-02-01,NLD,Perak,15,10,5
2020-02-01,NLD,Perlis,57,35,22
2020-02-01,NLD,Pulau Pinang,217,141,76
2020-02-01,NLD,Sabah,98,53,45
2020-02-01,NLD,Sarawak,246,141,105
2020-02-01,NLD,Selangor,4428,2686,1742
2020-02-01,NLD,Terengganu,0,0,0
2020-02-01,NLD,W.P. Labuan,16,9,7
2020-02-01,NOR,Johor,224,117,107
2020-02-01,NOR,Kedah,198,98,100
2020-02-01,NOR,Kelantan,2,1,1
2020-02-01,NOR,Melaka,0,0,0
2020-02-01,NOR,Pahang,1,1,0
2020-02-01,NOR,Perak,5,3,2
2020-02-01,NOR,Perlis,21,11,10
2020-02-01,NOR,Pulau Pinang,79,47,32
2020-02-01,NOR,Sabah,18,13,5
2020-02-01,NOR,Sarawak,42,30,12
2020-02-01,NOR,Selangor,1157,678,479
2020-02-01,NOR,W.P. Labuan,1,1,0
2020-02-01,NPL,Johor,353,279,74
2020-02-01,NPL,Kedah,1,1,0
2020-02-01,NPL,Pahang,0,0,0
2020-02-01,NPL,Perak,0,0,0
2020-02-01,NPL,Perlis,1,1,0
2020-02-01,NPL,Pulau Pinang,85,80,5
2020-02-01,NPL,Sabah,15,15,0
2020-02-01,NPL,Sarawak,138,100,38
2020-02-01,NPL,Selangor,11932,11466,466
2020-02-01,NPL,W.P. Labuan,100,84,16
2020-02-01,NRU,Johor,0,0,0
2020-02-01,NRU,Pulau Pinang,1,1,0
2020-02-01,NRU,Selangor,1,1,0
2020-02-01,NZL,Johor,561,384,177
2020-02-01,NZL,Kedah,90,59,31
2020-02-01,NZL,Kelantan,2,1,1
2020-02-01,NZL,Melaka,0,0,0
2020-02-01,NZL,Negeri Sembilan,0,0,0
2020-02-01,NZL,Pahang,3,3,0
2020-02-01,NZL,Perak,9,5,4
2020-02-01,NZL,Perlis,16,11,5
2020-02-01,NZL,Pulau Pinang,155,93,62
2020-02-01,NZL,Sabah,50,27,23
2020-02-01,NZL,Sarawak,103,70,33
2020-02-01,NZL,Selangor,2047,1259,788
2020-02-01,NZL,Terengganu,0,0,0
2020-02-01,NZL,W.P. Labuan,7,6,1
2020-02-01,OMN,Johor,4,2,2
2020-02-01,OMN,Kedah,3,2,1
2020-02-01,OMN,Kelantan,0,0,0
2020-02-01,OMN,Melaka,0,0,0
2020-02-01,OMN,Perak,0,0,0
2020-02-01,OMN,Perlis,0,0,0
2020-02-01,OMN,Pulau Pinang,7,4,3
2020-02-01,OMN,Sabah,1,1,0
2020-02-01,OMN,Sarawak,38,21,17
2020-02-01,OMN,Selangor,737,481,256
2020-02-01,PAK,Johor,748,595,153
2020-02-01,PAK,Kedah,65,44,21
2020-02-01,PAK,Kelantan,9,9,0
2020-02-01,PAK,Melaka,0,0,0
2020-02-01,PAK,Negeri Sembilan,0,0,0
2020-02-01,PAK,Pahang,1,1,0
2020-02-01,PAK,Perak,2,2,0
2020-02-01,PAK,Perlis,22,16,6
2020-02-01,PAK,Pulau Pinang,45,41,4
2020-02-01,PAK,Sabah,22,20,2
2020-02-01,PAK,Sarawak,371,352,19
2020-02-01,PAK,Selangor,13424,11655,1769
2020-02-01,PAK,W.P. Labuan,23,23,0
2020-02-01,PAN,Johor,4,3,1
2020-02-01,PAN,Kedah,1,1,0
2020-02-01,PAN,Perak,0,0,0
2020-02-01,PAN,Perlis,0,0,0
2020-02-01,PAN,Pulau Pinang,0,0,0
2020-02-01,PAN,Sabah,1,0,1
2020-02-01,PAN,Sarawak,0,0,0
2020-02-01,PAN,Selangor,33,13,20
2020-02-01,PER,Johor,28,14,14
2020-02-01,PER,Kedah,6,2,4
2020-02-01,PER,Kelantan,1,0,1
2020-02-01,PER,Pahang,0,0,0
2020-02-01,PER,Perak,0,0,0
2020-02-01,PER,Perlis,0,0,0
2020-02-01,PER,Pulau Pinang,7,3,4
2020-02-01,PER,Sabah,5,2,3
2020-02-01,PER,Sarawak,1,1,0
2020-02-01,PER,Selangor,147,77,70
2020-02-01,PER,W.P. Labuan,1,0,1
2020-02-01,PHL,Johor,12116,3987,8129
2020-02-01,PHL,Kedah,1096,374,722
2020-02-01,PHL,Kelantan,59,25,34
2020-02-01,PHL,Melaka,0,0,0
2020-02-01,PHL,Negeri Sembilan,0,0,0
2020-02-01,PHL,Pahang,18,16,2
2020-02-01,PHL,Perak,38,10,28
2020-02-01,PHL,Perlis,199,66,133
2020-02-01,PHL,Pulau Pinang,348,134,214
2020-02-01,PHL,Sabah,2134,1072,1062
2020-02-01,PHL,Sarawak,2850,1232,1618
2020-02-01,PHL,Selangor,13027,5783,7244
2020-02-01,PHL,Terengganu,0,0,0
2020-02-01,PHL,W.P. Labuan,193,84,109
2020-02-01,PLW,Johor,0,0,0
2020-02-01,PLW,Pulau Pinang,0,0,0
2020-02-01,PLW,Selangor,0,0,0
2020-02-01,PNG,Johor,8,5,3
2020-02-01,PNG,Kedah,0,0,0
2020-02-01,PNG,Kelantan,0,0,0
2020-02-01,PNG,Perak,0,0,0
2020-02-01,PNG,Pulau Pinang,1,0,1
2020-02-01,PNG,Sabah,4,2,2
2020-02-01,PNG,Sarawak,3,1,2
2020-02-01,PNG,Selangor,51,31,20
2020-02-01,POL,Johor,643,348,295
2020-02-01,POL,Kedah,431,216,215
2020-02-01,POL,Kelantan,10,3,7
2020-02-01,POL,Melaka,0,0,0
2020-02-01,POL,Negeri Sembilan,0,0,0
2020-02-01,POL,Pahang,0,0,0
2020-02-01,POL,Perak,5,2,3
2020-02-01,POL,Perlis,52,29,23
2020-02-01,POL,Pulau Pinang,133,60,73
2020-02-01,POL,Sabah,105,55,50
2020-02-01,POL,Sarawak,106,59,47
2020-02-01,POL,Selangor,1844,997,847
2020-02-01,POL,Terengganu,0,0,0
2020-02-01,POL,W.P. Labuan,5,3,2
2020-02-01,PRK,Selangor,5,4,1
2020-02-01,PRT,Johor,163,78,85
2020-02-01,PRT,Kedah,69,39,30
2020-02-01,PRT,Kelantan,4,2,2
2020-02-01,PRT,Melaka,0,0,0
2020-02-01,PRT,Pahang,0,0,0
2020-02-01,PRT,Perak,1,0,1
2020-02-01,PRT,Perlis,6,5,1
2020-02-01,PRT,Pulau Pinang,12,4,8
2020-02-01,PRT,Sabah,13,9,4
2020-02-01,PRT,Sarawak,10,7,3
2020-02-01,PRT,Selangor,479,284,195
2020-02-01,PRT,W.P. Labuan,1,0,1
2020-02-01,PRY,Johor,2,1,1
2020-02-01,PRY,Kedah,2,2,0
2020-02-01,PRY,Perak,0,0,0
2020-02-01,PRY,Perlis,1,1,0
2020-02-01,PRY,Pulau Pinang,0,0,0
2020-02-01,PRY,Sabah,0,0,0
2020-02-01,PRY,Sarawak,0,0,0
2020-02-01,PRY,Selangor,9,3,6
2020-02-01,PSE,Johor,14,8,6
2020-02-01,PSE,Kedah,1,0,1
2020-02-01,PSE,Kelantan,0,0,0
2020-02-01,PSE,Melaka,0,0,0
2020-02-01,PSE,Perak,0,0,0
2020-02-01,PSE,Perlis,0,0,0
2020-02-01,PSE,Pulau Pinang,5,3,2
2020-02-01,PSE,Sabah,1,1,0
2020-02-01,PSE,Sarawak,3,3,0
2020-02-01,PSE,Selangor,408,332,76
2020-02-01,QAT,Johor,3,1,2
2020-02-01,QAT,Kedah,5,4,1
2020-02-01,QAT,Perlis,0,0,0
2020-02-01,QAT,Pulau Pinang,1,1,0
2020-02-01,QAT,Sabah,0,0,0
2020-02-01,QAT,Sarawak,0,0,0
2020-02-01,QAT,Selangor,70,51,19
2020-02-01,REU,Johor,0,0,0
2020-02-01,REU,Sarawak,0,0,0
2020-02-01,ROU,Johor,98,57,41
2020-02-01,ROU,Kedah,131,68,63
2020-02-01,ROU,Kelantan,3,1,2
2020-02-01,ROU,Negeri Sembilan,0,0,0
2020-02-01,ROU,Pahang,0,0,0
2020-02-01,ROU,Perak,2,0,2
2020-02-01,ROU,Perlis,3,2,1
2020-02-01,ROU,Pulau Pinang,16,8,8
2020-02-01,ROU,Sabah,6,4,2
2020-02-01,ROU,Sarawak,6,4,2
2020-02-01,ROU,Selangor,638,352,286
2020-02-01,ROU,W.P. Labuan,0,0,0
2020-02-01,RUS,Johor,439,281,158
2020-02-01,RUS,Kedah,1215,537,678
2020-02-01,RUS,Kelantan,143,61,82
2020-02-01,RUS,Melaka,2,2,0
2020-02-01,RUS,Negeri Sembilan,0,0,0
2020-02-01,RUS,Pahang,4,4,0
2020-02-01,RUS,Perak,7,3,4
2020-02-01,RUS,Perlis,354,168,186
2020-02-01,RUS,Pulau Pinang,135,62,73
2020-02-01,RUS,Sabah,102,42,60
2020-02-01,RUS,Sarawak,73,37,36
2020-02-01,RUS,Selangor,10284,4766,5518
2020-02-01,RUS,W.P. Labuan,22,6,16
2020-02-01,RWA,Johor,0,0,0
2020-02-01,RWA,Kedah,0,0,0
2020-02-01,RWA,Pulau Pinang,0,0,0
2020-02-01,RWA,Selangor,4,3,1
2020-02-01,SAU,Johor,53,40,13
2020-02-01,SAU,Kedah,8,7,1
2020-02-01,SAU,Kelantan,3,1,2
2020-02-01,SAU,Melaka,0,0,0
2020-02-01,SAU,Perak,0,0,0
2020-02-01,SAU,Perlis,0,0,0
2020-02-01,SAU,Pulau Pinang,15,10,5
2020-02-01,SAU,Sabah,2,1,1
2020-02-01,SAU,Sarawak,2,2,0
2020-02-01,SAU,Selangor,3685,2229,1456
2020-02-01,SAU,W.P. Labuan,1,1,0
2020-02-01,SDN,Johor,12,11,1
2020-02-01,SDN,Kedah,1,1,0
2020-02-01,SDN,Kelantan,0,0,0
2020-02-01,SDN,Perlis,0,0,0
2020-02-01,SDN,Pulau Pinang,0,0,0
2020-02-01,SDN,Sabah,2,2,0
2020-02-01,SDN,Sarawak,1,1,0
2020-02-01,SDN,Selangor,1083,714,369
2020-02-01,SDN,W.P. Labuan,0,0,0
2020-02-01,SEN,Johor,1,1,0
2020-02-01,SEN,Kedah,0,0,0
2020-02-01,SEN,Kelantan,0,0,0
2020-02-01,SEN,Perak,0,0,0
2020-02-01,SEN,Perlis,0,0,0
2020-02-01,SEN,Pulau Pinang,1,1,0
2020-02-01,SEN,Sabah,0,0,0
2020-02-01,SEN,Sarawak,1,0,1
2020-02-01,SEN,Selangor,61,46,15
2020-02-01,SGP,Johor,887821,557719,330102
2020-02-01,SGP,Kedah,1332,834,498
2020-02-01,SGP,Kelantan,147,87,60
2020-02-01,SGP,Melaka,13,11,2
2020-02-01,SGP,Negeri Sembilan,1,1,0
2020-02-01,SGP,Pahang,236,135,101
2020-02-01,SGP,Perak,2223,1107,1116
2020-02-01,SGP,Perlis,56,40,16
2020-02-01,SGP,Pulau Pinang,5711,3166,2545
2020-02-01,SGP,Sabah,943,547,396
2020-02-01,SGP,Sarawak,1686,1036,650
2020-02-01,SGP,Selangor,20083,12332,7751
2020-02-01,SGP,Terengganu,0,0,0
2020-02-01,SGP,W.P. Labuan,25,21,4
2020-02-01,SGS,Johor,0,0,0
2020-02-01,SGS,Sabah,0,0,0
2020-02-01,SGS,Selangor,0,0,0
2020-02-01,SHN,Sarawak,0,0,0
2020-02-01,SLB,Johor,1,1,0
2020-02-01,SLB,Perlis,0,0,0
2020-02-01,SLB,Pulau Pinang,0,0,0
2020-02-01,SLB,Sabah,2,0,2
2020-02-01,SLB,Sarawak,4,2,2
2020-02-01,SLB,Selangor,1,1,0
2020-02-01,SLB,W.P. Labuan,0,0,0
2020-02-01,SLE,Johor,1,1,0
2020-02-01,SLE,Kedah,0,0,0
2020-02-01,SLE,Perak,0,0,0
2020-02-01,SLE,Pulau Pinang,3,2,1
2020-02-01,SLE,Sabah,0,0,0
2020-02-01,SLE,Selangor,39,27,12
2020-02-01,SLV,Johor,1,1,0
2020-02-01,SLV,Kedah,0,0,0
2020-02-01,SLV,Perak,0,0,0
2020-02-01,SLV,Perlis,0,0,0
2020-02-01,SLV,Pulau Pinang,2,0,2
2020-02-01,SLV,Sabah,1,0,1
2020-02-01,SLV,Selangor,17,8,9
2020-02-01,SLV,W.P. Labuan,1,0,1
2020-02-01,SMR,Johor,0,0,0
2020-02-01,SMR,Selangor,4,3,1
2020-02-01,SOM,Johor,2,0,2
2020-02-01,SOM,Kedah,0,0,0
2020-02-01,SOM,Kelantan,0,0,0
2020-02-01,SOM,Perlis,0,0,0
2020-02-01,SOM,Sabah,1,0,1
2020-02-01,SOM,Sarawak,0,0,0
2020-02-01,SOM,Selangor,354,245,109
2020-02-01,SRB,Johor,9,8,1
2020-02-01,SRB,Kedah,7,7,0
2020-02-01,SRB,Kelantan,0,0,0
2020-02-01,SRB,Pahang,0,0,0
2020-02-01,SRB,Perak,0,0,0
2020-02-01,SRB,Perlis,0,0,0
2020-02-01,SRB,Pulau Pinang,3,2,1
2020-02-01,SRB,Sabah,0,0,0
2020-02-01,SRB,Sarawak,0,0,0
2020-02-01,SRB,Selangor,96,51,45
2020-02-01,SSD,Johor,2,2,0
2020-02-01,SSD,Kedah,0,0,0
2020-02-01,SSD,Sarawak,0,0,0
2020-02-01,SSD,Selangor,12,9,3
2020-02-01,SSD,W.P. Labuan,0,0,0
2020-02-01,STP,Selangor,2,2,0
2020-02-01,SUR,Johor,4,2,2
2020-02-01,SUR,Kedah,0,0,0
2020-02-01,SUR,Kelantan,0,0,0
2020-02-01,SUR,Perak,0,0,0
2020-02-01,SUR,Perlis,0,0,0
2020-02-01,SUR,Pulau Pinang,0,0,0
2020-02-01,SUR,Sabah,0,0,0
2020-02-01,SUR,Sarawak,0,0,0
2020-02-01,SUR,Selangor,4,3,1
2020-02-01,SVK,Johor,42,27,15
2020-02-01,SVK,Kedah,273,132,141
2020-02-01,SVK,Kelantan,3,3,0
2020-02-01,SVK,Negeri Sembilan,0,0,0
2020-02-01,SVK,Pahang,0,0,0
2020-02-01,SVK,Perak,1,1,0
2020-02-01,SVK,Perlis,4,3,1
2020-02-01,SVK,Pulau Pinang,69,29,40
2020-02-01,SVK,Sabah,13,7,6
2020-02-01,SVK,Sarawak,3,3,0
2020-02-01,SVK,Selangor,542,279,263
2020-02-01,SVK,W.P. Labuan,3,2,1
2020-02-01,SVN,Johor,19,12,7
2020-02-01,SVN,Kedah,65,32,33
2020-02-01,SVN,Kelantan,0,0,0
2020-02-01,SVN,Perak,0,0,0
2020-02-01,SVN,Perlis,2,2,0
2020-02-01,SVN,Pulau Pinang,6,4,2
2020-02-01,SVN,Sabah,11,4,7
2020-02-01,SVN,Sarawak,1,0,1
2020-02-01,SVN,Selangor,281,158,123
2020-02-01,SVN,W.P. Labuan,0,0,0
2020-02-01,SWE,Johor,329,196,133
2020-02-01,SWE,Kedah,876,395,481
2020-02-01,SWE,Kelantan,14,12,2
2020-02-01,SWE,Melaka,0,0,0
2020-02-01,SWE,Negeri Sembilan,0,0,0
2020-02-01,SWE,Pahang,4,2,2
2020-02-01,SWE,Perak,10,7,3
2020-02-01,SWE,Perlis,37,29,8
2020-02-01,SWE,Pulau Pinang,103,64,39
2020-02-01,SWE,Sabah,60,28,32
2020-02-01,SWE,Sarawak,45,28,17
2020-02-01,SWE,Selangor,2478,1387,1091
2020-02-01,SWE,W.P. Labuan,4,0,4
2020-02-01,SWZ,Johor,0,0,0
2020-02-01,SWZ,Kedah,0,0,0
2020-02-01,SWZ,Pulau Pinang,0,0,0
2020-02-01,SWZ,Sabah,0,0,0
2020-02-01,SWZ,Selangor,6,5,1
2020-02-01,SYC,Johor,5,3,2
2020-02-01,SYC,Kedah,1,1,0
2020-02-01,SYC,Pulau Pinang,0,0,0
2020-02-01,SYC,Sabah,0,0,0
2020-02-01,SYC,Sarawak,0,0,0
2020-02-01,SYC,Selangor,70,36,34
2020-02-01,SYR,Johor,12,10,2
2020-02-01,SYR,Kedah,2,2,0
2020-02-01,SYR,Kelantan,0,0,0
2020-02-01,SYR,Pahang,0,0,0
2020-02-01,SYR,Perlis,1,1,0
2020-02-01,SYR,Pulau Pinang,6,3,3
2020-02-01,SYR,Sabah,1,1,0
2020-02-01,SYR,Sarawak,3,1,2
2020-02-01,SYR,Selangor,760,527,233
2020-02-01,SYR,W.P. Labuan,0,0,0
2020-02-01,TCA,Perlis,0,0,0
2020-02-01,TCD,Johor,0,0,0
2020-02-01,TCD,Kedah,0,0,0
2020-02-01,TCD,Perlis,0,0,0
2020-02-01,TCD,Selangor,26,23,3
2020-02-01,TGO,Johor,1,1,0
2020-02-01,TGO,Perak,0,0,0
2020-02-01,TGO,Pulau Pinang,0,0,0
2020-02-01,TGO,Selangor,8,8,0
2020-02-01,THA,Johor,4620,1253,3367
2020-02-01,THA,Kedah,41527,14919,26608
2020-02-01,THA,Kelantan,36173,19239,16934
2020-02-01,THA,Melaka,1,1,0
2020-02-01,THA,Negeri Sembilan,2,1,1
2020-02-01,THA,Pahang,0,0,0
2020-02-01,THA,Perak,11999,5604,6395
2020-02-01,THA,Perlis,41747,24293,17454
2020-02-01,THA,Pulau Pinang,1171,442,729
2020-02-01,THA,Sabah,138,51,87
2020-02-01,THA,Sarawak,505,206,299
2020-02-01,THA,Selangor,10529,4415,6114
2020-02-01,THA,Terengganu,0,0,0
2020-02-01,THA,W.P. Labuan,18,5,13
2020-02-01,TJK,Johor,0,0,0
2020-02-01,TJK,Kedah,5,4,1
2020-02-01,TJK,Perlis,0,0,0
2020-02-01,TJK,Pulau Pinang,1,0,1
2020-02-01,TJK,Sabah,0,0,0
2020-02-01,TJK,Selangor,106,84,22
2020-02-01,TKL,Selangor,0,0,0
2020-02-01,TKM,Johor,0,0,0
2020-02-01,TKM,Kedah,3,2,1
2020-02-01,TKM,Kelantan,0,0,0
2020-02-01,TKM,Perlis,0,0,0
2020-02-01,TKM,Pulau Pinang,0,0,0
2020-02-01,TKM,Sabah,0,0,0
2020-02-01,TKM,Sarawak,0,0,0
2020-02-01,TKM,Selangor,91,61,30
2020-02-01,TLS,Johor,3,1,2
2020-02-01,TLS,Kedah,0,0,0
2020-02-01,TLS,Perlis,0,0,0
2020-02-01,TLS,Pulau Pinang,1,1,0
2020-02-01,TLS,Sabah,0,0,0
2020-02-01,TLS,Sarawak,1,1,0
2020-02-01,TLS,Selangor,86,57,29
2020-02-01,TON,Johor,0,0,0
2020-02-01,TON,Pulau Pinang,1,1,0
2020-02-01,TON,Sarawak,0,0,0
2020-02-01,TON,Selangor,7,5,2
2020-02-01,TTO,Johor,15,14,1
2020-02-01,TTO,Kedah,0,0,0
2020-02-01,TTO,Pahang,0,0,0
2020-02-01,TTO,Pulau Pinang,2,1,1
2020-02-01,TTO,Sabah,0,0,0
2020-02-01,TTO,Sarawak,0,0,0
2020-02-01,TTO,Selangor,25,16,9
2020-02-01,TUN,Johor,7,5,2
2020-02-01,TUN,Kedah,14,12,2
2020-02-01,TUN,Kelantan,0,0,0
2020-02-01,TUN,Melaka,0,0,0
2020-02-01,TUN,Perak,0,0,0
2020-02-01,TUN,Perlis,0,0,0
2020-02-01,TUN,Pulau Pinang,9,5,4
2020-02-01,TUN,Sabah,1,0,1
2020-02-01,TUN,Sarawak,0,0,0
2020-02-01,TUN,Selangor,289,164,125
2020-02-01,TUN,W.P. Labuan,0,0,0
2020-02-01,TUR,Johor,259,179,80
2020-02-01,TUR,Kedah,50,37,13
2020-02-01,TUR,Kelantan,4,4,0
2020-02-01,TUR,Melaka,0,0,0
2020-02-01,TUR,Negeri Sembilan,0,0,0
2020-02-01,TUR,Pahang,0,0,0
2020-02-01,TUR,Perak,1,1,0
2020-02-01,TUR,Perlis,17,15,2
2020-02-01,TUR,Pulau Pinang,13,9,4
2020-02-01,TUR,Sabah,13,10,3
2020-02-01,TUR,Sarawak,21,19,2
2020-02-01,TUR,Selangor,926,663,263
2020-02-01,TUR,W.P. Labuan,2,2,0
2020-02-01,TUV,Selangor,0,0,0
2020-02-01,TWN,Johor,5036,2173,2863
2020-02-01,TWN,Kedah,171,95,76
2020-02-01,TWN,Kelantan,3,2,1
2020-02-01,TWN,Melaka,11,3,8
2020-02-01,TWN,Negeri Sembilan,0,0,0
2020-02-01,TWN,Pahang,1,0,1
2020-02-01,TWN,Perak,24,9,15
2020-02-01,TWN,Perlis,9,3,6
2020-02-01,TWN,Pulau Pinang,2937,1523,1414
2020-02-01,TWN,Sabah,2608,1233,1375
2020-02-01,TWN,Sarawak,311,111,200
2020-02-01,TWN,Selangor,11217,5789,5428
2020-02-01,TWN,W.P. Labuan,14,8,6
2020-02-01,TZA,Johor,9,2,7
2020-02-01,TZA,Kedah,0,0,0
2020-02-01,TZA,Perak,0,0,0
2020-02-01,TZA,Perlis,0,0,0
2020-02-01,TZA,Pulau Pinang,0,0,0
2020-02-01,TZA,Sabah,0,0,0
2020-02-01,TZA,Sarawak,1,1,0
2020-02-01,TZA,Selangor,183,102,81
2020-02-01,UGA,Johor,29,14,15
2020-02-01,UGA,Kedah,0,0,0
2020-02-01,UGA,Perak,0,0,0
2020-02-01,UGA,Perlis,0,0,0
2020-02-01,UGA,Pulau Pinang,2,0,2
2020-02-01,UGA,Sabah,0,0,0
2020-02-01,UGA,Sarawak,0,0,0
2020-02-01,UGA,Selangor,63,33,30
2020-02-01,UKR,Johor,97,59,38
2020-02-01,UKR,Kedah,386,183,203
2020-02-01,UKR,Kelantan,22,11,11
2020-02-01,UKR,Melaka,0,0,0
2020-02-01,UKR,Negeri Sembilan,0,0,0
2020-02-01,UKR,Pahang,3,3,0
2020-02-01,UKR,Perak,2,1,1
2020-02-01,UKR,Perlis,27,13,14
2020-02-01,UKR,Pulau Pinang,41,19,22
2020-02-01,UKR,Sabah,15,6,9
2020-02-01,UKR,Sarawak,28,15,13
2020-02-01,UKR,Selangor,2150,1079,1071
2020-02-01,UKR,W.P. Labuan,0,0,0
2020-02-01,URY,Johor,8,3,5
2020-02-01,URY,Kedah,1,0,1
2020-02-01,URY,Kelantan,1,0,1
2020-02-01,URY,Perak,0,0,0
2020-02-01,URY,Perlis,1,0,1
2020-02-01,URY,Pulau Pinang,2,0,2
2020-02-01,URY,Sabah,1,1,0
2020-02-01,URY,Sarawak,0,0,0
2020-02-01,URY,Selangor,64,30,34
2020-02-01,URY,W.P. Labuan,0,0,0
2020-02-01,USA,Johor,2947,1771,1176
2020-02-01,USA,Kedah,566,330,236
2020-02-01,USA,Kelantan,30,22,8
2020-02-01,USA,Melaka,5,2,3
2020-02-01,USA,Negeri Sembilan,0,0,0
2020-02-01,USA,Pahang,4,1,3
2020-02-01,USA,Perak,68,36,32
2020-02-01,USA,Perlis,114,74,40
2020-02-01,USA,Pulau Pinang,1199,703,496
2020-02-01,USA,Sabah,414,226,188
2020-02-01,USA,Sarawak,290,165,125
2020-02-01,USA,Selangor,11838,7168,4670
2020-02-01,USA,Terengganu,0,0,0
2020-02-01,USA,W.P. Labuan,7,5,2
2020-02-01,UZB,Johor,65,37,28
2020-02-01,UZB,Kedah,102,25,77
2020-02-01,UZB,Kelantan,1,0,1
2020-02-01,UZB,Perak,0,0,0
2020-02-01,UZB,Perlis,0,0,0
2020-02-01,UZB,Pulau Pinang,4,0,4
2020-02-01,UZB,Sabah,3,3,0
2020-02-01,UZB,Sarawak,5,4,1
2020-02-01,UZB,Selangor,1107,715,392
2020-02-01,VAT,Johor,0,0,0
2020-02-01,VAT,Sarawak,0,0,0
2020-02-01,VAT,Selangor,2,2,0
2020-02-01,VCT,Johor,0,0,0
2020-02-01,VCT,Kedah,1,0,1
2020-02-01,VCT,Pulau Pinang,0,0,0
2020-02-01,VCT,Sarawak,0,0,0
2020-02-01,VCT,Selangor,3,3,0
2020-02-01,VEN,Johor,24,16,8
2020-02-01,VEN,Kedah,1,0,1
2020-02-01,VEN,Kelantan,1,1,0
2020-02-01,VEN,Melaka,0,0,0
2020-02-01,VEN,Perak,0,0,0
2020-02-01,VEN,Perlis,0,0,0
2020-02-01,VEN,Pulau Pinang,0,0,0
2020-02-01,VEN,Sabah,1,1,0
2020-02-01,VEN,Sarawak,7,4,3
2020-02-01,VEN,Selangor,88,50,38
2020-02-01,VEN,W.P. Labuan,0,0,0
2020-02-01,VNM,Johor,8786,2492,6294
2020-02-01,VNM,Kedah,485,34,451
2020-02-01,VNM,Kelantan,28,17,11
2020-02-01,VNM,Melaka,0,0,0
2020-02-01,VNM,Negeri Sembilan,0,0,0
2020-02-01,VNM,Pahang,2,2,0
2020-02-01,VNM,Perak,51,4,47
2020-02-01,VNM,Perlis,93,19,74
2020-02-01,VNM,Pulau Pinang,899,198,701
2020-02-01,VNM,Sabah,34,8,26
2020-02-01,VNM,Sarawak,571,151,420
2020-02-01,VNM,Selangor,17058,5766,11292
2020-02-01,VNM,Terengganu,0,0,0
2020-02-01,VNM,W.P. Labuan,4,3,1
2020-02-01,VUT,Johor,12,10,2
2020-02-01,VUT,Kedah,1,1,0
2020-02-01,VUT,Pulau Pinang,1,1,0
2020-02-01,VUT,Sabah,3,3,0
2020-02-01,VUT,Sarawak,0,0,0
2020-02-01,VUT,Selangor,51,46,5
2020-02-01,WSM,Johor,0,0,0
2020-02-01,WSM,Sarawak,0,0,0
2020-02-01,WSM,Selangor,3,1,2
2020-02-01,XXX,Johor,153,84,69
2020-02-01,XXX,Kedah,24,13,11
2020-02-01,XXX,Kelantan,0,0,0
2020-02-01,XXX,Melaka,0,0,0
2020-02-01,XXX,Pahang,0,0,0
2020-02-01,XXX,Perak,4,3,1
2020-02-01,XXX,Perlis,2,2,0
2020-02-01,XXX,Pulau Pinang,79,42,37
2020-02-01,XXX,Sabah,23,14,9
2020-02-01,XXX,Sarawak,39,28,11
2020-02-01,XXX,Selangor,724,425,299
2020-02-01,XXX,W.P. Labuan,0,0,0
2020-02-01,YEM,Johor,44,27,17
2020-02-01,YEM,Kedah,6,4,2
2020-02-01,YEM,Kelantan,1,1,0
2020-02-01,YEM,Melaka,5,3,2
2020-02-01,YEM,Pahang,0,0,0
2020-02-01,YEM,Perak,0,0,0
2020-02-01,YEM,Perlis,2,2,0
2020-02-01,YEM,Pulau Pinang,12,10,2
2020-02-01,YEM,Sabah,1,1,0
2020-02-01,YEM,Sarawak,2,2,0
2020-02-01,YEM,Selangor,2987,2308,679
2020-02-01,YEM,W.P. Labuan,0,0,0
2020-02-01,ZAF,Johor,199,132,67
2020-02-01,ZAF,Kedah,67,34,33
2020-02-01,ZAF,Kelantan,18,9,9
2020-02-01,ZAF,Melaka,0,0,0
2020-02-01,ZAF,Pahang,0,0,0
2020-02-01,ZAF,Perak,1,1,0
2020-02-01,ZAF,Perlis,7,5,2
2020-02-01,ZAF,Pulau Pinang,46,30,16
2020-02-01,ZAF,Sabah,11,6,5
2020-02-01,ZAF,Sarawak,71,46,25
2020-02-01,ZAF,Selangor,938,519,419
2020-02-01,ZAF,Terengganu,0,0,0
2020-02-01,ZAF,W.P. Labuan,0,0,0
2020-02-01,ZAR,Selangor,1,0,1
2020-02-01,ZMB,Johor,2,1,1
2020-02-01,ZMB,Kedah,0,0,0
2020-02-01,ZMB,Perak,0,0,0
2020-02-01,ZMB,Perlis,0,0,0
2020-02-01,ZMB,Pulau Pinang,2,1,1
2020-02-01,ZMB,Sabah,0,0,0
2020-02-01,ZMB,Sarawak,1,1,0
2020-02-01,ZMB,Selangor,76,41,35
2020-02-01,ZWE,Johor,33,20,13
2020-02-01,ZWE,Kedah,0,0,0
2020-02-01,ZWE,Kelantan,1,1,0
2020-02-01,ZWE,Perak,0,0,0
2020-02-01,ZWE,Perlis,0,0,0
2020-02-01,ZWE,Pulau Pinang,1,1,0
2020-02-01,ZWE,Sabah,0,0,0
2020-02-01,ZWE,Sarawak,0,0,0
2020-02-01,ZWE,Selangor,134,82,52
2020-03-01,ABW,Kedah,0,0,0
2020-03-01,ABW,Pulau Pinang,0,0,0
2020-03-01,AFG,Johor,3,3,0
2020-03-01,AFG,Kedah,0,0,0
2020-03-01,AFG,Perlis,0,0,0
2020-03-01,AFG,Pulau Pinang,0,0,0
2020-03-01,AFG,Sarawak,0,0,0
2020-03-01,AFG,Selangor,84,68,16
2020-03-01,AGO,Johor,0,0,0
2020-03-01,AGO,Kedah,0,0,0
2020-03-01,AGO,Sabah,0,0,0
2020-03-01,AGO,Selangor,1,0,1
2020-03-01,AIA,Selangor,0,0,0
2020-03-01,ALB,Johor,7,6,1
2020-03-01,ALB,Kedah,0,0,0
2020-03-01,ALB,Perak,0,0,0
2020-03-01,ALB,Perlis,0,0,0
2020-03-01,ALB,Pulau Pinang,1,1,0
2020-03-01,ALB,Sabah,0,0,0
2020-03-01,ALB,Sarawak,0,0,0
2020-03-01,ALB,Selangor,19,10,9
2020-03-01,AND,Johor,0,0,0
2020-03-01,AND,Kedah,0,0,0
2020-03-01,AND,Perlis,0,0,0
2020-03-01,AND,Pulau Pinang,0,0,0
2020-03-01,AND,Selangor,1,1,0
2020-03-01,ANT,Selangor,0,0,0
2020-03-01,ARE,Johor,4,4,0
2020-03-01,ARE,Kedah,0,0,0
2020-03-01,ARE,Kelantan,0,0,0
2020-03-01,ARE,Perak,0,0,0
2020-03-01,ARE,Perlis,0,0,0
2020-03-01,ARE,Pulau Pinang,0,0,0
2020-03-01,ARE,Sabah,0,0,0
2020-03-01,ARE,Sarawak,0,0,0
2020-03-01,ARE,Selangor,60,49,11
2020-03-01,ARG,Johor,56,25,31
2020-03-01,ARG,Kedah,99,51,48
2020-03-01,ARG,Kelantan,0,0,0
2020-03-01,ARG,Melaka,0,0,0
2020-03-01,ARG,Perak,0,0,0
2020-03-01,ARG,Perlis,14,4,10
2020-03-01,ARG,Pulau Pinang,6,2,4
2020-03-01,ARG,Sabah,3,3,0
2020-03-01,ARG,Sarawak,3,3,0
2020-03-01,ARG,Selangor,329,181,148
2020-03-01,ARG,W.P. Labuan,1,1,0
2020-03-01,ARM,Johor,5,2,3
2020-03-01,ARM,Kedah,0,0,0
2020-03-01,ARM,Kelantan,0,0,0
2020-03-01,ARM,Perak,0,0,0
2020-03-01,ARM,Perlis,0,0,0
2020-03-01,ARM,Pulau Pinang,1,1,0
2020-03-01,ARM,Sabah,0,0,0
2020-03-01,ARM,Sarawak,0,0,0
2020-03-01,ARM,Selangor,18,9,9
2020-03-01,ATA,Selangor,0,0,0
2020-03-01,ATG,Johor,1,1,0
2020-03-01,ATG,Kedah,0,0,0
2020-03-01,ATG,Pulau Pinang,0,0,0
2020-03-01,ATG,Sarawak,0,0,0
2020-03-01,ATG,Selangor,6,5,1
2020-03-01,AUS,Johor,1347,887,460
2020-03-01,AUS,Kedah,253,148,105
2020-03-01,AUS,Kelantan,8,4,4
2020-03-01,AUS,Melaka,1,1,0
2020-03-01,AUS,Negeri Sembilan,1,1,0
2020-03-01,AUS,Pahang,2,1,1
2020-03-01,AUS,Perak,42,22,20
2020-03-01,AUS,Perlis,30,22,8
2020-03-01,AUS,Pulau Pinang,583,306,277
2020-03-01,AUS,Sabah,170,71,99
2020-03-01,AUS,Sarawak,160,102,58
2020-03-01,AUS,Selangor,6804,4239,2565
2020-03-01,AUS,Terengganu,2,2,0
2020-03-01,AUS,W.P. Labuan,6,4,2
2020-03-01,AUT,Johor,88,64,24
2020-03-01,AUT,Kedah,51,30,21
2020-03-01,AUT,Kelantan,7,6,1
2020-03-01,AUT,Melaka,0,0,0
2020-03-01,AUT,Negeri Sembilan,0,0,0
2020-03-01,AUT,Pahang,0,0,0
2020-03-01,AUT,Perak,0,0,0
2020-03-01,AUT,Perlis,6,4,2
2020-03-01,AUT,Pulau Pinang,42,26,16
2020-03-01,AUT,Sabah,9,5,4
2020-03-01,AUT,Sarawak,3,3,0
2020-03-01,AUT,Selangor,403,241,162
2020-03-01,AUT,Terengganu,0,0,0
2020-03-01,AUT,W.P. Labuan,0,0,0
2020-03-01,AZE,Johor,1,1,0
2020-03-01,AZE,Kedah,0,0,0
2020-03-01,AZE,Kelantan,0,0,0
2020-03-01,AZE,Melaka,0,0,0
2020-03-01,AZE,Perlis,0,0,0
2020-03-01,AZE,Pulau Pinang,0,0,0
2020-03-01,AZE,Sabah,0,0,0
2020-03-01,AZE,Sarawak,0,0,0
2020-03-01,AZE,Selangor,27,19,8
2020-03-01,AZE,W.P. Labuan,0,0,0
2020-03-01,BDI,Pulau Pinang,0,0,0
2020-03-01,BDI,Sarawak,0,0,0
2020-03-01,BDI,Selangor,1,1,0
2020-03-01,BEL,Johor,121,86,35
2020-03-01,BEL,Kedah,70,37,33
2020-03-01,BEL,Kelantan,6,4,2
2020-03-01,BEL,Melaka,0,0,0
2020-03-01,BEL,Negeri Sembilan,0,0,0
2020-03-01,BEL,Pahang,4,2,2
2020-03-01,BEL,Perak,0,0,0
2020-03-01,BEL,Perlis,9,5,4
2020-03-01,BEL,Pulau Pinang,30,22,8
2020-03-01,BEL,Sabah,16,12,4
2020-03-01,BEL,Sarawak,16,6,10
2020-03-01,BEL,Selangor,580,378,202
2020-03-01,BEL,W.P. Labuan,2,1,1
2020-03-01,BEN,Johor,0,0,0
2020-03-01,BEN,Kedah,0,0,0
2020-03-01,BEN,Perak,0,0,0
2020-03-01,BEN,Pulau Pinang,0,0,0
2020-03-01,BEN,Sabah,0,0,0
2020-03-01,BEN,Sarawak,0,0,0
2020-03-01,BEN,Selangor,1,1,0
2020-03-01,BFA,Perak,0,0,0
2020-03-01,BFA,Pulau Pinang,0,0,0
2020-03-01,BFA,Selangor,1,1,0
2020-03-01,BGD,Johor,794,699,95
2020-03-01,BGD,Kedah,0,0,0
2020-03-01,BGD,Kelantan,0,0,0
2020-03-01,BGD,Melaka,0,0,0
2020-03-01,BGD,Negeri Sembilan,0,0,0
2020-03-01,BGD,Pahang,0,0,0
2020-03-01,BGD,Perak,0,0,0
2020-03-01,BGD,Perlis,0,0,0
2020-03-01,BGD,Pulau Pinang,51,51,0
2020-03-01,BGD,Sabah,1,1,0
2020-03-01,BGD,Sarawak,48,48,0
2020-03-01,BGD,Selangor,9470,8768,702
2020-03-01,BGD,W.P. Labuan,5,5,0
2020-03-01,BGR,Johor,24,18,6
2020-03-01,BGR,Kedah,12,6,6
2020-03-01,BGR,Kelantan,0,0,0
2020-03-01,BGR,Pahang,0,0,0
2020-03-01,BGR,Perak,0,0,0
2020-03-01,BGR,Perlis,1,1,0
2020-03-01,BGR,Pulau Pinang,3,2,1
2020-03-01,BGR,Sabah,0,0,0
2020-03-01,BGR,Sarawak,0,0,0
2020-03-01,BGR,Selangor,146,90,56
2020-03-01,BGR,W.P. Labuan,0,0,0
2020-03-01,BHR,Johor,0,0,0
2020-03-01,BHR,Kedah,1,1,0
2020-03-01,BHR,Kelantan,0,0,0
2020-03-01,BHR,Perlis,0,0,0
2020-03-01,BHR,Pulau Pinang,0,0,0
2020-03-01,BHR,Sabah,0,0,0
2020-03-01,BHR,Sarawak,1,1,0
2020-03-01,BHR,Selangor,18,14,4
2020-03-01,BHS,Johor,0,0,0
2020-03-01,BHS,Kedah,0,0,0
2020-03-01,BHS,Perak,0,0,0
2020-03-01,BHS,Sabah,0,0,0
2020-03-01,BHS,Sarawak,0,0,0
2020-03-01,BHS,Selangor,2,1,1
2020-03-01,BIH,Johor,1,1,0
2020-03-01,BIH,Kedah,0,0,0
2020-03-01,BIH,Perlis,0,0,0
2020-03-01,BIH,Pulau Pinang,4,3,1
2020-03-01,BIH,Sabah,0,0,0
2020-03-01,BIH,Sarawak,0,0,0
2020-03-01,BIH,Selangor,24,17,7
2020-03-01,BLR,Johor,7,2,5
2020-03-01,BLR,Kedah,16,7,9
2020-03-01,BLR,Kelantan,0,0,0
2020-03-01,BLR,Pahang,0,0,0
2020-03-01,BLR,Perak,0,0,0
2020-03-01,BLR,Perlis,1,1,0
2020-03-01,BLR,Pulau Pinang,0,0,0
2020-03-01,BLR,Sabah,0,0,0
2020-03-01,BLR,Sarawak,2,0,2
2020-03-01,BLR,Selangor,208,97,111
2020-03-01,BLR,W.P. Labuan,1,0,1
2020-03-01,BLZ,Johor,0,0,0
2020-03-01,BLZ,Pulau Pinang,0,0,0
2020-03-01,BLZ,Sarawak,0,0,0
2020-03-01,BLZ,Selangor,2,2,0
2020-03-01,BMU,Selangor,0,0,0
2020-03-01,BOL,Johor,1,1,0
2020-03-01,BOL,Kedah,1,0,1
2020-03-01,BOL,Melaka,0,0,0
2020-03-01,BOL,Perak,0,0,0
2020-03-01,BOL,Perlis,0,0,0
2020-03-01,BOL,Pulau Pinang,0,0,0
2020-03-01,BOL,Sabah,0,0,0
2020-03-01,BOL,Sarawak,0,0,0
2020-03-01,BOL,Selangor,10,6,4
2020-03-01,BRA,Johor,71,39,32
2020-03-01,BRA,Kedah,53,29,24
2020-03-01,BRA,Kelantan,0,0,0
2020-03-01,BRA,Melaka,0,0,0
2020-03-01,BRA,Pahang,0,0,0
2020-03-01,BRA,Perak,0,0,0
2020-03-01,BRA,Perlis,2,0,2
2020-03-01,BRA,Pulau Pinang,14,7,7
2020-03-01,BRA,Sabah,5,2,3
2020-03-01,BRA,Sarawak,2,0,2
2020-03-01,BRA,Selangor,517,288,229
2020-03-01,BRA,W.P. Labuan,0,0,0
2020-03-01,BRB,Johor,1,0,1
2020-03-01,BRB,Kedah,0,0,0
2020-03-01,BRB,Perlis,0,0,0
2020-03-01,BRB,Pulau Pinang,0,0,0
2020-03-01,BRB,Selangor,0,0,0
2020-03-01,BRN,Johor,59,33,26
2020-03-01,BRN,Kedah,6,4,2
2020-03-01,BRN,Kelantan,4,2,2
2020-03-01,BRN,Melaka,0,0,0
2020-03-01,BRN,Pahang,0,0,0
2020-03-01,BRN,Perak,0,0,0
2020-03-01,BRN,Perlis,0,0,0
2020-03-01,BRN,Pulau Pinang,1,0,1
2020-03-01,BRN,Sabah,217,137,80
2020-03-01,BRN,Sarawak,29596,17860,11736
2020-03-01,BRN,Selangor,1243,669,574
2020-03-01,BRN,W.P. Labuan,470,341,129
2020-03-01,BTN,Johor,2,0,2
2020-03-01,BTN,Kedah,1,1,0
2020-03-01,BTN,Perak,0,0,0
2020-03-01,BTN,Perlis,0,0,0
2020-03-01,BTN,Pulau Pinang,0,0,0
2020-03-01,BTN,Sabah,0,0,0
2020-03-01,BTN,Sarawak,0,0,0
2020-03-01,BTN,Selangor,10,8,2
2020-03-01,BWA,Johor,0,0,0
2020-03-01,BWA,Kedah,0,0,0
2020-03-01,BWA,Perlis,0,0,0
2020-03-01,BWA,Pulau Pinang,0,0,0
2020-03-01,BWA,Sabah,0,0,0
2020-03-01,BWA,Sarawak,0,0,0
2020-03-01,BWA,Selangor,6,2,4
2020-03-01,CAF,Kedah,0,0,0
2020-03-01,CAF,Selangor,0,0,0
2020-03-01,CAN,Johor,450,272,178
2020-03-01,CAN,Kedah,130,76,54
2020-03-01,CAN,Kelantan,12,9,3
2020-03-01,CAN,Melaka,0,0,0
2020-03-01,CAN,Negeri Sembilan,0,0,0
2020-03-01,CAN,Pahang,2,1,1
2020-03-01,CAN,Perak,6,6,0
2020-03-01,CAN,Perlis,35,23,12
2020-03-01,CAN,Pulau Pinang,211,127,84
2020-03-01,CAN,Sabah,64,34,30
2020-03-01,CAN,Sarawak,131,83,48
2020-03-01,CAN,Selangor,1730,1023,707
2020-03-01,CAN,Terengganu,0,0,0
2020-03-01,CAN,W.P. Labuan,6,3,3
2020-03-01,CCK,Selangor,0,0,0
2020-03-01,CHE,Johor,174,104,70
2020-03-01,CHE,Kedah,134,70,64
2020-03-01,CHE,Kelantan,3,1,2
2020-03-01,CHE,Melaka,0,0,0
2020-03-01,CHE,Negeri Sembilan,0,0,0
2020-03-01,CHE,Pahang,0,0,0
2020-03-01,CHE,Perak,5,2,3
2020-03-01,CHE,Perlis,26,15,11
2020-03-01,CHE,Pulau Pinang,63,42,21
2020-03-01,CHE,Sabah,32,13,19
2020-03-01,CHE,Sarawak,21,8,13
2020-03-01,CHE,Selangor,624,368,256
2020-03-01,CHE,W.P. Labuan,0,0,0
2020-03-01,CHL,Johor,15,7,8
2020-03-01,CHL,Kedah,26,12,14
2020-03-01,CHL,Kelantan,2,0,2
2020-03-01,CHL,Melaka,0,0,0
2020-03-01,CHL,Pahang,0,0,0
2020-03-01,CHL,Perak,0,0,0
2020-03-01,CHL,Perlis,1,0,1
2020-03-01,CHL,Pulau Pinang,3,2,1
2020-03-01,CHL,Sabah,2,1,1
2020-03-01,CHL,Sarawak,0,0,0
2020-03-01,CHL,Selangor,163,81,82
2020-03-01,CHN,Johor,4791,1978,2813
2020-03-01,CHN,Kedah,232,92,140
2020-03-01,CHN,Kelantan,10,7,3
2020-03-01,CHN,Melaka,0,0,0
2020-03-01,CHN,Pahang,2,0,2
2020-03-01,CHN,Perak,197,73,124
2020-03-01,CHN,Perlis,30,17,13
2020-03-01,CHN,Pulau Pinang,954,530,424
2020-03-01,CHN,Sabah,105,51,54
2020-03-01,CHN,Sarawak,173,58,115
2020-03-01,CHN,Selangor,25271,15716,9555
2020-03-01,CHN,Terengganu,0,0,0
2020-03-01,CHN,W.P. Labuan,0,0,0
2020-03-01,CIV,Johor,0,0,0
2020-03-01,CIV,Kedah,0,0,0
2020-03-01,CIV,Pulau Pinang,0,0,0
2020-03-01,CIV,Sabah,0,0,0
2020-03-01,CIV,Sarawak,0,0,0
2020-03-01,CIV,Selangor,6,6,0
2020-03-01,CMR,Johor,4,4,0
2020-03-01,CMR,Kedah,0,0,0
2020-03-01,CMR,Pulau Pinang,0,0,0
2020-03-01,CMR,Sabah,0,0,0
2020-03-01,CMR,Sarawak,0,0,0
2020-03-01,CMR,Selangor,10,5,5
2020-03-01,COD,Johor,0,0,0
2020-03-01,COD,Pulau Pinang,0,0,0
2020-03-01,COD,Sarawak,0,0,0
2020-03-01,COD,Selangor,11,6,5
2020-03-01,COG,Johor,0,0,0
2020-03-01,COG,Kedah,1,0,1
2020-03-01,COG,Selangor,0,0,0
2020-03-01,COK,Selangor,0,0,0
2020-03-01,COL,Johor,3,1,2
2020-03-01,COL,Kedah,0,0,0
2020-03-01,COL,Perak,0,0,0
2020-03-01,COL,Pulau Pinang,1,1,0
2020-03-01,COL,Sabah,0,0,0
2020-03-01,COL,Sarawak,1,0,1
2020-03-01,COL,Selangor,54,28,26
2020-03-01,COL,W.P. Labuan,0,0,0
2020-03-01,COM,Johor,0,0,0
2020-03-01,COM,Kedah,0,0,0
2020-03-01,COM,Selangor,7,7,0
2020-03-01,CPV,Johor,0,0,0
2020-03-01,CPV,Kedah,0,0,0
2020-03-01,CPV,Pulau Pinang,0,0,0
2020-03-01,CPV,Sabah,0,0,0
2020-03-01,CPV,Selangor,2,2,0
2020-03-01,CRI,Johor,5,4,1
2020-03-01,CRI,Kedah,1,1,0
2020-03-01,CRI,Perak,0,0,0
2020-03-01,CRI,Perlis,0,0,0
2020-03-01,CRI,Pulau Pinang,1,0,1
2020-03-01,CRI,Sabah,0,0,0
2020-03-01,CRI,Sarawak,0,0,0
2020-03-01,CRI,Selangor,16,7,9
2020-03-01,CUB,Johor,2,2,0
2020-03-01,CUB,Kedah,1,1,0
2020-03-01,CUB,Perlis,0,0,0
2020-03-01,CUB,Pulau Pinang,0,0,0
2020-03-01,CUB,Sabah,0,0,0
2020-03-01,CUB,Sarawak,0,0,0
2020-03-01,CUB,Selangor,9,4,5
2020-03-01,CYP,Johor,4,3,1
2020-03-01,CYP,Kedah,0,0,0
2020-03-01,CYP,Perak,0,0,0
2020-03-01,CYP,Perlis,0,0,0
2020-03-01,CYP,Pulau Pinang,0,0,0
2020-03-01,CYP,Sabah,0,0,0
2020-03-01,CYP,Sarawak,0,0,0
2020-03-01,CYP,Selangor,17,12,5
2020-03-01,CZE,Johor,125,73,52
2020-03-01,CZE,Kedah,172,78,94
2020-03-01,CZE,Kelantan,1,1,0
2020-03-01,CZE,Melaka,0,0,0
2020-03-01,CZE,Negeri Sembilan,0,0,0
2020-03-01,CZE,Perak,0,0,0
2020-03-01,CZE,Perlis,8,6,2
2020-03-01,CZE,Pulau Pinang,10,7,3
2020-03-01,CZE,Sabah,22,11,11
2020-03-01,CZE,Sarawak,27,18,9
2020-03-01,CZE,Selangor,418,242,176
2020-03-01,CZE,W.P. Labuan,0,0,0
2020-03-01,DEU,Johor,1069,695,374
2020-03-01,DEU,Kedah,873,463,410
2020-03-01,DEU,Kelantan,31,21,10
2020-03-01,DEU,Melaka,0,0,0
2020-03-01,DEU,Negeri Sembilan,0,0,0
2020-03-01,DEU,Pahang,1,1,0
2020-03-01,DEU,Perak,11,6,5
2020-03-01,DEU,Perlis,90,58,32
2020-03-01,DEU,Pulau Pinang,318,204,114
2020-03-01,DEU,Sabah,105,65,40
2020-03-01,DEU,Sarawak,148,89,59
2020-03-01,DEU,Selangor,3930,2284,1646
2020-03-01,DEU,Terengganu,0,0,0
2020-03-01,DEU,W.P. Labuan,14,11,3
2020-03-01,DJI,Johor,0,0,0
2020-03-01,DJI,Selangor,4,0,4
2020-03-01,DMA,Johor,2,2,0
2020-03-01,DMA,Kedah,0,0,0
2020-03-01,DMA,Pulau Pinang,0,0,0
2020-03-01,DMA,Sabah,0,0,0
2020-03-01,DMA,Sarawak,0,0,0
2020-03-01,DMA,Selangor,12,10,2
2020-03-01,DMA,W.P. Labuan,0,0,0
2020-03-01,DNK,Johor,111,74,37
2020-03-01,DNK,Kedah,136,58,78
2020-03-01,DNK,Kelantan,0,0,0
2020-03-01,DNK,Melaka,0,0,0
2020-03-01,DNK,Negeri Sembilan,0,0,0
2020-03-01,DNK,Pahang,0,0,0
2020-03-01,DNK,Perak,2,1,1
2020-03-01,DNK,Perlis,3,1,2
2020-03-01,DNK,Pulau Pinang,44,28,16
2020-03-01,DNK,Sabah,47,22,25
2020-03-01,DNK,Sarawak,20,12,8
2020-03-01,DNK,Selangor,527,310,217
2020-03-01,DNK,W.P. Labuan,0,0,0
2020-03-01,DOM,Johor,0,0,0
2020-03-01,DOM,Kedah,0,0,0
2020-03-01,DOM,Perak,0,0,0
2020-03-01,DOM,Perlis,0,0,0
2020-03-01,DOM,Pulau Pinang,0,0,0
2020-03-01,DOM,Sabah,0,0,0
2020-03-01,DOM,Sarawak,0,0,0
2020-03-01,DOM,Selangor,6,4,2
2020-03-01,DZA,Johor,21,21,0
2020-03-01,DZA,Kedah,6,3,3
2020-03-01,DZA,Kelantan,0,0,0
2020-03-01,DZA,Melaka,0,0,0
2020-03-01,DZA,Perak,0,0,0
2020-03-01,DZA,Perlis,2,1,1
2020-03-01,DZA,Pulau Pinang,5,4,1
2020-03-01,DZA,Sabah,0,0,0
2020-03-01,DZA,Sarawak,0,0,0
2020-03-01,DZA,Selangor,333,239,94
2020-03-01,DZA,W.P. Labuan,0,0,0
2020-03-01,ECU,Johor,0,0,0
2020-03-01,ECU,Kedah,0,0,0
2020-03-01,ECU,Perak,0,0,0
2020-03-01,ECU,Perlis,0,0,0
2020-03-01,ECU,Pulau Pinang,0,0,0
2020-03-01,ECU,Sabah,0,0,0
2020-03-01,ECU,Sarawak,0,0,0
2020-03-01,ECU,Selangor,15,7,8
2020-03-01,EGY,Johor,91,80,11
2020-03-01,EGY,Kedah,4,2,2
2020-03-01,EGY,Kelantan,5,5,0
2020-03-01,EGY,Melaka,0,0,0
2020-03-01,EGY,Pahang,0,0,0
2020-03-01,EGY,Perak,0,0,0
2020-03-01,EGY,Perlis,0,0,0
2020-03-01,EGY,Pulau Pinang,7,4,3
2020-03-01,EGY,Sabah,1,1,0
2020-03-01,EGY,Sarawak,8,8,0
2020-03-01,EGY,Selangor,645,478,167
2020-03-01,EGY,Terengganu,0,0,0
2020-03-01,EGY,W.P. Labuan,2,2,0
2020-03-01,ERI,Johor,0,0,0
2020-03-01,ERI,Pulau Pinang,0,0,0
2020-03-01,ERI,Sabah,0,0,0
2020-03-01,ERI,Selangor,3,3,0
2020-03-01,ESP,Johor,160,101,59
2020-03-01,ESP,Kedah,114,53,61
2020-03-01,ESP,Kelantan,7,5,2
2020-03-01,ESP,Melaka,1,1,0
2020-03-01,ESP,Negeri Sembilan,0,0,0
2020-03-01,ESP,Pahang,1,1,0
2020-03-01,ESP,Perak,0,0,0
2020-03-01,ESP,Perlis,19,11,8
2020-03-01,ESP,Pulau Pinang,36,20,16
2020-03-01,ESP,Sabah,19,10,9
2020-03-01,ESP,Sarawak,16,7,9
2020-03-01,ESP,Selangor,1054,615,439
2020-03-01,ESP,W.P. Labuan,1,1,0
2020-03-01,EST,Johor,24,8,16
2020-03-01,EST,Kedah,65,27,38
2020-03-01,EST,Kelantan,1,0,1
2020-03-01,EST,Pahang,0,0,0
2020-03-01,EST,Perak,0,0,0
2020-03-01,EST,Perlis,0,0,0
2020-03-01,EST,Pulau Pinang,3,1,2
2020-03-01,EST,Sabah,2,0,2
2020-03-01,EST,Sarawak,2,0,2
2020-03-01,EST,Selangor,110,61,49
2020-03-01,EST,W.P. Labuan,2,1,1
2020-03-01,ETH,Johor,0,0,0
2020-03-01,ETH,Kedah,0,0,0
2020-03-01,ETH,Pulau Pinang,0,0,0
2020-03-01,ETH,Sarawak,0,0,0
2020-03-01,ETH,Selangor,13,6,7
2020-03-01,FIN,Johor,104,76,28
2020-03-01,FIN,Kedah,180,84,96
2020-03-01,FIN,Kelantan,3,2,1
2020-03-01,FIN,Melaka,2,1,1
2020-03-01,FIN,Negeri Sembilan,0,0,0
2020-03-01,FIN,Pahang,0,0,0
2020-03-01,FIN,Perak,2,1,1
2020-03-01,FIN,Perlis,6,5,1
2020-03-01,FIN,Pulau Pinang,43,26,17
2020-03-01,FIN,Sabah,12,6,6
2020-03-01,FIN,Sarawak,5,2,3
2020-03-01,FIN,Selangor,425,238,187
2020-03-01,FIN,W.P. Labuan,4,2,2
2020-03-01,FJI,Johor,0,0,0
2020-03-01,FJI,Kedah,0,0,0
2020-03-01,FJI,Kelantan,0,0,0
2020-03-01,FJI,Perak,0,0,0
2020-03-01,FJI,Perlis,0,0,0
2020-03-01,FJI,Pulau Pinang,0,0,0
2020-03-01,FJI,Sabah,0,0,0
2020-03-01,FJI,Sarawak,1,1,0
2020-03-01,FJI,Selangor,28,14,14
2020-03-01,FRA,Johor,792,518,274
2020-03-01,FRA,Kedah,693,391,302
2020-03-01,FRA,Kelantan,61,36,25
2020-03-01,FRA,Melaka,0,0,0
2020-03-01,FRA,Negeri Sembilan,1,1,0
2020-03-01,FRA,Pahang,12,7,5
2020-03-01,FRA,Perak,8,6,2
2020-03-01,FRA,Perlis,68,38,30
2020-03-01,FRA,Pulau Pinang,231,146,85
2020-03-01,FRA,Sabah,60,43,17
2020-03-01,FRA,Sarawak,43,32,11
2020-03-01,FRA,Selangor,4310,2537,1773
2020-03-01,FRA,Terengganu,0,0,0
2020-03-01,FRA,W.P. Labuan,1,1,0
2020-03-01,FSM,Johor,0,0,0
2020-03-01,FSM,Pulau Pinang,0,0,0
2020-03-01,FSM,Selangor,0,0,0
2020-03-01,GAB,Johor,0,0,0
2020-03-01,GAB,Pulau Pinang,0,0,0
2020-03-01,GAB,Sarawak,0,0,0
2020-03-01,GAB,Selangor,5,3,2
2020-03-01,GBR,Johor,2111,1405,706
2020-03-01,GBR,Kedah,794,443,351
2020-03-01,GBR,Kelantan,27,15,12
2020-03-01,GBR,Melaka,1,1,0
2020-03-01,GBR,Negeri Sembilan,1,1,0
2020-03-01,GBR,Pahang,2,1,1
2020-03-01,GBR,Perak,36,21,15
2020-03-01,GBR,Perlis,152,93,59
2020-03-01,GBR,Pulau Pinang,832,499,333
2020-03-01,GBR,Sabah,291,146,145
2020-03-01,GBR,Sarawak,449,312,137
2020-03-01,GBR,Selangor,8560,5286,3274
2020-03-01,GBR,Terengganu,2,2,0
2020-03-01,GBR,W.P. Labuan,48,38,10
2020-03-01,GEO,Johor,3,3,0
2020-03-01,GEO,Kedah,1,1,0
2020-03-01,GEO,Melaka,0,0,0
2020-03-01,GEO,Perak,0,0,0
2020-03-01,GEO,Perlis,0,0,0
2020-03-01,GEO,Pulau Pinang,1,1,0
2020-03-01,GEO,Sabah,0,0,0
2020-03-01,GEO,Sarawak,0,0,0
2020-03-01,GEO,Selangor,14,12,2
2020-03-01,GHA,Johor,2,1,1
2020-03-01,GHA,Kedah,0,0,0
2020-03-01,GHA,Kelantan,0,0,0
2020-03-01,GHA,Pulau Pinang,0,0,0
2020-03-01,GHA,Sabah,0,0,0
2020-03-01,GHA,Sarawak,0,0,0
2020-03-01,GHA,Selangor,19,14,5
2020-03-01,GIB,Johor,0,0,0
2020-03-01,GIB,Sarawak,0,0,0
2020-03-01,GIN,Johor,0,0,0
2020-03-01,GIN,Kedah,0,0,0
2020-03-01,GIN,Kelantan,1,1,0
2020-03-01,GIN,Perlis,0,0,0
2020-03-01,GIN,Pulau Pinang,0,0,0
2020-03-01,GIN,Sabah,0,0,0
2020-03-01,GIN,Sarawak,0,0,0
2020-03-01,GIN,Selangor,25,18,7
2020-03-01,GLP,Selangor,1,1,0
2020-03-01,GMB,Johor,0,0,0
2020-03-01,GMB,Kedah,0,0,0
2020-03-01,GMB,Kelantan,0,0,0
2020-03-01,GMB,Pulau Pinang,0,0,0
2020-03-01,GMB,Sabah,0,0,0
2020-03-01,GMB,Sarawak,0,0,0
2020-03-01,GMB,Selangor,33,26,7
2020-03-01,GNB,Johor,1,1,0
2020-03-01,GNB,Selangor,0,0,0
2020-03-01,GNQ,Johor,0,0,0
2020-03-01,GNQ,Selangor,0,0,0
2020-03-01,GRC,Johor,18,15,3
2020-03-01,GRC,Kedah,6,4,2
2020-03-01,GRC,Kelantan,1,1,0
2020-03-01,GRC,Melaka,0,0,0
2020-03-01,GRC,Negeri Sembilan,0,0,0
2020-03-01,GRC,Pahang,0,0,0
2020-03-01,GRC,Perak,0,0,0
2020-03-01,GRC,Perlis,0,0,0
2020-03-01,GRC,Pulau Pinang,4,3,1
2020-03-01,GRC,Sabah,2,2,0
2020-03-01,GRC,Sarawak,0,0,0
2020-03-01,GRC,Selangor,104,72,32
2020-03-01,GRD,Johor,6,6,0
2020-03-01,GRD,Kedah,0,0,0
2020-03-01,GRD,Pulau Pinang,0,0,0
2020-03-01,GRD,Sabah,0,0,0
2020-03-01,GRD,Sarawak,0,0,0
2020-03-01,GRD,Selangor,1,1,0
2020-03-01,GRL,Johor,0,0,0
2020-03-01,GRL,Selangor,0,0,0
2020-03-01,GTM,Johor,0,0,0
2020-03-01,GTM,Kedah,0,0,0
2020-03-01,GTM,Pahang,0,0,0
2020-03-01,GTM,Perak,0,0,0
2020-03-01,GTM,Pulau Pinang,0,0,0
2020-03-01,GTM,Sabah,0,0,0
2020-03-01,GTM,Sarawak,0,0,0
2020-03-01,GTM,Selangor,2,2,0
2020-03-01,GTM,W.P. Labuan,0,0,0
2020-03-01,GUY,Johor,0,0,0
2020-03-01,GUY,Kedah,0,0,0
2020-03-01,GUY,Pulau Pinang,0,0,0
2020-03-01,GUY,Sarawak,0,0,0
2020-03-01,GUY,Selangor,3,3,0
2020-03-01,HKG,Johor,0,0,0
2020-03-01,HKG,Kedah,0,0,0
2020-03-01,HKG,Kelantan,0,0,0
2020-03-01,HKG,Pahang,0,0,0
2020-03-01,HKG,Perak,7,4,3
2020-03-01,HKG,Perlis,1,1,0
2020-03-01,HKG,Pulau Pinang,0,0,0
2020-03-01,HKG,Sabah,0,0,0
2020-03-01,HKG,Sarawak,1,0,1
2020-03-01,HKG,Selangor,0,0,0
2020-03-01,HKG,Terengganu,0,0,0
2020-03-01,HMD,Johor,0,0,0
2020-03-01,HND,Johor,2,2,0
2020-03-01,HND,Kedah,2,0,2
2020-03-01,HND,Perak,0,0,0
2020-03-01,HND,Pulau Pinang,0,0,0
2020-03-01,HND,Sabah,0,0,0
2020-03-01,HND,Sarawak,0,0,0
2020-03-01,HND,Selangor,6,3,3
2020-03-01,HRV,Johor,20,17,3
2020-03-01,HRV,Kedah,6,4,2
2020-03-01,HRV,Kelantan,0,0,0
2020-03-01,HRV,Melaka,0,0,0
2020-03-01,HRV,Pahang,0,0,0
2020-03-01,HRV,Perak,0,0,0
2020-03-01,HRV,Perlis,0,0,0
2020-03-01,HRV,Pulau Pinang,4,2,2
2020-03-01,HRV,Sabah,1,1,0
2020-03-01,HRV,Sarawak,2,2,0
2020-03-01,HRV,Selangor,56,43,13
2020-03-01,HTI,Johor,0,0,0
2020-03-01,HTI,Kedah,0,0,0
2020-03-01,HTI,Kelantan,0,0,0
2020-03-01,HTI,Perak,0,0,0
2020-03-01,HTI,Pulau Pinang,0,0,0
2020-03-01,HTI,Sabah,0,0,0
2020-03-01,HTI,Selangor,0,0,0
2020-03-01,HUN,Johor,30,20,10
2020-03-01,HUN,Kedah,70,37,33
2020-03-01,HUN,Kelantan,1,1,0
2020-03-01,HUN,Pahang,0,0,0
2020-03-01,HUN,Perak,2,1,1
2020-03-01,HUN,Perlis,1,1,0
2020-03-01,HUN,Pulau Pinang,17,10,7
2020-03-01,HUN,Sabah,7,4,3
2020-03-01,HUN,Sarawak,3,2,1
2020-03-01,HUN,Selangor,396,204,192
2020-03-01,HUN,W.P. Labuan,0,0,0
2020-03-01,IDN,Johor,59621,34831,24790
2020-03-01,IDN,Kedah,813,312,501
2020-03-01,IDN,Kelantan,103,77,26
2020-03-01,IDN,Melaka,1014,482,532
2020-03-01,IDN,Negeri Sembilan,1686,1134,552
2020-03-01,IDN,Pahang,2,2,0
2020-03-01,IDN,Perak,93,35,58
2020-03-01,IDN,Perlis,203,109,94
2020-03-01,IDN,Pulau Pinang,11656,4678,6978
2020-03-01,IDN,Sabah,2945,1545,1400
2020-03-01,IDN,Sarawak,14387,8918,5469
2020-03-01,IDN,Selangor,39093,19629,19464
2020-03-01,IDN,Terengganu,7,7,0
2020-03-01,IDN,W.P. Labuan,60,40,20
2020-03-01,IND,Johor,6925,5476,1449
2020-03-01,IND,Kedah,130,87,43
2020-03-01,IND,Kelantan,4,4,0
2020-03-01,IND,Melaka,1,1,0
2020-03-01,IND,Negeri Sembilan,1,1,0
2020-03-01,IND,Pahang,3,2,1
2020-03-01,IND,Perak,104,72,32
2020-03-01,IND,Perlis,15,11,4
2020-03-01,IND,Pulau Pinang,172,127,45
2020-03-01,IND,Sabah,39,28,11
2020-03-01,IND,Sarawak,544,485,59
2020-03-01,IND,Selangor,19251,15243,4008
2020-03-01,IND,Terengganu,3,3,0
2020-03-01,IND,W.P. Labuan,18,16,2
2020-03-01,IOT,Pulau Pinang,0,0,0
2020-03-01,IOT,Selangor,0,0,0
2020-03-01,IRL,Johor,121,86,35
2020-03-01,IRL,Kedah,56,25,31
2020-03-01,IRL,Kelantan,2,1,1
2020-03-01,IRL,Negeri Sembilan,0,0,0
2020-03-01,IRL,Pahang,0,0,0
2020-03-01,IRL,Perak,5,2,3
2020-03-01,IRL,Perlis,9,5,4
2020-03-01,IRL,Pulau Pinang,36,24,12
2020-03-01,IRL,Sabah,2,1,1
2020-03-01,IRL,Sarawak,9,7,2
2020-03-01,IRL,Selangor,514,318,196
2020-03-01,IRL,Terengganu,0,0,0
2020-03-01,IRL,W.P. Labuan,1,0,1
2020-03-01,IRN,Johor,52,32,20
2020-03-01,IRN,Kedah,0,0,0
2020-03-01,IRN,Kelantan,0,0,0
2020-03-01,IRN,Perak,0,0,0
2020-03-01,IRN,Perlis,0,0,0
2020-03-01,IRN,Pulau Pinang,2,2,0
2020-03-01,IRN,Sabah,1,1,0
2020-03-01,IRN,Sarawak,0,0,0
2020-03-01,IRN,Selangor,651,381,270
2020-03-01,IRN,W.P. Labuan,0,0,0
2020-03-01,IRQ,Johor,9,7,2
2020-03-01,IRQ,Kedah,0,0,0
2020-03-01,IRQ,Kelantan,0,0,0
2020-03-01,IRQ,Melaka,0,0,0
2020-03-01,IRQ,Pahang,0,0,0
2020-03-01,IRQ,Perak,0,0,0
2020-03-01,IRQ,Perlis,0,0,0
2020-03-01,IRQ,Pulau Pinang,5,4,1
2020-03-01,IRQ,Sabah,0,0,0
2020-03-01,IRQ,Sarawak,0,0,0
2020-03-01,IRQ,Selangor,597,405,192
2020-03-01,ISL,Johor,4,4,0
2020-03-01,ISL,Kedah,4,2,2
2020-03-01,ISL,Kelantan,0,0,0
2020-03-01,ISL,Perak,0,0,0
2020-03-01,ISL,Perlis,1,1,0
2020-03-01,ISL,Pulau Pinang,0,0,0
2020-03-01,ISL,Sabah,0,0,0
2020-03-01,ISL,Sarawak,0,0,0
2020-03-01,ISL,Selangor,33,18,15
2020-03-01,ISL,W.P. Labuan,0,0,0
2020-03-01,ISR,Pulau Pinang,0,0,0
2020-03-01,ITA,Johor,196,157,39
2020-03-01,ITA,Kedah,165,91,74
2020-03-01,ITA,Kelantan,16,12,4
2020-03-01,ITA,Melaka,0,0,0
2020-03-01,ITA,Negeri Sembilan,0,0,0
2020-03-01,ITA,Pahang,0,0,0
2020-03-01,ITA,Perak,7,4,3
2020-03-01,ITA,Perlis,19,15,4
2020-03-01,ITA,Pulau Pinang,32,23,9
2020-03-01,ITA,Sabah,8,5,3
2020-03-01,ITA,Sarawak,29,14,15
2020-03-01,ITA,Selangor,685,485,200
2020-03-01,ITA,W.P. Labuan,4,4,0
2020-03-01,JAM,Johor,0,0,0
2020-03-01,JAM,Kedah,0,0,0
2020-03-01,JAM,Perak,0,0,0
2020-03-01,JAM,Pulau Pinang,2,1,1
2020-03-01,JAM,Sabah,0,0,0
2020-03-01,JAM,Sarawak,1,1,0
2020-03-01,JAM,Selangor,4,2,2
2020-03-01,JAM,W.P. Labuan,0,0,0
2020-03-01,JOR,Johor,8,4,4
2020-03-01,JOR,Kedah,11,7,4
2020-03-01,JOR,Kelantan,0,0,0
2020-03-01,JOR,Melaka,0,0,0
2020-03-01,JOR,Perlis,0,0,0
2020-03-01,JOR,Pulau Pinang,13,11,2
2020-03-01,JOR,Sabah,0,0,0
2020-03-01,JOR,Sarawak,1,1,0
2020-03-01,JOR,Selangor,263,196,67
2020-03-01,JOR,W.P. Labuan,0,0,0
2020-03-01,JPN,Johor,2284,1682,602
2020-03-01,JPN,Kedah,127,64,63
2020-03-01,JPN,Kelantan,8,8,0
2020-03-01,JPN,Melaka,1,1,0
2020-03-01,JPN,Negeri Sembilan,0,0,0
2020-03-01,JPN,Pahang,0,0,0
2020-03-01,JPN,Perak,11,6,5
2020-03-01,JPN,Perlis,45,38,7
2020-03-01,JPN,Pulau Pinang,306,211,95
2020-03-01,JPN,Sabah,303,149,154
2020-03-01,JPN,Sarawak,97,74,23
2020-03-01,JPN,Selangor,7593,4799,2794
2020-03-01,JPN,W.P. Labuan,27,15,12
2020-03-01,KAZ,Johor,10,2,8
2020-03-01,KAZ,Kedah,25,13,12
2020-03-01,KAZ,Kelantan,0,0,0
2020-03-01,KAZ,Melaka,0,0,0
2020-03-01,KAZ,Perak,0,0,0
2020-03-01,KAZ,Perlis,4,2,2
2020-03-01,KAZ,Pulau Pinang,3,2,1
2020-03-01,KAZ,Sabah,0,0,0
2020-03-01,KAZ,Sarawak,4,1,3
2020-03-01,KAZ,Selangor,1163,452,711
2020-03-01,KAZ,W.P. Labuan,0,0,0
2020-03-01,KEN,Johor,6,1,5
2020-03-01,KEN,Kedah,1,1,0
2020-03-01,KEN,Kelantan,1,0,1
2020-03-01,KEN,Perak,0,0,0
2020-03-01,KEN,Perlis,0,0,0
2020-03-01,KEN,Pulau Pinang,1,1,0
2020-03-01,KEN,Sabah,0,0,0
2020-03-01,KEN,Sarawak,0,0,0
2020-03-01,KEN,Selangor,103,65,38
2020-03-01,KGZ,Johor,8,7,1
2020-03-01,KGZ,Kedah,9,7,2
2020-03-01,KGZ,Kelantan,0,0,0
2020-03-01,KGZ,Perak,0,0,0
2020-03-01,KGZ,Perlis,1,0,1
2020-03-01,KGZ,Pulau Pinang,1,0,1
2020-03-01,KGZ,Sabah,0,0,0
2020-03-01,KGZ,Sarawak,0,0,0
2020-03-01,KGZ,Selangor,130,58,72
2020-03-01,KHM,Johor,370,133,237
2020-03-01,KHM,Kedah,149,95,54
2020-03-01,KHM,Kelantan,337,211,126
2020-03-01,KHM,Melaka,0,0,0
2020-03-01,KHM,Negeri Sembilan,0,0,0
2020-03-01,KHM,Pahang,0,0,0
2020-03-01,KHM,Perak,20,17,3
2020-03-01,KHM,Perlis,481,365,116
2020-03-01,KHM,Pulau Pinang,6,1,5
2020-03-01,KHM,Sabah,5,4,1
2020-03-01,KHM,Sarawak,5,0,5
2020-03-01,KHM,Selangor,1386,600,786
2020-03-01,KHM,W.P. Labuan,0,0,0
2020-03-01,KIR,Johor,2,2,0
2020-03-01,KIR,Sabah,0,0,0
2020-03-01,KIR,Selangor,0,0,0
2020-03-01,KNA,Johor,3,3,0
2020-03-01,KNA,Kedah,0,0,0
2020-03-01,KNA,Perlis,0,0,0
2020-03-01,KNA,Pulau Pinang,2,1,1
2020-03-01,KNA,Sabah,0,0,0
2020-03-01,KNA,Selangor,18,14,4
2020-03-01,KNA,W.P. Labuan,0,0,0
2020-03-01,KOR,Johor,1761,1062,699
2020-03-01,KOR,Kedah,54,30,24
2020-03-01,KOR,Kelantan,3,1,2
2020-03-01,KOR,Melaka,0,0,0
2020-03-01,KOR,Negeri Sembilan,0,0,0
2020-03-01,KOR,Pahang,5,4,1
2020-03-01,KOR,Perak,11,8,3
2020-03-01,KOR,Perlis,160,93,67
2020-03-01,KOR,Pulau Pinang,92,51,41
2020-03-01,KOR,Sabah,24,19,5
2020-03-01,KOR,Sarawak,70,36,34
2020-03-01,KOR,Selangor,2376,1423,953
2020-03-01,KOR,Terengganu,0,0,0
2020-03-01,KOR,W.P. Labuan,3,3,0
2020-03-01,KWT,Johor,1,0,1
2020-03-01,KWT,Kedah,5,2,3
2020-03-01,KWT,Kelantan,1,0,1
2020-03-01,KWT,Perak,0,0,0
2020-03-01,KWT,Perlis,0,0,0
2020-03-01,KWT,Pulau Pinang,1,1,0
2020-03-01,KWT,Sabah,0,0,0
2020-03-01,KWT,Sarawak,0,0,0
2020-03-01,KWT,Selangor,48,39,9
2020-03-01,KWT,W.P. Labuan,0,0,0
2020-03-01,LAO,Johor,29,5,24
2020-03-01,LAO,Kedah,670,54,616
2020-03-01,LAO,Kelantan,102,20,82
2020-03-01,LAO,Melaka,0,0,0
2020-03-01,LAO,Perak,7,2,5
2020-03-01,LAO,Perlis,223,66,157
2020-03-01,LAO,Pulau Pinang,0,0,0
2020-03-01,LAO,Sabah,0,0,0
2020-03-01,LAO,Sarawak,3,2,1
2020-03-01,LAO,Selangor,99,31,68
2020-03-01,LAO,W.P. Labuan,0,0,0
2020-03-01,LBN,Johor,6,4,2
2020-03-01,LBN,Kedah,0,0,0
2020-03-01,LBN,Kelantan,0,0,0
2020-03-01,LBN,Pahang,0,0,0
2020-03-01,LBN,Perak,0,0,0
2020-03-01,LBN,Perlis,0,0,0
2020-03-01,LBN,Pulau Pinang,0,0,0
2020-03-01,LBN,Sabah,0,0,0
2020-03-01,LBN,Sarawak,0,0,0
2020-03-01,LBN,Selangor,82,66,16
2020-03-01,LBN,W.P. Labuan,0,0,0
2020-03-01,LBR,Johor,0,0,0
2020-03-01,LBR,Kedah,0,0,0
2020-03-01,LBR,Sabah,0,0,0
2020-03-01,LBR,Sarawak,0,0,0
2020-03-01,LBR,Selangor,3,3,0
2020-03-01,LBY,Johor,1,1,0
2020-03-01,LBY,Kedah,1,1,0
2020-03-01,LBY,Perlis,0,0,0
2020-03-01,LBY,Pulau Pinang,0,0,0
2020-03-01,LBY,Sabah,0,0,0
2020-03-01,LBY,Sarawak,2,0,2
2020-03-01,LBY,Selangor,256,184,72
2020-03-01,LCA,Johor,2,2,0
2020-03-01,LCA,Kedah,0,0,0
2020-03-01,LCA,Pulau Pinang,0,0,0
2020-03-01,LCA,Sarawak,0,0,0
2020-03-01,LCA,Selangor,3,3,0
2020-03-01,LIE,Johor,0,0,0
2020-03-01,LIE,Kedah,0,0,0
2020-03-01,LIE,Perlis,0,0,0
2020-03-01,LIE,Pulau Pinang,0,0,0
2020-03-01,LIE,Sabah,0,0,0
2020-03-01,LIE,Sarawak,0,0,0
2020-03-01,LIE,Selangor,4,1,3
2020-03-01,LKA,Johor,340,265,75
2020-03-01,LKA,Kedah,4,3,1
2020-03-01,LKA,Kelantan,2,1,1
2020-03-01,LKA,Melaka,0,0,0
2020-03-01,LKA,Pahang,0,0,0
2020-03-01,LKA,Perak,1,1,0
2020-03-01,LKA,Perlis,0,0,0
2020-03-01,LKA,Pulau Pinang,7,7,0
2020-03-01,LKA,Sabah,1,1,0
2020-03-01,LKA,Sarawak,6,5,1
2020-03-01,LKA,Selangor,1437,907,530
2020-03-01,LKA,W.P. Labuan,0,0,0
2020-03-01,LSO,Johor,0,0,0
2020-03-01,LSO,Kedah,0,0,0
2020-03-01,LSO,Pulau Pinang,0,0,0
2020-03-01,LSO,Sarawak,0,0,0
2020-03-01,LSO,Selangor,2,2,0
2020-03-01,LTU,Johor,20,10,10
2020-03-01,LTU,Kedah,23,13,10
2020-03-01,LTU,Kelantan,1,1,0
2020-03-01,LTU,Pahang,0,0,0
2020-03-01,LTU,Perak,0,0,0
2020-03-01,LTU,Perlis,4,2,2
2020-03-01,LTU,Pulau Pinang,6,4,2
2020-03-01,LTU,Sabah,1,1,0
2020-03-01,LTU,Sarawak,2,1,1
2020-03-01,LTU,Selangor,131,71,60
2020-03-01,LTU,W.P. Labuan,3,2,1
2020-03-01,LUX,Johor,1,0,1
2020-03-01,LUX,Kedah,2,2,0
2020-03-01,LUX,Kelantan,2,0,2
2020-03-01,LUX,Perak,0,0,0
2020-03-01,LUX,Perlis,0,0,0
2020-03-01,LUX,Pulau Pinang,3,1,2
2020-03-01,LUX,Sabah,2,1,1
2020-03-01,LUX,Sarawak,0,0,0
2020-03-01,LUX,Selangor,23,13,10
2020-03-01,LVA,Johor,26,19,7
2020-03-01,LVA,Kedah,8,4,4
2020-03-01,LVA,Kelantan,0,0,0
2020-03-01,LVA,Pahang,0,0,0
2020-03-01,LVA,Perak,0,0,0
2020-03-01,LVA,Perlis,1,0,1
2020-03-01,LVA,Pulau Pinang,3,2,1
2020-03-01,LVA,Sabah,3,1,2
2020-03-01,LVA,Sarawak,0,0,0
2020-03-01,LVA,Selangor,97,43,54
2020-03-01,LVA,W.P. Labuan,0,0,0
2020-03-01,MAC,Johor,0,0,0
2020-03-01,MAC,Pahang,0,0,0
2020-03-01,MAC,Perak,0,0,0
2020-03-01,MAC,Selangor,0,0,0
2020-03-01,MAC,W.P. Labuan,0,0,0
2020-03-01,MAR,Johor,44,33,11
2020-03-01,MAR,Kedah,2,1,1
2020-03-01,MAR,Kelantan,0,0,0
2020-03-01,MAR,Melaka,0,0,0
2020-03-01,MAR,Pahang,0,0,0
2020-03-01,MAR,Perak,0,0,0
2020-03-01,MAR,Perlis,0,0,0
2020-03-01,MAR,Pulau Pinang,2,2,0
2020-03-01,MAR,Sabah,2,1,1
2020-03-01,MAR,Sarawak,1,1,0
2020-03-01,MAR,Selangor,324,176,148
2020-03-01,MAR,W.P. Labuan,1,1,0
2020-03-01,MCO,Johor,0,0,0
2020-03-01,MCO,Kedah,0,0,0
2020-03-01,MCO,Sabah,0,0,0
2020-03-01,MCO,Selangor,2,1,1
2020-03-01,MDA,Johor,5,2,3
2020-03-01,MDA,Kedah,3,1,2
2020-03-01,MDA,Kelantan,0,0,0
2020-03-01,MDA,Negeri Sembilan,0,0,0
2020-03-01,MDA,Perlis,0,0,0
2020-03-01,MDA,Pulau Pinang,2,1,1
2020-03-01,MDA,Sabah,0,0,0
2020-03-01,MDA,Sarawak,0,0,0
2020-03-01,MDA,Selangor,21,10,11
2020-03-01,MDG,Johor,2,2,0
2020-03-01,MDG,Kedah,1,0,1
2020-03-01,MDG,Perak,0,0,0
2020-03-01,MDG,Perlis,0,0,0
2020-03-01,MDG,Pulau Pinang,0,0,0
2020-03-01,MDG,Sabah,0,0,0
2020-03-01,MDG,Sarawak,0,0,0
2020-03-01,MDG,Selangor,25,12,13
2020-03-01,MDV,Johor,23,15,8
2020-03-01,MDV,Kedah,0,0,0
2020-03-01,MDV,Kelantan,0,0,0
2020-03-01,MDV,Perak,0,0,0
2020-03-01,MDV,Perlis,1,1,0
2020-03-01,MDV,Pulau Pinang,3,2,1
2020-03-01,MDV,Sabah,2,2,0
2020-03-01,MDV,Sarawak,0,0,0
2020-03-01,MDV,Selangor,951,546,405
2020-03-01,MEX,Johor,50,29,21
2020-03-01,MEX,Kedah,5,3,2
2020-03-01,MEX,Kelantan,1,1,0
2020-03-01,MEX,Pahang,0,0,0
2020-03-01,MEX,Perak,0,0,0
2020-03-01,MEX,Perlis,2,2,0
2020-03-01,MEX,Pulau Pinang,8,4,4
2020-03-01,MEX,Sabah,1,1,0
2020-03-01,MEX,Sarawak,5,3,2
2020-03-01,MEX,Selangor,201,101,100
2020-03-01,MEX,W.P. Labuan,0,0,0
2020-03-01,MHL,Johor,2,1,1
2020-03-01,MHL,Kedah,0,0,0
2020-03-01,MHL,Perak,0,0,0
2020-03-01,MHL,Pulau Pinang,0,0,0
2020-03-01,MHL,Sabah,0,0,0
2020-03-01,MHL,Selangor,3,2,1
2020-03-01,MKD,Johor,1,0,1
2020-03-01,MKD,Kedah,1,0,1
2020-03-01,MKD,Perak,0,0,0
2020-03-01,MKD,Pulau Pinang,0,0,0
2020-03-01,MKD,Sabah,0,0,0
2020-03-01,MKD,Sarawak,3,3,0
2020-03-01,MKD,Selangor,12,8,4
2020-03-01,MLI,Johor,3,3,0
2020-03-01,MLI,Sabah,0,0,0
2020-03-01,MLI,Selangor,9,7,2
2020-03-01,MLT,Johor,4,3,1
2020-03-01,MLT,Kedah,0,0,0
2020-03-01,MLT,Kelantan,0,0,0
2020-03-01,MLT,Perak,0,0,0
2020-03-01,MLT,Perlis,0,0,0
2020-03-01,MLT,Pulau Pinang,1,1,0
2020-03-01,MLT,Sabah,0,0,0
2020-03-01,MLT,Sarawak,0,0,0
2020-03-01,MLT,Selangor,8,7,1
2020-03-01,MLT,W.P. Labuan,0,0,0
2020-03-01,MMR,Johor,1309,453,856
2020-03-01,MMR,Kedah,8,2,6
2020-03-01,MMR,Kelantan,4,1,3
2020-03-01,MMR,Negeri Sembilan,0,0,0
2020-03-01,MMR,Pahang,6,6,0
2020-03-01,MMR,Perak,6,1,5
2020-03-01,MMR,Perlis,1,1,0
2020-03-01,MMR,Pulau Pinang,163,115,48
2020-03-01,MMR,Sabah,5,2,3
2020-03-01,MMR,Sarawak,13,10,3
2020-03-01,MMR,Selangor,4948,3764,1184
2020-03-01,MMR,Terengganu,0,0,0
2020-03-01,MMR,W.P. Labuan,0,0,0
2020-03-01,MNE,Johor,0,0,0
2020-03-01,MNE,Kedah,0,0,0
2020-03-01,MNE,Pulau Pinang,0,0,0
2020-03-01,MNE,Sabah,0,0,0
2020-03-01,MNE,Sarawak,0,0,0
2020-03-01,MNE,Selangor,7,5,2
2020-03-01,MNG,Johor,34,17,17
2020-03-01,MNG,Kedah,18,3,15
2020-03-01,MNG,Kelantan,0,0,0
2020-03-01,MNG,Perak,0,0,0
2020-03-01,MNG,Perlis,1,1,0
2020-03-01,MNG,Pulau Pinang,5,2,3
2020-03-01,MNG,Sabah,0,0,0
2020-03-01,MNG,Sarawak,0,0,0
2020-03-01,MNG,Selangor,93,37,56
2020-03-01,MNP,Selangor,0,0,0
2020-03-01,MOZ,Johor,0,0,0
2020-03-01,MOZ,Kedah,0,0,0
2020-03-01,MOZ,Perak,0,0,0
2020-03-01,MOZ,Pulau Pinang,0,0,0
2020-03-01,MOZ,Sabah,0,0,0
2020-03-01,MOZ,Sarawak,0,0,0
2020-03-01,MOZ,Selangor,7,4,3
2020-03-01,MRT,Johor,0,0,0
2020-03-01,MRT,Kedah,0,0,0
2020-03-01,MRT,Pulau Pinang,0,0,0
2020-03-01,MRT,Sabah,0,0,0
2020-03-01,MRT,Sarawak,0,0,0
2020-03-01,MRT,Selangor,8,7,1
2020-03-01,MUS,Johor,35,22,13
2020-03-01,MUS,Kedah,1,1,0
2020-03-01,MUS,Kelantan,0,0,0
2020-03-01,MUS,Pahang,1,1,0
2020-03-01,MUS,Perak,0,0,0
2020-03-01,MUS,Perlis,0,0,0
2020-03-01,MUS,Pulau Pinang,0,0,0
2020-03-01,MUS,Sabah,2,1,1
2020-03-01,MUS,Sarawak,0,0,0
2020-03-01,MUS,Selangor,188,128,60
2020-03-01,MWI,Johor,2,2,0
2020-03-01,MWI,Pulau Pinang,0,0,0
2020-03-01,MWI,Sabah,0,0,0
2020-03-01,MWI,Sarawak,0,0,0
2020-03-01,MWI,Selangor,4,3,1
2020-03-01,MYT,Selangor,0,0,0
2020-03-01,NAM,Johor,0,0,0
2020-03-01,NAM,Kedah,0,0,0
2020-03-01,NAM,Perak,0,0,0
2020-03-01,NAM,Perlis,1,0,1
2020-03-01,NAM,Pulau Pinang,2,0,2
2020-03-01,NAM,Sabah,0,0,0
2020-03-01,NAM,Sarawak,0,0,0
2020-03-01,NAM,Selangor,7,4,3
2020-03-01,NCL,Selangor,0,0,0
2020-03-01,NER,Johor,0,0,0
2020-03-01,NER,Sabah,0,0,0
2020-03-01,NER,Selangor,0,0,0
2020-03-01,NGA,Johor,6,6,0
2020-03-01,NGA,Kedah,0,0,0
2020-03-01,NGA,Perlis,0,0,0
2020-03-01,NGA,Pulau Pinang,3,2,1
2020-03-01,NGA,Sabah,0,0,0
2020-03-01,NGA,Sarawak,1,1,0
2020-03-01,NGA,Selangor,284,238,46
2020-03-01,NIC,Johor,0,0,0
2020-03-01,NIC,Kedah,1,1,0
2020-03-01,NIC,Pulau Pinang,0,0,0
2020-03-01,NIC,Sabah,0,0,0
2020-03-01,NIC,Selangor,2,1,1
2020-03-01,NLD,Johor,511,344,167
2020-03-01,NLD,Kedah,217,130,87
2020-03-01,NLD,Kelantan,14,10,4
2020-03-01,NLD,Melaka,2,0,2
2020-03-01,NLD,Negeri Sembilan,0,0,0
2020-03-01,NLD,Pahang,2,1,1
2020-03-01,NLD,Perak,2,2,0
2020-03-01,NLD,Perlis,27,16,11
2020-03-01,NLD,Pulau Pinang,108,71,37
2020-03-01,NLD,Sabah,40,23,17
2020-03-01,NLD,Sarawak,84,64,20
2020-03-01,NLD,Selangor,2187,1297,890
2020-03-01,NLD,Terengganu,0,0,0
2020-03-01,NLD,W.P. Labuan,1,0,1
2020-03-01,NOR,Johor,70,50,20
2020-03-01,NOR,Kedah,73,32,41
2020-03-01,NOR,Kelantan,0,0,0
2020-03-01,NOR,Melaka,0,0,0
2020-03-01,NOR,Pahang,0,0,0
2020-03-01,NOR,Perak,1,1,0
2020-03-01,NOR,Perlis,8,4,4
2020-03-01,NOR,Pulau Pinang,20,13,7
2020-03-01,NOR,Sabah,3,3,0
2020-03-01,NOR,Sarawak,16,11,5
2020-03-01,NOR,Selangor,400,212,188
2020-03-01,NOR,W.P. Labuan,0,0,0
2020-03-01,NPL,Johor,123,110,13
2020-03-01,NPL,Kedah,2,1,1
2020-03-01,NPL,Pahang,0,0,0
2020-03-01,NPL,Perak,0,0,0
2020-03-01,NPL,Perlis,0,0,0
2020-03-01,NPL,Pulau Pinang,65,58,7
2020-03-01,NPL,Sabah,46,46,0
2020-03-01,NPL,Sarawak,48,36,12
2020-03-01,NPL,Selangor,5976,5665,311
2020-03-01,NPL,W.P. Labuan,14,13,1
2020-03-01,NRU,Johor,0,0,0
2020-03-01,NRU,Pulau Pinang,0,0,0
2020-03-01,NRU,Selangor,0,0,0
2020-03-01,NZL,Johor,221,148,73
2020-03-01,NZL,Kedah,39,23,16
2020-03-01,NZL,Kelantan,2,2,0
2020-03-01,NZL,Melaka,0,0,0
2020-03-01,NZL,Negeri Sembilan,0,0,0
2020-03-01,NZL,Pahang,0,0,0
2020-03-01,NZL,Perak,10,6,4
2020-03-01,NZL,Perlis,7,6,1
2020-03-01,NZL,Pulau Pinang,71,38,33
2020-03-01,NZL,Sabah,18,5,13
2020-03-01,NZL,Sarawak,54,36,18
2020-03-01,NZL,Selangor,889,555,334
2020-03-01,NZL,Terengganu,0,0,0
2020-03-01,NZL,W.P. Labuan,0,0,0
2020-03-01,OMN,Johor,0,0,0
2020-03-01,OMN,Kedah,4,3,1
2020-03-01,OMN,Kelantan,0,0,0
2020-03-01,OMN,Melaka,0,0,0
2020-03-01,OMN,Perak,0,0,0
2020-03-01,OMN,Perlis,0,0,0
2020-03-01,OMN,Pulau Pinang,5,3,2
2020-03-01,OMN,Sabah,0,0,0
2020-03-01,OMN,Sarawak,3,3,0
2020-03-01,OMN,Selangor,175,124,51
2020-03-01,PAK,Johor,396,308,88
2020-03-01,PAK,Kedah,31,21,10
2020-03-01,PAK,Kelantan,5,5,0
2020-03-01,PAK,Melaka,0,0,0
2020-03-01,PAK,Negeri Sembilan,0,0,0
2020-03-01,PAK,Pahang,0,0,0
2020-03-01,PAK,Perak,2,2,0
2020-03-01,PAK,Perlis,9,8,1
2020-03-01,PAK,Pulau Pinang,16,15,1
2020-03-01,PAK,Sabah,3,3,0
2020-03-01,PAK,Sarawak,162,157,5
2020-03-01,PAK,Selangor,5966,5345,621
2020-03-01,PAK,W.P. Labuan,4,4,0
2020-03-01,PAN,Johor,1,1,0
2020-03-01,PAN,Kedah,0,0,0
2020-03-01,PAN,Perak,0,0,0
2020-03-01,PAN,Perlis,0,0,0
2020-03-01,PAN,Pulau Pinang,0,0,0
2020-03-01,PAN,Sabah,0,0,0
2020-03-01,PAN,Sarawak,0,0,0
2020-03-01,PAN,Selangor,8,3,5
2020-03-01,PER,Johor,8,5,3
2020-03-01,PER,Kedah,2,0,2
2020-03-01,PER,Kelantan,0,0,0
2020-03-01,PER,Pahang,0,0,0
2020-03-01,PER,Perak,0,0,0
2020-03-01,PER,Perlis,2,2,0
2020-03-01,PER,Pulau Pinang,1,1,0
2020-03-01,PER,Sabah,1,1,0
2020-03-01,PER,Sarawak,2,1,1
2020-03-01,PER,Selangor,48,24,24
2020-03-01,PER,W.P. Labuan,0,0,0
2020-03-01,PHL,Johor,6568,2051,4517
2020-03-01,PHL,Kedah,746,257,489
2020-03-01,PHL,Kelantan,36,23,13
2020-03-01,PHL,Melaka,0,0,0
2020-03-01,PHL,Negeri Sembilan,0,0,0
2020-03-01,PHL,Pahang,15,12,3
2020-03-01,PHL,Perak,25,8,17
2020-03-01,PHL,Perlis,138,45,93
2020-03-01,PHL,Pulau Pinang,205,54,151
2020-03-01,PHL,Sabah,1062,594,468
2020-03-01,PHL,Sarawak,1281,582,699
2020-03-01,PHL,Selangor,5551,2651,2900
2020-03-01,PHL,Terengganu,0,0,0
2020-03-01,PHL,W.P. Labuan,133,62,71
2020-03-01,PLW,Johor,0,0,0
2020-03-01,PLW,Pulau Pinang,0,0,0
2020-03-01,PLW,Selangor,0,0,0
2020-03-01,PNG,Johor,5,5,0
2020-03-01,PNG,Kedah,0,0,0
2020-03-01,PNG,Kelantan,0,0,0
2020-03-01,PNG,Perak,0,0,0
2020-03-01,PNG,Pulau Pinang,0,0,0
2020-03-01,PNG,Sabah,3,2,1
2020-03-01,PNG,Sarawak,2,1,1
2020-03-01,PNG,Selangor,13,8,5
2020-03-01,POL,Johor,166,100,66
2020-03-01,POL,Kedah,104,54,50
2020-03-01,POL,Kelantan,1,0,1
2020-03-01,POL,Melaka,0,0,0
2020-03-01,POL,Negeri Sembilan,0,0,0
2020-03-01,POL,Pahang,0,0,0
2020-03-01,POL,Perak,0,0,0
2020-03-01,POL,Perlis,19,9,10
2020-03-01,POL,Pulau Pinang,33,16,17
2020-03-01,POL,Sabah,31,17,14
2020-03-01,POL,Sarawak,33,22,11
2020-03-01,POL,Selangor,749,394,355
2020-03-01,POL,Terengganu,0,0,0
2020-03-01,POL,W.P. Labuan,14,10,4
2020-03-01,PRK,Selangor,0,0,0
2020-03-01,PRT,Johor,56,35,21
2020-03-01,PRT,Kedah,28,18,10
2020-03-01,PRT,Kelantan,0,0,0
2020-03-01,PRT,Melaka,0,0,0
2020-03-01,PRT,Pahang,0,0,0
2020-03-01,PRT,Perak,0,0,0
2020-03-01,PRT,Perlis,2,2,0
2020-03-01,PRT,Pulau Pinang,10,6,4
2020-03-01,PRT,Sabah,13,6,7
2020-03-01,PRT,Sarawak,4,2,2
2020-03-01,PRT,Selangor,234,138,96
2020-03-01,PRT,W.P. Labuan,0,0,0
2020-03-01,PRY,Johor,0,0,0
2020-03-01,PRY,Kedah,0,0,0
2020-03-01,PRY,Perak,0,0,0
2020-03-01,PRY,Perlis,0,0,0
2020-03-01,PRY,Pulau Pinang,0,0,0
2020-03-01,PRY,Sabah,0,0,0
2020-03-01,PRY,Sarawak,0,0,0
2020-03-01,PRY,Selangor,11,3,8
2020-03-01,PSE,Johor,3,3,0
2020-03-01,PSE,Kedah,0,0,0
2020-03-01,PSE,Kelantan,0,0,0
2020-03-01,PSE,Melaka,0,0,0
2020-03-01,PSE,Perak,0,0,0
2020-03-01,PSE,Perlis,0,0,0
2020-03-01,PSE,Pulau Pinang,1,1,0
2020-03-01,PSE,Sabah,0,0,0
2020-03-01,PSE,Sarawak,1,1,0
2020-03-01,PSE,Selangor,196,163,33
2020-03-01,QAT,Johor,0,0,0
2020-03-01,QAT,Kedah,1,1,0
2020-03-01,QAT,Perlis,0,0,0
2020-03-01,QAT,Pulau Pinang,0,0,0
2020-03-01,QAT,Sabah,0,0,0
2020-03-01,QAT,Sarawak,0,0,0
2020-03-01,QAT,Selangor,6,6,0
2020-03-01,REU,Johor,0,0,0
2020-03-01,REU,Sarawak,0,0,0
2020-03-01,ROU,Johor,54,35,19
2020-03-01,ROU,Kedah,36,18,18
2020-03-01,ROU,Kelantan,1,1,0
2020-03-01,ROU,Negeri Sembilan,0,0,0
2020-03-01,ROU,Pahang,0,0,0
2020-03-01,ROU,Perak,0,0,0
2020-03-01,ROU,Perlis,1,1,0
2020-03-01,ROU,Pulau Pinang,8,4,4
2020-03-01,ROU,Sabah,4,2,2
2020-03-01,ROU,Sarawak,7,5,2
2020-03-01,ROU,Selangor,385,191,194
2020-03-01,ROU,W.P. Labuan,3,2,1
2020-03-01,RUS,Johor,218,130,88
2020-03-01,RUS,Kedah,561,250,311
2020-03-01,RUS,Kelantan,69,34,35
2020-03-01,RUS,Melaka,0,0,0
2020-03-01,RUS,Negeri Sembilan,0,0,0
2020-03-01,RUS,Pahang,3,3,0
2020-03-01,RUS,Perak,3,1,2
2020-03-01,RUS,Perlis,167,81,86
2020-03-01,RUS,Pulau Pinang,83,39,44
2020-03-01,RUS,Sabah,46,24,22
2020-03-01,RUS,Sarawak,42,21,21
2020-03-01,RUS,Selangor,4991,2199,2792
2020-03-01,RUS,W.P. Labuan,9,6,3
2020-03-01,RWA,Johor,1,1,0
2020-03-01,RWA,Kedah,0,0,0
2020-03-01,RWA,Pulau Pinang,0,0,0
2020-03-01,RWA,Selangor,1,0,1
2020-03-01,SAU,Johor,13,11,2
2020-03-01,SAU,Kedah,1,1,0
2020-03-01,SAU,Kelantan,1,1,0
2020-03-01,SAU,Melaka,0,0,0
2020-03-01,SAU,Perak,0,0,0
2020-03-01,SAU,Perlis,0,0,0
2020-03-01,SAU,Pulau Pinang,11,6,5
2020-03-01,SAU,Sabah,0,0,0
2020-03-01,SAU,Sarawak,0,0,0
2020-03-01,SAU,Selangor,984,600,384
2020-03-01,SAU,W.P. Labuan,0,0,0
2020-03-01,SDN,Johor,2,2,0
2020-03-01,SDN,Kedah,0,0,0
2020-03-01,SDN,Kelantan,0,0,0
2020-03-01,SDN,Perlis,0,0,0
2020-03-01,SDN,Pulau Pinang,0,0,0
2020-03-01,SDN,Sabah,0,0,0
2020-03-01,SDN,Sarawak,0,0,0
2020-03-01,SDN,Selangor,373,233,140
2020-03-01,SDN,W.P. Labuan,0,0,0
2020-03-01,SEN,Johor,6,6,0
2020-03-01,SEN,Kedah,0,0,0
2020-03-01,SEN,Kelantan,0,0,0
2020-03-01,SEN,Perak,0,0,0
2020-03-01,SEN,Perlis,0,0,0
2020-03-01,SEN,Pulau Pinang,0,0,0
2020-03-01,SEN,Sabah,0,0,0
2020-03-01,SEN,Sarawak,0,0,0
2020-03-01,SEN,Selangor,19,17,2
2020-03-01,SGP,Johor,567130,351191,215939
2020-03-01,SGP,Kedah,1328,723,605
2020-03-01,SGP,Kelantan,201,107,94
2020-03-01,SGP,Melaka,6,6,0
2020-03-01,SGP,Negeri Sembilan,2,1,1
2020-03-01,SGP,Pahang,196,92,104
2020-03-01,SGP,Perak,1516,769,747
2020-03-01,SGP,Perlis,58,35,23
2020-03-01,SGP,Pulau Pinang,4627,2411,2216
2020-03-01,SGP,Sabah,814,454,360
2020-03-01,SGP,Sarawak,837,515,322
2020-03-01,SGP,Selangor,11654,6915,4739
2020-03-01,SGP,Terengganu,9,8,1
2020-03-01,SGP,W.P. Labuan,13,9,4
2020-03-01,SGS,Johor,0,0,0
2020-03-01,SGS,Sabah,0,0,0
2020-03-01,SGS,Selangor,0,0,0
2020-03-01,SHN,Sarawak,0,0,0
2020-03-01,SLB,Johor,1,1,0
2020-03-01,SLB,Perlis,0,0,0
2020-03-01,SLB,Pulau Pinang,0,0,0
2020-03-01,SLB,Sabah,0,0,0
2020-03-01,SLB,Sarawak,0,0,0
2020-03-01,SLB,Selangor,1,1,0
2020-03-01,SLB,W.P. Labuan,0,0,0
2020-03-01,SLE,Johor,0,0,0
2020-03-01,SLE,Kedah,0,0,0
2020-03-01,SLE,Perak,0,0,0
2020-03-01,SLE,Pulau Pinang,0,0,0
2020-03-01,SLE,Sabah,0,0,0
2020-03-01,SLE,Selangor,25,15,10
2020-03-01,SLV,Johor,0,0,0
2020-03-01,SLV,Kedah,0,0,0
2020-03-01,SLV,Perak,0,0,0
2020-03-01,SLV,Perlis,0,0,0
2020-03-01,SLV,Pulau Pinang,0,0,0
2020-03-01,SLV,Sabah,0,0,0
2020-03-01,SLV,Selangor,7,5,2
2020-03-01,SLV,W.P. Labuan,0,0,0
2020-03-01,SMR,Johor,0,0,0
2020-03-01,SMR,Selangor,1,1,0
2020-03-01,SOM,Johor,0,0,0
2020-03-01,SOM,Kedah,0,0,0
2020-03-01,SOM,Kelantan,0,0,0
2020-03-01,SOM,Perlis,0,0,0
2020-03-01,SOM,Sabah,0,0,0
2020-03-01,SOM,Sarawak,0,0,0
2020-03-01,SOM,Selangor,153,98,55
2020-03-01,SRB,Johor,3,1,2
2020-03-01,SRB,Kedah,3,1,2
2020-03-01,SRB,Kelantan,0,0,0
2020-03-01,SRB,Pahang,0,0,0
2020-03-01,SRB,Perak,0,0,0
2020-03-01,SRB,Perlis,0,0,0
2020-03-01,SRB,Pulau Pinang,2,2,0
2020-03-01,SRB,Sabah,1,1,0
2020-03-01,SRB,Sarawak,0,0,0
2020-03-01,SRB,Selangor,28,18,10
2020-03-01,SSD,Johor,0,0,0
2020-03-01,SSD,Kedah,0,0,0
2020-03-01,SSD,Sarawak,0,0,0
2020-03-01,SSD,Selangor,11,8,3
2020-03-01,SSD,W.P. Labuan,0,0,0
2020-03-01,STP,Selangor,0,0,0
2020-03-01,SUR,Johor,0,0,0
2020-03-01,SUR,Kedah,0,0,0
2020-03-01,SUR,Kelantan,0,0,0
2020-03-01,SUR,Perak,0,0,0
2020-03-01,SUR,Perlis,0,0,0
2020-03-01,SUR,Pulau Pinang,0,0,0
2020-03-01,SUR,Sabah,0,0,0
2020-03-01,SUR,Sarawak,0,0,0
2020-03-01,SUR,Selangor,9,5,4
2020-03-01,SVK,Johor,14,12,2
2020-03-01,SVK,Kedah,141,67,74
2020-03-01,SVK,Kelantan,2,2,0
2020-03-01,SVK,Negeri Sembilan,0,0,0
2020-03-01,SVK,Pahang,0,0,0
2020-03-01,SVK,Perak,0,0,0
2020-03-01,SVK,Perlis,0,0,0
2020-03-01,SVK,Pulau Pinang,2,1,1
2020-03-01,SVK,Sabah,11,4,7
2020-03-01,SVK,Sarawak,4,2,2
2020-03-01,SVK,Selangor,218,103,115
2020-03-01,SVK,W.P. Labuan,1,1,0
2020-03-01,SVN,Johor,5,3,2
2020-03-01,SVN,Kedah,15,7,8
2020-03-01,SVN,Kelantan,0,0,0
2020-03-01,SVN,Perak,0,0,0
2020-03-01,SVN,Perlis,0,0,0
2020-03-01,SVN,Pulau Pinang,0,0,0
2020-03-01,SVN,Sabah,1,1,0
2020-03-01,SVN,Sarawak,0,0,0
2020-03-01,SVN,Selangor,43,23,20
2020-03-01,SVN,W.P. Labuan,0,0,0
2020-03-01,SWE,Johor,142,83,59
2020-03-01,SWE,Kedah,286,128,158
2020-03-01,SWE,Kelantan,5,4,1
2020-03-01,SWE,Melaka,1,0,1
2020-03-01,SWE,Negeri Sembilan,0,0,0
2020-03-01,SWE,Pahang,0,0,0
2020-03-01,SWE,Perak,0,0,0
2020-03-01,SWE,Perlis,16,14,2
2020-03-01,SWE,Pulau Pinang,58,38,20
2020-03-01,SWE,Sabah,17,10,7
2020-03-01,SWE,Sarawak,12,7,5
2020-03-01,SWE,Selangor,839,469,370
2020-03-01,SWE,W.P. Labuan,4,3,1
2020-03-01,SWZ,Johor,0,0,0
2020-03-01,SWZ,Kedah,0,0,0
2020-03-01,SWZ,Pulau Pinang,0,0,0
2020-03-01,SWZ,Sabah,0,0,0
2020-03-01,SWZ,Selangor,6,2,4
2020-03-01,SYC,Johor,0,0,0
2020-03-01,SYC,Kedah,0,0,0
2020-03-01,SYC,Pulau Pinang,0,0,0
2020-03-01,SYC,Sabah,0,0,0
2020-03-01,SYC,Sarawak,0,0,0
2020-03-01,SYC,Selangor,25,8,17
2020-03-01,SYR,Johor,3,2,1
2020-03-01,SYR,Kedah,2,2,0
2020-03-01,SYR,Kelantan,0,0,0
2020-03-01,SYR,Pahang,0,0,0
2020-03-01,SYR,Perlis,0,0,0
2020-03-01,SYR,Pulau Pinang,0,0,0
2020-03-01,SYR,Sabah,0,0,0
2020-03-01,SYR,Sarawak,0,0,0
2020-03-01,SYR,Selangor,336,264,72
2020-03-01,SYR,W.P. Labuan,0,0,0
2020-03-01,TCA,Perlis,0,0,0
2020-03-01,TCD,Johor,0,0,0
2020-03-01,TCD,Kedah,0,0,0
2020-03-01,TCD,Perlis,0,0,0
2020-03-01,TCD,Selangor,5,5,0
2020-03-01,TGO,Johor,0,0,0
2020-03-01,TGO,Perak,0,0,0
2020-03-01,TGO,Pulau Pinang,0,0,0
2020-03-01,TGO,Selangor,4,4,0
2020-03-01,THA,Johor,1928,438,1490
2020-03-01,THA,Kedah,26140,11342,14798
2020-03-01,THA,Kelantan,19386,10005,9381
2020-03-01,THA,Melaka,1,1,0
2020-03-01,THA,Negeri Sembilan,2,2,0
2020-03-01,THA,Pahang,0,0,0
2020-03-01,THA,Perak,7402,3404,3998
2020-03-01,THA,Perlis,27314,15943,11371
2020-03-01,THA,Pulau Pinang,425,172,253
2020-03-01,THA,Sabah,75,15,60
2020-03-01,THA,Sarawak,275,97,178
2020-03-01,THA,Selangor,3221,1307,1914
2020-03-01,THA,Terengganu,3,3,0
2020-03-01,THA,W.P. Labuan,5,2,3
2020-03-01,TJK,Johor,3,3,0
2020-03-01,TJK,Kedah,0,0,0
2020-03-01,TJK,Perlis,0,0,0
2020-03-01,TJK,Pulau Pinang,0,0,0
2020-03-01,TJK,Sabah,0,0,0
2020-03-01,TJK,Selangor,54,41,13
2020-03-01,TKL,Selangor,0,0,0
2020-03-01,TKM,Johor,1,0,1
2020-03-01,TKM,Kedah,0,0,0
2020-03-01,TKM,Kelantan,0,0,0
2020-03-01,TKM,Perlis,1,1,0
2020-03-01,TKM,Pulau Pinang,0,0,0
2020-03-01,TKM,Sabah,0,0,0
2020-03-01,TKM,Sarawak,0,0,0
2020-03-01,TKM,Selangor,29,18,11
2020-03-01,TLS,Johor,0,0,0
2020-03-01,TLS,Kedah,0,0,0
2020-03-01,TLS,Perlis,0,0,0
2020-03-01,TLS,Pulau Pinang,1,0,1
2020-03-01,TLS,Sabah,0,0,0
2020-03-01,TLS,Sarawak,1,1,0
2020-03-01,TLS,Selangor,26,14,12
2020-03-01,TON,Johor,0,0,0
2020-03-01,TON,Pulau Pinang,0,0,0
2020-03-01,TON,Sarawak,0,0,0
2020-03-01,TON,Selangor,2,1,1
2020-03-01,TTO,Johor,7,7,0
2020-03-01,TTO,Kedah,0,0,0
2020-03-01,TTO,Pahang,0,0,0
2020-03-01,TTO,Pulau Pinang,0,0,0
2020-03-01,TTO,Sabah,0,0,0
2020-03-01,TTO,Sarawak,0,0,0
2020-03-01,TTO,Selangor,13,8,5
2020-03-01,TUN,Johor,6,2,4
2020-03-01,TUN,Kedah,3,2,1
2020-03-01,TUN,Kelantan,0,0,0
2020-03-01,TUN,Melaka,0,0,0
2020-03-01,TUN,Perak,0,0,0
2020-03-01,TUN,Perlis,0,0,0
2020-03-01,TUN,Pulau Pinang,0,0,0
2020-03-01,TUN,Sabah,0,0,0
2020-03-01,TUN,Sarawak,0,0,0
2020-03-01,TUN,Selangor,128,70,58
2020-03-01,TUN,W.P. Labuan,0,0,0
2020-03-01,TUR,Johor,70,63,7
2020-03-01,TUR,Kedah,26,19,7
2020-03-01,TUR,Kelantan,1,1,0
2020-03-01,TUR,Melaka,0,0,0
2020-03-01,TUR,Negeri Sembilan,0,0,0
2020-03-01,TUR,Pahang,0,0,0
2020-03-01,TUR,Perak,0,0,0
2020-03-01,TUR,Perlis,6,5,1
2020-03-01,TUR,Pulau Pinang,13,8,5
2020-03-01,TUR,Sabah,3,3,0
2020-03-01,TUR,Sarawak,7,6,1
2020-03-01,TUR,Selangor,364,284,80
2020-03-01,TUR,W.P. Labuan,1,1,0
2020-03-01,TUV,Selangor,0,0,0
2020-03-01,TWN,Johor,1199,463,736
2020-03-01,TWN,Kedah,31,23,8
2020-03-01,TWN,Kelantan,4,2,2
2020-03-01,TWN,Melaka,2,0,2
2020-03-01,TWN,Negeri Sembilan,0,0,0
2020-03-01,TWN,Pahang,0,0,0
2020-03-01,TWN,Perak,12,4,8
2020-03-01,TWN,Perlis,4,4,0
2020-03-01,TWN,Pulau Pinang,322,203,119
2020-03-01,TWN,Sabah,368,188,180
2020-03-01,TWN,Sarawak,55,22,33
2020-03-01,TWN,Selangor,2288,1430,858
2020-03-01,TWN,W.P. Labuan,6,5,1
2020-03-01,TZA,Johor,7,5,2
2020-03-01,TZA,Kedah,0,0,0
2020-03-01,TZA,Perak,0,0,0
2020-03-01,TZA,Perlis,0,0,0
2020-03-01,TZA,Pulau Pinang,0,0,0
2020-03-01,TZA,Sabah,4,1,3
2020-03-01,TZA,Sarawak,0,0,0
2020-03-01,TZA,Selangor,72,34,38
2020-03-01,UGA,Johor,5,1,4
2020-03-01,UGA,Kedah,0,0,0
2020-03-01,UGA,Perak,0,0,0
2020-03-01,UGA,Perlis,0,0,0
2020-03-01,UGA,Pulau Pinang,0,0,0
2020-03-01,UGA,Sabah,0,0,0
2020-03-01,UGA,Sarawak,1,1,0
2020-03-01,UGA,Selangor,50,29,21
2020-03-01,UKR,Johor,74,39,35
2020-03-01,UKR,Kedah,122,59,63
2020-03-01,UKR,Kelantan,8,3,5
2020-03-01,UKR,Melaka,0,0,0
2020-03-01,UKR,Negeri Sembilan,0,0,0
2020-03-01,UKR,Pahang,6,6,0
2020-03-01,UKR,Perak,1,1,0
2020-03-01,UKR,Perlis,15,8,7
2020-03-01,UKR,Pulau Pinang,40,18,22
2020-03-01,UKR,Sabah,7,3,4
2020-03-01,UKR,Sarawak,7,6,1
2020-03-01,UKR,Selangor,978,513,465
2020-03-01,UKR,W.P. Labuan,11,7,4
2020-03-01,URY,Johor,186,87,99
2020-03-01,URY,Kedah,1,1,0
2020-03-01,URY,Kelantan,27,10,17
2020-03-01,URY,Perak,0,0,0
2020-03-01,URY,Perlis,1,0,1
2020-03-01,URY,Pulau Pinang,5,2,3
2020-03-01,URY,Sabah,0,0,0
2020-03-01,URY,Sarawak,0,0,0
2020-03-01,URY,Selangor,86,33,53
2020-03-01,URY,W.P. Labuan,0,0,0
2020-03-01,USA,Johor,1236,807,429
2020-03-01,USA,Kedah,232,143,89
2020-03-01,USA,Kelantan,27,17,10
2020-03-01,USA,Melaka,2,2,0
2020-03-01,USA,Negeri Sembilan,0,0,0
2020-03-01,USA,Pahang,4,3,1
2020-03-01,USA,Perak,23,14,9
2020-03-01,USA,Perlis,53,34,19
2020-03-01,USA,Pulau Pinang,449,277,172
2020-03-01,USA,Sabah,141,84,57
2020-03-01,USA,Sarawak,86,40,46
2020-03-01,USA,Selangor,4577,2883,1694
2020-03-01,USA,Terengganu,0,0,0
2020-03-01,USA,W.P. Labuan,11,8,3
2020-03-01,UZB,Johor,20,11,9
2020-03-01,UZB,Kedah,26,3,23
2020-03-01,UZB,Kelantan,0,0,0
2020-03-01,UZB,Perak,1,1,0
2020-03-01,UZB,Perlis,1,0,1
2020-03-01,UZB,Pulau Pinang,3,2,1
2020-03-01,UZB,Sabah,0,0,0
2020-03-01,UZB,Sarawak,1,1,0
2020-03-01,UZB,Selangor,454,286,168
2020-03-01,VAT,Johor,0,0,0
2020-03-01,VAT,Sarawak,0,0,0
2020-03-01,VAT,Selangor,0,0,0
2020-03-01,VCT,Johor,0,0,0
2020-03-01,VCT,Kedah,0,0,0
2020-03-01,VCT,Pulau Pinang,0,0,0
2020-03-01,VCT,Sarawak,0,0,0
2020-03-01,VCT,Selangor,0,0,0
2020-03-01,VEN,Johor,9,3,6
2020-03-01,VEN,Kedah,1,1,0
2020-03-01,VEN,Kelantan,0,0,0
2020-03-01,VEN,Melaka,0,0,0
2020-03-01,VEN,Perak,0,0,0
2020-03-01,VEN,Perlis,0,0,0
2020-03-01,VEN,Pulau Pinang,0,0,0
2020-03-01,VEN,Sabah,0,0,0
2020-03-01,VEN,Sarawak,1,0,1
2020-03-01,VEN,Selangor,40,23,17
2020-03-01,VEN,W.P. Labuan,0,0,0
2020-03-01,VNM,Johor,3089,576,2513
2020-03-01,VNM,Kedah,412,34,378
2020-03-01,VNM,Kelantan,28,12,16
2020-03-01,VNM,Melaka,0,0,0
2020-03-01,VNM,Negeri Sembilan,0,0,0
2020-03-01,VNM,Pahang,2,1,1
2020-03-01,VNM,Perak,33,2,31
2020-03-01,VNM,Perlis,100,23,77
2020-03-01,VNM,Pulau Pinang,388,74,314
2020-03-01,VNM,Sabah,17,5,12
2020-03-01,VNM,Sarawak,352,98,254
2020-03-01,VNM,Selangor,5528,1776,3752
2020-03-01,VNM,Terengganu,0,0,0
2020-03-01,VNM,W.P. Labuan,2,2,0
2020-03-01,VUT,Johor,7,7,0
2020-03-01,VUT,Kedah,0,0,0
2020-03-01,VUT,Pulau Pinang,1,1,0
2020-03-01,VUT,Sabah,1,1,0
2020-03-01,VUT,Sarawak,0,0,0
2020-03-01,VUT,Selangor,33,32,1
2020-03-01,WSM,Johor,0,0,0
2020-03-01,WSM,Sarawak,0,0,0
2020-03-01,WSM,Selangor,1,0,1
2020-03-01,XXX,Johor,96,50,46
2020-03-01,XXX,Kedah,16,8,8
2020-03-01,XXX,Kelantan,0,0,0
2020-03-01,XXX,Melaka,0,0,0
2020-03-01,XXX,Pahang,0,0,0
2020-03-01,XXX,Perak,6,5,1
2020-03-01,XXX,Perlis,1,0,1
2020-03-01,XXX,Pulau Pinang,58,30,28
2020-03-01,XXX,Sabah,5,3,2
2020-03-01,XXX,Sarawak,31,26,5
2020-03-01,XXX,Selangor,332,206,126
2020-03-01,XXX,W.P. Labuan,0,0,0
2020-03-01,YEM,Johor,9,6,3
2020-03-01,YEM,Kedah,4,3,1
2020-03-01,YEM,Kelantan,0,0,0
2020-03-01,YEM,Melaka,5,3,2
2020-03-01,YEM,Pahang,0,0,0
2020-03-01,YEM,Perak,0,0,0
2020-03-01,YEM,Perlis,0,0,0
2020-03-01,YEM,Pulau Pinang,3,3,0
2020-03-01,YEM,Sabah,0,0,0
2020-03-01,YEM,Sarawak,0,0,0
2020-03-01,YEM,Selangor,820,605,215
2020-03-01,YEM,W.P. Labuan,0,0,0
2020-03-01,ZAF,Johor,85,54,31
2020-03-01,ZAF,Kedah,38,26,12
2020-03-01,ZAF,Kelantan,9,6,3
2020-03-01,ZAF,Melaka,0,0,0
2020-03-01,ZAF,Pahang,0,0,0
2020-03-01,ZAF,Perak,0,0,0
2020-03-01,ZAF,Perlis,3,1,2
2020-03-01,ZAF,Pulau Pinang,21,9,12
2020-03-01,ZAF,Sabah,6,4,2
2020-03-01,ZAF,Sarawak,28,17,11
2020-03-01,ZAF,Selangor,511,338,173
2020-03-01,ZAF,Terengganu,0,0,0
2020-03-01,ZAF,W.P. Labuan,0,0,0
2020-03-01,ZAR,Selangor,0,0,0
2020-03-01,ZMB,Johor,0,0,0
2020-03-01,ZMB,Kedah,1,1,0
2020-03-01,ZMB,Perak,0,0,0
2020-03-01,ZMB,Perlis,0,0,0
2020-03-01,ZMB,Pulau Pinang,0,0,0
2020-03-01,ZMB,Sabah,0,0,0
2020-03-01,ZMB,Sarawak,0,0,0
2020-03-01,ZMB,Selangor,24,16,8
2020-03-01,ZWE,Johor,10,7,3
2020-03-01,ZWE,Kedah,0,0,0
2020-03-01,ZWE,Kelantan,0,0,0
2020-03-01,ZWE,Perak,0,0,0
2020-03-01,ZWE,Perlis,0,0,0
2020-03-01,ZWE,Pulau Pinang,0,0,0
2020-03-01,ZWE,Sabah,0,0,0
2020-03-01,ZWE,Sarawak,0,0,0
2020-03-01,ZWE,Selangor,60,30,30
2020-04-01,ABW,Kedah,0,0,0
2020-04-01,ABW,Pulau Pinang,0,0,0
2020-04-01,AFG,Johor,0,0,0
2020-04-01,AFG,Kedah,0,0,0
2020-04-01,AFG,Perlis,0,0,0
2020-04-01,AFG,Pulau Pinang,0,0,0
2020-04-01,AFG,Sarawak,0,0,0
2020-04-01,AFG,Selangor,0,0,0
2020-04-01,AGO,Johor,0,0,0
2020-04-01,AGO,Kedah,0,0,0
2020-04-01,AGO,Sabah,0,0,0
2020-04-01,AGO,Selangor,0,0,0
2020-04-01,AIA,Selangor,0,0,0
2020-04-01,ALB,Johor,0,0,0
2020-04-01,ALB,Kedah,0,0,0
2020-04-01,ALB,Perak,0,0,0
2020-04-01,ALB,Perlis,0,0,0
2020-04-01,ALB,Pulau Pinang,0,0,0
2020-04-01,ALB,Sabah,0,0,0
2020-04-01,ALB,Sarawak,0,0,0
2020-04-01,ALB,Selangor,0,0,0
2020-04-01,AND,Johor,0,0,0
2020-04-01,AND,Kedah,0,0,0
2020-04-01,AND,Perlis,0,0,0
2020-04-01,AND,Pulau Pinang,0,0,0
2020-04-01,AND,Selangor,0,0,0
2020-04-01,ANT,Selangor,0,0,0
2020-04-01,ARE,Johor,0,0,0
2020-04-01,ARE,Kedah,0,0,0
2020-04-01,ARE,Kelantan,0,0,0
2020-04-01,ARE,Perak,0,0,0
2020-04-01,ARE,Perlis,0,0,0
2020-04-01,ARE,Pulau Pinang,0,0,0
2020-04-01,ARE,Sabah,0,0,0
2020-04-01,ARE,Sarawak,0,0,0
2020-04-01,ARE,Selangor,2,2,0
2020-04-01,ARG,Johor,0,0,0
2020-04-01,ARG,Kedah,0,0,0
2020-04-01,ARG,Kelantan,0,0,0
2020-04-01,ARG,Melaka,0,0,0
2020-04-01,ARG,Perak,0,0,0
2020-04-01,ARG,Perlis,0,0,0
2020-04-01,ARG,Pulau Pinang,0,0,0
2020-04-01,ARG,Sabah,0,0,0
2020-04-01,ARG,Sarawak,0,0,0
2020-04-01,ARG,Selangor,0,0,0
2020-04-01,ARG,W.P. Labuan,0,0,0
2020-04-01,ARM,Johor,0,0,0
2020-04-01,ARM,Kedah,0,0,0
2020-04-01,ARM,Kelantan,0,0,0
2020-04-01,ARM,Perak,0,0,0
2020-04-01,ARM,Perlis,0,0,0
2020-04-01,ARM,Pulau Pinang,0,0,0
2020-04-01,ARM,Sabah,0,0,0
2020-04-01,ARM,Sarawak,0,0,0
2020-04-01,ARM,Selangor,0,0,0
2020-04-01,ATA,Selangor,0,0,0
2020-04-01,ATG,Johor,0,0,0
2020-04-01,ATG,Kedah,0,0,0
2020-04-01,ATG,Pulau Pinang,0,0,0
2020-04-01,ATG,Sarawak,0,0,0
2020-04-01,ATG,Selangor,0,0,0
2020-04-01,AUS,Johor,0,0,0
2020-04-01,AUS,Kedah,0,0,0
2020-04-01,AUS,Kelantan,0,0,0
2020-04-01,AUS,Melaka,0,0,0
2020-04-01,AUS,Negeri Sembilan,0,0,0
2020-04-01,AUS,Pahang,0,0,0
2020-04-01,AUS,Perak,0,0,0
2020-04-01,AUS,Perlis,0,0,0
2020-04-01,AUS,Pulau Pinang,0,0,0
2020-04-01,AUS,Sabah,0,0,0
2020-04-01,AUS,Sarawak,0,0,0
2020-04-01,AUS,Selangor,9,8,1
2020-04-01,AUS,Terengganu,0,0,0
2020-04-01,AUS,W.P. Labuan,0,0,0
2020-04-01,AUT,Johor,0,0,0
2020-04-01,AUT,Kedah,1,1,0
2020-04-01,AUT,Kelantan,0,0,0
2020-04-01,AUT,Melaka,0,0,0
2020-04-01,AUT,Negeri Sembilan,0,0,0
2020-04-01,AUT,Pahang,0,0,0
2020-04-01,AUT,Perak,0,0,0
2020-04-01,AUT,Perlis,0,0,0
2020-04-01,AUT,Pulau Pinang,0,0,0
2020-04-01,AUT,Sabah,0,0,0
2020-04-01,AUT,Sarawak,0,0,0
2020-04-01,AUT,Selangor,0,0,0
2020-04-01,AUT,Terengganu,0,0,0
2020-04-01,AUT,W.P. Labuan,0,0,0
2020-04-01,AZE,Johor,0,0,0
2020-04-01,AZE,Kedah,0,0,0
2020-04-01,AZE,Kelantan,0,0,0
2020-04-01,AZE,Melaka,0,0,0
2020-04-01,AZE,Perlis,0,0,0
2020-04-01,AZE,Pulau Pinang,0,0,0
2020-04-01,AZE,Sabah,0,0,0
2020-04-01,AZE,Sarawak,0,0,0
2020-04-01,AZE,Selangor,0,0,0
2020-04-01,AZE,W.P. Labuan,0,0,0
2020-04-01,BDI,Pulau Pinang,0,0,0
2020-04-01,BDI,Sarawak,0,0,0
2020-04-01,BDI,Selangor,0,0,0
2020-04-01,BEL,Johor,1,0,1
2020-04-01,BEL,Kedah,0,0,0
2020-04-01,BEL,Kelantan,0,0,0
2020-04-01,BEL,Melaka,0,0,0
2020-04-01,BEL,Negeri Sembilan,0,0,0
2020-04-01,BEL,Pahang,0,0,0
2020-04-01,BEL,Perak,0,0,0
2020-04-01,BEL,Perlis,0,0,0
2020-04-01,BEL,Pulau Pinang,0,0,0
2020-04-01,BEL,Sabah,0,0,0
2020-04-01,BEL,Sarawak,0,0,0
2020-04-01,BEL,Selangor,6,6,0
2020-04-01,BEL,W.P. Labuan,0,0,0
2020-04-01,BEN,Johor,0,0,0
2020-04-01,BEN,Kedah,0,0,0
2020-04-01,BEN,Perak,0,0,0
2020-04-01,BEN,Pulau Pinang,0,0,0
2020-04-01,BEN,Sabah,0,0,0
2020-04-01,BEN,Sarawak,0,0,0
2020-04-01,BEN,Selangor,0,0,0
2020-04-01,BFA,Perak,0,0,0
2020-04-01,BFA,Pulau Pinang,0,0,0
2020-04-01,BFA,Selangor,0,0,0
2020-04-01,BGD,Johor,0,0,0
2020-04-01,BGD,Kedah,0,0,0
2020-04-01,BGD,Kelantan,0,0,0
2020-04-01,BGD,Melaka,0,0,0
2020-04-01,BGD,Negeri Sembilan,0,0,0
2020-04-01,BGD,Pahang,0,0,0
2020-04-01,BGD,Perak,0,0,0
2020-04-01,BGD,Perlis,0,0,0
2020-04-01,BGD,Pulau Pinang,0,0,0
2020-04-01,BGD,Sabah,0,0,0
2020-04-01,BGD,Sarawak,0,0,0
2020-04-01,BGD,Selangor,2,2,0
2020-04-01,BGD,W.P. Labuan,0,0,0
2020-04-01,BGR,Johor,0,0,0
2020-04-01,BGR,Kedah,0,0,0
2020-04-01,BGR,Kelantan,0,0,0
2020-04-01,BGR,Pahang,0,0,0
2020-04-01,BGR,Perak,0,0,0
2020-04-01,BGR,Perlis,0,0,0
2020-04-01,BGR,Pulau Pinang,0,0,0
2020-04-01,BGR,Sabah,0,0,0
2020-04-01,BGR,Sarawak,0,0,0
2020-04-01,BGR,Selangor,0,0,0
2020-04-01,BGR,W.P. Labuan,0,0,0
2020-04-01,BHR,Johor,0,0,0
2020-04-01,BHR,Kedah,0,0,0
2020-04-01,BHR,Kelantan,0,0,0
2020-04-01,BHR,Perlis,0,0,0
2020-04-01,BHR,Pulau Pinang,0,0,0
2020-04-01,BHR,Sabah,0,0,0
2020-04-01,BHR,Sarawak,0,0,0
2020-04-01,BHR,Selangor,0,0,0
2020-04-01,BHS,Johor,0,0,0
2020-04-01,BHS,Kedah,0,0,0
2020-04-01,BHS,Perak,0,0,0
2020-04-01,BHS,Sabah,0,0,0
2020-04-01,BHS,Sarawak,0,0,0
2020-04-01,BHS,Selangor,0,0,0
2020-04-01,BIH,Johor,0,0,0
2020-04-01,BIH,Kedah,0,0,0
2020-04-01,BIH,Perlis,0,0,0
2020-04-01,BIH,Pulau Pinang,0,0,0
2020-04-01,BIH,Sabah,0,0,0
2020-04-01,BIH,Sarawak,0,0,0
2020-04-01,BIH,Selangor,1,1,0
2020-04-01,BLR,Johor,0,0,0
2020-04-01,BLR,Kedah,0,0,0
2020-04-01,BLR,Kelantan,0,0,0
2020-04-01,BLR,Pahang,0,0,0
2020-04-01,BLR,Perak,0,0,0
2020-04-01,BLR,Perlis,0,0,0
2020-04-01,BLR,Pulau Pinang,0,0,0
2020-04-01,BLR,Sabah,0,0,0
2020-04-01,BLR,Sarawak,0,0,0
2020-04-01,BLR,Selangor,0,0,0
2020-04-01,BLR,W.P. Labuan,0,0,0
2020-04-01,BLZ,Johor,0,0,0
2020-04-01,BLZ,Pulau Pinang,0,0,0
2020-04-01,BLZ,Sarawak,0,0,0
2020-04-01,BLZ,Selangor,0,0,0
2020-04-01,BMU,Selangor,0,0,0
2020-04-01,BOL,Johor,0,0,0
2020-04-01,BOL,Kedah,0,0,0
2020-04-01,BOL,Melaka,0,0,0
2020-04-01,BOL,Perak,0,0,0
2020-04-01,BOL,Perlis,0,0,0
2020-04-01,BOL,Pulau Pinang,0,0,0
2020-04-01,BOL,Sabah,0,0,0
2020-04-01,BOL,Sarawak,0,0,0
2020-04-01,BOL,Selangor,0,0,0
2020-04-01,BRA,Johor,0,0,0
2020-04-01,BRA,Kedah,0,0,0
2020-04-01,BRA,Kelantan,0,0,0
2020-04-01,BRA,Melaka,0,0,0
2020-04-01,BRA,Pahang,0,0,0
2020-04-01,BRA,Perak,0,0,0
2020-04-01,BRA,Perlis,0,0,0
2020-04-01,BRA,Pulau Pinang,0,0,0
2020-04-01,BRA,Sabah,0,0,0
2020-04-01,BRA,Sarawak,0,0,0
2020-04-01,BRA,Selangor,0,0,0
2020-04-01,BRA,W.P. Labuan,0,0,0
2020-04-01,BRB,Johor,0,0,0
2020-04-01,BRB,Kedah,0,0,0
2020-04-01,BRB,Perlis,0,0,0
2020-04-01,BRB,Pulau Pinang,0,0,0
2020-04-01,BRB,Selangor,0,0,0
2020-04-01,BRN,Johor,0,0,0
2020-04-01,BRN,Kedah,0,0,0
2020-04-01,BRN,Kelantan,0,0,0
2020-04-01,BRN,Melaka,0,0,0
2020-04-01,BRN,Pahang,0,0,0
2020-04-01,BRN,Perak,0,0,0
2020-04-01,BRN,Perlis,0,0,0
2020-04-01,BRN,Pulau Pinang,0,0,0
2020-04-01,BRN,Sabah,0,0,0
2020-04-01,BRN,Sarawak,251,233,18
2020-04-01,BRN,Selangor,1,1,0
2020-04-01,BRN,W.P. Labuan,2,2,0
2020-04-01,BTN,Johor,0,0,0
2020-04-01,BTN,Kedah,0,0,0
2020-04-01,BTN,Perak,0,0,0
2020-04-01,BTN,Perlis,0,0,0
2020-04-01,BTN,Pulau Pinang,0,0,0
2020-04-01,BTN,Sabah,0,0,0
2020-04-01,BTN,Sarawak,0,0,0
2020-04-01,BTN,Selangor,0,0,0
2020-04-01,BWA,Johor,0,0,0
2020-04-01,BWA,Kedah,0,0,0
2020-04-01,BWA,Perlis,0,0,0
2020-04-01,BWA,Pulau Pinang,0,0,0
2020-04-01,BWA,Sabah,0,0,0
2020-04-01,BWA,Sarawak,0,0,0
2020-04-01,BWA,Selangor,0,0,0
2020-04-01,CAF,Kedah,0,0,0
2020-04-01,CAF,Selangor,0,0,0
2020-04-01,CAN,Johor,0,0,0
2020-04-01,CAN,Kedah,0,0,0
2020-04-01,CAN,Kelantan,0,0,0
2020-04-01,CAN,Melaka,0,0,0
2020-04-01,CAN,Negeri Sembilan,0,0,0
2020-04-01,CAN,Pahang,0,0,0
2020-04-01,CAN,Perak,0,0,0
2020-04-01,CAN,Perlis,0,0,0
2020-04-01,CAN,Pulau Pinang,0,0,0
2020-04-01,CAN,Sabah,0,0,0
2020-04-01,CAN,Sarawak,0,0,0
2020-04-01,CAN,Selangor,2,2,0
2020-04-01,CAN,Terengganu,0,0,0
2020-04-01,CAN,W.P. Labuan,0,0,0
2020-04-01,CCK,Selangor,0,0,0
2020-04-01,CHE,Johor,0,0,0
2020-04-01,CHE,Kedah,0,0,0
2020-04-01,CHE,Kelantan,0,0,0
2020-04-01,CHE,Melaka,0,0,0
2020-04-01,CHE,Negeri Sembilan,0,0,0
2020-04-01,CHE,Pahang,0,0,0
2020-04-01,CHE,Perak,0,0,0
2020-04-01,CHE,Perlis,0,0,0
2020-04-01,CHE,Pulau Pinang,0,0,0
2020-04-01,CHE,Sabah,0,0,0
2020-04-01,CHE,Sarawak,0,0,0
2020-04-01,CHE,Selangor,1,1,0
2020-04-01,CHE,W.P. Labuan,0,0,0
2020-04-01,CHL,Johor,0,0,0
2020-04-01,CHL,Kedah,0,0,0
2020-04-01,CHL,Kelantan,0,0,0
2020-04-01,CHL,Melaka,0,0,0
2020-04-01,CHL,Pahang,0,0,0
2020-04-01,CHL,Perak,0,0,0
2020-04-01,CHL,Perlis,0,0,0
2020-04-01,CHL,Pulau Pinang,0,0,0
2020-04-01,CHL,Sabah,0,0,0
2020-04-01,CHL,Sarawak,0,0,0
2020-04-01,CHL,Selangor,0,0,0
2020-04-01,CHN,Johor,2,0,2
2020-04-01,CHN,Kedah,0,0,0
2020-04-01,CHN,Kelantan,0,0,0
2020-04-01,CHN,Melaka,0,0,0
2020-04-01,CHN,Pahang,0,0,0
2020-04-01,CHN,Perak,0,0,0
2020-04-01,CHN,Perlis,0,0,0
2020-04-01,CHN,Pulau Pinang,0,0,0
2020-04-01,CHN,Sabah,0,0,0
2020-04-01,CHN,Sarawak,1,0,1
2020-04-01,CHN,Selangor,57,28,29
2020-04-01,CHN,Terengganu,0,0,0
2020-04-01,CHN,W.P. Labuan,0,0,0
2020-04-01,CIV,Johor,0,0,0
2020-04-01,CIV,Kedah,0,0,0
2020-04-01,CIV,Pulau Pinang,0,0,0
2020-04-01,CIV,Sabah,0,0,0
2020-04-01,CIV,Sarawak,0,0,0
2020-04-01,CIV,Selangor,0,0,0
2020-04-01,CMR,Johor,0,0,0
2020-04-01,CMR,Kedah,0,0,0
2020-04-01,CMR,Pulau Pinang,0,0,0
2020-04-01,CMR,Sabah,0,0,0
2020-04-01,CMR,Sarawak,0,0,0
2020-04-01,CMR,Selangor,0,0,0
2020-04-01,COD,Johor,0,0,0
2020-04-01,COD,Pulau Pinang,0,0,0
2020-04-01,COD,Sarawak,0,0,0
2020-04-01,COD,Selangor,0,0,0
2020-04-01,COG,Johor,0,0,0
2020-04-01,COG,Kedah,0,0,0
2020-04-01,COG,Selangor,0,0,0
2020-04-01,COK,Selangor,0,0,0
2020-04-01,COL,Johor,0,0,0
2020-04-01,COL,Kedah,0,0,0
2020-04-01,COL,Perak,0,0,0
2020-04-01,COL,Pulau Pinang,0,0,0
2020-04-01,COL,Sabah,0,0,0
2020-04-01,COL,Sarawak,0,0,0
2020-04-01,COL,Selangor,0,0,0
2020-04-01,COL,W.P. Labuan,0,0,0
2020-04-01,COM,Johor,0,0,0
2020-04-01,COM,Kedah,0,0,0
2020-04-01,COM,Selangor,0,0,0
2020-04-01,CPV,Johor,0,0,0
2020-04-01,CPV,Kedah,0,0,0
2020-04-01,CPV,Pulau Pinang,0,0,0
2020-04-01,CPV,Sabah,0,0,0
2020-04-01,CPV,Selangor,0,0,0
2020-04-01,CRI,Johor,0,0,0
2020-04-01,CRI,Kedah,0,0,0
2020-04-01,CRI,Perak,0,0,0
2020-04-01,CRI,Perlis,0,0,0
2020-04-01,CRI,Pulau Pinang,0,0,0
2020-04-01,CRI,Sabah,0,0,0
2020-04-01,CRI,Sarawak,0,0,0
2020-04-01,CRI,Selangor,0,0,0
2020-04-01,CUB,Johor,0,0,0
2020-04-01,CUB,Kedah,0,0,0
2020-04-01,CUB,Perlis,0,0,0
2020-04-01,CUB,Pulau Pinang,0,0,0
2020-04-01,CUB,Sabah,0,0,0
2020-04-01,CUB,Sarawak,0,0,0
2020-04-01,CUB,Selangor,0,0,0
2020-04-01,CYP,Johor,0,0,0
2020-04-01,CYP,Kedah,0,0,0
2020-04-01,CYP,Perak,0,0,0
2020-04-01,CYP,Perlis,0,0,0
2020-04-01,CYP,Pulau Pinang,0,0,0
2020-04-01,CYP,Sabah,0,0,0
2020-04-01,CYP,Sarawak,0,0,0
2020-04-01,CYP,Selangor,0,0,0
2020-04-01,CZE,Johor,0,0,0
2020-04-01,CZE,Kedah,0,0,0
2020-04-01,CZE,Kelantan,0,0,0
2020-04-01,CZE,Melaka,0,0,0
2020-04-01,CZE,Negeri Sembilan,0,0,0
2020-04-01,CZE,Perak,0,0,0
2020-04-01,CZE,Perlis,0,0,0
2020-04-01,CZE,Pulau Pinang,0,0,0
2020-04-01,CZE,Sabah,0,0,0
2020-04-01,CZE,Sarawak,0,0,0
2020-04-01,CZE,Selangor,0,0,0
2020-04-01,CZE,W.P. Labuan,0,0,0
2020-04-01,DEU,Johor,4,2,2
2020-04-01,DEU,Kedah,0,0,0
2020-04-01,DEU,Kelantan,0,0,0
2020-04-01,DEU,Melaka,0,0,0
2020-04-01,DEU,Negeri Sembilan,0,0,0
2020-04-01,DEU,Pahang,0,0,0
2020-04-01,DEU,Perak,0,0,0
2020-04-01,DEU,Perlis,0,0,0
2020-04-01,DEU,Pulau Pinang,0,0,0
2020-04-01,DEU,Sabah,0,0,0
2020-04-01,DEU,Sarawak,0,0,0
2020-04-01,DEU,Selangor,2,2,0
2020-04-01,DEU,Terengganu,0,0,0
2020-04-01,DEU,W.P. Labuan,0,0,0
2020-04-01,DJI,Johor,0,0,0
2020-04-01,DJI,Selangor,0,0,0
2020-04-01,DMA,Johor,0,0,0
2020-04-01,DMA,Kedah,0,0,0
2020-04-01,DMA,Pulau Pinang,0,0,0
2020-04-01,DMA,Sabah,0,0,0
2020-04-01,DMA,Sarawak,0,0,0
2020-04-01,DMA,Selangor,0,0,0
2020-04-01,DMA,W.P. Labuan,0,0,0
2020-04-01,DNK,Johor,0,0,0
2020-04-01,DNK,Kedah,0,0,0
2020-04-01,DNK,Kelantan,0,0,0
2020-04-01,DNK,Melaka,0,0,0
2020-04-01,DNK,Negeri Sembilan,0,0,0
2020-04-01,DNK,Pahang,0,0,0
2020-04-01,DNK,Perak,0,0,0
2020-04-01,DNK,Perlis,0,0,0
2020-04-01,DNK,Pulau Pinang,0,0,0
2020-04-01,DNK,Sabah,0,0,0
2020-04-01,DNK,Sarawak,0,0,0
2020-04-01,DNK,Selangor,0,0,0
2020-04-01,DNK,W.P. Labuan,0,0,0
2020-04-01,DOM,Johor,0,0,0
2020-04-01,DOM,Kedah,0,0,0
2020-04-01,DOM,Perak,0,0,0
2020-04-01,DOM,Perlis,0,0,0
2020-04-01,DOM,Pulau Pinang,0,0,0
2020-04-01,DOM,Sabah,0,0,0
2020-04-01,DOM,Sarawak,0,0,0
2020-04-01,DOM,Selangor,0,0,0
2020-04-01,DZA,Johor,0,0,0
2020-04-01,DZA,Kedah,0,0,0
2020-04-01,DZA,Kelantan,0,0,0
2020-04-01,DZA,Melaka,0,0,0
2020-04-01,DZA,Perak,0,0,0
2020-04-01,DZA,Perlis,0,0,0
2020-04-01,DZA,Pulau Pinang,0,0,0
2020-04-01,DZA,Sabah,0,0,0
2020-04-01,DZA,Sarawak,0,0,0
2020-04-01,DZA,Selangor,0,0,0
2020-04-01,DZA,W.P. Labuan,0,0,0
2020-04-01,ECU,Johor,0,0,0
2020-04-01,ECU,Kedah,0,0,0
2020-04-01,ECU,Perak,0,0,0
2020-04-01,ECU,Perlis,0,0,0
2020-04-01,ECU,Pulau Pinang,0,0,0
2020-04-01,ECU,Sabah,0,0,0
2020-04-01,ECU,Sarawak,0,0,0
2020-04-01,ECU,Selangor,0,0,0
2020-04-01,EGY,Johor,6,6,0
2020-04-01,EGY,Kedah,0,0,0
2020-04-01,EGY,Kelantan,0,0,0
2020-04-01,EGY,Melaka,0,0,0
2020-04-01,EGY,Pahang,0,0,0
2020-04-01,EGY,Perak,0,0,0
2020-04-01,EGY,Perlis,0,0,0
2020-04-01,EGY,Pulau Pinang,0,0,0
2020-04-01,EGY,Sabah,0,0,0
2020-04-01,EGY,Sarawak,0,0,0
2020-04-01,EGY,Selangor,2,1,1
2020-04-01,EGY,Terengganu,0,0,0
2020-04-01,EGY,W.P. Labuan,0,0,0
2020-04-01,ERI,Johor,0,0,0
2020-04-01,ERI,Pulau Pinang,0,0,0
2020-04-01,ERI,Sabah,0,0,0
2020-04-01,ERI,Selangor,0,0,0
2020-04-01,ESP,Johor,0,0,0
2020-04-01,ESP,Kedah,0,0,0
2020-04-01,ESP,Kelantan,0,0,0
2020-04-01,ESP,Melaka,0,0,0
2020-04-01,ESP,Negeri Sembilan,0,0,0
2020-04-01,ESP,Pahang,0,0,0
2020-04-01,ESP,Perak,0,0,0
2020-04-01,ESP,Perlis,0,0,0
2020-04-01,ESP,Pulau Pinang,0,0,0
2020-04-01,ESP,Sabah,0,0,0
2020-04-01,ESP,Sarawak,0,0,0
2020-04-01,ESP,Selangor,0,0,0
2020-04-01,ESP,W.P. Labuan,0,0,0
2020-04-01,EST,Johor,0,0,0
2020-04-01,EST,Kedah,0,0,0
2020-04-01,EST,Kelantan,0,0,0
2020-04-01,EST,Pahang,0,0,0
2020-04-01,EST,Perak,0,0,0
2020-04-01,EST,Perlis,0,0,0
2020-04-01,EST,Pulau Pinang,0,0,0
2020-04-01,EST,Sabah,0,0,0
2020-04-01,EST,Sarawak,0,0,0
2020-04-01,EST,Selangor,0,0,0
2020-04-01,EST,W.P. Labuan,0,0,0
2020-04-01,ETH,Johor,0,0,0
2020-04-01,ETH,Kedah,0,0,0
2020-04-01,ETH,Pulau Pinang,0,0,0
2020-04-01,ETH,Sarawak,0,0,0
2020-04-01,ETH,Selangor,0,0,0
2020-04-01,FIN,Johor,1,1,0
2020-04-01,FIN,Kedah,0,0,0
2020-04-01,FIN,Kelantan,0,0,0
2020-04-01,FIN,Melaka,0,0,0
2020-04-01,FIN,Negeri Sembilan,0,0,0
2020-04-01,FIN,Pahang,0,0,0
2020-04-01,FIN,Perak,0,0,0
2020-04-01,FIN,Perlis,0,0,0
2020-04-01,FIN,Pulau Pinang,1,1,0
2020-04-01,FIN,Sabah,0,0,0
2020-04-01,FIN,Sarawak,0,0,0
2020-04-01,FIN,Selangor,0,0,0
2020-04-01,FIN,W.P. Labuan,0,0,0
2020-04-01,FJI,Johor,0,0,0
2020-04-01,FJI,Kedah,0,0,0
2020-04-01,FJI,Kelantan,0,0,0
2020-04-01,FJI,Perak,0,0,0
2020-04-01,FJI,Perlis,0,0,0
2020-04-01,FJI,Pulau Pinang,0,0,0
2020-04-01,FJI,Sabah,0,0,0
2020-04-01,FJI,Sarawak,0,0,0
2020-04-01,FJI,Selangor,0,0,0
2020-04-01,FRA,Johor,1,1,0
2020-04-01,FRA,Kedah,0,0,0
2020-04-01,FRA,Kelantan,0,0,0
2020-04-01,FRA,Melaka,0,0,0
2020-04-01,FRA,Negeri Sembilan,0,0,0
2020-04-01,FRA,Pahang,0,0,0
2020-04-01,FRA,Perak,0,0,0
2020-04-01,FRA,Perlis,0,0,0
2020-04-01,FRA,Pulau Pinang,0,0,0
2020-04-01,FRA,Sabah,0,0,0
2020-04-01,FRA,Sarawak,0,0,0
2020-04-01,FRA,Selangor,2,1,1
2020-04-01,FRA,Terengganu,0,0,0
2020-04-01,FRA,W.P. Labuan,0,0,0
2020-04-01,FSM,Johor,0,0,0
2020-04-01,FSM,Pulau Pinang,0,0,0
2020-04-01,FSM,Selangor,0,0,0
2020-04-01,GAB,Johor,0,0,0
2020-04-01,GAB,Pulau Pinang,0,0,0
2020-04-01,GAB,Sarawak,0,0,0
2020-04-01,GAB,Selangor,0,0,0
2020-04-01,GBR,Johor,1,1,0
2020-04-01,GBR,Kedah,0,0,0
2020-04-01,GBR,Kelantan,0,0,0
2020-04-01,GBR,Melaka,0,0,0
2020-04-01,GBR,Negeri Sembilan,0,0,0
2020-04-01,GBR,Pahang,0,0,0
2020-04-01,GBR,Perak,0,0,0
2020-04-01,GBR,Perlis,0,0,0
2020-04-01,GBR,Pulau Pinang,0,0,0
2020-04-01,GBR,Sabah,0,0,0
2020-04-01,GBR,Sarawak,0,0,0
2020-04-01,GBR,Selangor,17,14,3
2020-04-01,GBR,Terengganu,0,0,0
2020-04-01,GBR,W.P. Labuan,0,0,0
2020-04-01,GEO,Johor,0,0,0
2020-04-01,GEO,Kedah,0,0,0
2020-04-01,GEO,Melaka,0,0,0
2020-04-01,GEO,Perak,0,0,0
2020-04-01,GEO,Perlis,0,0,0
2020-04-01,GEO,Pulau Pinang,0,0,0
2020-04-01,GEO,Sabah,0,0,0
2020-04-01,GEO,Sarawak,0,0,0
2020-04-01,GEO,Selangor,0,0,0
2020-04-01,GHA,Johor,0,0,0
2020-04-01,GHA,Kedah,0,0,0
2020-04-01,GHA,Kelantan,0,0,0
2020-04-01,GHA,Pulau Pinang,0,0,0
2020-04-01,GHA,Sabah,0,0,0
2020-04-01,GHA,Sarawak,0,0,0
2020-04-01,GHA,Selangor,0,0,0
2020-04-01,GIB,Johor,0,0,0
2020-04-01,GIB,Sarawak,0,0,0
2020-04-01,GIN,Johor,0,0,0
2020-04-01,GIN,Kedah,0,0,0
2020-04-01,GIN,Kelantan,0,0,0
2020-04-01,GIN,Perlis,0,0,0
2020-04-01,GIN,Pulau Pinang,0,0,0
2020-04-01,GIN,Sabah,0,0,0
2020-04-01,GIN,Sarawak,0,0,0
2020-04-01,GIN,Selangor,0,0,0
2020-04-01,GLP,Selangor,0,0,0
2020-04-01,GMB,Johor,0,0,0
2020-04-01,GMB,Kedah,0,0,0
2020-04-01,GMB,Kelantan,0,0,0
2020-04-01,GMB,Pulau Pinang,0,0,0
2020-04-01,GMB,Sabah,0,0,0
2020-04-01,GMB,Sarawak,0,0,0
2020-04-01,GMB,Selangor,0,0,0
2020-04-01,GNB,Johor,0,0,0
2020-04-01,GNB,Selangor,0,0,0
2020-04-01,GNQ,Johor,0,0,0
2020-04-01,GNQ,Selangor,0,0,0
2020-04-01,GRC,Johor,0,0,0
2020-04-01,GRC,Kedah,0,0,0
2020-04-01,GRC,Kelantan,0,0,0
2020-04-01,GRC,Melaka,0,0,0
2020-04-01,GRC,Negeri Sembilan,0,0,0
2020-04-01,GRC,Pahang,0,0,0
2020-04-01,GRC,Perak,0,0,0
2020-04-01,GRC,Perlis,0,0,0
2020-04-01,GRC,Pulau Pinang,0,0,0
2020-04-01,GRC,Sabah,0,0,0
2020-04-01,GRC,Sarawak,0,0,0
2020-04-01,GRC,Selangor,0,0,0
2020-04-01,GRD,Johor,0,0,0
2020-04-01,GRD,Kedah,0,0,0
2020-04-01,GRD,Pulau Pinang,0,0,0
2020-04-01,GRD,Sabah,0,0,0
2020-04-01,GRD,Sarawak,0,0,0
2020-04-01,GRD,Selangor,0,0,0
2020-04-01,GRL,Johor,0,0,0
2020-04-01,GRL,Selangor,0,0,0
2020-04-01,GTM,Johor,0,0,0
2020-04-01,GTM,Kedah,0,0,0
2020-04-01,GTM,Pahang,0,0,0
2020-04-01,GTM,Perak,0,0,0
2020-04-01,GTM,Pulau Pinang,0,0,0
2020-04-01,GTM,Sabah,0,0,0
2020-04-01,GTM,Sarawak,0,0,0
2020-04-01,GTM,Selangor,0,0,0
2020-04-01,GTM,W.P. Labuan,0,0,0
2020-04-01,GUY,Johor,0,0,0
2020-04-01,GUY,Kedah,0,0,0
2020-04-01,GUY,Pulau Pinang,0,0,0
2020-04-01,GUY,Sarawak,0,0,0
2020-04-01,GUY,Selangor,0,0,0
2020-04-01,HKG,Johor,0,0,0
2020-04-01,HKG,Kedah,0,0,0
2020-04-01,HKG,Kelantan,0,0,0
2020-04-01,HKG,Pahang,0,0,0
2020-04-01,HKG,Perak,0,0,0
2020-04-01,HKG,Perlis,0,0,0
2020-04-01,HKG,Pulau Pinang,0,0,0
2020-04-01,HKG,Sabah,0,0,0
2020-04-01,HKG,Sarawak,0,0,0
2020-04-01,HKG,Selangor,0,0,0
2020-04-01,HKG,Terengganu,0,0,0
2020-04-01,HMD,Johor,0,0,0
2020-04-01,HND,Johor,0,0,0
2020-04-01,HND,Kedah,0,0,0
2020-04-01,HND,Perak,0,0,0
2020-04-01,HND,Pulau Pinang,0,0,0
2020-04-01,HND,Sabah,0,0,0
2020-04-01,HND,Sarawak,0,0,0
2020-04-01,HND,Selangor,0,0,0
2020-04-01,HRV,Johor,2,2,0
2020-04-01,HRV,Kedah,0,0,0
2020-04-01,HRV,Kelantan,0,0,0
2020-04-01,HRV,Melaka,0,0,0
2020-04-01,HRV,Pahang,0,0,0
2020-04-01,HRV,Perak,0,0,0
2020-04-01,HRV,Perlis,0,0,0
2020-04-01,HRV,Pulau Pinang,0,0,0
2020-04-01,HRV,Sabah,0,0,0
2020-04-01,HRV,Sarawak,0,0,0
2020-04-01,HRV,Selangor,0,0,0
2020-04-01,HTI,Johor,0,0,0
2020-04-01,HTI,Kedah,0,0,0
2020-04-01,HTI,Kelantan,0,0,0
2020-04-01,HTI,Perak,0,0,0
2020-04-01,HTI,Pulau Pinang,0,0,0
2020-04-01,HTI,Sabah,0,0,0
2020-04-01,HTI,Selangor,0,0,0
2020-04-01,HUN,Johor,0,0,0
2020-04-01,HUN,Kedah,0,0,0
2020-04-01,HUN,Kelantan,0,0,0
2020-04-01,HUN,Pahang,0,0,0
2020-04-01,HUN,Perak,0,0,0
2020-04-01,HUN,Perlis,0,0,0
2020-04-01,HUN,Pulau Pinang,2,2,0
2020-04-01,HUN,Sabah,0,0,0
2020-04-01,HUN,Sarawak,0,0,0
2020-04-01,HUN,Selangor,0,0,0
2020-04-01,HUN,W.P. Labuan,0,0,0
2020-04-01,IDN,Johor,89,52,37
2020-04-01,IDN,Kedah,16,16,0
2020-04-01,IDN,Kelantan,1,0,1
2020-04-01,IDN,Melaka,0,0,0
2020-04-01,IDN,Negeri Sembilan,1,1,0
2020-04-01,IDN,Pahang,0,0,0
2020-04-01,IDN,Perak,0,0,0
2020-04-01,IDN,Perlis,0,0,0
2020-04-01,IDN,Pulau Pinang,0,0,0
2020-04-01,IDN,Sabah,18,2,16
2020-04-01,IDN,Sarawak,201,188,13
2020-04-01,IDN,Selangor,104,46,58
2020-04-01,IDN,Terengganu,0,0,0
2020-04-01,IDN,W.P. Labuan,0,0,0
2020-04-01,IND,Johor,5,5,0
2020-04-01,IND,Kedah,0,0,0
2020-04-01,IND,Kelantan,0,0,0
2020-04-01,IND,Melaka,0,0,0
2020-04-01,IND,Negeri Sembilan,0,0,0
2020-04-01,IND,Pahang,0,0,0
2020-04-01,IND,Perak,0,0,0
2020-04-01,IND,Perlis,0,0,0
2020-04-01,IND,Pulau Pinang,0,0,0
2020-04-01,IND,Sabah,0,0,0
2020-04-01,IND,Sarawak,0,0,0
2020-04-01,IND,Selangor,42,21,21
2020-04-01,IND,Terengganu,0,0,0
2020-04-01,IND,W.P. Labuan,0,0,0
2020-04-01,IOT,Pulau Pinang,0,0,0
2020-04-01,IOT,Selangor,0,0,0
2020-04-01,IRL,Johor,0,0,0
2020-04-01,IRL,Kedah,0,0,0
2020-04-01,IRL,Kelantan,0,0,0
2020-04-01,IRL,Negeri Sembilan,0,0,0
2020-04-01,IRL,Pahang,0,0,0
2020-04-01,IRL,Perak,0,0,0
2020-04-01,IRL,Perlis,0,0,0
2020-04-01,IRL,Pulau Pinang,0,0,0
2020-04-01,IRL,Sabah,0,0,0
2020-04-01,IRL,Sarawak,0,0,0
2020-04-01,IRL,Selangor,2,2,0
2020-04-01,IRL,Terengganu,0,0,0
2020-04-01,IRL,W.P. Labuan,0,0,0
2020-04-01,IRN,Johor,0,0,0
2020-04-01,IRN,Kedah,0,0,0
2020-04-01,IRN,Kelantan,0,0,0
2020-04-01,IRN,Perak,0,0,0
2020-04-01,IRN,Perlis,0,0,0
2020-04-01,IRN,Pulau Pinang,0,0,0
2020-04-01,IRN,Sabah,0,0,0
2020-04-01,IRN,Sarawak,0,0,0
2020-04-01,IRN,Selangor,0,0,0
2020-04-01,IRN,W.P. Labuan,0,0,0
2020-04-01,IRQ,Johor,0,0,0
2020-04-01,IRQ,Kedah,0,0,0
2020-04-01,IRQ,Kelantan,0,0,0
2020-04-01,IRQ,Melaka,0,0,0
2020-04-01,IRQ,Pahang,0,0,0
2020-04-01,IRQ,Perak,0,0,0
2020-04-01,IRQ,Perlis,0,0,0
2020-04-01,IRQ,Pulau Pinang,0,0,0
2020-04-01,IRQ,Sabah,0,0,0
2020-04-01,IRQ,Sarawak,0,0,0
2020-04-01,IRQ,Selangor,0,0,0
2020-04-01,ISL,Johor,0,0,0
2020-04-01,ISL,Kedah,0,0,0
2020-04-01,ISL,Kelantan,0,0,0
2020-04-01,ISL,Perak,0,0,0
2020-04-01,ISL,Perlis,0,0,0
2020-04-01,ISL,Pulau Pinang,0,0,0
2020-04-01,ISL,Sabah,0,0,0
2020-04-01,ISL,Sarawak,0,0,0
2020-04-01,ISL,Selangor,0,0,0
2020-04-01,ISL,W.P. Labuan,0,0,0
2020-04-01,ISR,Pulau Pinang,0,0,0
2020-04-01,ITA,Johor,0,0,0
2020-04-01,ITA,Kedah,0,0,0
2020-04-01,ITA,Kelantan,0,0,0
2020-04-01,ITA,Melaka,0,0,0
2020-04-01,ITA,Negeri Sembilan,0,0,0
2020-04-01,ITA,Pahang,0,0,0
2020-04-01,ITA,Perak,0,0,0
2020-04-01,ITA,Perlis,0,0,0
2020-04-01,ITA,Pulau Pinang,0,0,0
2020-04-01,ITA,Sabah,0,0,0
2020-04-01,ITA,Sarawak,0,0,0
2020-04-01,ITA,Selangor,2,2,0
2020-04-01,ITA,W.P. Labuan,0,0,0
2020-04-01,JAM,Johor,0,0,0
2020-04-01,JAM,Kedah,0,0,0
2020-04-01,JAM,Perak,0,0,0
2020-04-01,JAM,Pulau Pinang,0,0,0
2020-04-01,JAM,Sabah,0,0,0
2020-04-01,JAM,Sarawak,0,0,0
2020-04-01,JAM,Selangor,0,0,0
2020-04-01,JAM,W.P. Labuan,0,0,0
2020-04-01,JOR,Johor,0,0,0
2020-04-01,JOR,Kedah,0,0,0
2020-04-01,JOR,Kelantan,0,0,0
2020-04-01,JOR,Melaka,0,0,0
2020-04-01,JOR,Perlis,0,0,0
2020-04-01,JOR,Pulau Pinang,0,0,0
2020-04-01,JOR,Sabah,0,0,0
2020-04-01,JOR,Sarawak,0,0,0
2020-04-01,JOR,Selangor,0,0,0
2020-04-01,JOR,W.P. Labuan,0,0,0
2020-04-01,JPN,Johor,0,0,0
2020-04-01,JPN,Kedah,0,0,0
2020-04-01,JPN,Kelantan,0,0,0
2020-04-01,JPN,Melaka,0,0,0
2020-04-01,JPN,Negeri Sembilan,0,0,0
2020-04-01,JPN,Pahang,0,0,0
2020-04-01,JPN,Perak,0,0,0
2020-04-01,JPN,Perlis,0,0,0
2020-04-01,JPN,Pulau Pinang,0,0,0
2020-04-01,JPN,Sabah,0,0,0
2020-04-01,JPN,Sarawak,0,0,0
2020-04-01,JPN,Selangor,7,6,1
2020-04-01,JPN,W.P. Labuan,0,0,0
2020-04-01,KAZ,Johor,0,0,0
2020-04-01,KAZ,Kedah,0,0,0
2020-04-01,KAZ,Kelantan,0,0,0
2020-04-01,KAZ,Melaka,0,0,0
2020-04-01,KAZ,Perak,0,0,0
2020-04-01,KAZ,Perlis,0,0,0
2020-04-01,KAZ,Pulau Pinang,0,0,0
2020-04-01,KAZ,Sabah,0,0,0
2020-04-01,KAZ,Sarawak,0,0,0
2020-04-01,KAZ,Selangor,0,0,0
2020-04-01,KAZ,W.P. Labuan,0,0,0
2020-04-01,KEN,Johor,0,0,0
2020-04-01,KEN,Kedah,0,0,0
2020-04-01,KEN,Kelantan,0,0,0
2020-04-01,KEN,Perak,0,0,0
2020-04-01,KEN,Perlis,0,0,0
2020-04-01,KEN,Pulau Pinang,0,0,0
2020-04-01,KEN,Sabah,0,0,0
2020-04-01,KEN,Sarawak,0,0,0
2020-04-01,KEN,Selangor,0,0,0
2020-04-01,KGZ,Johor,0,0,0
2020-04-01,KGZ,Kedah,0,0,0
2020-04-01,KGZ,Kelantan,0,0,0
2020-04-01,KGZ,Perak,0,0,0
2020-04-01,KGZ,Perlis,0,0,0
2020-04-01,KGZ,Pulau Pinang,0,0,0
2020-04-01,KGZ,Sabah,0,0,0
2020-04-01,KGZ,Sarawak,0,0,0
2020-04-01,KGZ,Selangor,0,0,0
2020-04-01,KHM,Johor,0,0,0
2020-04-01,KHM,Kedah,1,0,1
2020-04-01,KHM,Kelantan,1,1,0
2020-04-01,KHM,Melaka,0,0,0
2020-04-01,KHM,Negeri Sembilan,0,0,0
2020-04-01,KHM,Pahang,0,0,0
2020-04-01,KHM,Perak,0,0,0
2020-04-01,KHM,Perlis,0,0,0
2020-04-01,KHM,Pulau Pinang,0,0,0
2020-04-01,KHM,Sabah,0,0,0
2020-04-01,KHM,Sarawak,0,0,0
2020-04-01,KHM,Selangor,5,1,4
2020-04-01,KHM,W.P. Labuan,0,0,0
2020-04-01,KIR,Johor,0,0,0
2020-04-01,KIR,Sabah,0,0,0
2020-04-01,KIR,Selangor,0,0,0
2020-04-01,KNA,Johor,0,0,0
2020-04-01,KNA,Kedah,0,0,0
2020-04-01,KNA,Perlis,0,0,0
2020-04-01,KNA,Pulau Pinang,0,0,0
2020-04-01,KNA,Sabah,0,0,0
2020-04-01,KNA,Selangor,0,0,0
2020-04-01,KNA,W.P. Labuan,0,0,0
2020-04-01,KOR,Johor,1,1,0
2020-04-01,KOR,Kedah,0,0,0
2020-04-01,KOR,Kelantan,0,0,0
2020-04-01,KOR,Melaka,0,0,0
2020-04-01,KOR,Negeri Sembilan,0,0,0
2020-04-01,KOR,Pahang,0,0,0
2020-04-01,KOR,Perak,0,0,0
2020-04-01,KOR,Perlis,0,0,0
2020-04-01,KOR,Pulau Pinang,0,0,0
2020-04-01,KOR,Sabah,0,0,0
2020-04-01,KOR,Sarawak,0,0,0
2020-04-01,KOR,Selangor,1,1,0
2020-04-01,KOR,Terengganu,0,0,0
2020-04-01,KOR,W.P. Labuan,0,0,0
2020-04-01,KWT,Johor,0,0,0
2020-04-01,KWT,Kedah,0,0,0
2020-04-01,KWT,Kelantan,0,0,0
2020-04-01,KWT,Perak,0,0,0
2020-04-01,KWT,Perlis,0,0,0
2020-04-01,KWT,Pulau Pinang,0,0,0
2020-04-01,KWT,Sabah,0,0,0
2020-04-01,KWT,Sarawak,0,0,0
2020-04-01,KWT,Selangor,0,0,0
2020-04-01,KWT,W.P. Labuan,0,0,0
2020-04-01,LAO,Johor,0,0,0
2020-04-01,LAO,Kedah,1,0,1
2020-04-01,LAO,Kelantan,0,0,0
2020-04-01,LAO,Melaka,0,0,0
2020-04-01,LAO,Perak,0,0,0
2020-04-01,LAO,Perlis,0,0,0
2020-04-01,LAO,Pulau Pinang,0,0,0
2020-04-01,LAO,Sabah,0,0,0
2020-04-01,LAO,Sarawak,0,0,0
2020-04-01,LAO,Selangor,1,0,1
2020-04-01,LAO,W.P. Labuan,0,0,0
2020-04-01,LBN,Johor,0,0,0
2020-04-01,LBN,Kedah,0,0,0
2020-04-01,LBN,Kelantan,0,0,0
2020-04-01,LBN,Pahang,0,0,0
2020-04-01,LBN,Perak,0,0,0
2020-04-01,LBN,Perlis,0,0,0
2020-04-01,LBN,Pulau Pinang,0,0,0
2020-04-01,LBN,Sabah,0,0,0
2020-04-01,LBN,Sarawak,0,0,0
2020-04-01,LBN,Selangor,0,0,0
2020-04-01,LBN,W.P. Labuan,0,0,0
2020-04-01,LBR,Johor,0,0,0
2020-04-01,LBR,Kedah,0,0,0
2020-04-01,LBR,Sabah,0,0,0
2020-04-01,LBR,Sarawak,0,0,0
2020-04-01,LBR,Selangor,0,0,0
2020-04-01,LBY,Johor,0,0,0
2020-04-01,LBY,Kedah,0,0,0
2020-04-01,LBY,Perlis,0,0,0
2020-04-01,LBY,Pulau Pinang,0,0,0
2020-04-01,LBY,Sabah,0,0,0
2020-04-01,LBY,Sarawak,0,0,0
2020-04-01,LBY,Selangor,0,0,0
2020-04-01,LCA,Johor,0,0,0
2020-04-01,LCA,Kedah,0,0,0
2020-04-01,LCA,Pulau Pinang,0,0,0
2020-04-01,LCA,Sarawak,0,0,0
2020-04-01,LCA,Selangor,0,0,0
2020-04-01,LIE,Johor,0,0,0
2020-04-01,LIE,Kedah,0,0,0
2020-04-01,LIE,Perlis,0,0,0
2020-04-01,LIE,Pulau Pinang,0,0,0
2020-04-01,LIE,Sabah,0,0,0
2020-04-01,LIE,Sarawak,0,0,0
2020-04-01,LIE,Selangor,0,0,0
2020-04-01,LKA,Johor,1,1,0
2020-04-01,LKA,Kedah,0,0,0
2020-04-01,LKA,Kelantan,0,0,0
2020-04-01,LKA,Melaka,0,0,0
2020-04-01,LKA,Pahang,0,0,0
2020-04-01,LKA,Perak,0,0,0
2020-04-01,LKA,Perlis,0,0,0
2020-04-01,LKA,Pulau Pinang,0,0,0
2020-04-01,LKA,Sabah,0,0,0
2020-04-01,LKA,Sarawak,0,0,0
2020-04-01,LKA,Selangor,4,3,1
2020-04-01,LKA,W.P. Labuan,0,0,0
2020-04-01,LSO,Johor,0,0,0
2020-04-01,LSO,Kedah,0,0,0
2020-04-01,LSO,Pulau Pinang,0,0,0
2020-04-01,LSO,Sarawak,0,0,0
2020-04-01,LSO,Selangor,0,0,0
2020-04-01,LTU,Johor,0,0,0
2020-04-01,LTU,Kedah,0,0,0
2020-04-01,LTU,Kelantan,0,0,0
2020-04-01,LTU,Pahang,0,0,0
2020-04-01,LTU,Perak,0,0,0
2020-04-01,LTU,Perlis,0,0,0
2020-04-01,LTU,Pulau Pinang,0,0,0
2020-04-01,LTU,Sabah,0,0,0
2020-04-01,LTU,Sarawak,0,0,0
2020-04-01,LTU,Selangor,0,0,0
2020-04-01,LTU,W.P. Labuan,0,0,0
2020-04-01,LUX,Johor,0,0,0
2020-04-01,LUX,Kedah,0,0,0
2020-04-01,LUX,Kelantan,0,0,0
2020-04-01,LUX,Perak,0,0,0
2020-04-01,LUX,Perlis,0,0,0
2020-04-01,LUX,Pulau Pinang,0,0,0
2020-04-01,LUX,Sabah,0,0,0
2020-04-01,LUX,Sarawak,0,0,0
2020-04-01,LUX,Selangor,0,0,0
2020-04-01,LVA,Johor,0,0,0
2020-04-01,LVA,Kedah,0,0,0
2020-04-01,LVA,Kelantan,0,0,0
2020-04-01,LVA,Pahang,0,0,0
2020-04-01,LVA,Perak,0,0,0
2020-04-01,LVA,Perlis,0,0,0
2020-04-01,LVA,Pulau Pinang,0,0,0
2020-04-01,LVA,Sabah,0,0,0
2020-04-01,LVA,Sarawak,0,0,0
2020-04-01,LVA,Selangor,0,0,0
2020-04-01,LVA,W.P. Labuan,0,0,0
2020-04-01,MAC,Johor,0,0,0
2020-04-01,MAC,Pahang,0,0,0
2020-04-01,MAC,Perak,0,0,0
2020-04-01,MAC,Selangor,0,0,0
2020-04-01,MAC,W.P. Labuan,0,0,0
2020-04-01,MAR,Johor,0,0,0
2020-04-01,MAR,Kedah,0,0,0
2020-04-01,MAR,Kelantan,0,0,0
2020-04-01,MAR,Melaka,0,0,0
2020-04-01,MAR,Pahang,0,0,0
2020-04-01,MAR,Perak,0,0,0
2020-04-01,MAR,Perlis,0,0,0
2020-04-01,MAR,Pulau Pinang,0,0,0
2020-04-01,MAR,Sabah,0,0,0
2020-04-01,MAR,Sarawak,0,0,0
2020-04-01,MAR,Selangor,1,0,1
2020-04-01,MAR,W.P. Labuan,0,0,0
2020-04-01,MCO,Johor,0,0,0
2020-04-01,MCO,Kedah,0,0,0
2020-04-01,MCO,Sabah,0,0,0
2020-04-01,MCO,Selangor,0,0,0
2020-04-01,MDA,Johor,0,0,0
2020-04-01,MDA,Kedah,0,0,0
2020-04-01,MDA,Kelantan,0,0,0
2020-04-01,MDA,Negeri Sembilan,0,0,0
2020-04-01,MDA,Perlis,0,0,0
2020-04-01,MDA,Pulau Pinang,0,0,0
2020-04-01,MDA,Sabah,0,0,0
2020-04-01,MDA,Sarawak,0,0,0
2020-04-01,MDA,Selangor,0,0,0
2020-04-01,MDG,Johor,0,0,0
2020-04-01,MDG,Kedah,0,0,0
2020-04-01,MDG,Perak,0,0,0
2020-04-01,MDG,Perlis,0,0,0
2020-04-01,MDG,Pulau Pinang,0,0,0
2020-04-01,MDG,Sabah,0,0,0
2020-04-01,MDG,Sarawak,0,0,0
2020-04-01,MDG,Selangor,0,0,0
2020-04-01,MDV,Johor,0,0,0
2020-04-01,MDV,Kedah,0,0,0
2020-04-01,MDV,Kelantan,0,0,0
2020-04-01,MDV,Perak,0,0,0
2020-04-01,MDV,Perlis,0,0,0
2020-04-01,MDV,Pulau Pinang,0,0,0
2020-04-01,MDV,Sabah,0,0,0
2020-04-01,MDV,Sarawak,0,0,0
2020-04-01,MDV,Selangor,0,0,0
2020-04-01,MEX,Johor,0,0,0
2020-04-01,MEX,Kedah,0,0,0
2020-04-01,MEX,Kelantan,0,0,0
2020-04-01,MEX,Pahang,0,0,0
2020-04-01,MEX,Perak,0,0,0
2020-04-01,MEX,Perlis,0,0,0
2020-04-01,MEX,Pulau Pinang,0,0,0
2020-04-01,MEX,Sabah,0,0,0
2020-04-01,MEX,Sarawak,0,0,0
2020-04-01,MEX,Selangor,0,0,0
2020-04-01,MEX,W.P. Labuan,0,0,0
2020-04-01,MHL,Johor,0,0,0
2020-04-01,MHL,Kedah,0,0,0
2020-04-01,MHL,Perak,0,0,0
2020-04-01,MHL,Pulau Pinang,0,0,0
2020-04-01,MHL,Sabah,0,0,0
2020-04-01,MHL,Selangor,0,0,0
2020-04-01,MKD,Johor,0,0,0
2020-04-01,MKD,Kedah,0,0,0
2020-04-01,MKD,Perak,0,0,0
2020-04-01,MKD,Pulau Pinang,0,0,0
2020-04-01,MKD,Sabah,0,0,0
2020-04-01,MKD,Sarawak,0,0,0
2020-04-01,MKD,Selangor,0,0,0
2020-04-01,MLI,Johor,0,0,0
2020-04-01,MLI,Sabah,0,0,0
2020-04-01,MLI,Selangor,0,0,0
2020-04-01,MLT,Johor,0,0,0
2020-04-01,MLT,Kedah,0,0,0
2020-04-01,MLT,Kelantan,0,0,0
2020-04-01,MLT,Perak,0,0,0
2020-04-01,MLT,Perlis,0,0,0
2020-04-01,MLT,Pulau Pinang,0,0,0
2020-04-01,MLT,Sabah,0,0,0
2020-04-01,MLT,Sarawak,0,0,0
2020-04-01,MLT,Selangor,0,0,0
2020-04-01,MLT,W.P. Labuan,0,0,0
2020-04-01,MMR,Johor,10,10,0
2020-04-01,MMR,Kedah,0,0,0
2020-04-01,MMR,Kelantan,0,0,0
2020-04-01,MMR,Negeri Sembilan,0,0,0
2020-04-01,MMR,Pahang,0,0,0
2020-04-01,MMR,Perak,0,0,0
2020-04-01,MMR,Perlis,0,0,0
2020-04-01,MMR,Pulau Pinang,0,0,0
2020-04-01,MMR,Sabah,0,0,0
2020-04-01,MMR,Sarawak,0,0,0
2020-04-01,MMR,Selangor,6,1,5
2020-04-01,MMR,Terengganu,0,0,0
2020-04-01,MMR,W.P. Labuan,0,0,0
2020-04-01,MNE,Johor,0,0,0
2020-04-01,MNE,Kedah,0,0,0
2020-04-01,MNE,Pulau Pinang,0,0,0
2020-04-01,MNE,Sabah,0,0,0
2020-04-01,MNE,Sarawak,0,0,0
2020-04-01,MNE,Selangor,0,0,0
2020-04-01,MNG,Johor,0,0,0
2020-04-01,MNG,Kedah,0,0,0
2020-04-01,MNG,Kelantan,0,0,0
2020-04-01,MNG,Perak,0,0,0
2020-04-01,MNG,Perlis,0,0,0
2020-04-01,MNG,Pulau Pinang,0,0,0
2020-04-01,MNG,Sabah,0,0,0
2020-04-01,MNG,Sarawak,0,0,0
2020-04-01,MNG,Selangor,0,0,0
2020-04-01,MNP,Selangor,0,0,0
2020-04-01,MOZ,Johor,0,0,0
2020-04-01,MOZ,Kedah,0,0,0
2020-04-01,MOZ,Perak,0,0,0
2020-04-01,MOZ,Pulau Pinang,0,0,0
2020-04-01,MOZ,Sabah,0,0,0
2020-04-01,MOZ,Sarawak,0,0,0
2020-04-01,MOZ,Selangor,0,0,0
2020-04-01,MRT,Johor,0,0,0
2020-04-01,MRT,Kedah,0,0,0
2020-04-01,MRT,Pulau Pinang,0,0,0
2020-04-01,MRT,Sabah,0,0,0
2020-04-01,MRT,Sarawak,0,0,0
2020-04-01,MRT,Selangor,1,1,0
2020-04-01,MUS,Johor,0,0,0
2020-04-01,MUS,Kedah,0,0,0
2020-04-01,MUS,Kelantan,0,0,0
2020-04-01,MUS,Pahang,0,0,0
2020-04-01,MUS,Perak,0,0,0
2020-04-01,MUS,Perlis,0,0,0
2020-04-01,MUS,Pulau Pinang,0,0,0
2020-04-01,MUS,Sabah,0,0,0
2020-04-01,MUS,Sarawak,0,0,0
2020-04-01,MUS,Selangor,0,0,0
2020-04-01,MWI,Johor,0,0,0
2020-04-01,MWI,Pulau Pinang,0,0,0
2020-04-01,MWI,Sabah,0,0,0
2020-04-01,MWI,Sarawak,0,0,0
2020-04-01,MWI,Selangor,0,0,0
2020-04-01,MYT,Selangor,0,0,0
2020-04-01,NAM,Johor,0,0,0
2020-04-01,NAM,Kedah,0,0,0
2020-04-01,NAM,Perak,0,0,0
2020-04-01,NAM,Perlis,0,0,0
2020-04-01,NAM,Pulau Pinang,0,0,0
2020-04-01,NAM,Sabah,0,0,0
2020-04-01,NAM,Sarawak,0,0,0
2020-04-01,NAM,Selangor,0,0,0
2020-04-01,NCL,Selangor,0,0,0
2020-04-01,NER,Johor,0,0,0
2020-04-01,NER,Sabah,0,0,0
2020-04-01,NER,Selangor,0,0,0
2020-04-01,NGA,Johor,0,0,0
2020-04-01,NGA,Kedah,0,0,0
2020-04-01,NGA,Perlis,0,0,0
2020-04-01,NGA,Pulau Pinang,0,0,0
2020-04-01,NGA,Sabah,0,0,0
2020-04-01,NGA,Sarawak,0,0,0
2020-04-01,NGA,Selangor,2,2,0
2020-04-01,NIC,Johor,0,0,0
2020-04-01,NIC,Kedah,0,0,0
2020-04-01,NIC,Pulau Pinang,0,0,0
2020-04-01,NIC,Sabah,0,0,0
2020-04-01,NIC,Selangor,0,0,0
2020-04-01,NLD,Johor,0,0,0
2020-04-01,NLD,Kedah,0,0,0
2020-04-01,NLD,Kelantan,0,0,0
2020-04-01,NLD,Melaka,0,0,0
2020-04-01,NLD,Negeri Sembilan,0,0,0
2020-04-01,NLD,Pahang,0,0,0
2020-04-01,NLD,Perak,0,0,0
2020-04-01,NLD,Perlis,0,0,0
2020-04-01,NLD,Pulau Pinang,1,1,0
2020-04-01,NLD,Sabah,0,0,0
2020-04-01,NLD,Sarawak,0,0,0
2020-04-01,NLD,Selangor,31,14,17
2020-04-01,NLD,Terengganu,0,0,0
2020-04-01,NLD,W.P. Labuan,0,0,0
2020-04-01,NOR,Johor,0,0,0
2020-04-01,NOR,Kedah,0,0,0
2020-04-01,NOR,Kelantan,0,0,0
2020-04-01,NOR,Melaka,0,0,0
2020-04-01,NOR,Pahang,0,0,0
2020-04-01,NOR,Perak,0,0,0
2020-04-01,NOR,Perlis,0,0,0
2020-04-01,NOR,Pulau Pinang,0,0,0
2020-04-01,NOR,Sabah,0,0,0
2020-04-01,NOR,Sarawak,0,0,0
2020-04-01,NOR,Selangor,0,0,0
2020-04-01,NOR,W.P. Labuan,0,0,0
2020-04-01,NPL,Johor,0,0,0
2020-04-01,NPL,Kedah,0,0,0
2020-04-01,NPL,Pahang,0,0,0
2020-04-01,NPL,Perak,0,0,0
2020-04-01,NPL,Perlis,0,0,0
2020-04-01,NPL,Pulau Pinang,0,0,0
2020-04-01,NPL,Sabah,0,0,0
2020-04-01,NPL,Sarawak,0,0,0
2020-04-01,NPL,Selangor,0,0,0
2020-04-01,NPL,W.P. Labuan,0,0,0
2020-04-01,NRU,Johor,0,0,0
2020-04-01,NRU,Pulau Pinang,0,0,0
2020-04-01,NRU,Selangor,0,0,0
2020-04-01,NZL,Johor,0,0,0
2020-04-01,NZL,Kedah,0,0,0
2020-04-01,NZL,Kelantan,0,0,0
2020-04-01,NZL,Melaka,0,0,0
2020-04-01,NZL,Negeri Sembilan,0,0,0
2020-04-01,NZL,Pahang,0,0,0
2020-04-01,NZL,Perak,0,0,0
2020-04-01,NZL,Perlis,0,0,0
2020-04-01,NZL,Pulau Pinang,0,0,0
2020-04-01,NZL,Sabah,0,0,0
2020-04-01,NZL,Sarawak,0,0,0
2020-04-01,NZL,Selangor,2,1,1
2020-04-01,NZL,Terengganu,0,0,0
2020-04-01,NZL,W.P. Labuan,0,0,0
2020-04-01,OMN,Johor,0,0,0
2020-04-01,OMN,Kedah,0,0,0
2020-04-01,OMN,Kelantan,0,0,0
2020-04-01,OMN,Melaka,0,0,0
2020-04-01,OMN,Perak,0,0,0
2020-04-01,OMN,Perlis,0,0,0
2020-04-01,OMN,Pulau Pinang,0,0,0
2020-04-01,OMN,Sabah,0,0,0
2020-04-01,OMN,Sarawak,0,0,0
2020-04-01,OMN,Selangor,0,0,0
2020-04-01,PAK,Johor,0,0,0
2020-04-01,PAK,Kedah,0,0,0
2020-04-01,PAK,Kelantan,0,0,0
2020-04-01,PAK,Melaka,0,0,0
2020-04-01,PAK,Negeri Sembilan,0,0,0
2020-04-01,PAK,Pahang,0,0,0
2020-04-01,PAK,Perak,0,0,0
2020-04-01,PAK,Perlis,0,0,0
2020-04-01,PAK,Pulau Pinang,0,0,0
2020-04-01,PAK,Sabah,0,0,0
2020-04-01,PAK,Sarawak,0,0,0
2020-04-01,PAK,Selangor,31,29,2
2020-04-01,PAK,W.P. Labuan,0,0,0
2020-04-01,PAN,Johor,0,0,0
2020-04-01,PAN,Kedah,0,0,0
2020-04-01,PAN,Perak,0,0,0
2020-04-01,PAN,Perlis,0,0,0
2020-04-01,PAN,Pulau Pinang,0,0,0
2020-04-01,PAN,Sabah,0,0,0
2020-04-01,PAN,Sarawak,0,0,0
2020-04-01,PAN,Selangor,0,0,0
2020-04-01,PER,Johor,0,0,0
2020-04-01,PER,Kedah,0,0,0
2020-04-01,PER,Kelantan,0,0,0
2020-04-01,PER,Pahang,0,0,0
2020-04-01,PER,Perak,0,0,0
2020-04-01,PER,Perlis,0,0,0
2020-04-01,PER,Pulau Pinang,0,0,0
2020-04-01,PER,Sabah,0,0,0
2020-04-01,PER,Sarawak,0,0,0
2020-04-01,PER,Selangor,0,0,0
2020-04-01,PER,W.P. Labuan,0,0,0
2020-04-01,PHL,Johor,3,2,1
2020-04-01,PHL,Kedah,0,0,0
2020-04-01,PHL,Kelantan,0,0,0
2020-04-01,PHL,Melaka,0,0,0
2020-04-01,PHL,Negeri Sembilan,0,0,0
2020-04-01,PHL,Pahang,0,0,0
2020-04-01,PHL,Perak,0,0,0
2020-04-01,PHL,Perlis,0,0,0
2020-04-01,PHL,Pulau Pinang,0,0,0
2020-04-01,PHL,Sabah,0,0,0
2020-04-01,PHL,Sarawak,9,9,0
2020-04-01,PHL,Selangor,4,1,3
2020-04-01,PHL,Terengganu,0,0,0
2020-04-01,PHL,W.P. Labuan,0,0,0
2020-04-01,PLW,Johor,0,0,0
2020-04-01,PLW,Pulau Pinang,0,0,0
2020-04-01,PLW,Selangor,0,0,0
2020-04-01,PNG,Johor,0,0,0
2020-04-01,PNG,Kedah,0,0,0
2020-04-01,PNG,Kelantan,0,0,0
2020-04-01,PNG,Perak,0,0,0
2020-04-01,PNG,Pulau Pinang,0,0,0
2020-04-01,PNG,Sabah,0,0,0
2020-04-01,PNG,Sarawak,0,0,0
2020-04-01,PNG,Selangor,0,0,0
2020-04-01,POL,Johor,0,0,0
2020-04-01,POL,Kedah,0,0,0
2020-04-01,POL,Kelantan,0,0,0
2020-04-01,POL,Melaka,0,0,0
2020-04-01,POL,Negeri Sembilan,0,0,0
2020-04-01,POL,Pahang,0,0,0
2020-04-01,POL,Perak,0,0,0
2020-04-01,POL,Perlis,0,0,0
2020-04-01,POL,Pulau Pinang,0,0,0
2020-04-01,POL,Sabah,0,0,0
2020-04-01,POL,Sarawak,0,0,0
2020-04-01,POL,Selangor,0,0,0
2020-04-01,POL,Terengganu,0,0,0
2020-04-01,POL,W.P. Labuan,0,0,0
2020-04-01,PRK,Selangor,0,0,0
2020-04-01,PRT,Johor,0,0,0
2020-04-01,PRT,Kedah,0,0,0
2020-04-01,PRT,Kelantan,0,0,0
2020-04-01,PRT,Melaka,0,0,0
2020-04-01,PRT,Pahang,0,0,0
2020-04-01,PRT,Perak,0,0,0
2020-04-01,PRT,Perlis,0,0,0
2020-04-01,PRT,Pulau Pinang,0,0,0
2020-04-01,PRT,Sabah,0,0,0
2020-04-01,PRT,Sarawak,0,0,0
2020-04-01,PRT,Selangor,0,0,0
2020-04-01,PRT,W.P. Labuan,0,0,0
2020-04-01,PRY,Johor,0,0,0
2020-04-01,PRY,Kedah,0,0,0
2020-04-01,PRY,Perak,0,0,0
2020-04-01,PRY,Perlis,0,0,0
2020-04-01,PRY,Pulau Pinang,0,0,0
2020-04-01,PRY,Sabah,0,0,0
2020-04-01,PRY,Sarawak,0,0,0
2020-04-01,PRY,Selangor,0,0,0
2020-04-01,PSE,Johor,0,0,0
2020-04-01,PSE,Kedah,0,0,0
2020-04-01,PSE,Kelantan,0,0,0
2020-04-01,PSE,Melaka,0,0,0
2020-04-01,PSE,Perak,0,0,0
2020-04-01,PSE,Perlis,0,0,0
2020-04-01,PSE,Pulau Pinang,0,0,0
2020-04-01,PSE,Sabah,0,0,0
2020-04-01,PSE,Sarawak,0,0,0
2020-04-01,PSE,Selangor,0,0,0
2020-04-01,QAT,Johor,0,0,0
2020-04-01,QAT,Kedah,0,0,0
2020-04-01,QAT,Perlis,0,0,0
2020-04-01,QAT,Pulau Pinang,0,0,0
2020-04-01,QAT,Sabah,0,0,0
2020-04-01,QAT,Sarawak,0,0,0
2020-04-01,QAT,Selangor,0,0,0
2020-04-01,REU,Johor,0,0,0
2020-04-01,REU,Sarawak,0,0,0
2020-04-01,ROU,Johor,0,0,0
2020-04-01,ROU,Kedah,0,0,0
2020-04-01,ROU,Kelantan,0,0,0
2020-04-01,ROU,Negeri Sembilan,0,0,0
2020-04-01,ROU,Pahang,0,0,0
2020-04-01,ROU,Perak,0,0,0
2020-04-01,ROU,Perlis,0,0,0
2020-04-01,ROU,Pulau Pinang,0,0,0
2020-04-01,ROU,Sabah,0,0,0
2020-04-01,ROU,Sarawak,0,0,0
2020-04-01,ROU,Selangor,3,1,2
2020-04-01,ROU,W.P. Labuan,0,0,0
2020-04-01,RUS,Johor,1,1,0
2020-04-01,RUS,Kedah,0,0,0
2020-04-01,RUS,Kelantan,0,0,0
2020-04-01,RUS,Melaka,0,0,0
2020-04-01,RUS,Negeri Sembilan,0,0,0
2020-04-01,RUS,Pahang,0,0,0
2020-04-01,RUS,Perak,0,0,0
2020-04-01,RUS,Perlis,0,0,0
2020-04-01,RUS,Pulau Pinang,0,0,0
2020-04-01,RUS,Sabah,0,0,0
2020-04-01,RUS,Sarawak,0,0,0
2020-04-01,RUS,Selangor,1,0,1
2020-04-01,RUS,W.P. Labuan,0,0,0
2020-04-01,RWA,Johor,0,0,0
2020-04-01,RWA,Kedah,0,0,0
2020-04-01,RWA,Pulau Pinang,0,0,0
2020-04-01,RWA,Selangor,0,0,0
2020-04-01,SAU,Johor,0,0,0
2020-04-01,SAU,Kedah,0,0,0
2020-04-01,SAU,Kelantan,0,0,0
2020-04-01,SAU,Melaka,0,0,0
2020-04-01,SAU,Perak,0,0,0
2020-04-01,SAU,Perlis,0,0,0
2020-04-01,SAU,Pulau Pinang,0,0,0
2020-04-01,SAU,Sabah,0,0,0
2020-04-01,SAU,Sarawak,0,0,0
2020-04-01,SAU,Selangor,0,0,0
2020-04-01,SAU,W.P. Labuan,0,0,0
2020-04-01,SDN,Johor,0,0,0
2020-04-01,SDN,Kedah,0,0,0
2020-04-01,SDN,Kelantan,0,0,0
2020-04-01,SDN,Perlis,0,0,0
2020-04-01,SDN,Pulau Pinang,0,0,0
2020-04-01,SDN,Sabah,0,0,0
2020-04-01,SDN,Sarawak,0,0,0
2020-04-01,SDN,Selangor,0,0,0
2020-04-01,SDN,W.P. Labuan,0,0,0
2020-04-01,SEN,Johor,0,0,0
2020-04-01,SEN,Kedah,0,0,0
2020-04-01,SEN,Kelantan,0,0,0
2020-04-01,SEN,Perak,0,0,0
2020-04-01,SEN,Perlis,0,0,0
2020-04-01,SEN,Pulau Pinang,0,0,0
2020-04-01,SEN,Sabah,0,0,0
2020-04-01,SEN,Sarawak,0,0,0
2020-04-01,SEN,Selangor,0,0,0
2020-04-01,SGP,Johor,81,67,14
2020-04-01,SGP,Kedah,1,1,0
2020-04-01,SGP,Kelantan,0,0,0
2020-04-01,SGP,Melaka,0,0,0
2020-04-01,SGP,Negeri Sembilan,0,0,0
2020-04-01,SGP,Pahang,0,0,0
2020-04-01,SGP,Perak,0,0,0
2020-04-01,SGP,Perlis,0,0,0
2020-04-01,SGP,Pulau Pinang,0,0,0
2020-04-01,SGP,Sabah,0,0,0
2020-04-01,SGP,Sarawak,0,0,0
2020-04-01,SGP,Selangor,15,7,8
2020-04-01,SGP,Terengganu,0,0,0
2020-04-01,SGP,W.P. Labuan,0,0,0
2020-04-01,SGS,Johor,0,0,0
2020-04-01,SGS,Sabah,0,0,0
2020-04-01,SGS,Selangor,0,0,0
2020-04-01,SHN,Sarawak,0,0,0
2020-04-01,SLB,Johor,0,0,0
2020-04-01,SLB,Perlis,0,0,0
2020-04-01,SLB,Pulau Pinang,0,0,0
2020-04-01,SLB,Sabah,0,0,0
2020-04-01,SLB,Sarawak,0,0,0
2020-04-01,SLB,Selangor,0,0,0
2020-04-01,SLB,W.P. Labuan,0,0,0
2020-04-01,SLE,Johor,0,0,0
2020-04-01,SLE,Kedah,0,0,0
2020-04-01,SLE,Perak,0,0,0
2020-04-01,SLE,Pulau Pinang,0,0,0
2020-04-01,SLE,Sabah,0,0,0
2020-04-01,SLE,Selangor,0,0,0
2020-04-01,SLV,Johor,0,0,0
2020-04-01,SLV,Kedah,0,0,0
2020-04-01,SLV,Perak,0,0,0
2020-04-01,SLV,Perlis,0,0,0
2020-04-01,SLV,Pulau Pinang,0,0,0
2020-04-01,SLV,Sabah,0,0,0
2020-04-01,SLV,Selangor,0,0,0
2020-04-01,SLV,W.P. Labuan,0,0,0
2020-04-01,SMR,Johor,0,0,0
2020-04-01,SMR,Selangor,0,0,0
2020-04-01,SOM,Johor,0,0,0
2020-04-01,SOM,Kedah,0,0,0
2020-04-01,SOM,Kelantan,0,0,0
2020-04-01,SOM,Perlis,0,0,0
2020-04-01,SOM,Sabah,0,0,0
2020-04-01,SOM,Sarawak,0,0,0
2020-04-01,SOM,Selangor,0,0,0
2020-04-01,SRB,Johor,0,0,0
2020-04-01,SRB,Kedah,0,0,0
2020-04-01,SRB,Kelantan,0,0,0
2020-04-01,SRB,Pahang,0,0,0
2020-04-01,SRB,Perak,0,0,0
2020-04-01,SRB,Perlis,0,0,0
2020-04-01,SRB,Pulau Pinang,0,0,0
2020-04-01,SRB,Sabah,0,0,0
2020-04-01,SRB,Sarawak,0,0,0
2020-04-01,SRB,Selangor,0,0,0
2020-04-01,SSD,Johor,0,0,0
2020-04-01,SSD,Kedah,0,0,0
2020-04-01,SSD,Sarawak,0,0,0
2020-04-01,SSD,Selangor,0,0,0
2020-04-01,SSD,W.P. Labuan,0,0,0
2020-04-01,STP,Selangor,0,0,0
2020-04-01,SUR,Johor,0,0,0
2020-04-01,SUR,Kedah,0,0,0
2020-04-01,SUR,Kelantan,0,0,0
2020-04-01,SUR,Perak,0,0,0
2020-04-01,SUR,Perlis,0,0,0
2020-04-01,SUR,Pulau Pinang,0,0,0
2020-04-01,SUR,Sabah,0,0,0
2020-04-01,SUR,Sarawak,0,0,0
2020-04-01,SUR,Selangor,0,0,0
2020-04-01,SVK,Johor,0,0,0
2020-04-01,SVK,Kedah,0,0,0
2020-04-01,SVK,Kelantan,0,0,0
2020-04-01,SVK,Negeri Sembilan,0,0,0
2020-04-01,SVK,Pahang,0,0,0
2020-04-01,SVK,Perak,0,0,0
2020-04-01,SVK,Perlis,0,0,0
2020-04-01,SVK,Pulau Pinang,0,0,0
2020-04-01,SVK,Sabah,0,0,0
2020-04-01,SVK,Sarawak,0,0,0
2020-04-01,SVK,Selangor,0,0,0
2020-04-01,SVK,W.P. Labuan,0,0,0
2020-04-01,SVN,Johor,0,0,0
2020-04-01,SVN,Kedah,0,0,0
2020-04-01,SVN,Kelantan,0,0,0
2020-04-01,SVN,Perak,0,0,0
2020-04-01,SVN,Perlis,0,0,0
2020-04-01,SVN,Pulau Pinang,0,0,0
2020-04-01,SVN,Sabah,0,0,0
2020-04-01,SVN,Sarawak,0,0,0
2020-04-01,SVN,Selangor,0,0,0
2020-04-01,SVN,W.P. Labuan,0,0,0
2020-04-01,SWE,Johor,0,0,0
2020-04-01,SWE,Kedah,0,0,0
2020-04-01,SWE,Kelantan,0,0,0
2020-04-01,SWE,Melaka,0,0,0
2020-04-01,SWE,Negeri Sembilan,0,0,0
2020-04-01,SWE,Pahang,0,0,0
2020-04-01,SWE,Perak,0,0,0
2020-04-01,SWE,Perlis,0,0,0
2020-04-01,SWE,Pulau Pinang,2,2,0
2020-04-01,SWE,Sabah,0,0,0
2020-04-01,SWE,Sarawak,0,0,0
2020-04-01,SWE,Selangor,1,1,0
2020-04-01,SWE,W.P. Labuan,0,0,0
2020-04-01,SWZ,Johor,0,0,0
2020-04-01,SWZ,Kedah,0,0,0
2020-04-01,SWZ,Pulau Pinang,0,0,0
2020-04-01,SWZ,Sabah,0,0,0
2020-04-01,SWZ,Selangor,0,0,0
2020-04-01,SYC,Johor,0,0,0
2020-04-01,SYC,Kedah,0,0,0
2020-04-01,SYC,Pulau Pinang,0,0,0
2020-04-01,SYC,Sabah,0,0,0
2020-04-01,SYC,Sarawak,0,0,0
2020-04-01,SYC,Selangor,0,0,0
2020-04-01,SYR,Johor,0,0,0
2020-04-01,SYR,Kedah,0,0,0
2020-04-01,SYR,Kelantan,0,0,0
2020-04-01,SYR,Pahang,0,0,0
2020-04-01,SYR,Perlis,0,0,0
2020-04-01,SYR,Pulau Pinang,0,0,0
2020-04-01,SYR,Sabah,0,0,0
2020-04-01,SYR,Sarawak,0,0,0
2020-04-01,SYR,Selangor,0,0,0
2020-04-01,SYR,W.P. Labuan,0,0,0
2020-04-01,TCA,Perlis,0,0,0
2020-04-01,TCD,Johor,0,0,0
2020-04-01,TCD,Kedah,0,0,0
2020-04-01,TCD,Perlis,0,0,0
2020-04-01,TCD,Selangor,1,1,0
2020-04-01,TGO,Johor,0,0,0
2020-04-01,TGO,Perak,0,0,0
2020-04-01,TGO,Pulau Pinang,0,0,0
2020-04-01,TGO,Selangor,0,0,0
2020-04-01,THA,Johor,85,84,1
2020-04-01,THA,Kedah,13817,13143,674
2020-04-01,THA,Kelantan,20,4,16
2020-04-01,THA,Melaka,0,0,0
2020-04-01,THA,Negeri Sembilan,0,0,0
2020-04-01,THA,Pahang,0,0,0
2020-04-01,THA,Perak,2,0,2
2020-04-01,THA,Perlis,2,0,2
2020-04-01,THA,Pulau Pinang,0,0,0
2020-04-01,THA,Sabah,0,0,0
2020-04-01,THA,Sarawak,8,8,0
2020-04-01,THA,Selangor,16,4,12
2020-04-01,THA,Terengganu,0,0,0
2020-04-01,THA,W.P. Labuan,0,0,0
2020-04-01,TJK,Johor,0,0,0
2020-04-01,TJK,Kedah,0,0,0
2020-04-01,TJK,Perlis,0,0,0
2020-04-01,TJK,Pulau Pinang,0,0,0
2020-04-01,TJK,Sabah,0,0,0
2020-04-01,TJK,Selangor,0,0,0
2020-04-01,TKL,Selangor,0,0,0
2020-04-01,TKM,Johor,0,0,0
2020-04-01,TKM,Kedah,0,0,0
2020-04-01,TKM,Kelantan,0,0,0
2020-04-01,TKM,Perlis,0,0,0
2020-04-01,TKM,Pulau Pinang,0,0,0
2020-04-01,TKM,Sabah,0,0,0
2020-04-01,TKM,Sarawak,0,0,0
2020-04-01,TKM,Selangor,0,0,0
2020-04-01,TLS,Johor,0,0,0
2020-04-01,TLS,Kedah,0,0,0
2020-04-01,TLS,Perlis,0,0,0
2020-04-01,TLS,Pulau Pinang,0,0,0
2020-04-01,TLS,Sabah,0,0,0
2020-04-01,TLS,Sarawak,0,0,0
2020-04-01,TLS,Selangor,0,0,0
2020-04-01,TON,Johor,0,0,0
2020-04-01,TON,Pulau Pinang,0,0,0
2020-04-01,TON,Sarawak,0,0,0
2020-04-01,TON,Selangor,0,0,0
2020-04-01,TTO,Johor,0,0,0
2020-04-01,TTO,Kedah,0,0,0
2020-04-01,TTO,Pahang,0,0,0
2020-04-01,TTO,Pulau Pinang,0,0,0
2020-04-01,TTO,Sabah,0,0,0
2020-04-01,TTO,Sarawak,0,0,0
2020-04-01,TTO,Selangor,0,0,0
2020-04-01,TUN,Johor,0,0,0
2020-04-01,TUN,Kedah,0,0,0
2020-04-01,TUN,Kelantan,0,0,0
2020-04-01,TUN,Melaka,0,0,0
2020-04-01,TUN,Perak,0,0,0
2020-04-01,TUN,Perlis,0,0,0
2020-04-01,TUN,Pulau Pinang,0,0,0
2020-04-01,TUN,Sabah,0,0,0
2020-04-01,TUN,Sarawak,0,0,0
2020-04-01,TUN,Selangor,0,0,0
2020-04-01,TUN,W.P. Labuan,0,0,0
2020-04-01,TUR,Johor,0,0,0
2020-04-01,TUR,Kedah,0,0,0
2020-04-01,TUR,Kelantan,0,0,0
2020-04-01,TUR,Melaka,0,0,0
2020-04-01,TUR,Negeri Sembilan,0,0,0
2020-04-01,TUR,Pahang,0,0,0
2020-04-01,TUR,Perak,0,0,0
2020-04-01,TUR,Perlis,0,0,0
2020-04-01,TUR,Pulau Pinang,0,0,0
2020-04-01,TUR,Sabah,0,0,0
2020-04-01,TUR,Sarawak,0,0,0
2020-04-01,TUR,Selangor,1,1,0
2020-04-01,TUR,W.P. Labuan,0,0,0
2020-04-01,TUV,Selangor,0,0,0
2020-04-01,TWN,Johor,0,0,0
2020-04-01,TWN,Kedah,0,0,0
2020-04-01,TWN,Kelantan,0,0,0
2020-04-01,TWN,Melaka,0,0,0
2020-04-01,TWN,Negeri Sembilan,0,0,0
2020-04-01,TWN,Pahang,0,0,0
2020-04-01,TWN,Perak,0,0,0
2020-04-01,TWN,Perlis,0,0,0
2020-04-01,TWN,Pulau Pinang,0,0,0
2020-04-01,TWN,Sabah,0,0,0
2020-04-01,TWN,Sarawak,0,0,0
2020-04-01,TWN,Selangor,3,3,0
2020-04-01,TWN,W.P. Labuan,0,0,0
2020-04-01,TZA,Johor,0,0,0
2020-04-01,TZA,Kedah,0,0,0
2020-04-01,TZA,Perak,0,0,0
2020-04-01,TZA,Perlis,0,0,0
2020-04-01,TZA,Pulau Pinang,0,0,0
2020-04-01,TZA,Sabah,0,0,0
2020-04-01,TZA,Sarawak,0,0,0
2020-04-01,TZA,Selangor,0,0,0
2020-04-01,UGA,Johor,0,0,0
2020-04-01,UGA,Kedah,0,0,0
2020-04-01,UGA,Perak,0,0,0
2020-04-01,UGA,Perlis,0,0,0
2020-04-01,UGA,Pulau Pinang,0,0,0
2020-04-01,UGA,Sabah,0,0,0
2020-04-01,UGA,Sarawak,0,0,0
2020-04-01,UGA,Selangor,0,0,0
2020-04-01,UKR,Johor,0,0,0
2020-04-01,UKR,Kedah,0,0,0
2020-04-01,UKR,Kelantan,0,0,0
2020-04-01,UKR,Melaka,0,0,0
2020-04-01,UKR,Negeri Sembilan,0,0,0
2020-04-01,UKR,Pahang,0,0,0
2020-04-01,UKR,Perak,0,0,0
2020-04-01,UKR,Perlis,0,0,0
2020-04-01,UKR,Pulau Pinang,0,0,0
2020-04-01,UKR,Sabah,0,0,0
2020-04-01,UKR,Sarawak,0,0,0
2020-04-01,UKR,Selangor,0,0,0
2020-04-01,UKR,W.P. Labuan,0,0,0
2020-04-01,URY,Johor,0,0,0
2020-04-01,URY,Kedah,0,0,0
2020-04-01,URY,Kelantan,0,0,0
2020-04-01,URY,Perak,0,0,0
2020-04-01,URY,Perlis,0,0,0
2020-04-01,URY,Pulau Pinang,0,0,0
2020-04-01,URY,Sabah,0,0,0
2020-04-01,URY,Sarawak,0,0,0
2020-04-01,URY,Selangor,0,0,0
2020-04-01,URY,W.P. Labuan,0,0,0
2020-04-01,USA,Johor,0,0,0
2020-04-01,USA,Kedah,0,0,0
2020-04-01,USA,Kelantan,0,0,0
2020-04-01,USA,Melaka,0,0,0
2020-04-01,USA,Negeri Sembilan,0,0,0
2020-04-01,USA,Pahang,0,0,0
2020-04-01,USA,Perak,0,0,0
2020-04-01,USA,Perlis,0,0,0
2020-04-01,USA,Pulau Pinang,5,4,1
2020-04-01,USA,Sabah,0,0,0
2020-04-01,USA,Sarawak,0,0,0
2020-04-01,USA,Selangor,11,9,2
2020-04-01,USA,Terengganu,0,0,0
2020-04-01,USA,W.P. Labuan,0,0,0
2020-04-01,UZB,Johor,0,0,0
2020-04-01,UZB,Kedah,0,0,0
2020-04-01,UZB,Kelantan,0,0,0
2020-04-01,UZB,Perak,0,0,0
2020-04-01,UZB,Perlis,0,0,0
2020-04-01,UZB,Pulau Pinang,0,0,0
2020-04-01,UZB,Sabah,0,0,0
2020-04-01,UZB,Sarawak,0,0,0
2020-04-01,UZB,Selangor,0,0,0
2020-04-01,VAT,Johor,0,0,0
2020-04-01,VAT,Sarawak,0,0,0
2020-04-01,VAT,Selangor,0,0,0
2020-04-01,VCT,Johor,0,0,0
2020-04-01,VCT,Kedah,0,0,0
2020-04-01,VCT,Pulau Pinang,0,0,0
2020-04-01,VCT,Sarawak,0,0,0
2020-04-01,VCT,Selangor,0,0,0
2020-04-01,VEN,Johor,0,0,0
2020-04-01,VEN,Kedah,0,0,0
2020-04-01,VEN,Kelantan,0,0,0
2020-04-01,VEN,Melaka,0,0,0
2020-04-01,VEN,Perak,0,0,0
2020-04-01,VEN,Perlis,0,0,0
2020-04-01,VEN,Pulau Pinang,0,0,0
2020-04-01,VEN,Sabah,0,0,0
2020-04-01,VEN,Sarawak,0,0,0
2020-04-01,VEN,Selangor,0,0,0
2020-04-01,VEN,W.P. Labuan,0,0,0
2020-04-01,VNM,Johor,2,0,2
2020-04-01,VNM,Kedah,0,0,0
2020-04-01,VNM,Kelantan,0,0,0
2020-04-01,VNM,Melaka,0,0,0
2020-04-01,VNM,Negeri Sembilan,0,0,0
2020-04-01,VNM,Pahang,0,0,0
2020-04-01,VNM,Perak,0,0,0
2020-04-01,VNM,Perlis,0,0,0
2020-04-01,VNM,Pulau Pinang,0,0,0
2020-04-01,VNM,Sabah,0,0,0
2020-04-01,VNM,Sarawak,0,0,0
2020-04-01,VNM,Selangor,14,4,10
2020-04-01,VNM,Terengganu,0,0,0
2020-04-01,VNM,W.P. Labuan,0,0,0
2020-04-01,VUT,Johor,0,0,0
2020-04-01,VUT,Kedah,0,0,0
2020-04-01,VUT,Pulau Pinang,0,0,0
2020-04-01,VUT,Sabah,0,0,0
2020-04-01,VUT,Sarawak,0,0,0
2020-04-01,VUT,Selangor,0,0,0
2020-04-01,WSM,Johor,0,0,0
2020-04-01,WSM,Sarawak,0,0,0
2020-04-01,WSM,Selangor,0,0,0
2020-04-01,XXX,Johor,0,0,0
2020-04-01,XXX,Kedah,0,0,0
2020-04-01,XXX,Kelantan,0,0,0
2020-04-01,XXX,Melaka,0,0,0
2020-04-01,XXX,Pahang,0,0,0
2020-04-01,XXX,Perak,0,0,0
2020-04-01,XXX,Perlis,0,0,0
2020-04-01,XXX,Pulau Pinang,0,0,0
2020-04-01,XXX,Sabah,0,0,0
2020-04-01,XXX,Sarawak,0,0,0
2020-04-01,XXX,Selangor,0,0,0
2020-04-01,XXX,W.P. Labuan,0,0,0
2020-04-01,YEM,Johor,0,0,0
2020-04-01,YEM,Kedah,0,0,0
2020-04-01,YEM,Kelantan,0,0,0
2020-04-01,YEM,Melaka,0,0,0
2020-04-01,YEM,Pahang,0,0,0
2020-04-01,YEM,Perak,0,0,0
2020-04-01,YEM,Perlis,0,0,0
2020-04-01,YEM,Pulau Pinang,0,0,0
2020-04-01,YEM,Sabah,0,0,0
2020-04-01,YEM,Sarawak,0,0,0
2020-04-01,YEM,Selangor,0,0,0
2020-04-01,YEM,W.P. Labuan,0,0,0
2020-04-01,ZAF,Johor,0,0,0
2020-04-01,ZAF,Kedah,0,0,0
2020-04-01,ZAF,Kelantan,0,0,0
2020-04-01,ZAF,Melaka,0,0,0
2020-04-01,ZAF,Pahang,0,0,0
2020-04-01,ZAF,Perak,0,0,0
2020-04-01,ZAF,Perlis,0,0,0
2020-04-01,ZAF,Pulau Pinang,0,0,0
2020-04-01,ZAF,Sabah,0,0,0
2020-04-01,ZAF,Sarawak,0,0,0
2020-04-01,ZAF,Selangor,0,0,0
2020-04-01,ZAF,Terengganu,0,0,0
2020-04-01,ZAF,W.P. Labuan,0,0,0
2020-04-01,ZAR,Selangor,0,0,0
2020-04-01,ZMB,Johor,0,0,0
2020-04-01,ZMB,Kedah,0,0,0
2020-04-01,ZMB,Perak,0,0,0
2020-04-01,ZMB,Perlis,0,0,0
2020-04-01,ZMB,Pulau Pinang,0,0,0
2020-04-01,ZMB,Sabah,0,0,0
2020-04-01,ZMB,Sarawak,0,0,0
2020-04-01,ZMB,Selangor,0,0,0
2020-04-01,ZWE,Johor,0,0,0
2020-04-01,ZWE,Kedah,0,0,0
2020-04-01,ZWE,Kelantan,0,0,0
2020-04-01,ZWE,Perak,0,0,0
2020-04-01,ZWE,Perlis,0,0,0
2020-04-01,ZWE,Pulau Pinang,0,0,0
2020-04-01,ZWE,Sabah,0,0,0
2020-04-01,ZWE,Sarawak,0,0,0
2020-04-01,ZWE,Selangor,0,0,0
2020-05-01,ABW,Kedah,0,0,0
2020-05-01,ABW,Pulau Pinang,0,0,0
2020-05-01,AFG,Johor,0,0,0
2020-05-01,AFG,Kedah,0,0,0
2020-05-01,AFG,Perlis,0,0,0
2020-05-01,AFG,Pulau Pinang,0,0,0
2020-05-01,AFG,Sarawak,0,0,0
2020-05-01,AFG,Selangor,1,1,0
2020-05-01,AGO,Johor,0,0,0
2020-05-01,AGO,Kedah,0,0,0
2020-05-01,AGO,Sabah,0,0,0
2020-05-01,AGO,Selangor,0,0,0
2020-05-01,AIA,Selangor,0,0,0
2020-05-01,ALB,Johor,0,0,0
2020-05-01,ALB,Kedah,0,0,0
2020-05-01,ALB,Perak,0,0,0
2020-05-01,ALB,Perlis,0,0,0
2020-05-01,ALB,Pulau Pinang,0,0,0
2020-05-01,ALB,Sabah,0,0,0
2020-05-01,ALB,Sarawak,0,0,0
2020-05-01,ALB,Selangor,0,0,0
2020-05-01,AND,Johor,0,0,0
2020-05-01,AND,Kedah,0,0,0
2020-05-01,AND,Perlis,0,0,0
2020-05-01,AND,Pulau Pinang,0,0,0
2020-05-01,AND,Selangor,0,0,0
2020-05-01,ANT,Selangor,0,0,0
2020-05-01,ARE,Johor,0,0,0
2020-05-01,ARE,Kedah,0,0,0
2020-05-01,ARE,Kelantan,0,0,0
2020-05-01,ARE,Perak,0,0,0
2020-05-01,ARE,Perlis,0,0,0
2020-05-01,ARE,Pulau Pinang,0,0,0
2020-05-01,ARE,Sabah,0,0,0
2020-05-01,ARE,Sarawak,0,0,0
2020-05-01,ARE,Selangor,0,0,0
2020-05-01,ARG,Johor,0,0,0
2020-05-01,ARG,Kedah,0,0,0
2020-05-01,ARG,Kelantan,0,0,0
2020-05-01,ARG,Melaka,0,0,0
2020-05-01,ARG,Perak,0,0,0
2020-05-01,ARG,Perlis,0,0,0
2020-05-01,ARG,Pulau Pinang,0,0,0
2020-05-01,ARG,Sabah,0,0,0
2020-05-01,ARG,Sarawak,0,0,0
2020-05-01,ARG,Selangor,0,0,0
2020-05-01,ARG,W.P. Labuan,0,0,0
2020-05-01,ARM,Johor,0,0,0
2020-05-01,ARM,Kedah,0,0,0
2020-05-01,ARM,Kelantan,0,0,0
2020-05-01,ARM,Perak,0,0,0
2020-05-01,ARM,Perlis,0,0,0
2020-05-01,ARM,Pulau Pinang,0,0,0
2020-05-01,ARM,Sabah,0,0,0
2020-05-01,ARM,Sarawak,0,0,0
2020-05-01,ARM,Selangor,0,0,0
2020-05-01,ATA,Selangor,0,0,0
2020-05-01,ATG,Johor,0,0,0
2020-05-01,ATG,Kedah,0,0,0
2020-05-01,ATG,Pulau Pinang,0,0,0
2020-05-01,ATG,Sarawak,0,0,0
2020-05-01,ATG,Selangor,0,0,0
2020-05-01,AUS,Johor,0,0,0
2020-05-01,AUS,Kedah,0,0,0
2020-05-01,AUS,Kelantan,0,0,0
2020-05-01,AUS,Melaka,0,0,0
2020-05-01,AUS,Negeri Sembilan,0,0,0
2020-05-01,AUS,Pahang,0,0,0
2020-05-01,AUS,Perak,0,0,0
2020-05-01,AUS,Perlis,0,0,0
2020-05-01,AUS,Pulau Pinang,0,0,0
2020-05-01,AUS,Sabah,0,0,0
2020-05-01,AUS,Sarawak,0,0,0
2020-05-01,AUS,Selangor,42,35,7
2020-05-01,AUS,Terengganu,0,0,0
2020-05-01,AUS,W.P. Labuan,0,0,0
2020-05-01,AUT,Johor,0,0,0
2020-05-01,AUT,Kedah,0,0,0
2020-05-01,AUT,Kelantan,0,0,0
2020-05-01,AUT,Melaka,0,0,0
2020-05-01,AUT,Negeri Sembilan,0,0,0
2020-05-01,AUT,Pahang,0,0,0
2020-05-01,AUT,Perak,0,0,0
2020-05-01,AUT,Perlis,0,0,0
2020-05-01,AUT,Pulau Pinang,0,0,0
2020-05-01,AUT,Sabah,0,0,0
2020-05-01,AUT,Sarawak,0,0,0
2020-05-01,AUT,Selangor,0,0,0
2020-05-01,AUT,Terengganu,0,0,0
2020-05-01,AUT,W.P. Labuan,0,0,0
2020-05-01,AZE,Johor,0,0,0
2020-05-01,AZE,Kedah,0,0,0
2020-05-01,AZE,Kelantan,0,0,0
2020-05-01,AZE,Melaka,0,0,0
2020-05-01,AZE,Perlis,0,0,0
2020-05-01,AZE,Pulau Pinang,0,0,0
2020-05-01,AZE,Sabah,0,0,0
2020-05-01,AZE,Sarawak,0,0,0
2020-05-01,AZE,Selangor,1,1,0
2020-05-01,AZE,W.P. Labuan,0,0,0
2020-05-01,BDI,Pulau Pinang,0,0,0
2020-05-01,BDI,Sarawak,0,0,0
2020-05-01,BDI,Selangor,0,0,0
2020-05-01,BEL,Johor,0,0,0
2020-05-01,BEL,Kedah,0,0,0
2020-05-01,BEL,Kelantan,0,0,0
2020-05-01,BEL,Melaka,0,0,0
2020-05-01,BEL,Negeri Sembilan,0,0,0
2020-05-01,BEL,Pahang,0,0,0
2020-05-01,BEL,Perak,0,0,0
2020-05-01,BEL,Perlis,0,0,0
2020-05-01,BEL,Pulau Pinang,0,0,0
2020-05-01,BEL,Sabah,0,0,0
2020-05-01,BEL,Sarawak,0,0,0
2020-05-01,BEL,Selangor,1,0,1
2020-05-01,BEL,W.P. Labuan,0,0,0
2020-05-01,BEN,Johor,0,0,0
2020-05-01,BEN,Kedah,0,0,0
2020-05-01,BEN,Perak,0,0,0
2020-05-01,BEN,Pulau Pinang,0,0,0
2020-05-01,BEN,Sabah,0,0,0
2020-05-01,BEN,Sarawak,0,0,0
2020-05-01,BEN,Selangor,0,0,0
2020-05-01,BFA,Perak,0,0,0
2020-05-01,BFA,Pulau Pinang,0,0,0
2020-05-01,BFA,Selangor,0,0,0
2020-05-01,BGD,Johor,0,0,0
2020-05-01,BGD,Kedah,0,0,0
2020-05-01,BGD,Kelantan,0,0,0
2020-05-01,BGD,Melaka,0,0,0
2020-05-01,BGD,Negeri Sembilan,0,0,0
2020-05-01,BGD,Pahang,0,0,0
2020-05-01,BGD,Perak,0,0,0
2020-05-01,BGD,Perlis,0,0,0
2020-05-01,BGD,Pulau Pinang,0,0,0
2020-05-01,BGD,Sabah,0,0,0
2020-05-01,BGD,Sarawak,0,0,0
2020-05-01,BGD,Selangor,10,9,1
2020-05-01,BGD,W.P. Labuan,0,0,0
2020-05-01,BGR,Johor,0,0,0
2020-05-01,BGR,Kedah,0,0,0
2020-05-01,BGR,Kelantan,0,0,0
2020-05-01,BGR,Pahang,0,0,0
2020-05-01,BGR,Perak,0,0,0
2020-05-01,BGR,Perlis,0,0,0
2020-05-01,BGR,Pulau Pinang,0,0,0
2020-05-01,BGR,Sabah,0,0,0
2020-05-01,BGR,Sarawak,0,0,0
2020-05-01,BGR,Selangor,0,0,0
2020-05-01,BGR,W.P. Labuan,0,0,0
2020-05-01,BHR,Johor,0,0,0
2020-05-01,BHR,Kedah,0,0,0
2020-05-01,BHR,Kelantan,0,0,0
2020-05-01,BHR,Perlis,0,0,0
2020-05-01,BHR,Pulau Pinang,0,0,0
2020-05-01,BHR,Sabah,0,0,0
2020-05-01,BHR,Sarawak,0,0,0
2020-05-01,BHR,Selangor,0,0,0
2020-05-01,BHS,Johor,0,0,0
2020-05-01,BHS,Kedah,0,0,0
2020-05-01,BHS,Perak,0,0,0
2020-05-01,BHS,Sabah,0,0,0
2020-05-01,BHS,Sarawak,0,0,0
2020-05-01,BHS,Selangor,0,0,0
2020-05-01,BIH,Johor,0,0,0
2020-05-01,BIH,Kedah,0,0,0
2020-05-01,BIH,Perlis,0,0,0
2020-05-01,BIH,Pulau Pinang,0,0,0
2020-05-01,BIH,Sabah,0,0,0
2020-05-01,BIH,Sarawak,0,0,0
2020-05-01,BIH,Selangor,0,0,0
2020-05-01,BLR,Johor,0,0,0
2020-05-01,BLR,Kedah,0,0,0
2020-05-01,BLR,Kelantan,0,0,0
2020-05-01,BLR,Pahang,0,0,0
2020-05-01,BLR,Perak,0,0,0
2020-05-01,BLR,Perlis,0,0,0
2020-05-01,BLR,Pulau Pinang,0,0,0
2020-05-01,BLR,Sabah,0,0,0
2020-05-01,BLR,Sarawak,0,0,0
2020-05-01,BLR,Selangor,0,0,0
2020-05-01,BLR,W.P. Labuan,0,0,0
2020-05-01,BLZ,Johor,0,0,0
2020-05-01,BLZ,Pulau Pinang,0,0,0
2020-05-01,BLZ,Sarawak,0,0,0
2020-05-01,BLZ,Selangor,0,0,0
2020-05-01,BMU,Selangor,0,0,0
2020-05-01,BOL,Johor,0,0,0
2020-05-01,BOL,Kedah,0,0,0
2020-05-01,BOL,Melaka,0,0,0
2020-05-01,BOL,Perak,0,0,0
2020-05-01,BOL,Perlis,0,0,0
2020-05-01,BOL,Pulau Pinang,0,0,0
2020-05-01,BOL,Sabah,0,0,0
2020-05-01,BOL,Sarawak,0,0,0
2020-05-01,BOL,Selangor,0,0,0
2020-05-01,BRA,Johor,0,0,0
2020-05-01,BRA,Kedah,0,0,0
2020-05-01,BRA,Kelantan,0,0,0
2020-05-01,BRA,Melaka,0,0,0
2020-05-01,BRA,Pahang,0,0,0
2020-05-01,BRA,Perak,0,0,0
2020-05-01,BRA,Perlis,0,0,0
2020-05-01,BRA,Pulau Pinang,0,0,0
2020-05-01,BRA,Sabah,0,0,0
2020-05-01,BRA,Sarawak,0,0,0
2020-05-01,BRA,Selangor,12,12,0
2020-05-01,BRA,W.P. Labuan,0,0,0
2020-05-01,BRB,Johor,0,0,0
2020-05-01,BRB,Kedah,0,0,0
2020-05-01,BRB,Perlis,0,0,0
2020-05-01,BRB,Pulau Pinang,0,0,0
2020-05-01,BRB,Selangor,0,0,0
2020-05-01,BRN,Johor,0,0,0
2020-05-01,BRN,Kedah,0,0,0
2020-05-01,BRN,Kelantan,0,0,0
2020-05-01,BRN,Melaka,0,0,0
2020-05-01,BRN,Pahang,0,0,0
2020-05-01,BRN,Perak,0,0,0
2020-05-01,BRN,Perlis,0,0,0
2020-05-01,BRN,Pulau Pinang,0,0,0
2020-05-01,BRN,Sabah,0,0,0
2020-05-01,BRN,Sarawak,328,320,8
2020-05-01,BRN,Selangor,1,1,0
2020-05-01,BRN,W.P. Labuan,1,1,0
2020-05-01,BTN,Johor,0,0,0
2020-05-01,BTN,Kedah,0,0,0
2020-05-01,BTN,Perak,0,0,0
2020-05-01,BTN,Perlis,0,0,0
2020-05-01,BTN,Pulau Pinang,0,0,0
2020-05-01,BTN,Sabah,0,0,0
2020-05-01,BTN,Sarawak,0,0,0
2020-05-01,BTN,Selangor,0,0,0
2020-05-01,BWA,Johor,0,0,0
2020-05-01,BWA,Kedah,0,0,0
2020-05-01,BWA,Perlis,0,0,0
2020-05-01,BWA,Pulau Pinang,0,0,0
2020-05-01,BWA,Sabah,0,0,0
2020-05-01,BWA,Sarawak,0,0,0
2020-05-01,BWA,Selangor,0,0,0
2020-05-01,CAF,Kedah,0,0,0
2020-05-01,CAF,Selangor,0,0,0
2020-05-01,CAN,Johor,1,1,0
2020-05-01,CAN,Kedah,0,0,0
2020-05-01,CAN,Kelantan,0,0,0
2020-05-01,CAN,Melaka,0,0,0
2020-05-01,CAN,Negeri Sembilan,0,0,0
2020-05-01,CAN,Pahang,0,0,0
2020-05-01,CAN,Perak,0,0,0
2020-05-01,CAN,Perlis,0,0,0
2020-05-01,CAN,Pulau Pinang,0,0,0
2020-05-01,CAN,Sabah,0,0,0
2020-05-01,CAN,Sarawak,0,0,0
2020-05-01,CAN,Selangor,19,17,2
2020-05-01,CAN,Terengganu,0,0,0
2020-05-01,CAN,W.P. Labuan,0,0,0
2020-05-01,CCK,Selangor,0,0,0
2020-05-01,CHE,Johor,0,0,0
2020-05-01,CHE,Kedah,0,0,0
2020-05-01,CHE,Kelantan,0,0,0
2020-05-01,CHE,Melaka,0,0,0
2020-05-01,CHE,Negeri Sembilan,0,0,0
2020-05-01,CHE,Pahang,0,0,0
2020-05-01,CHE,Perak,0,0,0
2020-05-01,CHE,Perlis,0,0,0
2020-05-01,CHE,Pulau Pinang,0,0,0
2020-05-01,CHE,Sabah,0,0,0
2020-05-01,CHE,Sarawak,0,0,0
2020-05-01,CHE,Selangor,1,1,0
2020-05-01,CHE,W.P. Labuan,0,0,0
2020-05-01,CHL,Johor,0,0,0
2020-05-01,CHL,Kedah,0,0,0
2020-05-01,CHL,Kelantan,0,0,0
2020-05-01,CHL,Melaka,0,0,0
2020-05-01,CHL,Pahang,0,0,0
2020-05-01,CHL,Perak,0,0,0
2020-05-01,CHL,Perlis,0,0,0
2020-05-01,CHL,Pulau Pinang,0,0,0
2020-05-01,CHL,Sabah,0,0,0
2020-05-01,CHL,Sarawak,0,0,0
2020-05-01,CHL,Selangor,0,0,0
2020-05-01,CHN,Johor,2,0,2
2020-05-01,CHN,Kedah,0,0,0
2020-05-01,CHN,Kelantan,0,0,0
2020-05-01,CHN,Melaka,0,0,0
2020-05-01,CHN,Pahang,0,0,0
2020-05-01,CHN,Perak,0,0,0
2020-05-01,CHN,Perlis,0,0,0
2020-05-01,CHN,Pulau Pinang,0,0,0
2020-05-01,CHN,Sabah,0,0,0
2020-05-01,CHN,Sarawak,0,0,0
2020-05-01,CHN,Selangor,21,11,10
2020-05-01,CHN,Terengganu,0,0,0
2020-05-01,CHN,W.P. Labuan,0,0,0
2020-05-01,CIV,Johor,0,0,0
2020-05-01,CIV,Kedah,0,0,0
2020-05-01,CIV,Pulau Pinang,0,0,0
2020-05-01,CIV,Sabah,0,0,0
2020-05-01,CIV,Sarawak,0,0,0
2020-05-01,CIV,Selangor,0,0,0
2020-05-01,CMR,Johor,0,0,0
2020-05-01,CMR,Kedah,0,0,0
2020-05-01,CMR,Pulau Pinang,0,0,0
2020-05-01,CMR,Sabah,0,0,0
2020-05-01,CMR,Sarawak,0,0,0
2020-05-01,CMR,Selangor,0,0,0
2020-05-01,COD,Johor,0,0,0
2020-05-01,COD,Pulau Pinang,0,0,0
2020-05-01,COD,Sarawak,0,0,0
2020-05-01,COD,Selangor,0,0,0
2020-05-01,COG,Johor,0,0,0
2020-05-01,COG,Kedah,0,0,0
2020-05-01,COG,Selangor,0,0,0
2020-05-01,COK,Selangor,0,0,0
2020-05-01,COL,Johor,0,0,0
2020-05-01,COL,Kedah,0,0,0
2020-05-01,COL,Perak,0,0,0
2020-05-01,COL,Pulau Pinang,0,0,0
2020-05-01,COL,Sabah,0,0,0
2020-05-01,COL,Sarawak,0,0,0
2020-05-01,COL,Selangor,0,0,0
2020-05-01,COL,W.P. Labuan,0,0,0
2020-05-01,COM,Johor,0,0,0
2020-05-01,COM,Kedah,0,0,0
2020-05-01,COM,Selangor,0,0,0
2020-05-01,CPV,Johor,0,0,0
2020-05-01,CPV,Kedah,0,0,0
2020-05-01,CPV,Pulau Pinang,0,0,0
2020-05-01,CPV,Sabah,0,0,0
2020-05-01,CPV,Selangor,0,0,0
2020-05-01,CRI,Johor,0,0,0
2020-05-01,CRI,Kedah,0,0,0
2020-05-01,CRI,Perak,0,0,0
2020-05-01,CRI,Perlis,0,0,0
2020-05-01,CRI,Pulau Pinang,0,0,0
2020-05-01,CRI,Sabah,0,0,0
2020-05-01,CRI,Sarawak,0,0,0
2020-05-01,CRI,Selangor,0,0,0
2020-05-01,CUB,Johor,0,0,0
2020-05-01,CUB,Kedah,0,0,0
2020-05-01,CUB,Perlis,0,0,0
2020-05-01,CUB,Pulau Pinang,0,0,0
2020-05-01,CUB,Sabah,0,0,0
2020-05-01,CUB,Sarawak,0,0,0
2020-05-01,CUB,Selangor,0,0,0
2020-05-01,CYP,Johor,0,0,0
2020-05-01,CYP,Kedah,0,0,0
2020-05-01,CYP,Perak,0,0,0
2020-05-01,CYP,Perlis,0,0,0
2020-05-01,CYP,Pulau Pinang,0,0,0
2020-05-01,CYP,Sabah,0,0,0
2020-05-01,CYP,Sarawak,0,0,0
2020-05-01,CYP,Selangor,0,0,0
2020-05-01,CZE,Johor,0,0,0
2020-05-01,CZE,Kedah,0,0,0
2020-05-01,CZE,Kelantan,0,0,0
2020-05-01,CZE,Melaka,0,0,0
2020-05-01,CZE,Negeri Sembilan,0,0,0
2020-05-01,CZE,Perak,0,0,0
2020-05-01,CZE,Perlis,0,0,0
2020-05-01,CZE,Pulau Pinang,0,0,0
2020-05-01,CZE,Sabah,0,0,0
2020-05-01,CZE,Sarawak,0,0,0
2020-05-01,CZE,Selangor,1,1,0
2020-05-01,CZE,W.P. Labuan,0,0,0
2020-05-01,DEU,Johor,0,0,0
2020-05-01,DEU,Kedah,0,0,0
2020-05-01,DEU,Kelantan,0,0,0
2020-05-01,DEU,Melaka,0,0,0
2020-05-01,DEU,Negeri Sembilan,0,0,0
2020-05-01,DEU,Pahang,0,0,0
2020-05-01,DEU,Perak,0,0,0
2020-05-01,DEU,Perlis,0,0,0
2020-05-01,DEU,Pulau Pinang,0,0,0
2020-05-01,DEU,Sabah,0,0,0
2020-05-01,DEU,Sarawak,0,0,0
2020-05-01,DEU,Selangor,4,2,2
2020-05-01,DEU,Terengganu,0,0,0
2020-05-01,DEU,W.P. Labuan,0,0,0
2020-05-01,DJI,Johor,0,0,0
2020-05-01,DJI,Selangor,0,0,0
2020-05-01,DMA,Johor,0,0,0
2020-05-01,DMA,Kedah,0,0,0
2020-05-01,DMA,Pulau Pinang,0,0,0
2020-05-01,DMA,Sabah,0,0,0
2020-05-01,DMA,Sarawak,0,0,0
2020-05-01,DMA,Selangor,0,0,0
2020-05-01,DMA,W.P. Labuan,0,0,0
2020-05-01,DNK,Johor,0,0,0
2020-05-01,DNK,Kedah,0,0,0
2020-05-01,DNK,Kelantan,0,0,0
2020-05-01,DNK,Melaka,0,0,0
2020-05-01,DNK,Negeri Sembilan,0,0,0
2020-05-01,DNK,Pahang,0,0,0
2020-05-01,DNK,Perak,0,0,0
2020-05-01,DNK,Perlis,0,0,0
2020-05-01,DNK,Pulau Pinang,0,0,0
2020-05-01,DNK,Sabah,0,0,0
2020-05-01,DNK,Sarawak,0,0,0
2020-05-01,DNK,Selangor,0,0,0
2020-05-01,DNK,W.P. Labuan,0,0,0
2020-05-01,DOM,Johor,0,0,0
2020-05-01,DOM,Kedah,0,0,0
2020-05-01,DOM,Perak,0,0,0
2020-05-01,DOM,Perlis,0,0,0
2020-05-01,DOM,Pulau Pinang,0,0,0
2020-05-01,DOM,Sabah,0,0,0
2020-05-01,DOM,Sarawak,0,0,0
2020-05-01,DOM,Selangor,0,0,0
2020-05-01,DZA,Johor,0,0,0
2020-05-01,DZA,Kedah,0,0,0
2020-05-01,DZA,Kelantan,0,0,0
2020-05-01,DZA,Melaka,0,0,0
2020-05-01,DZA,Perak,0,0,0
2020-05-01,DZA,Perlis,0,0,0
2020-05-01,DZA,Pulau Pinang,0,0,0
2020-05-01,DZA,Sabah,0,0,0
2020-05-01,DZA,Sarawak,0,0,0
2020-05-01,DZA,Selangor,0,0,0
2020-05-01,DZA,W.P. Labuan,0,0,0
2020-05-01,ECU,Johor,0,0,0
2020-05-01,ECU,Kedah,0,0,0
2020-05-01,ECU,Perak,0,0,0
2020-05-01,ECU,Perlis,0,0,0
2020-05-01,ECU,Pulau Pinang,0,0,0
2020-05-01,ECU,Sabah,0,0,0
2020-05-01,ECU,Sarawak,0,0,0
2020-05-01,ECU,Selangor,0,0,0
2020-05-01,EGY,Johor,0,0,0
2020-05-01,EGY,Kedah,0,0,0
2020-05-01,EGY,Kelantan,0,0,0
2020-05-01,EGY,Melaka,0,0,0
2020-05-01,EGY,Pahang,0,0,0
2020-05-01,EGY,Perak,0,0,0
2020-05-01,EGY,Perlis,0,0,0
2020-05-01,EGY,Pulau Pinang,0,0,0
2020-05-01,EGY,Sabah,0,0,0
2020-05-01,EGY,Sarawak,0,0,0
2020-05-01,EGY,Selangor,13,11,2
2020-05-01,EGY,Terengganu,0,0,0
2020-05-01,EGY,W.P. Labuan,0,0,0
2020-05-01,ERI,Johor,0,0,0
2020-05-01,ERI,Pulau Pinang,0,0,0
2020-05-01,ERI,Sabah,0,0,0
2020-05-01,ERI,Selangor,0,0,0
2020-05-01,ESP,Johor,0,0,0
2020-05-01,ESP,Kedah,0,0,0
2020-05-01,ESP,Kelantan,0,0,0
2020-05-01,ESP,Melaka,0,0,0
2020-05-01,ESP,Negeri Sembilan,0,0,0
2020-05-01,ESP,Pahang,0,0,0
2020-05-01,ESP,Perak,0,0,0
2020-05-01,ESP,Perlis,0,0,0
2020-05-01,ESP,Pulau Pinang,0,0,0
2020-05-01,ESP,Sabah,0,0,0
2020-05-01,ESP,Sarawak,0,0,0
2020-05-01,ESP,Selangor,0,0,0
2020-05-01,ESP,W.P. Labuan,0,0,0
2020-05-01,EST,Johor,0,0,0
2020-05-01,EST,Kedah,0,0,0
2020-05-01,EST,Kelantan,0,0,0
2020-05-01,EST,Pahang,0,0,0
2020-05-01,EST,Perak,0,0,0
2020-05-01,EST,Perlis,0,0,0
2020-05-01,EST,Pulau Pinang,0,0,0
2020-05-01,EST,Sabah,0,0,0
2020-05-01,EST,Sarawak,0,0,0
2020-05-01,EST,Selangor,0,0,0
2020-05-01,EST,W.P. Labuan,0,0,0
2020-05-01,ETH,Johor,0,0,0
2020-05-01,ETH,Kedah,0,0,0
2020-05-01,ETH,Pulau Pinang,0,0,0
2020-05-01,ETH,Sarawak,0,0,0
2020-05-01,ETH,Selangor,0,0,0
2020-05-01,FIN,Johor,0,0,0
2020-05-01,FIN,Kedah,0,0,0
2020-05-01,FIN,Kelantan,0,0,0
2020-05-01,FIN,Melaka,0,0,0
2020-05-01,FIN,Negeri Sembilan,0,0,0
2020-05-01,FIN,Pahang,0,0,0
2020-05-01,FIN,Perak,0,0,0
2020-05-01,FIN,Perlis,0,0,0
2020-05-01,FIN,Pulau Pinang,0,0,0
2020-05-01,FIN,Sabah,0,0,0
2020-05-01,FIN,Sarawak,0,0,0
2020-05-01,FIN,Selangor,2,1,1
2020-05-01,FIN,W.P. Labuan,0,0,0
2020-05-01,FJI,Johor,0,0,0
2020-05-01,FJI,Kedah,0,0,0
2020-05-01,FJI,Kelantan,0,0,0
2020-05-01,FJI,Perak,0,0,0
2020-05-01,FJI,Perlis,0,0,0
2020-05-01,FJI,Pulau Pinang,0,0,0
2020-05-01,FJI,Sabah,0,0,0
2020-05-01,FJI,Sarawak,0,0,0
2020-05-01,FJI,Selangor,0,0,0
2020-05-01,FRA,Johor,0,0,0
2020-05-01,FRA,Kedah,0,0,0
2020-05-01,FRA,Kelantan,0,0,0
2020-05-01,FRA,Melaka,0,0,0
2020-05-01,FRA,Negeri Sembilan,0,0,0
2020-05-01,FRA,Pahang,0,0,0
2020-05-01,FRA,Perak,0,0,0
2020-05-01,FRA,Perlis,0,0,0
2020-05-01,FRA,Pulau Pinang,0,0,0
2020-05-01,FRA,Sabah,0,0,0
2020-05-01,FRA,Sarawak,0,0,0
2020-05-01,FRA,Selangor,7,7,0
2020-05-01,FRA,Terengganu,0,0,0
2020-05-01,FRA,W.P. Labuan,0,0,0
2020-05-01,FSM,Johor,0,0,0
2020-05-01,FSM,Pulau Pinang,0,0,0
2020-05-01,FSM,Selangor,0,0,0
2020-05-01,GAB,Johor,0,0,0
2020-05-01,GAB,Pulau Pinang,0,0,0
2020-05-01,GAB,Sarawak,0,0,0
2020-05-01,GAB,Selangor,0,0,0
2020-05-01,GBR,Johor,3,3,0
2020-05-01,GBR,Kedah,2,1,1
2020-05-01,GBR,Kelantan,0,0,0
2020-05-01,GBR,Melaka,0,0,0
2020-05-01,GBR,Negeri Sembilan,0,0,0
2020-05-01,GBR,Pahang,0,0,0
2020-05-01,GBR,Perak,0,0,0
2020-05-01,GBR,Perlis,0,0,0
2020-05-01,GBR,Pulau Pinang,0,0,0
2020-05-01,GBR,Sabah,0,0,0
2020-05-01,GBR,Sarawak,0,0,0
2020-05-01,GBR,Selangor,54,52,2
2020-05-01,GBR,Terengganu,0,0,0
2020-05-01,GBR,W.P. Labuan,0,0,0
2020-05-01,GEO,Johor,0,0,0
2020-05-01,GEO,Kedah,0,0,0
2020-05-01,GEO,Melaka,0,0,0
2020-05-01,GEO,Perak,0,0,0
2020-05-01,GEO,Perlis,0,0,0
2020-05-01,GEO,Pulau Pinang,0,0,0
2020-05-01,GEO,Sabah,0,0,0
2020-05-01,GEO,Sarawak,0,0,0
2020-05-01,GEO,Selangor,0,0,0
2020-05-01,GHA,Johor,0,0,0
2020-05-01,GHA,Kedah,0,0,0
2020-05-01,GHA,Kelantan,0,0,0
2020-05-01,GHA,Pulau Pinang,0,0,0
2020-05-01,GHA,Sabah,0,0,0
2020-05-01,GHA,Sarawak,0,0,0
2020-05-01,GHA,Selangor,0,0,0
2020-05-01,GIB,Johor,0,0,0
2020-05-01,GIB,Sarawak,0,0,0
2020-05-01,GIN,Johor,0,0,0
2020-05-01,GIN,Kedah,0,0,0
2020-05-01,GIN,Kelantan,0,0,0
2020-05-01,GIN,Perlis,0,0,0
2020-05-01,GIN,Pulau Pinang,0,0,0
2020-05-01,GIN,Sabah,0,0,0
2020-05-01,GIN,Sarawak,0,0,0
2020-05-01,GIN,Selangor,0,0,0
2020-05-01,GLP,Selangor,0,0,0
2020-05-01,GMB,Johor,0,0,0
2020-05-01,GMB,Kedah,0,0,0
2020-05-01,GMB,Kelantan,0,0,0
2020-05-01,GMB,Pulau Pinang,0,0,0
2020-05-01,GMB,Sabah,0,0,0
2020-05-01,GMB,Sarawak,0,0,0
2020-05-01,GMB,Selangor,0,0,0
2020-05-01,GNB,Johor,0,0,0
2020-05-01,GNB,Selangor,0,0,0
2020-05-01,GNQ,Johor,0,0,0
2020-05-01,GNQ,Selangor,0,0,0
2020-05-01,GRC,Johor,0,0,0
2020-05-01,GRC,Kedah,0,0,0
2020-05-01,GRC,Kelantan,0,0,0
2020-05-01,GRC,Melaka,0,0,0
2020-05-01,GRC,Negeri Sembilan,0,0,0
2020-05-01,GRC,Pahang,0,0,0
2020-05-01,GRC,Perak,0,0,0
2020-05-01,GRC,Perlis,0,0,0
2020-05-01,GRC,Pulau Pinang,0,0,0
2020-05-01,GRC,Sabah,0,0,0
2020-05-01,GRC,Sarawak,0,0,0
2020-05-01,GRC,Selangor,0,0,0
2020-05-01,GRD,Johor,0,0,0
2020-05-01,GRD,Kedah,0,0,0
2020-05-01,GRD,Pulau Pinang,0,0,0
2020-05-01,GRD,Sabah,0,0,0
2020-05-01,GRD,Sarawak,0,0,0
2020-05-01,GRD,Selangor,0,0,0
2020-05-01,GRL,Johor,0,0,0
2020-05-01,GRL,Selangor,0,0,0
2020-05-01,GTM,Johor,0,0,0
2020-05-01,GTM,Kedah,0,0,0
2020-05-01,GTM,Pahang,0,0,0
2020-05-01,GTM,Perak,0,0,0
2020-05-01,GTM,Pulau Pinang,0,0,0
2020-05-01,GTM,Sabah,0,0,0
2020-05-01,GTM,Sarawak,0,0,0
2020-05-01,GTM,Selangor,0,0,0
2020-05-01,GTM,W.P. Labuan,0,0,0
2020-05-01,GUY,Johor,0,0,0
2020-05-01,GUY,Kedah,0,0,0
2020-05-01,GUY,Pulau Pinang,0,0,0
2020-05-01,GUY,Sarawak,0,0,0
2020-05-01,GUY,Selangor,0,0,0
2020-05-01,HKG,Johor,0,0,0
2020-05-01,HKG,Kedah,0,0,0
2020-05-01,HKG,Kelantan,0,0,0
2020-05-01,HKG,Pahang,0,0,0
2020-05-01,HKG,Perak,0,0,0
2020-05-01,HKG,Perlis,0,0,0
2020-05-01,HKG,Pulau Pinang,0,0,0
2020-05-01,HKG,Sabah,0,0,0
2020-05-01,HKG,Sarawak,0,0,0
2020-05-01,HKG,Selangor,0,0,0
2020-05-01,HKG,Terengganu,0,0,0
2020-05-01,HMD,Johor,0,0,0
2020-05-01,HND,Johor,0,0,0
2020-05-01,HND,Kedah,0,0,0
2020-05-01,HND,Perak,0,0,0
2020-05-01,HND,Pulau Pinang,0,0,0
2020-05-01,HND,Sabah,0,0,0
2020-05-01,HND,Sarawak,0,0,0
2020-05-01,HND,Selangor,0,0,0
2020-05-01,HRV,Johor,0,0,0
2020-05-01,HRV,Kedah,0,0,0
2020-05-01,HRV,Kelantan,0,0,0
2020-05-01,HRV,Melaka,0,0,0
2020-05-01,HRV,Pahang,0,0,0
2020-05-01,HRV,Perak,0,0,0
2020-05-01,HRV,Perlis,0,0,0
2020-05-01,HRV,Pulau Pinang,0,0,0
2020-05-01,HRV,Sabah,0,0,0
2020-05-01,HRV,Sarawak,0,0,0
2020-05-01,HRV,Selangor,8,8,0
2020-05-01,HTI,Johor,0,0,0
2020-05-01,HTI,Kedah,0,0,0
2020-05-01,HTI,Kelantan,0,0,0
2020-05-01,HTI,Perak,0,0,0
2020-05-01,HTI,Pulau Pinang,0,0,0
2020-05-01,HTI,Sabah,0,0,0
2020-05-01,HTI,Selangor,0,0,0
2020-05-01,HUN,Johor,0,0,0
2020-05-01,HUN,Kedah,0,0,0
2020-05-01,HUN,Kelantan,0,0,0
2020-05-01,HUN,Pahang,0,0,0
2020-05-01,HUN,Perak,0,0,0
2020-05-01,HUN,Perlis,0,0,0
2020-05-01,HUN,Pulau Pinang,0,0,0
2020-05-01,HUN,Sabah,0,0,0
2020-05-01,HUN,Sarawak,0,0,0
2020-05-01,HUN,Selangor,0,0,0
2020-05-01,HUN,W.P. Labuan,0,0,0
2020-05-01,IDN,Johor,40,37,3
2020-05-01,IDN,Kedah,8,8,0
2020-05-01,IDN,Kelantan,0,0,0
2020-05-01,IDN,Melaka,0,0,0
2020-05-01,IDN,Negeri Sembilan,0,0,0
2020-05-01,IDN,Pahang,2,2,0
2020-05-01,IDN,Perak,0,0,0
2020-05-01,IDN,Perlis,0,0,0
2020-05-01,IDN,Pulau Pinang,0,0,0
2020-05-01,IDN,Sabah,8,1,7
2020-05-01,IDN,Sarawak,100,90,10
2020-05-01,IDN,Selangor,75,34,41
2020-05-01,IDN,Terengganu,0,0,0
2020-05-01,IDN,W.P. Labuan,1,1,0
2020-05-01,IND,Johor,3,1,2
2020-05-01,IND,Kedah,0,0,0
2020-05-01,IND,Kelantan,0,0,0
2020-05-01,IND,Melaka,0,0,0
2020-05-01,IND,Negeri Sembilan,0,0,0
2020-05-01,IND,Pahang,0,0,0
2020-05-01,IND,Perak,0,0,0
2020-05-01,IND,Perlis,0,0,0
2020-05-01,IND,Pulau Pinang,0,0,0
2020-05-01,IND,Sabah,0,0,0
2020-05-01,IND,Sarawak,0,0,0
2020-05-01,IND,Selangor,35,20,15
2020-05-01,IND,Terengganu,0,0,0
2020-05-01,IND,W.P. Labuan,0,0,0
2020-05-01,IOT,Pulau Pinang,0,0,0
2020-05-01,IOT,Selangor,0,0,0
2020-05-01,IRL,Johor,0,0,0
2020-05-01,IRL,Kedah,0,0,0
2020-05-01,IRL,Kelantan,0,0,0
2020-05-01,IRL,Negeri Sembilan,0,0,0
2020-05-01,IRL,Pahang,0,0,0
2020-05-01,IRL,Perak,0,0,0
2020-05-01,IRL,Perlis,0,0,0
2020-05-01,IRL,Pulau Pinang,0,0,0
2020-05-01,IRL,Sabah,0,0,0
2020-05-01,IRL,Sarawak,0,0,0
2020-05-01,IRL,Selangor,6,4,2
2020-05-01,IRL,Terengganu,0,0,0
2020-05-01,IRL,W.P. Labuan,0,0,0
2020-05-01,IRN,Johor,0,0,0
2020-05-01,IRN,Kedah,0,0,0
2020-05-01,IRN,Kelantan,0,0,0
2020-05-01,IRN,Perak,0,0,0
2020-05-01,IRN,Perlis,0,0,0
2020-05-01,IRN,Pulau Pinang,0,0,0
2020-05-01,IRN,Sabah,0,0,0
2020-05-01,IRN,Sarawak,0,0,0
2020-05-01,IRN,Selangor,1,1,0
2020-05-01,IRN,W.P. Labuan,0,0,0
2020-05-01,IRQ,Johor,0,0,0
2020-05-01,IRQ,Kedah,0,0,0
2020-05-01,IRQ,Kelantan,0,0,0
2020-05-01,IRQ,Melaka,0,0,0
2020-05-01,IRQ,Pahang,0,0,0
2020-05-01,IRQ,Perak,0,0,0
2020-05-01,IRQ,Perlis,0,0,0
2020-05-01,IRQ,Pulau Pinang,0,0,0
2020-05-01,IRQ,Sabah,0,0,0
2020-05-01,IRQ,Sarawak,0,0,0
2020-05-01,IRQ,Selangor,0,0,0
2020-05-01,ISL,Johor,0,0,0
2020-05-01,ISL,Kedah,0,0,0
2020-05-01,ISL,Kelantan,0,0,0
2020-05-01,ISL,Perak,0,0,0
2020-05-01,ISL,Perlis,0,0,0
2020-05-01,ISL,Pulau Pinang,0,0,0
2020-05-01,ISL,Sabah,0,0,0
2020-05-01,ISL,Sarawak,0,0,0
2020-05-01,ISL,Selangor,0,0,0
2020-05-01,ISL,W.P. Labuan,0,0,0
2020-05-01,ISR,Pulau Pinang,0,0,0
2020-05-01,ITA,Johor,0,0,0
2020-05-01,ITA,Kedah,0,0,0
2020-05-01,ITA,Kelantan,0,0,0
2020-05-01,ITA,Melaka,0,0,0
2020-05-01,ITA,Negeri Sembilan,0,0,0
2020-05-01,ITA,Pahang,0,0,0
2020-05-01,ITA,Perak,0,0,0
2020-05-01,ITA,Perlis,0,0,0
2020-05-01,ITA,Pulau Pinang,0,0,0
2020-05-01,ITA,Sabah,0,0,0
2020-05-01,ITA,Sarawak,0,0,0
2020-05-01,ITA,Selangor,0,0,0
2020-05-01,ITA,W.P. Labuan,0,0,0
2020-05-01,JAM,Johor,0,0,0
2020-05-01,JAM,Kedah,0,0,0
2020-05-01,JAM,Perak,0,0,0
2020-05-01,JAM,Pulau Pinang,0,0,0
2020-05-01,JAM,Sabah,0,0,0
2020-05-01,JAM,Sarawak,0,0,0
2020-05-01,JAM,Selangor,0,0,0
2020-05-01,JAM,W.P. Labuan,0,0,0
2020-05-01,JOR,Johor,0,0,0
2020-05-01,JOR,Kedah,0,0,0
2020-05-01,JOR,Kelantan,0,0,0
2020-05-01,JOR,Melaka,0,0,0
2020-05-01,JOR,Perlis,0,0,0
2020-05-01,JOR,Pulau Pinang,0,0,0
2020-05-01,JOR,Sabah,0,0,0
2020-05-01,JOR,Sarawak,0,0,0
2020-05-01,JOR,Selangor,0,0,0
2020-05-01,JOR,W.P. Labuan,0,0,0
2020-05-01,JPN,Johor,0,0,0
2020-05-01,JPN,Kedah,0,0,0
2020-05-01,JPN,Kelantan,0,0,0
2020-05-01,JPN,Melaka,0,0,0
2020-05-01,JPN,Negeri Sembilan,0,0,0
2020-05-01,JPN,Pahang,0,0,0
2020-05-01,JPN,Perak,0,0,0
2020-05-01,JPN,Perlis,0,0,0
2020-05-01,JPN,Pulau Pinang,0,0,0
2020-05-01,JPN,Sabah,0,0,0
2020-05-01,JPN,Sarawak,0,0,0
2020-05-01,JPN,Selangor,8,6,2
2020-05-01,JPN,W.P. Labuan,0,0,0
2020-05-01,KAZ,Johor,0,0,0
2020-05-01,KAZ,Kedah,0,0,0
2020-05-01,KAZ,Kelantan,0,0,0
2020-05-01,KAZ,Melaka,0,0,0
2020-05-01,KAZ,Perak,0,0,0
2020-05-01,KAZ,Perlis,0,0,0
2020-05-01,KAZ,Pulau Pinang,0,0,0
2020-05-01,KAZ,Sabah,0,0,0
2020-05-01,KAZ,Sarawak,0,0,0
2020-05-01,KAZ,Selangor,0,0,0
2020-05-01,KAZ,W.P. Labuan,0,0,0
2020-05-01,KEN,Johor,0,0,0
2020-05-01,KEN,Kedah,0,0,0
2020-05-01,KEN,Kelantan,0,0,0
2020-05-01,KEN,Perak,0,0,0
2020-05-01,KEN,Perlis,0,0,0
2020-05-01,KEN,Pulau Pinang,0,0,0
2020-05-01,KEN,Sabah,0,0,0
2020-05-01,KEN,Sarawak,0,0,0
2020-05-01,KEN,Selangor,0,0,0
2020-05-01,KGZ,Johor,0,0,0
2020-05-01,KGZ,Kedah,0,0,0
2020-05-01,KGZ,Kelantan,0,0,0
2020-05-01,KGZ,Perak,0,0,0
2020-05-01,KGZ,Perlis,0,0,0
2020-05-01,KGZ,Pulau Pinang,0,0,0
2020-05-01,KGZ,Sabah,0,0,0
2020-05-01,KGZ,Sarawak,0,0,0
2020-05-01,KGZ,Selangor,0,0,0
2020-05-01,KHM,Johor,0,0,0
2020-05-01,KHM,Kedah,0,0,0
2020-05-01,KHM,Kelantan,0,0,0
2020-05-01,KHM,Melaka,0,0,0
2020-05-01,KHM,Negeri Sembilan,0,0,0
2020-05-01,KHM,Pahang,0,0,0
2020-05-01,KHM,Perak,0,0,0
2020-05-01,KHM,Perlis,0,0,0
2020-05-01,KHM,Pulau Pinang,0,0,0
2020-05-01,KHM,Sabah,0,0,0
2020-05-01,KHM,Sarawak,0,0,0
2020-05-01,KHM,Selangor,2,0,2
2020-05-01,KHM,W.P. Labuan,0,0,0
2020-05-01,KIR,Johor,0,0,0
2020-05-01,KIR,Sabah,0,0,0
2020-05-01,KIR,Selangor,0,0,0
2020-05-01,KNA,Johor,0,0,0
2020-05-01,KNA,Kedah,0,0,0
2020-05-01,KNA,Perlis,0,0,0
2020-05-01,KNA,Pulau Pinang,0,0,0
2020-05-01,KNA,Sabah,0,0,0
2020-05-01,KNA,Selangor,0,0,0
2020-05-01,KNA,W.P. Labuan,0,0,0
2020-05-01,KOR,Johor,0,0,0
2020-05-01,KOR,Kedah,0,0,0
2020-05-01,KOR,Kelantan,0,0,0
2020-05-01,KOR,Melaka,0,0,0
2020-05-01,KOR,Negeri Sembilan,0,0,0
2020-05-01,KOR,Pahang,0,0,0
2020-05-01,KOR,Perak,0,0,0
2020-05-01,KOR,Perlis,0,0,0
2020-05-01,KOR,Pulau Pinang,0,0,0
2020-05-01,KOR,Sabah,0,0,0
2020-05-01,KOR,Sarawak,0,0,0
2020-05-01,KOR,Selangor,2,1,1
2020-05-01,KOR,Terengganu,0,0,0
2020-05-01,KOR,W.P. Labuan,0,0,0
2020-05-01,KWT,Johor,0,0,0
2020-05-01,KWT,Kedah,0,0,0
2020-05-01,KWT,Kelantan,0,0,0
2020-05-01,KWT,Perak,0,0,0
2020-05-01,KWT,Perlis,0,0,0
2020-05-01,KWT,Pulau Pinang,0,0,0
2020-05-01,KWT,Sabah,0,0,0
2020-05-01,KWT,Sarawak,0,0,0
2020-05-01,KWT,Selangor,0,0,0
2020-05-01,KWT,W.P. Labuan,0,0,0
2020-05-01,LAO,Johor,1,0,1
2020-05-01,LAO,Kedah,0,0,0
2020-05-01,LAO,Kelantan,0,0,0
2020-05-01,LAO,Melaka,0,0,0
2020-05-01,LAO,Perak,0,0,0
2020-05-01,LAO,Perlis,0,0,0
2020-05-01,LAO,Pulau Pinang,0,0,0
2020-05-01,LAO,Sabah,0,0,0
2020-05-01,LAO,Sarawak,0,0,0
2020-05-01,LAO,Selangor,3,0,3
2020-05-01,LAO,W.P. Labuan,0,0,0
2020-05-01,LBN,Johor,0,0,0
2020-05-01,LBN,Kedah,0,0,0
2020-05-01,LBN,Kelantan,0,0,0
2020-05-01,LBN,Pahang,0,0,0
2020-05-01,LBN,Perak,0,0,0
2020-05-01,LBN,Perlis,0,0,0
2020-05-01,LBN,Pulau Pinang,0,0,0
2020-05-01,LBN,Sabah,0,0,0
2020-05-01,LBN,Sarawak,0,0,0
2020-05-01,LBN,Selangor,1,1,0
2020-05-01,LBN,W.P. Labuan,0,0,0
2020-05-01,LBR,Johor,0,0,0
2020-05-01,LBR,Kedah,0,0,0
2020-05-01,LBR,Sabah,0,0,0
2020-05-01,LBR,Sarawak,0,0,0
2020-05-01,LBR,Selangor,0,0,0
2020-05-01,LBY,Johor,0,0,0
2020-05-01,LBY,Kedah,0,0,0
2020-05-01,LBY,Perlis,0,0,0
2020-05-01,LBY,Pulau Pinang,0,0,0
2020-05-01,LBY,Sabah,0,0,0
2020-05-01,LBY,Sarawak,0,0,0
2020-05-01,LBY,Selangor,0,0,0
2020-05-01,LCA,Johor,0,0,0
2020-05-01,LCA,Kedah,0,0,0
2020-05-01,LCA,Pulau Pinang,0,0,0
2020-05-01,LCA,Sarawak,0,0,0
2020-05-01,LCA,Selangor,0,0,0
2020-05-01,LIE,Johor,0,0,0
2020-05-01,LIE,Kedah,0,0,0
2020-05-01,LIE,Perlis,0,0,0
2020-05-01,LIE,Pulau Pinang,0,0,0
2020-05-01,LIE,Sabah,0,0,0
2020-05-01,LIE,Sarawak,0,0,0
2020-05-01,LIE,Selangor,0,0,0
2020-05-01,LKA,Johor,0,0,0
2020-05-01,LKA,Kedah,0,0,0
2020-05-01,LKA,Kelantan,0,0,0
2020-05-01,LKA,Melaka,0,0,0
2020-05-01,LKA,Pahang,0,0,0
2020-05-01,LKA,Perak,0,0,0
2020-05-01,LKA,Perlis,0,0,0
2020-05-01,LKA,Pulau Pinang,0,0,0
2020-05-01,LKA,Sabah,0,0,0
2020-05-01,LKA,Sarawak,0,0,0
2020-05-01,LKA,Selangor,1,1,0
2020-05-01,LKA,W.P. Labuan,0,0,0
2020-05-01,LSO,Johor,0,0,0
2020-05-01,LSO,Kedah,0,0,0
2020-05-01,LSO,Pulau Pinang,0,0,0
2020-05-01,LSO,Sarawak,0,0,0
2020-05-01,LSO,Selangor,0,0,0
2020-05-01,LTU,Johor,2,2,0
2020-05-01,LTU,Kedah,0,0,0
2020-05-01,LTU,Kelantan,0,0,0
2020-05-01,LTU,Pahang,0,0,0
2020-05-01,LTU,Perak,0,0,0
2020-05-01,LTU,Perlis,0,0,0
2020-05-01,LTU,Pulau Pinang,0,0,0
2020-05-01,LTU,Sabah,0,0,0
2020-05-01,LTU,Sarawak,0,0,0
2020-05-01,LTU,Selangor,1,1,0
2020-05-01,LTU,W.P. Labuan,0,0,0
2020-05-01,LUX,Johor,0,0,0
2020-05-01,LUX,Kedah,0,0,0
2020-05-01,LUX,Kelantan,0,0,0
2020-05-01,LUX,Perak,0,0,0
2020-05-01,LUX,Perlis,0,0,0
2020-05-01,LUX,Pulau Pinang,0,0,0
2020-05-01,LUX,Sabah,0,0,0
2020-05-01,LUX,Sarawak,0,0,0
2020-05-01,LUX,Selangor,0,0,0
2020-05-01,LVA,Johor,2,2,0
2020-05-01,LVA,Kedah,0,0,0
2020-05-01,LVA,Kelantan,0,0,0
2020-05-01,LVA,Pahang,0,0,0
2020-05-01,LVA,Perak,0,0,0
2020-05-01,LVA,Perlis,0,0,0
2020-05-01,LVA,Pulau Pinang,0,0,0
2020-05-01,LVA,Sabah,0,0,0
2020-05-01,LVA,Sarawak,0,0,0
2020-05-01,LVA,Selangor,1,1,0
2020-05-01,LVA,W.P. Labuan,0,0,0
2020-05-01,MAC,Johor,0,0,0
2020-05-01,MAC,Pahang,0,0,0
2020-05-01,MAC,Perak,0,0,0
2020-05-01,MAC,Selangor,0,0,0
2020-05-01,MAC,W.P. Labuan,0,0,0
2020-05-01,MAR,Johor,0,0,0
2020-05-01,MAR,Kedah,0,0,0
2020-05-01,MAR,Kelantan,0,0,0
2020-05-01,MAR,Melaka,0,0,0
2020-05-01,MAR,Pahang,0,0,0
2020-05-01,MAR,Perak,0,0,0
2020-05-01,MAR,Perlis,0,0,0
2020-05-01,MAR,Pulau Pinang,0,0,0
2020-05-01,MAR,Sabah,0,0,0
2020-05-01,MAR,Sarawak,0,0,0
2020-05-01,MAR,Selangor,0,0,0
2020-05-01,MAR,W.P. Labuan,0,0,0
2020-05-01,MCO,Johor,0,0,0
2020-05-01,MCO,Kedah,0,0,0
2020-05-01,MCO,Sabah,0,0,0
2020-05-01,MCO,Selangor,0,0,0
2020-05-01,MDA,Johor,0,0,0
2020-05-01,MDA,Kedah,0,0,0
2020-05-01,MDA,Kelantan,0,0,0
2020-05-01,MDA,Negeri Sembilan,0,0,0
2020-05-01,MDA,Perlis,0,0,0
2020-05-01,MDA,Pulau Pinang,0,0,0
2020-05-01,MDA,Sabah,0,0,0
2020-05-01,MDA,Sarawak,0,0,0
2020-05-01,MDA,Selangor,0,0,0
2020-05-01,MDG,Johor,0,0,0
2020-05-01,MDG,Kedah,0,0,0
2020-05-01,MDG,Perak,0,0,0
2020-05-01,MDG,Perlis,0,0,0
2020-05-01,MDG,Pulau Pinang,0,0,0
2020-05-01,MDG,Sabah,0,0,0
2020-05-01,MDG,Sarawak,0,0,0
2020-05-01,MDG,Selangor,0,0,0
2020-05-01,MDV,Johor,0,0,0
2020-05-01,MDV,Kedah,0,0,0
2020-05-01,MDV,Kelantan,0,0,0
2020-05-01,MDV,Perak,0,0,0
2020-05-01,MDV,Perlis,0,0,0
2020-05-01,MDV,Pulau Pinang,0,0,0
2020-05-01,MDV,Sabah,0,0,0
2020-05-01,MDV,Sarawak,0,0,0
2020-05-01,MDV,Selangor,0,0,0
2020-05-01,MEX,Johor,0,0,0
2020-05-01,MEX,Kedah,0,0,0
2020-05-01,MEX,Kelantan,0,0,0
2020-05-01,MEX,Pahang,0,0,0
2020-05-01,MEX,Perak,0,0,0
2020-05-01,MEX,Perlis,0,0,0
2020-05-01,MEX,Pulau Pinang,0,0,0
2020-05-01,MEX,Sabah,0,0,0
2020-05-01,MEX,Sarawak,0,0,0
2020-05-01,MEX,Selangor,0,0,0
2020-05-01,MEX,W.P. Labuan,0,0,0
2020-05-01,MHL,Johor,0,0,0
2020-05-01,MHL,Kedah,0,0,0
2020-05-01,MHL,Perak,0,0,0
2020-05-01,MHL,Pulau Pinang,0,0,0
2020-05-01,MHL,Sabah,0,0,0
2020-05-01,MHL,Selangor,0,0,0
2020-05-01,MKD,Johor,0,0,0
2020-05-01,MKD,Kedah,0,0,0
2020-05-01,MKD,Perak,0,0,0
2020-05-01,MKD,Pulau Pinang,0,0,0
2020-05-01,MKD,Sabah,0,0,0
2020-05-01,MKD,Sarawak,0,0,0
2020-05-01,MKD,Selangor,0,0,0
2020-05-01,MLI,Johor,0,0,0
2020-05-01,MLI,Sabah,0,0,0
2020-05-01,MLI,Selangor,0,0,0
2020-05-01,MLT,Johor,0,0,0
2020-05-01,MLT,Kedah,0,0,0
2020-05-01,MLT,Kelantan,0,0,0
2020-05-01,MLT,Perak,0,0,0
2020-05-01,MLT,Perlis,0,0,0
2020-05-01,MLT,Pulau Pinang,0,0,0
2020-05-01,MLT,Sabah,0,0,0
2020-05-01,MLT,Sarawak,0,0,0
2020-05-01,MLT,Selangor,0,0,0
2020-05-01,MLT,W.P. Labuan,0,0,0
2020-05-01,MMR,Johor,2,2,0
2020-05-01,MMR,Kedah,0,0,0
2020-05-01,MMR,Kelantan,0,0,0
2020-05-01,MMR,Negeri Sembilan,0,0,0
2020-05-01,MMR,Pahang,0,0,0
2020-05-01,MMR,Perak,0,0,0
2020-05-01,MMR,Perlis,0,0,0
2020-05-01,MMR,Pulau Pinang,0,0,0
2020-05-01,MMR,Sabah,0,0,0
2020-05-01,MMR,Sarawak,0,0,0
2020-05-01,MMR,Selangor,8,4,4
2020-05-01,MMR,Terengganu,0,0,0
2020-05-01,MMR,W.P. Labuan,0,0,0
2020-05-01,MNE,Johor,0,0,0
2020-05-01,MNE,Kedah,0,0,0
2020-05-01,MNE,Pulau Pinang,0,0,0
2020-05-01,MNE,Sabah,0,0,0
2020-05-01,MNE,Sarawak,0,0,0
2020-05-01,MNE,Selangor,0,0,0
2020-05-01,MNG,Johor,0,0,0
2020-05-01,MNG,Kedah,0,0,0
2020-05-01,MNG,Kelantan,0,0,0
2020-05-01,MNG,Perak,0,0,0
2020-05-01,MNG,Perlis,0,0,0
2020-05-01,MNG,Pulau Pinang,0,0,0
2020-05-01,MNG,Sabah,0,0,0
2020-05-01,MNG,Sarawak,0,0,0
2020-05-01,MNG,Selangor,0,0,0
2020-05-01,MNP,Selangor,0,0,0
2020-05-01,MOZ,Johor,0,0,0
2020-05-01,MOZ,Kedah,0,0,0
2020-05-01,MOZ,Perak,0,0,0
2020-05-01,MOZ,Pulau Pinang,0,0,0
2020-05-01,MOZ,Sabah,0,0,0
2020-05-01,MOZ,Sarawak,0,0,0
2020-05-01,MOZ,Selangor,0,0,0
2020-05-01,MRT,Johor,0,0,0
2020-05-01,MRT,Kedah,0,0,0
2020-05-01,MRT,Pulau Pinang,0,0,0
2020-05-01,MRT,Sabah,0,0,0
2020-05-01,MRT,Sarawak,0,0,0
2020-05-01,MRT,Selangor,0,0,0
2020-05-01,MUS,Johor,0,0,0
2020-05-01,MUS,Kedah,0,0,0
2020-05-01,MUS,Kelantan,0,0,0
2020-05-01,MUS,Pahang,0,0,0
2020-05-01,MUS,Perak,0,0,0
2020-05-01,MUS,Perlis,0,0,0
2020-05-01,MUS,Pulau Pinang,0,0,0
2020-05-01,MUS,Sabah,0,0,0
2020-05-01,MUS,Sarawak,0,0,0
2020-05-01,MUS,Selangor,0,0,0
2020-05-01,MWI,Johor,0,0,0
2020-05-01,MWI,Pulau Pinang,0,0,0
2020-05-01,MWI,Sabah,0,0,0
2020-05-01,MWI,Sarawak,0,0,0
2020-05-01,MWI,Selangor,0,0,0
2020-05-01,MYT,Selangor,0,0,0
2020-05-01,NAM,Johor,0,0,0
2020-05-01,NAM,Kedah,0,0,0
2020-05-01,NAM,Perak,0,0,0
2020-05-01,NAM,Perlis,0,0,0
2020-05-01,NAM,Pulau Pinang,0,0,0
2020-05-01,NAM,Sabah,0,0,0
2020-05-01,NAM,Sarawak,0,0,0
2020-05-01,NAM,Selangor,0,0,0
2020-05-01,NCL,Selangor,0,0,0
2020-05-01,NER,Johor,0,0,0
2020-05-01,NER,Sabah,0,0,0
2020-05-01,NER,Selangor,0,0,0
2020-05-01,NGA,Johor,0,0,0
2020-05-01,NGA,Kedah,0,0,0
2020-05-01,NGA,Perlis,0,0,0
2020-05-01,NGA,Pulau Pinang,0,0,0
2020-05-01,NGA,Sabah,0,0,0
2020-05-01,NGA,Sarawak,0,0,0
2020-05-01,NGA,Selangor,1,1,0
2020-05-01,NIC,Johor,0,0,0
2020-05-01,NIC,Kedah,0,0,0
2020-05-01,NIC,Pulau Pinang,0,0,0
2020-05-01,NIC,Sabah,0,0,0
2020-05-01,NIC,Selangor,0,0,0
2020-05-01,NLD,Johor,4,4,0
2020-05-01,NLD,Kedah,0,0,0
2020-05-01,NLD,Kelantan,0,0,0
2020-05-01,NLD,Melaka,0,0,0
2020-05-01,NLD,Negeri Sembilan,0,0,0
2020-05-01,NLD,Pahang,0,0,0
2020-05-01,NLD,Perak,0,0,0
2020-05-01,NLD,Perlis,0,0,0
2020-05-01,NLD,Pulau Pinang,0,0,0
2020-05-01,NLD,Sabah,0,0,0
2020-05-01,NLD,Sarawak,0,0,0
2020-05-01,NLD,Selangor,12,8,4
2020-05-01,NLD,Terengganu,0,0,0
2020-05-01,NLD,W.P. Labuan,0,0,0
2020-05-01,NOR,Johor,0,0,0
2020-05-01,NOR,Kedah,0,0,0
2020-05-01,NOR,Kelantan,0,0,0
2020-05-01,NOR,Melaka,0,0,0
2020-05-01,NOR,Pahang,0,0,0
2020-05-01,NOR,Perak,0,0,0
2020-05-01,NOR,Perlis,0,0,0
2020-05-01,NOR,Pulau Pinang,0,0,0
2020-05-01,NOR,Sabah,0,0,0
2020-05-01,NOR,Sarawak,0,0,0
2020-05-01,NOR,Selangor,2,2,0
2020-05-01,NOR,W.P. Labuan,0,0,0
2020-05-01,NPL,Johor,0,0,0
2020-05-01,NPL,Kedah,0,0,0
2020-05-01,NPL,Pahang,0,0,0
2020-05-01,NPL,Perak,0,0,0
2020-05-01,NPL,Perlis,0,0,0
2020-05-01,NPL,Pulau Pinang,0,0,0
2020-05-01,NPL,Sabah,0,0,0
2020-05-01,NPL,Sarawak,0,0,0
2020-05-01,NPL,Selangor,0,0,0
2020-05-01,NPL,W.P. Labuan,0,0,0
2020-05-01,NRU,Johor,0,0,0
2020-05-01,NRU,Pulau Pinang,0,0,0
2020-05-01,NRU,Selangor,0,0,0
2020-05-01,NZL,Johor,0,0,0
2020-05-01,NZL,Kedah,2,1,1
2020-05-01,NZL,Kelantan,0,0,0
2020-05-01,NZL,Melaka,0,0,0
2020-05-01,NZL,Negeri Sembilan,0,0,0
2020-05-01,NZL,Pahang,0,0,0
2020-05-01,NZL,Perak,0,0,0
2020-05-01,NZL,Perlis,0,0,0
2020-05-01,NZL,Pulau Pinang,0,0,0
2020-05-01,NZL,Sabah,0,0,0
2020-05-01,NZL,Sarawak,0,0,0
2020-05-01,NZL,Selangor,5,5,0
2020-05-01,NZL,Terengganu,0,0,0
2020-05-01,NZL,W.P. Labuan,0,0,0
2020-05-01,OMN,Johor,0,0,0
2020-05-01,OMN,Kedah,0,0,0
2020-05-01,OMN,Kelantan,0,0,0
2020-05-01,OMN,Melaka,0,0,0
2020-05-01,OMN,Perak,0,0,0
2020-05-01,OMN,Perlis,0,0,0
2020-05-01,OMN,Pulau Pinang,0,0,0
2020-05-01,OMN,Sabah,0,0,0
2020-05-01,OMN,Sarawak,0,0,0
2020-05-01,OMN,Selangor,0,0,0
2020-05-01,PAK,Johor,0,0,0
2020-05-01,PAK,Kedah,0,0,0
2020-05-01,PAK,Kelantan,0,0,0
2020-05-01,PAK,Melaka,0,0,0
2020-05-01,PAK,Negeri Sembilan,0,0,0
2020-05-01,PAK,Pahang,0,0,0
2020-05-01,PAK,Perak,0,0,0
2020-05-01,PAK,Perlis,0,0,0
2020-05-01,PAK,Pulau Pinang,0,0,0
2020-05-01,PAK,Sabah,0,0,0
2020-05-01,PAK,Sarawak,0,0,0
2020-05-01,PAK,Selangor,35,31,4
2020-05-01,PAK,W.P. Labuan,0,0,0
2020-05-01,PAN,Johor,0,0,0
2020-05-01,PAN,Kedah,0,0,0
2020-05-01,PAN,Perak,0,0,0
2020-05-01,PAN,Perlis,0,0,0
2020-05-01,PAN,Pulau Pinang,0,0,0
2020-05-01,PAN,Sabah,0,0,0
2020-05-01,PAN,Sarawak,0,0,0
2020-05-01,PAN,Selangor,0,0,0
2020-05-01,PER,Johor,0,0,0
2020-05-01,PER,Kedah,0,0,0
2020-05-01,PER,Kelantan,0,0,0
2020-05-01,PER,Pahang,0,0,0
2020-05-01,PER,Perak,0,0,0
2020-05-01,PER,Perlis,0,0,0
2020-05-01,PER,Pulau Pinang,0,0,0
2020-05-01,PER,Sabah,0,0,0
2020-05-01,PER,Sarawak,0,0,0
2020-05-01,PER,Selangor,0,0,0
2020-05-01,PER,W.P. Labuan,0,0,0
2020-05-01,PHL,Johor,3,0,3
2020-05-01,PHL,Kedah,0,0,0
2020-05-01,PHL,Kelantan,0,0,0
2020-05-01,PHL,Melaka,0,0,0
2020-05-01,PHL,Negeri Sembilan,0,0,0
2020-05-01,PHL,Pahang,0,0,0
2020-05-01,PHL,Perak,0,0,0
2020-05-01,PHL,Perlis,0,0,0
2020-05-01,PHL,Pulau Pinang,0,0,0
2020-05-01,PHL,Sabah,1,0,1
2020-05-01,PHL,Sarawak,14,14,0
2020-05-01,PHL,Selangor,9,4,5
2020-05-01,PHL,Terengganu,0,0,0
2020-05-01,PHL,W.P. Labuan,0,0,0
2020-05-01,PLW,Johor,0,0,0
2020-05-01,PLW,Pulau Pinang,0,0,0
2020-05-01,PLW,Selangor,0,0,0
2020-05-01,PNG,Johor,0,0,0
2020-05-01,PNG,Kedah,0,0,0
2020-05-01,PNG,Kelantan,0,0,0
2020-05-01,PNG,Perak,0,0,0
2020-05-01,PNG,Pulau Pinang,0,0,0
2020-05-01,PNG,Sabah,0,0,0
2020-05-01,PNG,Sarawak,0,0,0
2020-05-01,PNG,Selangor,0,0,0
2020-05-01,POL,Johor,6,6,0
2020-05-01,POL,Kedah,0,0,0
2020-05-01,POL,Kelantan,0,0,0
2020-05-01,POL,Melaka,0,0,0
2020-05-01,POL,Negeri Sembilan,0,0,0
2020-05-01,POL,Pahang,0,0,0
2020-05-01,POL,Perak,0,0,0
2020-05-01,POL,Perlis,0,0,0
2020-05-01,POL,Pulau Pinang,0,0,0
2020-05-01,POL,Sabah,0,0,0
2020-05-01,POL,Sarawak,0,0,0
2020-05-01,POL,Selangor,6,6,0
2020-05-01,POL,Terengganu,0,0,0
2020-05-01,POL,W.P. Labuan,0,0,0
2020-05-01,PRK,Selangor,0,0,0
2020-05-01,PRT,Johor,0,0,0
2020-05-01,PRT,Kedah,0,0,0
2020-05-01,PRT,Kelantan,0,0,0
2020-05-01,PRT,Melaka,0,0,0
2020-05-01,PRT,Pahang,0,0,0
2020-05-01,PRT,Perak,0,0,0
2020-05-01,PRT,Perlis,0,0,0
2020-05-01,PRT,Pulau Pinang,0,0,0
2020-05-01,PRT,Sabah,0,0,0
2020-05-01,PRT,Sarawak,0,0,0
2020-05-01,PRT,Selangor,1,1,0
2020-05-01,PRT,W.P. Labuan,0,0,0
2020-05-01,PRY,Johor,0,0,0
2020-05-01,PRY,Kedah,0,0,0
2020-05-01,PRY,Perak,0,0,0
2020-05-01,PRY,Perlis,0,0,0
2020-05-01,PRY,Pulau Pinang,0,0,0
2020-05-01,PRY,Sabah,0,0,0
2020-05-01,PRY,Sarawak,0,0,0
2020-05-01,PRY,Selangor,0,0,0
2020-05-01,PSE,Johor,0,0,0
2020-05-01,PSE,Kedah,0,0,0
2020-05-01,PSE,Kelantan,0,0,0
2020-05-01,PSE,Melaka,0,0,0
2020-05-01,PSE,Perak,0,0,0
2020-05-01,PSE,Perlis,0,0,0
2020-05-01,PSE,Pulau Pinang,0,0,0
2020-05-01,PSE,Sabah,0,0,0
2020-05-01,PSE,Sarawak,0,0,0
2020-05-01,PSE,Selangor,2,1,1
2020-05-01,QAT,Johor,0,0,0
2020-05-01,QAT,Kedah,0,0,0
2020-05-01,QAT,Perlis,0,0,0
2020-05-01,QAT,Pulau Pinang,0,0,0
2020-05-01,QAT,Sabah,0,0,0
2020-05-01,QAT,Sarawak,0,0,0
2020-05-01,QAT,Selangor,0,0,0
2020-05-01,REU,Johor,0,0,0
2020-05-01,REU,Sarawak,0,0,0
2020-05-01,ROU,Johor,2,2,0
2020-05-01,ROU,Kedah,0,0,0
2020-05-01,ROU,Kelantan,0,0,0
2020-05-01,ROU,Negeri Sembilan,0,0,0
2020-05-01,ROU,Pahang,0,0,0
2020-05-01,ROU,Perak,0,0,0
2020-05-01,ROU,Perlis,0,0,0
2020-05-01,ROU,Pulau Pinang,0,0,0
2020-05-01,ROU,Sabah,0,0,0
2020-05-01,ROU,Sarawak,0,0,0
2020-05-01,ROU,Selangor,0,0,0
2020-05-01,ROU,W.P. Labuan,0,0,0
2020-05-01,RUS,Johor,0,0,0
2020-05-01,RUS,Kedah,0,0,0
2020-05-01,RUS,Kelantan,0,0,0
2020-05-01,RUS,Melaka,0,0,0
2020-05-01,RUS,Negeri Sembilan,0,0,0
2020-05-01,RUS,Pahang,0,0,0
2020-05-01,RUS,Perak,0,0,0
2020-05-01,RUS,Perlis,0,0,0
2020-05-01,RUS,Pulau Pinang,0,0,0
2020-05-01,RUS,Sabah,0,0,0
2020-05-01,RUS,Sarawak,0,0,0
2020-05-01,RUS,Selangor,6,4,2
2020-05-01,RUS,W.P. Labuan,0,0,0
2020-05-01,RWA,Johor,0,0,0
2020-05-01,RWA,Kedah,0,0,0
2020-05-01,RWA,Pulau Pinang,0,0,0
2020-05-01,RWA,Selangor,0,0,0
2020-05-01,SAU,Johor,0,0,0
2020-05-01,SAU,Kedah,0,0,0
2020-05-01,SAU,Kelantan,0,0,0
2020-05-01,SAU,Melaka,0,0,0
2020-05-01,SAU,Perak,0,0,0
2020-05-01,SAU,Perlis,0,0,0
2020-05-01,SAU,Pulau Pinang,0,0,0
2020-05-01,SAU,Sabah,0,0,0
2020-05-01,SAU,Sarawak,0,0,0
2020-05-01,SAU,Selangor,0,0,0
2020-05-01,SAU,W.P. Labuan,0,0,0
2020-05-01,SDN,Johor,0,0,0
2020-05-01,SDN,Kedah,0,0,0
2020-05-01,SDN,Kelantan,0,0,0
2020-05-01,SDN,Perlis,0,0,0
2020-05-01,SDN,Pulau Pinang,0,0,0
2020-05-01,SDN,Sabah,0,0,0
2020-05-01,SDN,Sarawak,0,0,0
2020-05-01,SDN,Selangor,0,0,0
2020-05-01,SDN,W.P. Labuan,0,0,0
2020-05-01,SEN,Johor,0,0,0
2020-05-01,SEN,Kedah,0,0,0
2020-05-01,SEN,Kelantan,0,0,0
2020-05-01,SEN,Perak,0,0,0
2020-05-01,SEN,Perlis,0,0,0
2020-05-01,SEN,Pulau Pinang,0,0,0
2020-05-01,SEN,Sabah,0,0,0
2020-05-01,SEN,Sarawak,0,0,0
2020-05-01,SEN,Selangor,0,0,0
2020-05-01,SGP,Johor,56,53,3
2020-05-01,SGP,Kedah,0,0,0
2020-05-01,SGP,Kelantan,0,0,0
2020-05-01,SGP,Melaka,0,0,0
2020-05-01,SGP,Negeri Sembilan,0,0,0
2020-05-01,SGP,Pahang,0,0,0
2020-05-01,SGP,Perak,0,0,0
2020-05-01,SGP,Perlis,0,0,0
2020-05-01,SGP,Pulau Pinang,0,0,0
2020-05-01,SGP,Sabah,0,0,0
2020-05-01,SGP,Sarawak,3,0,3
2020-05-01,SGP,Selangor,21,10,11
2020-05-01,SGP,Terengganu,0,0,0
2020-05-01,SGP,W.P. Labuan,0,0,0
2020-05-01,SGS,Johor,0,0,0
2020-05-01,SGS,Sabah,0,0,0
2020-05-01,SGS,Selangor,0,0,0
2020-05-01,SHN,Sarawak,0,0,0
2020-05-01,SLB,Johor,0,0,0
2020-05-01,SLB,Perlis,0,0,0
2020-05-01,SLB,Pulau Pinang,0,0,0
2020-05-01,SLB,Sabah,0,0,0
2020-05-01,SLB,Sarawak,0,0,0
2020-05-01,SLB,Selangor,0,0,0
2020-05-01,SLB,W.P. Labuan,0,0,0
2020-05-01,SLE,Johor,0,0,0
2020-05-01,SLE,Kedah,0,0,0
2020-05-01,SLE,Perak,0,0,0
2020-05-01,SLE,Pulau Pinang,0,0,0
2020-05-01,SLE,Sabah,0,0,0
2020-05-01,SLE,Selangor,0,0,0
2020-05-01,SLV,Johor,0,0,0
2020-05-01,SLV,Kedah,0,0,0
2020-05-01,SLV,Perak,0,0,0
2020-05-01,SLV,Perlis,0,0,0
2020-05-01,SLV,Pulau Pinang,0,0,0
2020-05-01,SLV,Sabah,0,0,0
2020-05-01,SLV,Selangor,0,0,0
2020-05-01,SLV,W.P. Labuan,0,0,0
2020-05-01,SMR,Johor,0,0,0
2020-05-01,SMR,Selangor,0,0,0
2020-05-01,SOM,Johor,0,0,0
2020-05-01,SOM,Kedah,0,0,0
2020-05-01,SOM,Kelantan,0,0,0
2020-05-01,SOM,Perlis,0,0,0
2020-05-01,SOM,Sabah,0,0,0
2020-05-01,SOM,Sarawak,0,0,0
2020-05-01,SOM,Selangor,0,0,0
2020-05-01,SRB,Johor,0,0,0
2020-05-01,SRB,Kedah,0,0,0
2020-05-01,SRB,Kelantan,0,0,0
2020-05-01,SRB,Pahang,0,0,0
2020-05-01,SRB,Perak,0,0,0
2020-05-01,SRB,Perlis,0,0,0
2020-05-01,SRB,Pulau Pinang,0,0,0
2020-05-01,SRB,Sabah,0,0,0
2020-05-01,SRB,Sarawak,0,0,0
2020-05-01,SRB,Selangor,0,0,0
2020-05-01,SSD,Johor,0,0,0
2020-05-01,SSD,Kedah,0,0,0
2020-05-01,SSD,Sarawak,0,0,0
2020-05-01,SSD,Selangor,0,0,0
2020-05-01,SSD,W.P. Labuan,0,0,0
2020-05-01,STP,Selangor,0,0,0
2020-05-01,SUR,Johor,0,0,0
2020-05-01,SUR,Kedah,0,0,0
2020-05-01,SUR,Kelantan,0,0,0
2020-05-01,SUR,Perak,0,0,0
2020-05-01,SUR,Perlis,0,0,0
2020-05-01,SUR,Pulau Pinang,0,0,0
2020-05-01,SUR,Sabah,0,0,0
2020-05-01,SUR,Sarawak,0,0,0
2020-05-01,SUR,Selangor,0,0,0
2020-05-01,SVK,Johor,0,0,0
2020-05-01,SVK,Kedah,0,0,0
2020-05-01,SVK,Kelantan,0,0,0
2020-05-01,SVK,Negeri Sembilan,0,0,0
2020-05-01,SVK,Pahang,0,0,0
2020-05-01,SVK,Perak,0,0,0
2020-05-01,SVK,Perlis,0,0,0
2020-05-01,SVK,Pulau Pinang,0,0,0
2020-05-01,SVK,Sabah,0,0,0
2020-05-01,SVK,Sarawak,0,0,0
2020-05-01,SVK,Selangor,0,0,0
2020-05-01,SVK,W.P. Labuan,0,0,0
2020-05-01,SVN,Johor,0,0,0
2020-05-01,SVN,Kedah,0,0,0
2020-05-01,SVN,Kelantan,0,0,0
2020-05-01,SVN,Perak,0,0,0
2020-05-01,SVN,Perlis,0,0,0
2020-05-01,SVN,Pulau Pinang,0,0,0
2020-05-01,SVN,Sabah,0,0,0
2020-05-01,SVN,Sarawak,0,0,0
2020-05-01,SVN,Selangor,0,0,0
2020-05-01,SVN,W.P. Labuan,0,0,0
2020-05-01,SWE,Johor,0,0,0
2020-05-01,SWE,Kedah,0,0,0
2020-05-01,SWE,Kelantan,0,0,0
2020-05-01,SWE,Melaka,0,0,0
2020-05-01,SWE,Negeri Sembilan,0,0,0
2020-05-01,SWE,Pahang,0,0,0
2020-05-01,SWE,Perak,0,0,0
2020-05-01,SWE,Perlis,0,0,0
2020-05-01,SWE,Pulau Pinang,0,0,0
2020-05-01,SWE,Sabah,0,0,0
2020-05-01,SWE,Sarawak,0,0,0
2020-05-01,SWE,Selangor,1,1,0
2020-05-01,SWE,W.P. Labuan,0,0,0
2020-05-01,SWZ,Johor,0,0,0
2020-05-01,SWZ,Kedah,0,0,0
2020-05-01,SWZ,Pulau Pinang,0,0,0
2020-05-01,SWZ,Sabah,0,0,0
2020-05-01,SWZ,Selangor,0,0,0
2020-05-01,SYC,Johor,0,0,0
2020-05-01,SYC,Kedah,0,0,0
2020-05-01,SYC,Pulau Pinang,0,0,0
2020-05-01,SYC,Sabah,0,0,0
2020-05-01,SYC,Sarawak,0,0,0
2020-05-01,SYC,Selangor,0,0,0
2020-05-01,SYR,Johor,0,0,0
2020-05-01,SYR,Kedah,0,0,0
2020-05-01,SYR,Kelantan,0,0,0
2020-05-01,SYR,Pahang,0,0,0
2020-05-01,SYR,Perlis,0,0,0
2020-05-01,SYR,Pulau Pinang,0,0,0
2020-05-01,SYR,Sabah,0,0,0
2020-05-01,SYR,Sarawak,0,0,0
2020-05-01,SYR,Selangor,0,0,0
2020-05-01,SYR,W.P. Labuan,0,0,0
2020-05-01,TCA,Perlis,0,0,0
2020-05-01,TCD,Johor,0,0,0
2020-05-01,TCD,Kedah,0,0,0
2020-05-01,TCD,Perlis,0,0,0
2020-05-01,TCD,Selangor,0,0,0
2020-05-01,TGO,Johor,0,0,0
2020-05-01,TGO,Perak,0,0,0
2020-05-01,TGO,Pulau Pinang,0,0,0
2020-05-01,TGO,Selangor,0,0,0
2020-05-01,THA,Johor,88,88,0
2020-05-01,THA,Kedah,12912,12099,813
2020-05-01,THA,Kelantan,18,6,12
2020-05-01,THA,Melaka,0,0,0
2020-05-01,THA,Negeri Sembilan,0,0,0
2020-05-01,THA,Pahang,0,0,0
2020-05-01,THA,Perak,0,0,0
2020-05-01,THA,Perlis,24,3,21
2020-05-01,THA,Pulau Pinang,0,0,0
2020-05-01,THA,Sabah,0,0,0
2020-05-01,THA,Sarawak,6,6,0
2020-05-01,THA,Selangor,89,75,14
2020-05-01,THA,Terengganu,0,0,0
2020-05-01,THA,W.P. Labuan,0,0,0
2020-05-01,TJK,Johor,0,0,0
2020-05-01,TJK,Kedah,0,0,0
2020-05-01,TJK,Perlis,0,0,0
2020-05-01,TJK,Pulau Pinang,0,0,0
2020-05-01,TJK,Sabah,0,0,0
2020-05-01,TJK,Selangor,0,0,0
2020-05-01,TKL,Selangor,0,0,0
2020-05-01,TKM,Johor,0,0,0
2020-05-01,TKM,Kedah,0,0,0
2020-05-01,TKM,Kelantan,0,0,0
2020-05-01,TKM,Perlis,0,0,0
2020-05-01,TKM,Pulau Pinang,0,0,0
2020-05-01,TKM,Sabah,0,0,0
2020-05-01,TKM,Sarawak,0,0,0
2020-05-01,TKM,Selangor,0,0,0
2020-05-01,TLS,Johor,0,0,0
2020-05-01,TLS,Kedah,0,0,0
2020-05-01,TLS,Perlis,0,0,0
2020-05-01,TLS,Pulau Pinang,0,0,0
2020-05-01,TLS,Sabah,0,0,0
2020-05-01,TLS,Sarawak,0,0,0
2020-05-01,TLS,Selangor,1,1,0
2020-05-01,TON,Johor,0,0,0
2020-05-01,TON,Pulau Pinang,0,0,0
2020-05-01,TON,Sarawak,0,0,0
2020-05-01,TON,Selangor,0,0,0
2020-05-01,TTO,Johor,0,0,0
2020-05-01,TTO,Kedah,0,0,0
2020-05-01,TTO,Pahang,0,0,0
2020-05-01,TTO,Pulau Pinang,0,0,0
2020-05-01,TTO,Sabah,0,0,0
2020-05-01,TTO,Sarawak,0,0,0
2020-05-01,TTO,Selangor,0,0,0
2020-05-01,TUN,Johor,0,0,0
2020-05-01,TUN,Kedah,0,0,0
2020-05-01,TUN,Kelantan,0,0,0
2020-05-01,TUN,Melaka,0,0,0
2020-05-01,TUN,Perak,0,0,0
2020-05-01,TUN,Perlis,0,0,0
2020-05-01,TUN,Pulau Pinang,0,0,0
2020-05-01,TUN,Sabah,0,0,0
2020-05-01,TUN,Sarawak,0,0,0
2020-05-01,TUN,Selangor,0,0,0
2020-05-01,TUN,W.P. Labuan,0,0,0
2020-05-01,TUR,Johor,0,0,0
2020-05-01,TUR,Kedah,0,0,0
2020-05-01,TUR,Kelantan,0,0,0
2020-05-01,TUR,Melaka,0,0,0
2020-05-01,TUR,Negeri Sembilan,0,0,0
2020-05-01,TUR,Pahang,0,0,0
2020-05-01,TUR,Perak,0,0,0
2020-05-01,TUR,Perlis,0,0,0
2020-05-01,TUR,Pulau Pinang,0,0,0
2020-05-01,TUR,Sabah,0,0,0
2020-05-01,TUR,Sarawak,3,2,1
2020-05-01,TUR,Selangor,8,7,1
2020-05-01,TUR,W.P. Labuan,0,0,0
2020-05-01,TUV,Selangor,0,0,0
2020-05-01,TWN,Johor,0,0,0
2020-05-01,TWN,Kedah,0,0,0
2020-05-01,TWN,Kelantan,0,0,0
2020-05-01,TWN,Melaka,0,0,0
2020-05-01,TWN,Negeri Sembilan,0,0,0
2020-05-01,TWN,Pahang,0,0,0
2020-05-01,TWN,Perak,0,0,0
2020-05-01,TWN,Perlis,0,0,0
2020-05-01,TWN,Pulau Pinang,0,0,0
2020-05-01,TWN,Sabah,0,0,0
2020-05-01,TWN,Sarawak,0,0,0
2020-05-01,TWN,Selangor,2,0,2
2020-05-01,TWN,W.P. Labuan,0,0,0
2020-05-01,TZA,Johor,0,0,0
2020-05-01,TZA,Kedah,0,0,0
2020-05-01,TZA,Perak,0,0,0
2020-05-01,TZA,Perlis,0,0,0
2020-05-01,TZA,Pulau Pinang,0,0,0
2020-05-01,TZA,Sabah,0,0,0
2020-05-01,TZA,Sarawak,0,0,0
2020-05-01,TZA,Selangor,0,0,0
2020-05-01,UGA,Johor,0,0,0
2020-05-01,UGA,Kedah,0,0,0
2020-05-01,UGA,Perak,0,0,0
2020-05-01,UGA,Perlis,0,0,0
2020-05-01,UGA,Pulau Pinang,0,0,0
2020-05-01,UGA,Sabah,0,0,0
2020-05-01,UGA,Sarawak,0,0,0
2020-05-01,UGA,Selangor,0,0,0
2020-05-01,UKR,Johor,2,2,0
2020-05-01,UKR,Kedah,0,0,0
2020-05-01,UKR,Kelantan,0,0,0
2020-05-01,UKR,Melaka,0,0,0
2020-05-01,UKR,Negeri Sembilan,0,0,0
2020-05-01,UKR,Pahang,0,0,0
2020-05-01,UKR,Perak,0,0,0
2020-05-01,UKR,Perlis,0,0,0
2020-05-01,UKR,Pulau Pinang,0,0,0
2020-05-01,UKR,Sabah,10,10,0
2020-05-01,UKR,Sarawak,0,0,0
2020-05-01,UKR,Selangor,0,0,0
2020-05-01,UKR,W.P. Labuan,0,0,0
2020-05-01,URY,Johor,0,0,0
2020-05-01,URY,Kedah,0,0,0
2020-05-01,URY,Kelantan,0,0,0
2020-05-01,URY,Perak,0,0,0
2020-05-01,URY,Perlis,0,0,0
2020-05-01,URY,Pulau Pinang,0,0,0
2020-05-01,URY,Sabah,0,0,0
2020-05-01,URY,Sarawak,0,0,0
2020-05-01,URY,Selangor,0,0,0
2020-05-01,URY,W.P. Labuan,0,0,0
2020-05-01,USA,Johor,0,0,0
2020-05-01,USA,Kedah,0,0,0
2020-05-01,USA,Kelantan,0,0,0
2020-05-01,USA,Melaka,0,0,0
2020-05-01,USA,Negeri Sembilan,0,0,0
2020-05-01,USA,Pahang,0,0,0
2020-05-01,USA,Perak,0,0,0
2020-05-01,USA,Perlis,0,0,0
2020-05-01,USA,Pulau Pinang,1,1,0
2020-05-01,USA,Sabah,0,0,0
2020-05-01,USA,Sarawak,0,0,0
2020-05-01,USA,Selangor,22,18,4
2020-05-01,USA,Terengganu,0,0,0
2020-05-01,USA,W.P. Labuan,0,0,0
2020-05-01,UZB,Johor,0,0,0
2020-05-01,UZB,Kedah,0,0,0
2020-05-01,UZB,Kelantan,0,0,0
2020-05-01,UZB,Perak,0,0,0
2020-05-01,UZB,Perlis,0,0,0
2020-05-01,UZB,Pulau Pinang,0,0,0
2020-05-01,UZB,Sabah,0,0,0
2020-05-01,UZB,Sarawak,0,0,0
2020-05-01,UZB,Selangor,0,0,0
2020-05-01,VAT,Johor,0,0,0
2020-05-01,VAT,Sarawak,0,0,0
2020-05-01,VAT,Selangor,0,0,0
2020-05-01,VCT,Johor,0,0,0
2020-05-01,VCT,Kedah,0,0,0
2020-05-01,VCT,Pulau Pinang,0,0,0
2020-05-01,VCT,Sarawak,0,0,0
2020-05-01,VCT,Selangor,0,0,0
2020-05-01,VEN,Johor,0,0,0
2020-05-01,VEN,Kedah,0,0,0
2020-05-01,VEN,Kelantan,0,0,0
2020-05-01,VEN,Melaka,0,0,0
2020-05-01,VEN,Perak,0,0,0
2020-05-01,VEN,Perlis,0,0,0
2020-05-01,VEN,Pulau Pinang,0,0,0
2020-05-01,VEN,Sabah,0,0,0
2020-05-01,VEN,Sarawak,0,0,0
2020-05-01,VEN,Selangor,0,0,0
2020-05-01,VEN,W.P. Labuan,0,0,0
2020-05-01,VNM,Johor,4,3,1
2020-05-01,VNM,Kedah,0,0,0
2020-05-01,VNM,Kelantan,0,0,0
2020-05-01,VNM,Melaka,0,0,0
2020-05-01,VNM,Negeri Sembilan,0,0,0
2020-05-01,VNM,Pahang,0,0,0
2020-05-01,VNM,Perak,0,0,0
2020-05-01,VNM,Perlis,0,0,0
2020-05-01,VNM,Pulau Pinang,0,0,0
2020-05-01,VNM,Sabah,0,0,0
2020-05-01,VNM,Sarawak,0,0,0
2020-05-01,VNM,Selangor,46,0,46
2020-05-01,VNM,Terengganu,0,0,0
2020-05-01,VNM,W.P. Labuan,0,0,0
2020-05-01,VUT,Johor,0,0,0
2020-05-01,VUT,Kedah,0,0,0
2020-05-01,VUT,Pulau Pinang,0,0,0
2020-05-01,VUT,Sabah,0,0,0
2020-05-01,VUT,Sarawak,0,0,0
2020-05-01,VUT,Selangor,0,0,0
2020-05-01,WSM,Johor,0,0,0
2020-05-01,WSM,Sarawak,0,0,0
2020-05-01,WSM,Selangor,0,0,0
2020-05-01,XXX,Johor,0,0,0
2020-05-01,XXX,Kedah,0,0,0
2020-05-01,XXX,Kelantan,0,0,0
2020-05-01,XXX,Melaka,0,0,0
2020-05-01,XXX,Pahang,0,0,0
2020-05-01,XXX,Perak,0,0,0
2020-05-01,XXX,Perlis,0,0,0
2020-05-01,XXX,Pulau Pinang,0,0,0
2020-05-01,XXX,Sabah,0,0,0
2020-05-01,XXX,Sarawak,0,0,0
2020-05-01,XXX,Selangor,4,3,1
2020-05-01,XXX,W.P. Labuan,0,0,0
2020-05-01,YEM,Johor,0,0,0
2020-05-01,YEM,Kedah,0,0,0
2020-05-01,YEM,Kelantan,0,0,0
2020-05-01,YEM,Melaka,0,0,0
2020-05-01,YEM,Pahang,0,0,0
2020-05-01,YEM,Perak,0,0,0
2020-05-01,YEM,Perlis,0,0,0
2020-05-01,YEM,Pulau Pinang,0,0,0
2020-05-01,YEM,Sabah,0,0,0
2020-05-01,YEM,Sarawak,0,0,0
2020-05-01,YEM,Selangor,1,0,1
2020-05-01,YEM,W.P. Labuan,0,0,0
2020-05-01,ZAF,Johor,0,0,0
2020-05-01,ZAF,Kedah,0,0,0
2020-05-01,ZAF,Kelantan,0,0,0
2020-05-01,ZAF,Melaka,0,0,0
2020-05-01,ZAF,Pahang,0,0,0
2020-05-01,ZAF,Perak,0,0,0
2020-05-01,ZAF,Perlis,0,0,0
2020-05-01,ZAF,Pulau Pinang,0,0,0
2020-05-01,ZAF,Sabah,0,0,0
2020-05-01,ZAF,Sarawak,0,0,0
2020-05-01,ZAF,Selangor,1,1,0
2020-05-01,ZAF,Terengganu,0,0,0
2020-05-01,ZAF,W.P. Labuan,0,0,0
2020-05-01,ZAR,Selangor,0,0,0
2020-05-01,ZMB,Johor,0,0,0
2020-05-01,ZMB,Kedah,0,0,0
2020-05-01,ZMB,Perak,0,0,0
2020-05-01,ZMB,Perlis,0,0,0
2020-05-01,ZMB,Pulau Pinang,0,0,0
2020-05-01,ZMB,Sabah,0,0,0
2020-05-01,ZMB,Sarawak,0,0,0
2020-05-01,ZMB,Selangor,0,0,0
2020-05-01,ZWE,Johor,0,0,0
2020-05-01,ZWE,Kedah,0,0,0
2020-05-01,ZWE,Kelantan,0,0,0
2020-05-01,ZWE,Perak,0,0,0
2020-05-01,ZWE,Perlis,0,0,0
2020-05-01,ZWE,Pulau Pinang,0,0,0
2020-05-01,ZWE,Sabah,0,0,0
2020-05-01,ZWE,Sarawak,0,0,0
2020-05-01,ZWE,Selangor,0,0,0
2020-06-01,ABW,Kedah,0,0,0
2020-06-01,ABW,Pulau Pinang,0,0,0
2020-06-01,AFG,Johor,0,0,0
2020-06-01,AFG,Kedah,0,0,0
2020-06-01,AFG,Perlis,0,0,0
2020-06-01,AFG,Pulau Pinang,0,0,0
2020-06-01,AFG,Sarawak,0,0,0
2020-06-01,AFG,Selangor,1,1,0
2020-06-01,AGO,Johor,0,0,0
2020-06-01,AGO,Kedah,0,0,0
2020-06-01,AGO,Sabah,0,0,0
2020-06-01,AGO,Selangor,0,0,0
2020-06-01,AIA,Selangor,0,0,0
2020-06-01,ALB,Johor,0,0,0
2020-06-01,ALB,Kedah,0,0,0
2020-06-01,ALB,Perak,0,0,0
2020-06-01,ALB,Perlis,0,0,0
2020-06-01,ALB,Pulau Pinang,0,0,0
2020-06-01,ALB,Sabah,0,0,0
2020-06-01,ALB,Sarawak,0,0,0
2020-06-01,ALB,Selangor,0,0,0
2020-06-01,AND,Johor,0,0,0
2020-06-01,AND,Kedah,0,0,0
2020-06-01,AND,Perlis,0,0,0
2020-06-01,AND,Pulau Pinang,0,0,0
2020-06-01,AND,Selangor,0,0,0
2020-06-01,ANT,Selangor,0,0,0
2020-06-01,ARE,Johor,0,0,0
2020-06-01,ARE,Kedah,0,0,0
2020-06-01,ARE,Kelantan,0,0,0
2020-06-01,ARE,Perak,0,0,0
2020-06-01,ARE,Perlis,0,0,0
2020-06-01,ARE,Pulau Pinang,0,0,0
2020-06-01,ARE,Sabah,0,0,0
2020-06-01,ARE,Sarawak,0,0,0
2020-06-01,ARE,Selangor,2,2,0
2020-06-01,ARG,Johor,0,0,0
2020-06-01,ARG,Kedah,0,0,0
2020-06-01,ARG,Kelantan,0,0,0
2020-06-01,ARG,Melaka,0,0,0
2020-06-01,ARG,Perak,0,0,0
2020-06-01,ARG,Perlis,0,0,0
2020-06-01,ARG,Pulau Pinang,0,0,0
2020-06-01,ARG,Sabah,0,0,0
2020-06-01,ARG,Sarawak,0,0,0
2020-06-01,ARG,Selangor,0,0,0
2020-06-01,ARG,W.P. Labuan,0,0,0
2020-06-01,ARM,Johor,0,0,0
2020-06-01,ARM,Kedah,0,0,0
2020-06-01,ARM,Kelantan,0,0,0
2020-06-01,ARM,Perak,0,0,0
2020-06-01,ARM,Perlis,0,0,0
2020-06-01,ARM,Pulau Pinang,0,0,0
2020-06-01,ARM,Sabah,0,0,0
2020-06-01,ARM,Sarawak,0,0,0
2020-06-01,ARM,Selangor,0,0,0
2020-06-01,ATA,Selangor,0,0,0
2020-06-01,ATG,Johor,0,0,0
2020-06-01,ATG,Kedah,0,0,0
2020-06-01,ATG,Pulau Pinang,0,0,0
2020-06-01,ATG,Sarawak,0,0,0
2020-06-01,ATG,Selangor,0,0,0
2020-06-01,AUS,Johor,4,4,0
2020-06-01,AUS,Kedah,0,0,0
2020-06-01,AUS,Kelantan,0,0,0
2020-06-01,AUS,Melaka,0,0,0
2020-06-01,AUS,Negeri Sembilan,0,0,0
2020-06-01,AUS,Pahang,0,0,0
2020-06-01,AUS,Perak,0,0,0
2020-06-01,AUS,Perlis,0,0,0
2020-06-01,AUS,Pulau Pinang,0,0,0
2020-06-01,AUS,Sabah,0,0,0
2020-06-01,AUS,Sarawak,1,1,0
2020-06-01,AUS,Selangor,36,21,15
2020-06-01,AUS,Terengganu,0,0,0
2020-06-01,AUS,W.P. Labuan,0,0,0
2020-06-01,AUT,Johor,0,0,0
2020-06-01,AUT,Kedah,0,0,0
2020-06-01,AUT,Kelantan,0,0,0
2020-06-01,AUT,Melaka,0,0,0
2020-06-01,AUT,Negeri Sembilan,0,0,0
2020-06-01,AUT,Pahang,0,0,0
2020-06-01,AUT,Perak,0,0,0
2020-06-01,AUT,Perlis,0,0,0
2020-06-01,AUT,Pulau Pinang,0,0,0
2020-06-01,AUT,Sabah,0,0,0
2020-06-01,AUT,Sarawak,0,0,0
2020-06-01,AUT,Selangor,0,0,0
2020-06-01,AUT,Terengganu,0,0,0
2020-06-01,AUT,W.P. Labuan,0,0,0
2020-06-01,AZE,Johor,0,0,0
2020-06-01,AZE,Kedah,0,0,0
2020-06-01,AZE,Kelantan,0,0,0
2020-06-01,AZE,Melaka,0,0,0
2020-06-01,AZE,Perlis,0,0,0
2020-06-01,AZE,Pulau Pinang,0,0,0
2020-06-01,AZE,Sabah,0,0,0
2020-06-01,AZE,Sarawak,0,0,0
2020-06-01,AZE,Selangor,0,0,0
2020-06-01,AZE,W.P. Labuan,0,0,0
2020-06-01,BDI,Pulau Pinang,0,0,0
2020-06-01,BDI,Sarawak,0,0,0
2020-06-01,BDI,Selangor,0,0,0
2020-06-01,BEL,Johor,0,0,0
2020-06-01,BEL,Kedah,0,0,0
2020-06-01,BEL,Kelantan,0,0,0
2020-06-01,BEL,Melaka,0,0,0
2020-06-01,BEL,Negeri Sembilan,0,0,0
2020-06-01,BEL,Pahang,0,0,0
2020-06-01,BEL,Perak,0,0,0
2020-06-01,BEL,Perlis,0,0,0
2020-06-01,BEL,Pulau Pinang,0,0,0
2020-06-01,BEL,Sabah,0,0,0
2020-06-01,BEL,Sarawak,0,0,0
2020-06-01,BEL,Selangor,0,0,0
2020-06-01,BEL,W.P. Labuan,0,0,0
2020-06-01,BEN,Johor,0,0,0
2020-06-01,BEN,Kedah,0,0,0
2020-06-01,BEN,Perak,0,0,0
2020-06-01,BEN,Pulau Pinang,0,0,0
2020-06-01,BEN,Sabah,0,0,0
2020-06-01,BEN,Sarawak,0,0,0
2020-06-01,BEN,Selangor,0,0,0
2020-06-01,BFA,Perak,0,0,0
2020-06-01,BFA,Pulau Pinang,0,0,0
2020-06-01,BFA,Selangor,0,0,0
2020-06-01,BGD,Johor,0,0,0
2020-06-01,BGD,Kedah,0,0,0
2020-06-01,BGD,Kelantan,0,0,0
2020-06-01,BGD,Melaka,0,0,0
2020-06-01,BGD,Negeri Sembilan,0,0,0
2020-06-01,BGD,Pahang,0,0,0
2020-06-01,BGD,Perak,0,0,0
2020-06-01,BGD,Perlis,0,0,0
2020-06-01,BGD,Pulau Pinang,0,0,0
2020-06-01,BGD,Sabah,0,0,0
2020-06-01,BGD,Sarawak,0,0,0
2020-06-01,BGD,Selangor,39,32,7
2020-06-01,BGD,W.P. Labuan,0,0,0
2020-06-01,BGR,Johor,0,0,0
2020-06-01,BGR,Kedah,0,0,0
2020-06-01,BGR,Kelantan,0,0,0
2020-06-01,BGR,Pahang,0,0,0
2020-06-01,BGR,Perak,0,0,0
2020-06-01,BGR,Perlis,0,0,0
2020-06-01,BGR,Pulau Pinang,0,0,0
2020-06-01,BGR,Sabah,0,0,0
2020-06-01,BGR,Sarawak,0,0,0
2020-06-01,BGR,Selangor,0,0,0
2020-06-01,BGR,W.P. Labuan,0,0,0
2020-06-01,BHR,Johor,0,0,0
2020-06-01,BHR,Kedah,0,0,0
2020-06-01,BHR,Kelantan,0,0,0
2020-06-01,BHR,Perlis,0,0,0
2020-06-01,BHR,Pulau Pinang,0,0,0
2020-06-01,BHR,Sabah,0,0,0
2020-06-01,BHR,Sarawak,0,0,0
2020-06-01,BHR,Selangor,0,0,0
2020-06-01,BHS,Johor,0,0,0
2020-06-01,BHS,Kedah,0,0,0
2020-06-01,BHS,Perak,0,0,0
2020-06-01,BHS,Sabah,0,0,0
2020-06-01,BHS,Sarawak,0,0,0
2020-06-01,BHS,Selangor,0,0,0
2020-06-01,BIH,Johor,0,0,0
2020-06-01,BIH,Kedah,0,0,0
2020-06-01,BIH,Perlis,0,0,0
2020-06-01,BIH,Pulau Pinang,0,0,0
2020-06-01,BIH,Sabah,0,0,0
2020-06-01,BIH,Sarawak,0,0,0
2020-06-01,BIH,Selangor,0,0,0
2020-06-01,BLR,Johor,0,0,0
2020-06-01,BLR,Kedah,0,0,0
2020-06-01,BLR,Kelantan,0,0,0
2020-06-01,BLR,Pahang,0,0,0
2020-06-01,BLR,Perak,0,0,0
2020-06-01,BLR,Perlis,0,0,0
2020-06-01,BLR,Pulau Pinang,0,0,0
2020-06-01,BLR,Sabah,0,0,0
2020-06-01,BLR,Sarawak,0,0,0
2020-06-01,BLR,Selangor,0,0,0
2020-06-01,BLR,W.P. Labuan,0,0,0
2020-06-01,BLZ,Johor,0,0,0
2020-06-01,BLZ,Pulau Pinang,0,0,0
2020-06-01,BLZ,Sarawak,0,0,0
2020-06-01,BLZ,Selangor,0,0,0
2020-06-01,BMU,Selangor,0,0,0
2020-06-01,BOL,Johor,0,0,0
2020-06-01,BOL,Kedah,0,0,0
2020-06-01,BOL,Melaka,0,0,0
2020-06-01,BOL,Perak,0,0,0
2020-06-01,BOL,Perlis,0,0,0
2020-06-01,BOL,Pulau Pinang,0,0,0
2020-06-01,BOL,Sabah,0,0,0
2020-06-01,BOL,Sarawak,0,0,0
2020-06-01,BOL,Selangor,0,0,0
2020-06-01,BRA,Johor,0,0,0
2020-06-01,BRA,Kedah,0,0,0
2020-06-01,BRA,Kelantan,0,0,0
2020-06-01,BRA,Melaka,0,0,0
2020-06-01,BRA,Pahang,0,0,0
2020-06-01,BRA,Perak,0,0,0
2020-06-01,BRA,Perlis,0,0,0
2020-06-01,BRA,Pulau Pinang,0,0,0
2020-06-01,BRA,Sabah,0,0,0
2020-06-01,BRA,Sarawak,0,0,0
2020-06-01,BRA,Selangor,2,2,0
2020-06-01,BRA,W.P. Labuan,0,0,0
2020-06-01,BRB,Johor,0,0,0
2020-06-01,BRB,Kedah,0,0,0
2020-06-01,BRB,Perlis,0,0,0
2020-06-01,BRB,Pulau Pinang,0,0,0
2020-06-01,BRB,Selangor,0,0,0
2020-06-01,BRN,Johor,0,0,0
2020-06-01,BRN,Kedah,0,0,0
2020-06-01,BRN,Kelantan,0,0,0
2020-06-01,BRN,Melaka,0,0,0
2020-06-01,BRN,Pahang,0,0,0
2020-06-01,BRN,Perak,0,0,0
2020-06-01,BRN,Perlis,0,0,0
2020-06-01,BRN,Pulau Pinang,0,0,0
2020-06-01,BRN,Sabah,0,0,0
2020-06-01,BRN,Sarawak,428,411,17
2020-06-01,BRN,Selangor,37,34,3
2020-06-01,BRN,W.P. Labuan,0,0,0
2020-06-01,BTN,Johor,0,0,0
2020-06-01,BTN,Kedah,0,0,0
2020-06-01,BTN,Perak,0,0,0
2020-06-01,BTN,Perlis,0,0,0
2020-06-01,BTN,Pulau Pinang,0,0,0
2020-06-01,BTN,Sabah,0,0,0
2020-06-01,BTN,Sarawak,0,0,0
2020-06-01,BTN,Selangor,0,0,0
2020-06-01,BWA,Johor,0,0,0
2020-06-01,BWA,Kedah,0,0,0
2020-06-01,BWA,Perlis,0,0,0
2020-06-01,BWA,Pulau Pinang,0,0,0
2020-06-01,BWA,Sabah,0,0,0
2020-06-01,BWA,Sarawak,0,0,0
2020-06-01,BWA,Selangor,0,0,0
2020-06-01,CAF,Kedah,0,0,0
2020-06-01,CAF,Selangor,0,0,0
2020-06-01,CAN,Johor,0,0,0
2020-06-01,CAN,Kedah,0,0,0
2020-06-01,CAN,Kelantan,0,0,0
2020-06-01,CAN,Melaka,0,0,0
2020-06-01,CAN,Negeri Sembilan,0,0,0
2020-06-01,CAN,Pahang,0,0,0
2020-06-01,CAN,Perak,0,0,0
2020-06-01,CAN,Perlis,0,0,0
2020-06-01,CAN,Pulau Pinang,0,0,0
2020-06-01,CAN,Sabah,0,0,0
2020-06-01,CAN,Sarawak,1,1,0
2020-06-01,CAN,Selangor,14,12,2
2020-06-01,CAN,Terengganu,0,0,0
2020-06-01,CAN,W.P. Labuan,0,0,0
2020-06-01,CCK,Selangor,0,0,0
2020-06-01,CHE,Johor,1,1,0
2020-06-01,CHE,Kedah,0,0,0
2020-06-01,CHE,Kelantan,0,0,0
2020-06-01,CHE,Melaka,0,0,0
2020-06-01,CHE,Negeri Sembilan,0,0,0
2020-06-01,CHE,Pahang,0,0,0
2020-06-01,CHE,Perak,0,0,0
2020-06-01,CHE,Perlis,0,0,0
2020-06-01,CHE,Pulau Pinang,0,0,0
2020-06-01,CHE,Sabah,0,0,0
2020-06-01,CHE,Sarawak,0,0,0
2020-06-01,CHE,Selangor,2,2,0
2020-06-01,CHE,W.P. Labuan,0,0,0
2020-06-01,CHL,Johor,0,0,0
2020-06-01,CHL,Kedah,0,0,0
2020-06-01,CHL,Kelantan,0,0,0
2020-06-01,CHL,Melaka,0,0,0
2020-06-01,CHL,Pahang,0,0,0
2020-06-01,CHL,Perak,0,0,0
2020-06-01,CHL,Perlis,0,0,0
2020-06-01,CHL,Pulau Pinang,0,0,0
2020-06-01,CHL,Sabah,0,0,0
2020-06-01,CHL,Sarawak,0,0,0
2020-06-01,CHL,Selangor,0,0,0
2020-06-01,CHN,Johor,0,0,0
2020-06-01,CHN,Kedah,0,0,0
2020-06-01,CHN,Kelantan,0,0,0
2020-06-01,CHN,Melaka,0,0,0
2020-06-01,CHN,Pahang,0,0,0
2020-06-01,CHN,Perak,0,0,0
2020-06-01,CHN,Perlis,0,0,0
2020-06-01,CHN,Pulau Pinang,0,0,0
2020-06-01,CHN,Sabah,0,0,0
2020-06-01,CHN,Sarawak,2,0,2
2020-06-01,CHN,Selangor,194,135,59
2020-06-01,CHN,Terengganu,0,0,0
2020-06-01,CHN,W.P. Labuan,0,0,0
2020-06-01,CIV,Johor,0,0,0
2020-06-01,CIV,Kedah,0,0,0
2020-06-01,CIV,Pulau Pinang,0,0,0
2020-06-01,CIV,Sabah,0,0,0
2020-06-01,CIV,Sarawak,0,0,0
2020-06-01,CIV,Selangor,0,0,0
2020-06-01,CMR,Johor,0,0,0
2020-06-01,CMR,Kedah,0,0,0
2020-06-01,CMR,Pulau Pinang,0,0,0
2020-06-01,CMR,Sabah,0,0,0
2020-06-01,CMR,Sarawak,0,0,0
2020-06-01,CMR,Selangor,0,0,0
2020-06-01,COD,Johor,0,0,0
2020-06-01,COD,Pulau Pinang,0,0,0
2020-06-01,COD,Sarawak,0,0,0
2020-06-01,COD,Selangor,0,0,0
2020-06-01,COG,Johor,0,0,0
2020-06-01,COG,Kedah,0,0,0
2020-06-01,COG,Selangor,0,0,0
2020-06-01,COK,Selangor,0,0,0
2020-06-01,COL,Johor,0,0,0
2020-06-01,COL,Kedah,0,0,0
2020-06-01,COL,Perak,0,0,0
2020-06-01,COL,Pulau Pinang,0,0,0
2020-06-01,COL,Sabah,0,0,0
2020-06-01,COL,Sarawak,0,0,0
2020-06-01,COL,Selangor,0,0,0
2020-06-01,COL,W.P. Labuan,0,0,0
2020-06-01,COM,Johor,0,0,0
2020-06-01,COM,Kedah,0,0,0
2020-06-01,COM,Selangor,0,0,0
2020-06-01,CPV,Johor,0,0,0
2020-06-01,CPV,Kedah,0,0,0
2020-06-01,CPV,Pulau Pinang,0,0,0
2020-06-01,CPV,Sabah,0,0,0
2020-06-01,CPV,Selangor,0,0,0
2020-06-01,CRI,Johor,0,0,0
2020-06-01,CRI,Kedah,0,0,0
2020-06-01,CRI,Perak,0,0,0
2020-06-01,CRI,Perlis,0,0,0
2020-06-01,CRI,Pulau Pinang,0,0,0
2020-06-01,CRI,Sabah,0,0,0
2020-06-01,CRI,Sarawak,0,0,0
2020-06-01,CRI,Selangor,0,0,0
2020-06-01,CUB,Johor,0,0,0
2020-06-01,CUB,Kedah,0,0,0
2020-06-01,CUB,Perlis,0,0,0
2020-06-01,CUB,Pulau Pinang,0,0,0
2020-06-01,CUB,Sabah,0,0,0
2020-06-01,CUB,Sarawak,0,0,0
2020-06-01,CUB,Selangor,0,0,0
2020-06-01,CYP,Johor,0,0,0
2020-06-01,CYP,Kedah,0,0,0
2020-06-01,CYP,Perak,0,0,0
2020-06-01,CYP,Perlis,0,0,0
2020-06-01,CYP,Pulau Pinang,0,0,0
2020-06-01,CYP,Sabah,0,0,0
2020-06-01,CYP,Sarawak,0,0,0
2020-06-01,CYP,Selangor,0,0,0
2020-06-01,CZE,Johor,0,0,0
2020-06-01,CZE,Kedah,0,0,0
2020-06-01,CZE,Kelantan,0,0,0
2020-06-01,CZE,Melaka,0,0,0
2020-06-01,CZE,Negeri Sembilan,0,0,0
2020-06-01,CZE,Perak,0,0,0
2020-06-01,CZE,Perlis,0,0,0
2020-06-01,CZE,Pulau Pinang,0,0,0
2020-06-01,CZE,Sabah,0,0,0
2020-06-01,CZE,Sarawak,0,0,0
2020-06-01,CZE,Selangor,1,1,0
2020-06-01,CZE,W.P. Labuan,0,0,0
2020-06-01,DEU,Johor,0,0,0
2020-06-01,DEU,Kedah,0,0,0
2020-06-01,DEU,Kelantan,0,0,0
2020-06-01,DEU,Melaka,0,0,0
2020-06-01,DEU,Negeri Sembilan,0,0,0
2020-06-01,DEU,Pahang,0,0,0
2020-06-01,DEU,Perak,0,0,0
2020-06-01,DEU,Perlis,0,0,0
2020-06-01,DEU,Pulau Pinang,0,0,0
2020-06-01,DEU,Sabah,0,0,0
2020-06-01,DEU,Sarawak,1,1,0
2020-06-01,DEU,Selangor,18,15,3
2020-06-01,DEU,Terengganu,0,0,0
2020-06-01,DEU,W.P. Labuan,0,0,0
2020-06-01,DJI,Johor,0,0,0
2020-06-01,DJI,Selangor,0,0,0
2020-06-01,DMA,Johor,0,0,0
2020-06-01,DMA,Kedah,0,0,0
2020-06-01,DMA,Pulau Pinang,0,0,0
2020-06-01,DMA,Sabah,0,0,0
2020-06-01,DMA,Sarawak,0,0,0
2020-06-01,DMA,Selangor,1,1,0
2020-06-01,DMA,W.P. Labuan,0,0,0
2020-06-01,DNK,Johor,0,0,0
2020-06-01,DNK,Kedah,0,0,0
2020-06-01,DNK,Kelantan,0,0,0
2020-06-01,DNK,Melaka,0,0,0
2020-06-01,DNK,Negeri Sembilan,0,0,0
2020-06-01,DNK,Pahang,0,0,0
2020-06-01,DNK,Perak,0,0,0
2020-06-01,DNK,Perlis,0,0,0
2020-06-01,DNK,Pulau Pinang,0,0,0
2020-06-01,DNK,Sabah,0,0,0
2020-06-01,DNK,Sarawak,0,0,0
2020-06-01,DNK,Selangor,2,2,0
2020-06-01,DNK,W.P. Labuan,0,0,0
2020-06-01,DOM,Johor,0,0,0
2020-06-01,DOM,Kedah,0,0,0
2020-06-01,DOM,Perak,0,0,0
2020-06-01,DOM,Perlis,0,0,0
2020-06-01,DOM,Pulau Pinang,0,0,0
2020-06-01,DOM,Sabah,0,0,0
2020-06-01,DOM,Sarawak,0,0,0
2020-06-01,DOM,Selangor,0,0,0
2020-06-01,DZA,Johor,0,0,0
2020-06-01,DZA,Kedah,0,0,0
2020-06-01,DZA,Kelantan,0,0,0
2020-06-01,DZA,Melaka,0,0,0
2020-06-01,DZA,Perak,0,0,0
2020-06-01,DZA,Perlis,0,0,0
2020-06-01,DZA,Pulau Pinang,0,0,0
2020-06-01,DZA,Sabah,0,0,0
2020-06-01,DZA,Sarawak,0,0,0
2020-06-01,DZA,Selangor,1,1,0
2020-06-01,DZA,W.P. Labuan,0,0,0
2020-06-01,ECU,Johor,0,0,0
2020-06-01,ECU,Kedah,0,0,0
2020-06-01,ECU,Perak,0,0,0
2020-06-01,ECU,Perlis,0,0,0
2020-06-01,ECU,Pulau Pinang,0,0,0
2020-06-01,ECU,Sabah,0,0,0
2020-06-01,ECU,Sarawak,0,0,0
2020-06-01,ECU,Selangor,1,0,1
2020-06-01,EGY,Johor,0,0,0
2020-06-01,EGY,Kedah,0,0,0
2020-06-01,EGY,Kelantan,0,0,0
2020-06-01,EGY,Melaka,0,0,0
2020-06-01,EGY,Pahang,0,0,0
2020-06-01,EGY,Perak,0,0,0
2020-06-01,EGY,Perlis,0,0,0
2020-06-01,EGY,Pulau Pinang,0,0,0
2020-06-01,EGY,Sabah,0,0,0
2020-06-01,EGY,Sarawak,0,0,0
2020-06-01,EGY,Selangor,3,3,0
2020-06-01,EGY,Terengganu,0,0,0
2020-06-01,EGY,W.P. Labuan,0,0,0
2020-06-01,ERI,Johor,0,0,0
2020-06-01,ERI,Pulau Pinang,0,0,0
2020-06-01,ERI,Sabah,0,0,0
2020-06-01,ERI,Selangor,0,0,0
2020-06-01,ESP,Johor,0,0,0
2020-06-01,ESP,Kedah,0,0,0
2020-06-01,ESP,Kelantan,0,0,0
2020-06-01,ESP,Melaka,0,0,0
2020-06-01,ESP,Negeri Sembilan,0,0,0
2020-06-01,ESP,Pahang,0,0,0
2020-06-01,ESP,Perak,0,0,0
2020-06-01,ESP,Perlis,0,0,0
2020-06-01,ESP,Pulau Pinang,0,0,0
2020-06-01,ESP,Sabah,0,0,0
2020-06-01,ESP,Sarawak,0,0,0
2020-06-01,ESP,Selangor,3,1,2
2020-06-01,ESP,W.P. Labuan,0,0,0
2020-06-01,EST,Johor,0,0,0
2020-06-01,EST,Kedah,0,0,0
2020-06-01,EST,Kelantan,0,0,0
2020-06-01,EST,Pahang,0,0,0
2020-06-01,EST,Perak,0,0,0
2020-06-01,EST,Perlis,0,0,0
2020-06-01,EST,Pulau Pinang,0,0,0
2020-06-01,EST,Sabah,0,0,0
2020-06-01,EST,Sarawak,0,0,0
2020-06-01,EST,Selangor,0,0,0
2020-06-01,EST,W.P. Labuan,0,0,0
2020-06-01,ETH,Johor,0,0,0
2020-06-01,ETH,Kedah,0,0,0
2020-06-01,ETH,Pulau Pinang,0,0,0
2020-06-01,ETH,Sarawak,0,0,0
2020-06-01,ETH,Selangor,0,0,0
2020-06-01,FIN,Johor,0,0,0
2020-06-01,FIN,Kedah,0,0,0
2020-06-01,FIN,Kelantan,0,0,0
2020-06-01,FIN,Melaka,0,0,0
2020-06-01,FIN,Negeri Sembilan,0,0,0
2020-06-01,FIN,Pahang,0,0,0
2020-06-01,FIN,Perak,0,0,0
2020-06-01,FIN,Perlis,0,0,0
2020-06-01,FIN,Pulau Pinang,0,0,0
2020-06-01,FIN,Sabah,0,0,0
2020-06-01,FIN,Sarawak,0,0,0
2020-06-01,FIN,Selangor,0,0,0
2020-06-01,FIN,W.P. Labuan,0,0,0
2020-06-01,FJI,Johor,0,0,0
2020-06-01,FJI,Kedah,0,0,0
2020-06-01,FJI,Kelantan,0,0,0
2020-06-01,FJI,Perak,0,0,0
2020-06-01,FJI,Perlis,0,0,0
2020-06-01,FJI,Pulau Pinang,0,0,0
2020-06-01,FJI,Sabah,0,0,0
2020-06-01,FJI,Sarawak,0,0,0
2020-06-01,FJI,Selangor,0,0,0
2020-06-01,FRA,Johor,3,2,1
2020-06-01,FRA,Kedah,0,0,0
2020-06-01,FRA,Kelantan,0,0,0
2020-06-01,FRA,Melaka,0,0,0
2020-06-01,FRA,Negeri Sembilan,0,0,0
2020-06-01,FRA,Pahang,0,0,0
2020-06-01,FRA,Perak,0,0,0
2020-06-01,FRA,Perlis,0,0,0
2020-06-01,FRA,Pulau Pinang,1,1,0
2020-06-01,FRA,Sabah,0,0,0
2020-06-01,FRA,Sarawak,0,0,0
2020-06-01,FRA,Selangor,22,18,4
2020-06-01,FRA,Terengganu,0,0,0
2020-06-01,FRA,W.P. Labuan,0,0,0
2020-06-01,FSM,Johor,0,0,0
2020-06-01,FSM,Pulau Pinang,0,0,0
2020-06-01,FSM,Selangor,0,0,0
2020-06-01,GAB,Johor,0,0,0
2020-06-01,GAB,Pulau Pinang,0,0,0
2020-06-01,GAB,Sarawak,0,0,0
2020-06-01,GAB,Selangor,0,0,0
2020-06-01,GBR,Johor,4,4,0
2020-06-01,GBR,Kedah,0,0,0
2020-06-01,GBR,Kelantan,0,0,0
2020-06-01,GBR,Melaka,0,0,0
2020-06-01,GBR,Negeri Sembilan,0,0,0
2020-06-01,GBR,Pahang,0,0,0
2020-06-01,GBR,Perak,0,0,0
2020-06-01,GBR,Perlis,0,0,0
2020-06-01,GBR,Pulau Pinang,0,0,0
2020-06-01,GBR,Sabah,0,0,0
2020-06-01,GBR,Sarawak,3,3,0
2020-06-01,GBR,Selangor,94,78,16
2020-06-01,GBR,Terengganu,0,0,0
2020-06-01,GBR,W.P. Labuan,0,0,0
2020-06-01,GEO,Johor,0,0,0
2020-06-01,GEO,Kedah,0,0,0
2020-06-01,GEO,Melaka,0,0,0
2020-06-01,GEO,Perak,0,0,0
2020-06-01,GEO,Perlis,0,0,0
2020-06-01,GEO,Pulau Pinang,0,0,0
2020-06-01,GEO,Sabah,0,0,0
2020-06-01,GEO,Sarawak,0,0,0
2020-06-01,GEO,Selangor,1,1,0
2020-06-01,GHA,Johor,0,0,0
2020-06-01,GHA,Kedah,0,0,0
2020-06-01,GHA,Kelantan,0,0,0
2020-06-01,GHA,Pulau Pinang,0,0,0
2020-06-01,GHA,Sabah,0,0,0
2020-06-01,GHA,Sarawak,0,0,0
2020-06-01,GHA,Selangor,0,0,0
2020-06-01,GIB,Johor,0,0,0
2020-06-01,GIB,Sarawak,0,0,0
2020-06-01,GIN,Johor,0,0,0
2020-06-01,GIN,Kedah,0,0,0
2020-06-01,GIN,Kelantan,0,0,0
2020-06-01,GIN,Perlis,0,0,0
2020-06-01,GIN,Pulau Pinang,0,0,0
2020-06-01,GIN,Sabah,0,0,0
2020-06-01,GIN,Sarawak,0,0,0
2020-06-01,GIN,Selangor,0,0,0
2020-06-01,GLP,Selangor,0,0,0
2020-06-01,GMB,Johor,0,0,0
2020-06-01,GMB,Kedah,0,0,0
2020-06-01,GMB,Kelantan,0,0,0
2020-06-01,GMB,Pulau Pinang,0,0,0
2020-06-01,GMB,Sabah,0,0,0
2020-06-01,GMB,Sarawak,0,0,0
2020-06-01,GMB,Selangor,0,0,0
2020-06-01,GNB,Johor,0,0,0
2020-06-01,GNB,Selangor,0,0,0
2020-06-01,GNQ,Johor,0,0,0
2020-06-01,GNQ,Selangor,0,0,0
2020-06-01,GRC,Johor,0,0,0
2020-06-01,GRC,Kedah,0,0,0
2020-06-01,GRC,Kelantan,0,0,0
2020-06-01,GRC,Melaka,0,0,0
2020-06-01,GRC,Negeri Sembilan,0,0,0
2020-06-01,GRC,Pahang,0,0,0
2020-06-01,GRC,Perak,0,0,0
2020-06-01,GRC,Perlis,0,0,0
2020-06-01,GRC,Pulau Pinang,0,0,0
2020-06-01,GRC,Sabah,0,0,0
2020-06-01,GRC,Sarawak,0,0,0
2020-06-01,GRC,Selangor,2,1,1
2020-06-01,GRD,Johor,0,0,0
2020-06-01,GRD,Kedah,0,0,0
2020-06-01,GRD,Pulau Pinang,0,0,0
2020-06-01,GRD,Sabah,0,0,0
2020-06-01,GRD,Sarawak,0,0,0
2020-06-01,GRD,Selangor,0,0,0
2020-06-01,GRL,Johor,0,0,0
2020-06-01,GRL,Selangor,0,0,0
2020-06-01,GTM,Johor,0,0,0
2020-06-01,GTM,Kedah,0,0,0
2020-06-01,GTM,Pahang,0,0,0
2020-06-01,GTM,Perak,0,0,0
2020-06-01,GTM,Pulau Pinang,0,0,0
2020-06-01,GTM,Sabah,0,0,0
2020-06-01,GTM,Sarawak,0,0,0
2020-06-01,GTM,Selangor,0,0,0
2020-06-01,GTM,W.P. Labuan,0,0,0
2020-06-01,GUY,Johor,0,0,0
2020-06-01,GUY,Kedah,0,0,0
2020-06-01,GUY,Pulau Pinang,0,0,0
2020-06-01,GUY,Sarawak,0,0,0
2020-06-01,GUY,Selangor,0,0,0
2020-06-01,HKG,Johor,0,0,0
2020-06-01,HKG,Kedah,0,0,0
2020-06-01,HKG,Kelantan,0,0,0
2020-06-01,HKG,Pahang,0,0,0
2020-06-01,HKG,Perak,0,0,0
2020-06-01,HKG,Perlis,0,0,0
2020-06-01,HKG,Pulau Pinang,0,0,0
2020-06-01,HKG,Sabah,0,0,0
2020-06-01,HKG,Sarawak,0,0,0
2020-06-01,HKG,Selangor,0,0,0
2020-06-01,HKG,Terengganu,0,0,0
2020-06-01,HMD,Johor,0,0,0
2020-06-01,HND,Johor,0,0,0
2020-06-01,HND,Kedah,0,0,0
2020-06-01,HND,Perak,0,0,0
2020-06-01,HND,Pulau Pinang,0,0,0
2020-06-01,HND,Sabah,0,0,0
2020-06-01,HND,Sarawak,0,0,0
2020-06-01,HND,Selangor,0,0,0
2020-06-01,HRV,Johor,0,0,0
2020-06-01,HRV,Kedah,0,0,0
2020-06-01,HRV,Kelantan,0,0,0
2020-06-01,HRV,Melaka,0,0,0
2020-06-01,HRV,Pahang,0,0,0
2020-06-01,HRV,Perak,0,0,0
2020-06-01,HRV,Perlis,0,0,0
2020-06-01,HRV,Pulau Pinang,0,0,0
2020-06-01,HRV,Sabah,0,0,0
2020-06-01,HRV,Sarawak,0,0,0
2020-06-01,HRV,Selangor,1,1,0
2020-06-01,HTI,Johor,0,0,0
2020-06-01,HTI,Kedah,0,0,0
2020-06-01,HTI,Kelantan,0,0,0
2020-06-01,HTI,Perak,0,0,0
2020-06-01,HTI,Pulau Pinang,0,0,0
2020-06-01,HTI,Sabah,0,0,0
2020-06-01,HTI,Selangor,0,0,0
2020-06-01,HUN,Johor,0,0,0
2020-06-01,HUN,Kedah,0,0,0
2020-06-01,HUN,Kelantan,0,0,0
2020-06-01,HUN,Pahang,0,0,0
2020-06-01,HUN,Perak,0,0,0
2020-06-01,HUN,Perlis,0,0,0
2020-06-01,HUN,Pulau Pinang,0,0,0
2020-06-01,HUN,Sabah,0,0,0
2020-06-01,HUN,Sarawak,0,0,0
2020-06-01,HUN,Selangor,1,0,1
2020-06-01,HUN,W.P. Labuan,0,0,0
2020-06-01,IDN,Johor,84,62,22
2020-06-01,IDN,Kedah,7,7,0
2020-06-01,IDN,Kelantan,6,0,6
2020-06-01,IDN,Melaka,0,0,0
2020-06-01,IDN,Negeri Sembilan,0,0,0
2020-06-01,IDN,Pahang,0,0,0
2020-06-01,IDN,Perak,0,0,0
2020-06-01,IDN,Perlis,0,0,0
2020-06-01,IDN,Pulau Pinang,14,0,14
2020-06-01,IDN,Sabah,28,5,23
2020-06-01,IDN,Sarawak,444,423,21
2020-06-01,IDN,Selangor,144,53,91
2020-06-01,IDN,Terengganu,1,1,0
2020-06-01,IDN,W.P. Labuan,0,0,0
2020-06-01,IND,Johor,3,3,0
2020-06-01,IND,Kedah,0,0,0
2020-06-01,IND,Kelantan,0,0,0
2020-06-01,IND,Melaka,0,0,0
2020-06-01,IND,Negeri Sembilan,0,0,0
2020-06-01,IND,Pahang,0,0,0
2020-06-01,IND,Perak,0,0,0
2020-06-01,IND,Perlis,0,0,0
2020-06-01,IND,Pulau Pinang,0,0,0
2020-06-01,IND,Sabah,0,0,0
2020-06-01,IND,Sarawak,0,0,0
2020-06-01,IND,Selangor,70,40,30
2020-06-01,IND,Terengganu,0,0,0
2020-06-01,IND,W.P. Labuan,0,0,0
2020-06-01,IOT,Pulau Pinang,0,0,0
2020-06-01,IOT,Selangor,0,0,0
2020-06-01,IRL,Johor,1,1,0
2020-06-01,IRL,Kedah,0,0,0
2020-06-01,IRL,Kelantan,0,0,0
2020-06-01,IRL,Negeri Sembilan,0,0,0
2020-06-01,IRL,Pahang,0,0,0
2020-06-01,IRL,Perak,0,0,0
2020-06-01,IRL,Perlis,0,0,0
2020-06-01,IRL,Pulau Pinang,0,0,0
2020-06-01,IRL,Sabah,0,0,0
2020-06-01,IRL,Sarawak,0,0,0
2020-06-01,IRL,Selangor,3,2,1
2020-06-01,IRL,Terengganu,0,0,0
2020-06-01,IRL,W.P. Labuan,0,0,0
2020-06-01,IRN,Johor,0,0,0
2020-06-01,IRN,Kedah,0,0,0
2020-06-01,IRN,Kelantan,0,0,0
2020-06-01,IRN,Perak,0,0,0
2020-06-01,IRN,Perlis,0,0,0
2020-06-01,IRN,Pulau Pinang,0,0,0
2020-06-01,IRN,Sabah,0,0,0
2020-06-01,IRN,Sarawak,0,0,0
2020-06-01,IRN,Selangor,5,4,1
2020-06-01,IRN,W.P. Labuan,0,0,0
2020-06-01,IRQ,Johor,0,0,0
2020-06-01,IRQ,Kedah,0,0,0
2020-06-01,IRQ,Kelantan,0,0,0
2020-06-01,IRQ,Melaka,0,0,0
2020-06-01,IRQ,Pahang,0,0,0
2020-06-01,IRQ,Perak,0,0,0
2020-06-01,IRQ,Perlis,0,0,0
2020-06-01,IRQ,Pulau Pinang,0,0,0
2020-06-01,IRQ,Sabah,0,0,0
2020-06-01,IRQ,Sarawak,0,0,0
2020-06-01,IRQ,Selangor,11,6,5
2020-06-01,ISL,Johor,0,0,0
2020-06-01,ISL,Kedah,0,0,0
2020-06-01,ISL,Kelantan,0,0,0
2020-06-01,ISL,Perak,0,0,0
2020-06-01,ISL,Perlis,0,0,0
2020-06-01,ISL,Pulau Pinang,0,0,0
2020-06-01,ISL,Sabah,0,0,0
2020-06-01,ISL,Sarawak,0,0,0
2020-06-01,ISL,Selangor,0,0,0
2020-06-01,ISL,W.P. Labuan,0,0,0
2020-06-01,ISR,Pulau Pinang,0,0,0
2020-06-01,ITA,Johor,0,0,0
2020-06-01,ITA,Kedah,0,0,0
2020-06-01,ITA,Kelantan,0,0,0
2020-06-01,ITA,Melaka,0,0,0
2020-06-01,ITA,Negeri Sembilan,0,0,0
2020-06-01,ITA,Pahang,0,0,0
2020-06-01,ITA,Perak,0,0,0
2020-06-01,ITA,Perlis,0,0,0
2020-06-01,ITA,Pulau Pinang,0,0,0
2020-06-01,ITA,Sabah,0,0,0
2020-06-01,ITA,Sarawak,0,0,0
2020-06-01,ITA,Selangor,4,2,2
2020-06-01,ITA,W.P. Labuan,0,0,0
2020-06-01,JAM,Johor,0,0,0
2020-06-01,JAM,Kedah,0,0,0
2020-06-01,JAM,Perak,0,0,0
2020-06-01,JAM,Pulau Pinang,0,0,0
2020-06-01,JAM,Sabah,0,0,0
2020-06-01,JAM,Sarawak,0,0,0
2020-06-01,JAM,Selangor,0,0,0
2020-06-01,JAM,W.P. Labuan,0,0,0
2020-06-01,JOR,Johor,0,0,0
2020-06-01,JOR,Kedah,0,0,0
2020-06-01,JOR,Kelantan,0,0,0
2020-06-01,JOR,Melaka,0,0,0
2020-06-01,JOR,Perlis,0,0,0
2020-06-01,JOR,Pulau Pinang,0,0,0
2020-06-01,JOR,Sabah,0,0,0
2020-06-01,JOR,Sarawak,0,0,0
2020-06-01,JOR,Selangor,2,1,1
2020-06-01,JOR,W.P. Labuan,0,0,0
2020-06-01,JPN,Johor,0,0,0
2020-06-01,JPN,Kedah,0,0,0
2020-06-01,JPN,Kelantan,0,0,0
2020-06-01,JPN,Melaka,0,0,0
2020-06-01,JPN,Negeri Sembilan,0,0,0
2020-06-01,JPN,Pahang,0,0,0
2020-06-01,JPN,Perak,0,0,0
2020-06-01,JPN,Perlis,0,0,0
2020-06-01,JPN,Pulau Pinang,0,0,0
2020-06-01,JPN,Sabah,0,0,0
2020-06-01,JPN,Sarawak,0,0,0
2020-06-01,JPN,Selangor,47,30,17
2020-06-01,JPN,W.P. Labuan,0,0,0
2020-06-01,KAZ,Johor,0,0,0
2020-06-01,KAZ,Kedah,0,0,0
2020-06-01,KAZ,Kelantan,0,0,0
2020-06-01,KAZ,Melaka,0,0,0
2020-06-01,KAZ,Perak,0,0,0
2020-06-01,KAZ,Perlis,0,0,0
2020-06-01,KAZ,Pulau Pinang,0,0,0
2020-06-01,KAZ,Sabah,0,0,0
2020-06-01,KAZ,Sarawak,0,0,0
2020-06-01,KAZ,Selangor,1,0,1
2020-06-01,KAZ,W.P. Labuan,0,0,0
2020-06-01,KEN,Johor,0,0,0
2020-06-01,KEN,Kedah,0,0,0
2020-06-01,KEN,Kelantan,0,0,0
2020-06-01,KEN,Perak,0,0,0
2020-06-01,KEN,Perlis,0,0,0
2020-06-01,KEN,Pulau Pinang,0,0,0
2020-06-01,KEN,Sabah,0,0,0
2020-06-01,KEN,Sarawak,0,0,0
2020-06-01,KEN,Selangor,0,0,0
2020-06-01,KGZ,Johor,0,0,0
2020-06-01,KGZ,Kedah,0,0,0
2020-06-01,KGZ,Kelantan,0,0,0
2020-06-01,KGZ,Perak,0,0,0
2020-06-01,KGZ,Perlis,0,0,0
2020-06-01,KGZ,Pulau Pinang,0,0,0
2020-06-01,KGZ,Sabah,0,0,0
2020-06-01,KGZ,Sarawak,0,0,0
2020-06-01,KGZ,Selangor,0,0,0
2020-06-01,KHM,Johor,0,0,0
2020-06-01,KHM,Kedah,0,0,0
2020-06-01,KHM,Kelantan,0,0,0
2020-06-01,KHM,Melaka,0,0,0
2020-06-01,KHM,Negeri Sembilan,0,0,0
2020-06-01,KHM,Pahang,0,0,0
2020-06-01,KHM,Perak,0,0,0
2020-06-01,KHM,Perlis,0,0,0
2020-06-01,KHM,Pulau Pinang,0,0,0
2020-06-01,KHM,Sabah,0,0,0
2020-06-01,KHM,Sarawak,0,0,0
2020-06-01,KHM,Selangor,14,6,8
2020-06-01,KHM,W.P. Labuan,0,0,0
2020-06-01,KIR,Johor,0,0,0
2020-06-01,KIR,Sabah,0,0,0
2020-06-01,KIR,Selangor,0,0,0
2020-06-01,KNA,Johor,0,0,0
2020-06-01,KNA,Kedah,0,0,0
2020-06-01,KNA,Perlis,0,0,0
2020-06-01,KNA,Pulau Pinang,0,0,0
2020-06-01,KNA,Sabah,0,0,0
2020-06-01,KNA,Selangor,0,0,0
2020-06-01,KNA,W.P. Labuan,0,0,0
2020-06-01,KOR,Johor,0,0,0
2020-06-01,KOR,Kedah,0,0,0
2020-06-01,KOR,Kelantan,0,0,0
2020-06-01,KOR,Melaka,0,0,0
2020-06-01,KOR,Negeri Sembilan,0,0,0
2020-06-01,KOR,Pahang,0,0,0
2020-06-01,KOR,Perak,0,0,0
2020-06-01,KOR,Perlis,0,0,0
2020-06-01,KOR,Pulau Pinang,0,0,0
2020-06-01,KOR,Sabah,0,0,0
2020-06-01,KOR,Sarawak,0,0,0
2020-06-01,KOR,Selangor,45,35,10
2020-06-01,KOR,Terengganu,0,0,0
2020-06-01,KOR,W.P. Labuan,0,0,0
2020-06-01,KWT,Johor,0,0,0
2020-06-01,KWT,Kedah,0,0,0
2020-06-01,KWT,Kelantan,0,0,0
2020-06-01,KWT,Perak,0,0,0
2020-06-01,KWT,Perlis,0,0,0
2020-06-01,KWT,Pulau Pinang,0,0,0
2020-06-01,KWT,Sabah,0,0,0
2020-06-01,KWT,Sarawak,0,0,0
2020-06-01,KWT,Selangor,0,0,0
2020-06-01,KWT,W.P. Labuan,0,0,0
2020-06-01,LAO,Johor,0,0,0
2020-06-01,LAO,Kedah,0,0,0
2020-06-01,LAO,Kelantan,0,0,0
2020-06-01,LAO,Melaka,0,0,0
2020-06-01,LAO,Perak,0,0,0
2020-06-01,LAO,Perlis,0,0,0
2020-06-01,LAO,Pulau Pinang,0,0,0
2020-06-01,LAO,Sabah,0,0,0
2020-06-01,LAO,Sarawak,0,0,0
2020-06-01,LAO,Selangor,0,0,0
2020-06-01,LAO,W.P. Labuan,0,0,0
2020-06-01,LBN,Johor,0,0,0
2020-06-01,LBN,Kedah,0,0,0
2020-06-01,LBN,Kelantan,0,0,0
2020-06-01,LBN,Pahang,0,0,0
2020-06-01,LBN,Perak,0,0,0
2020-06-01,LBN,Perlis,0,0,0
2020-06-01,LBN,Pulau Pinang,0,0,0
2020-06-01,LBN,Sabah,0,0,0
2020-06-01,LBN,Sarawak,0,0,0
2020-06-01,LBN,Selangor,0,0,0
2020-06-01,LBN,W.P. Labuan,0,0,0
2020-06-01,LBR,Johor,0,0,0
2020-06-01,LBR,Kedah,0,0,0
2020-06-01,LBR,Sabah,0,0,0
2020-06-01,LBR,Sarawak,0,0,0
2020-06-01,LBR,Selangor,0,0,0
2020-06-01,LBY,Johor,0,0,0
2020-06-01,LBY,Kedah,0,0,0
2020-06-01,LBY,Perlis,0,0,0
2020-06-01,LBY,Pulau Pinang,0,0,0
2020-06-01,LBY,Sabah,0,0,0
2020-06-01,LBY,Sarawak,0,0,0
2020-06-01,LBY,Selangor,0,0,0
2020-06-01,LCA,Johor,0,0,0
2020-06-01,LCA,Kedah,0,0,0
2020-06-01,LCA,Pulau Pinang,0,0,0
2020-06-01,LCA,Sarawak,0,0,0
2020-06-01,LCA,Selangor,0,0,0
2020-06-01,LIE,Johor,0,0,0
2020-06-01,LIE,Kedah,0,0,0
2020-06-01,LIE,Perlis,0,0,0
2020-06-01,LIE,Pulau Pinang,0,0,0
2020-06-01,LIE,Sabah,0,0,0
2020-06-01,LIE,Sarawak,0,0,0
2020-06-01,LIE,Selangor,0,0,0
2020-06-01,LKA,Johor,0,0,0
2020-06-01,LKA,Kedah,0,0,0
2020-06-01,LKA,Kelantan,0,0,0
2020-06-01,LKA,Melaka,0,0,0
2020-06-01,LKA,Pahang,0,0,0
2020-06-01,LKA,Perak,0,0,0
2020-06-01,LKA,Perlis,0,0,0
2020-06-01,LKA,Pulau Pinang,0,0,0
2020-06-01,LKA,Sabah,0,0,0
2020-06-01,LKA,Sarawak,0,0,0
2020-06-01,LKA,Selangor,9,6,3
2020-06-01,LKA,W.P. Labuan,0,0,0
2020-06-01,LSO,Johor,0,0,0
2020-06-01,LSO,Kedah,0,0,0
2020-06-01,LSO,Pulau Pinang,0,0,0
2020-06-01,LSO,Sarawak,0,0,0
2020-06-01,LSO,Selangor,0,0,0
2020-06-01,LTU,Johor,1,1,0
2020-06-01,LTU,Kedah,0,0,0
2020-06-01,LTU,Kelantan,0,0,0
2020-06-01,LTU,Pahang,0,0,0
2020-06-01,LTU,Perak,0,0,0
2020-06-01,LTU,Perlis,0,0,0
2020-06-01,LTU,Pulau Pinang,0,0,0
2020-06-01,LTU,Sabah,0,0,0
2020-06-01,LTU,Sarawak,0,0,0
2020-06-01,LTU,Selangor,0,0,0
2020-06-01,LTU,W.P. Labuan,0,0,0
2020-06-01,LUX,Johor,0,0,0
2020-06-01,LUX,Kedah,0,0,0
2020-06-01,LUX,Kelantan,0,0,0
2020-06-01,LUX,Perak,0,0,0
2020-06-01,LUX,Perlis,0,0,0
2020-06-01,LUX,Pulau Pinang,0,0,0
2020-06-01,LUX,Sabah,0,0,0
2020-06-01,LUX,Sarawak,0,0,0
2020-06-01,LUX,Selangor,0,0,0
2020-06-01,LVA,Johor,1,1,0
2020-06-01,LVA,Kedah,0,0,0
2020-06-01,LVA,Kelantan,0,0,0
2020-06-01,LVA,Pahang,0,0,0
2020-06-01,LVA,Perak,0,0,0
2020-06-01,LVA,Perlis,0,0,0
2020-06-01,LVA,Pulau Pinang,0,0,0
2020-06-01,LVA,Sabah,0,0,0
2020-06-01,LVA,Sarawak,0,0,0
2020-06-01,LVA,Selangor,0,0,0
2020-06-01,LVA,W.P. Labuan,0,0,0
2020-06-01,MAC,Johor,0,0,0
2020-06-01,MAC,Pahang,0,0,0
2020-06-01,MAC,Perak,0,0,0
2020-06-01,MAC,Selangor,0,0,0
2020-06-01,MAC,W.P. Labuan,0,0,0
2020-06-01,MAR,Johor,0,0,0
2020-06-01,MAR,Kedah,0,0,0
2020-06-01,MAR,Kelantan,0,0,0
2020-06-01,MAR,Melaka,0,0,0
2020-06-01,MAR,Pahang,0,0,0
2020-06-01,MAR,Perak,0,0,0
2020-06-01,MAR,Perlis,0,0,0
2020-06-01,MAR,Pulau Pinang,0,0,0
2020-06-01,MAR,Sabah,0,0,0
2020-06-01,MAR,Sarawak,0,0,0
2020-06-01,MAR,Selangor,5,0,5
2020-06-01,MAR,W.P. Labuan,0,0,0
2020-06-01,MCO,Johor,0,0,0
2020-06-01,MCO,Kedah,0,0,0
2020-06-01,MCO,Sabah,0,0,0
2020-06-01,MCO,Selangor,0,0,0
2020-06-01,MDA,Johor,0,0,0
2020-06-01,MDA,Kedah,0,0,0
2020-06-01,MDA,Kelantan,0,0,0
2020-06-01,MDA,Negeri Sembilan,0,0,0
2020-06-01,MDA,Perlis,0,0,0
2020-06-01,MDA,Pulau Pinang,0,0,0
2020-06-01,MDA,Sabah,0,0,0
2020-06-01,MDA,Sarawak,0,0,0
2020-06-01,MDA,Selangor,0,0,0
2020-06-01,MDG,Johor,0,0,0
2020-06-01,MDG,Kedah,0,0,0
2020-06-01,MDG,Perak,0,0,0
2020-06-01,MDG,Perlis,0,0,0
2020-06-01,MDG,Pulau Pinang,0,0,0
2020-06-01,MDG,Sabah,0,0,0
2020-06-01,MDG,Sarawak,0,0,0
2020-06-01,MDG,Selangor,0,0,0
2020-06-01,MDV,Johor,0,0,0
2020-06-01,MDV,Kedah,0,0,0
2020-06-01,MDV,Kelantan,0,0,0
2020-06-01,MDV,Perak,0,0,0
2020-06-01,MDV,Perlis,0,0,0
2020-06-01,MDV,Pulau Pinang,0,0,0
2020-06-01,MDV,Sabah,0,0,0
2020-06-01,MDV,Sarawak,0,0,0
2020-06-01,MDV,Selangor,3,2,1
2020-06-01,MEX,Johor,0,0,0
2020-06-01,MEX,Kedah,0,0,0
2020-06-01,MEX,Kelantan,0,0,0
2020-06-01,MEX,Pahang,0,0,0
2020-06-01,MEX,Perak,0,0,0
2020-06-01,MEX,Perlis,0,0,0
2020-06-01,MEX,Pulau Pinang,0,0,0
2020-06-01,MEX,Sabah,0,0,0
2020-06-01,MEX,Sarawak,0,0,0
2020-06-01,MEX,Selangor,1,1,0
2020-06-01,MEX,W.P. Labuan,0,0,0
2020-06-01,MHL,Johor,0,0,0
2020-06-01,MHL,Kedah,0,0,0
2020-06-01,MHL,Perak,0,0,0
2020-06-01,MHL,Pulau Pinang,0,0,0
2020-06-01,MHL,Sabah,0,0,0
2020-06-01,MHL,Selangor,0,0,0
2020-06-01,MKD,Johor,0,0,0
2020-06-01,MKD,Kedah,0,0,0
2020-06-01,MKD,Perak,0,0,0
2020-06-01,MKD,Pulau Pinang,0,0,0
2020-06-01,MKD,Sabah,0,0,0
2020-06-01,MKD,Sarawak,0,0,0
2020-06-01,MKD,Selangor,1,1,0
2020-06-01,MLI,Johor,0,0,0
2020-06-01,MLI,Sabah,0,0,0
2020-06-01,MLI,Selangor,0,0,0
2020-06-01,MLT,Johor,0,0,0
2020-06-01,MLT,Kedah,0,0,0
2020-06-01,MLT,Kelantan,0,0,0
2020-06-01,MLT,Perak,0,0,0
2020-06-01,MLT,Perlis,0,0,0
2020-06-01,MLT,Pulau Pinang,0,0,0
2020-06-01,MLT,Sabah,0,0,0
2020-06-01,MLT,Sarawak,0,0,0
2020-06-01,MLT,Selangor,0,0,0
2020-06-01,MLT,W.P. Labuan,0,0,0
2020-06-01,MMR,Johor,13,12,1
2020-06-01,MMR,Kedah,0,0,0
2020-06-01,MMR,Kelantan,0,0,0
2020-06-01,MMR,Negeri Sembilan,0,0,0
2020-06-01,MMR,Pahang,0,0,0
2020-06-01,MMR,Perak,0,0,0
2020-06-01,MMR,Perlis,0,0,0
2020-06-01,MMR,Pulau Pinang,0,0,0
2020-06-01,MMR,Sabah,0,0,0
2020-06-01,MMR,Sarawak,0,0,0
2020-06-01,MMR,Selangor,24,5,19
2020-06-01,MMR,Terengganu,0,0,0
2020-06-01,MMR,W.P. Labuan,0,0,0
2020-06-01,MNE,Johor,0,0,0
2020-06-01,MNE,Kedah,0,0,0
2020-06-01,MNE,Pulau Pinang,0,0,0
2020-06-01,MNE,Sabah,0,0,0
2020-06-01,MNE,Sarawak,0,0,0
2020-06-01,MNE,Selangor,1,0,1
2020-06-01,MNG,Johor,0,0,0
2020-06-01,MNG,Kedah,0,0,0
2020-06-01,MNG,Kelantan,0,0,0
2020-06-01,MNG,Perak,0,0,0
2020-06-01,MNG,Perlis,0,0,0
2020-06-01,MNG,Pulau Pinang,0,0,0
2020-06-01,MNG,Sabah,0,0,0
2020-06-01,MNG,Sarawak,0,0,0
2020-06-01,MNG,Selangor,0,0,0
2020-06-01,MNP,Selangor,0,0,0
2020-06-01,MOZ,Johor,0,0,0
2020-06-01,MOZ,Kedah,0,0,0
2020-06-01,MOZ,Perak,0,0,0
2020-06-01,MOZ,Pulau Pinang,0,0,0
2020-06-01,MOZ,Sabah,0,0,0
2020-06-01,MOZ,Sarawak,0,0,0
2020-06-01,MOZ,Selangor,0,0,0
2020-06-01,MRT,Johor,0,0,0
2020-06-01,MRT,Kedah,0,0,0
2020-06-01,MRT,Pulau Pinang,0,0,0
2020-06-01,MRT,Sabah,0,0,0
2020-06-01,MRT,Sarawak,0,0,0
2020-06-01,MRT,Selangor,0,0,0
2020-06-01,MUS,Johor,0,0,0
2020-06-01,MUS,Kedah,0,0,0
2020-06-01,MUS,Kelantan,0,0,0
2020-06-01,MUS,Pahang,0,0,0
2020-06-01,MUS,Perak,0,0,0
2020-06-01,MUS,Perlis,0,0,0
2020-06-01,MUS,Pulau Pinang,0,0,0
2020-06-01,MUS,Sabah,0,0,0
2020-06-01,MUS,Sarawak,0,0,0
2020-06-01,MUS,Selangor,0,0,0
2020-06-01,MWI,Johor,0,0,0
2020-06-01,MWI,Pulau Pinang,0,0,0
2020-06-01,MWI,Sabah,0,0,0
2020-06-01,MWI,Sarawak,0,0,0
2020-06-01,MWI,Selangor,0,0,0
2020-06-01,MYT,Selangor,0,0,0
2020-06-01,NAM,Johor,0,0,0
2020-06-01,NAM,Kedah,0,0,0
2020-06-01,NAM,Perak,0,0,0
2020-06-01,NAM,Perlis,0,0,0
2020-06-01,NAM,Pulau Pinang,0,0,0
2020-06-01,NAM,Sabah,0,0,0
2020-06-01,NAM,Sarawak,0,0,0
2020-06-01,NAM,Selangor,0,0,0
2020-06-01,NCL,Selangor,0,0,0
2020-06-01,NER,Johor,0,0,0
2020-06-01,NER,Sabah,0,0,0
2020-06-01,NER,Selangor,0,0,0
2020-06-01,NGA,Johor,0,0,0
2020-06-01,NGA,Kedah,0,0,0
2020-06-01,NGA,Perlis,0,0,0
2020-06-01,NGA,Pulau Pinang,0,0,0
2020-06-01,NGA,Sabah,0,0,0
2020-06-01,NGA,Sarawak,0,0,0
2020-06-01,NGA,Selangor,4,4,0
2020-06-01,NIC,Johor,0,0,0
2020-06-01,NIC,Kedah,0,0,0
2020-06-01,NIC,Pulau Pinang,0,0,0
2020-06-01,NIC,Sabah,0,0,0
2020-06-01,NIC,Selangor,0,0,0
2020-06-01,NLD,Johor,0,0,0
2020-06-01,NLD,Kedah,0,0,0
2020-06-01,NLD,Kelantan,0,0,0
2020-06-01,NLD,Melaka,0,0,0
2020-06-01,NLD,Negeri Sembilan,0,0,0
2020-06-01,NLD,Pahang,0,0,0
2020-06-01,NLD,Perak,0,0,0
2020-06-01,NLD,Perlis,0,0,0
2020-06-01,NLD,Pulau Pinang,0,0,0
2020-06-01,NLD,Sabah,0,0,0
2020-06-01,NLD,Sarawak,0,0,0
2020-06-01,NLD,Selangor,15,12,3
2020-06-01,NLD,Terengganu,0,0,0
2020-06-01,NLD,W.P. Labuan,0,0,0
2020-06-01,NOR,Johor,2,2,0
2020-06-01,NOR,Kedah,0,0,0
2020-06-01,NOR,Kelantan,0,0,0
2020-06-01,NOR,Melaka,0,0,0
2020-06-01,NOR,Pahang,0,0,0
2020-06-01,NOR,Perak,0,0,0
2020-06-01,NOR,Perlis,0,0,0
2020-06-01,NOR,Pulau Pinang,0,0,0
2020-06-01,NOR,Sabah,0,0,0
2020-06-01,NOR,Sarawak,0,0,0
2020-06-01,NOR,Selangor,3,3,0
2020-06-01,NOR,W.P. Labuan,0,0,0
2020-06-01,NPL,Johor,1,1,0
2020-06-01,NPL,Kedah,0,0,0
2020-06-01,NPL,Pahang,0,0,0
2020-06-01,NPL,Perak,0,0,0
2020-06-01,NPL,Perlis,0,0,0
2020-06-01,NPL,Pulau Pinang,0,0,0
2020-06-01,NPL,Sabah,0,0,0
2020-06-01,NPL,Sarawak,0,0,0
2020-06-01,NPL,Selangor,3,3,0
2020-06-01,NPL,W.P. Labuan,0,0,0
2020-06-01,NRU,Johor,0,0,0
2020-06-01,NRU,Pulau Pinang,0,0,0
2020-06-01,NRU,Selangor,0,0,0
2020-06-01,NZL,Johor,2,2,0
2020-06-01,NZL,Kedah,2,2,0
2020-06-01,NZL,Kelantan,0,0,0
2020-06-01,NZL,Melaka,0,0,0
2020-06-01,NZL,Negeri Sembilan,0,0,0
2020-06-01,NZL,Pahang,0,0,0
2020-06-01,NZL,Perak,0,0,0
2020-06-01,NZL,Perlis,0,0,0
2020-06-01,NZL,Pulau Pinang,0,0,0
2020-06-01,NZL,Sabah,0,0,0
2020-06-01,NZL,Sarawak,0,0,0
2020-06-01,NZL,Selangor,8,4,4
2020-06-01,NZL,Terengganu,0,0,0
2020-06-01,NZL,W.P. Labuan,0,0,0
2020-06-01,OMN,Johor,0,0,0
2020-06-01,OMN,Kedah,0,0,0
2020-06-01,OMN,Kelantan,0,0,0
2020-06-01,OMN,Melaka,0,0,0
2020-06-01,OMN,Perak,0,0,0
2020-06-01,OMN,Perlis,0,0,0
2020-06-01,OMN,Pulau Pinang,0,0,0
2020-06-01,OMN,Sabah,0,0,0
2020-06-01,OMN,Sarawak,0,0,0
2020-06-01,OMN,Selangor,0,0,0
2020-06-01,PAK,Johor,0,0,0
2020-06-01,PAK,Kedah,0,0,0
2020-06-01,PAK,Kelantan,0,0,0
2020-06-01,PAK,Melaka,0,0,0
2020-06-01,PAK,Negeri Sembilan,0,0,0
2020-06-01,PAK,Pahang,0,0,0
2020-06-01,PAK,Perak,0,0,0
2020-06-01,PAK,Perlis,0,0,0
2020-06-01,PAK,Pulau Pinang,0,0,0
2020-06-01,PAK,Sabah,0,0,0
2020-06-01,PAK,Sarawak,0,0,0
2020-06-01,PAK,Selangor,128,111,17
2020-06-01,PAK,W.P. Labuan,0,0,0
2020-06-01,PAN,Johor,0,0,0
2020-06-01,PAN,Kedah,0,0,0
2020-06-01,PAN,Perak,0,0,0
2020-06-01,PAN,Perlis,0,0,0
2020-06-01,PAN,Pulau Pinang,0,0,0
2020-06-01,PAN,Sabah,0,0,0
2020-06-01,PAN,Sarawak,0,0,0
2020-06-01,PAN,Selangor,0,0,0
2020-06-01,PER,Johor,0,0,0
2020-06-01,PER,Kedah,0,0,0
2020-06-01,PER,Kelantan,0,0,0
2020-06-01,PER,Pahang,0,0,0
2020-06-01,PER,Perak,0,0,0
2020-06-01,PER,Perlis,0,0,0
2020-06-01,PER,Pulau Pinang,0,0,0
2020-06-01,PER,Sabah,0,0,0
2020-06-01,PER,Sarawak,0,0,0
2020-06-01,PER,Selangor,0,0,0
2020-06-01,PER,W.P. Labuan,0,0,0
2020-06-01,PHL,Johor,0,0,0
2020-06-01,PHL,Kedah,1,0,1
2020-06-01,PHL,Kelantan,0,0,0
2020-06-01,PHL,Melaka,0,0,0
2020-06-01,PHL,Negeri Sembilan,0,0,0
2020-06-01,PHL,Pahang,0,0,0
2020-06-01,PHL,Perak,0,0,0
2020-06-01,PHL,Perlis,0,0,0
2020-06-01,PHL,Pulau Pinang,0,0,0
2020-06-01,PHL,Sabah,5,1,4
2020-06-01,PHL,Sarawak,51,47,4
2020-06-01,PHL,Selangor,20,3,17
2020-06-01,PHL,Terengganu,0,0,0
2020-06-01,PHL,W.P. Labuan,5,5,0
2020-06-01,PLW,Johor,0,0,0
2020-06-01,PLW,Pulau Pinang,0,0,0
2020-06-01,PLW,Selangor,0,0,0
2020-06-01,PNG,Johor,0,0,0
2020-06-01,PNG,Kedah,0,0,0
2020-06-01,PNG,Kelantan,0,0,0
2020-06-01,PNG,Perak,0,0,0
2020-06-01,PNG,Pulau Pinang,0,0,0
2020-06-01,PNG,Sabah,0,0,0
2020-06-01,PNG,Sarawak,0,0,0
2020-06-01,PNG,Selangor,0,0,0
2020-06-01,POL,Johor,4,4,0
2020-06-01,POL,Kedah,0,0,0
2020-06-01,POL,Kelantan,0,0,0
2020-06-01,POL,Melaka,0,0,0
2020-06-01,POL,Negeri Sembilan,0,0,0
2020-06-01,POL,Pahang,0,0,0
2020-06-01,POL,Perak,0,0,0
2020-06-01,POL,Perlis,0,0,0
2020-06-01,POL,Pulau Pinang,0,0,0
2020-06-01,POL,Sabah,0,0,0
2020-06-01,POL,Sarawak,0,0,0
2020-06-01,POL,Selangor,1,1,0
2020-06-01,POL,Terengganu,0,0,0
2020-06-01,POL,W.P. Labuan,0,0,0
2020-06-01,PRK,Selangor,0,0,0
2020-06-01,PRT,Johor,0,0,0
2020-06-01,PRT,Kedah,0,0,0
2020-06-01,PRT,Kelantan,0,0,0
2020-06-01,PRT,Melaka,0,0,0
2020-06-01,PRT,Pahang,0,0,0
2020-06-01,PRT,Perak,0,0,0
2020-06-01,PRT,Perlis,0,0,0
2020-06-01,PRT,Pulau Pinang,0,0,0
2020-06-01,PRT,Sabah,0,0,0
2020-06-01,PRT,Sarawak,0,0,0
2020-06-01,PRT,Selangor,1,1,0
2020-06-01,PRT,W.P. Labuan,0,0,0
2020-06-01,PRY,Johor,0,0,0
2020-06-01,PRY,Kedah,0,0,0
2020-06-01,PRY,Perak,0,0,0
2020-06-01,PRY,Perlis,0,0,0
2020-06-01,PRY,Pulau Pinang,0,0,0
2020-06-01,PRY,Sabah,0,0,0
2020-06-01,PRY,Sarawak,0,0,0
2020-06-01,PRY,Selangor,0,0,0
2020-06-01,PSE,Johor,0,0,0
2020-06-01,PSE,Kedah,0,0,0
2020-06-01,PSE,Kelantan,0,0,0
2020-06-01,PSE,Melaka,0,0,0
2020-06-01,PSE,Perak,0,0,0
2020-06-01,PSE,Perlis,0,0,0
2020-06-01,PSE,Pulau Pinang,0,0,0
2020-06-01,PSE,Sabah,0,0,0
2020-06-01,PSE,Sarawak,0,0,0
2020-06-01,PSE,Selangor,1,1,0
2020-06-01,QAT,Johor,0,0,0
2020-06-01,QAT,Kedah,0,0,0
2020-06-01,QAT,Perlis,0,0,0
2020-06-01,QAT,Pulau Pinang,0,0,0
2020-06-01,QAT,Sabah,0,0,0
2020-06-01,QAT,Sarawak,0,0,0
2020-06-01,QAT,Selangor,0,0,0
2020-06-01,REU,Johor,0,0,0
2020-06-01,REU,Sarawak,0,0,0
2020-06-01,ROU,Johor,2,2,0
2020-06-01,ROU,Kedah,0,0,0
2020-06-01,ROU,Kelantan,0,0,0
2020-06-01,ROU,Negeri Sembilan,0,0,0
2020-06-01,ROU,Pahang,0,0,0
2020-06-01,ROU,Perak,0,0,0
2020-06-01,ROU,Perlis,0,0,0
2020-06-01,ROU,Pulau Pinang,0,0,0
2020-06-01,ROU,Sabah,0,0,0
2020-06-01,ROU,Sarawak,0,0,0
2020-06-01,ROU,Selangor,9,8,1
2020-06-01,ROU,W.P. Labuan,0,0,0
2020-06-01,RUS,Johor,0,0,0
2020-06-01,RUS,Kedah,0,0,0
2020-06-01,RUS,Kelantan,0,0,0
2020-06-01,RUS,Melaka,0,0,0
2020-06-01,RUS,Negeri Sembilan,0,0,0
2020-06-01,RUS,Pahang,0,0,0
2020-06-01,RUS,Perak,0,0,0
2020-06-01,RUS,Perlis,0,0,0
2020-06-01,RUS,Pulau Pinang,0,0,0
2020-06-01,RUS,Sabah,0,0,0
2020-06-01,RUS,Sarawak,0,0,0
2020-06-01,RUS,Selangor,17,16,1
2020-06-01,RUS,W.P. Labuan,0,0,0
2020-06-01,RWA,Johor,0,0,0
2020-06-01,RWA,Kedah,0,0,0
2020-06-01,RWA,Pulau Pinang,0,0,0
2020-06-01,RWA,Selangor,0,0,0
2020-06-01,SAU,Johor,0,0,0
2020-06-01,SAU,Kedah,0,0,0
2020-06-01,SAU,Kelantan,0,0,0
2020-06-01,SAU,Melaka,0,0,0
2020-06-01,SAU,Perak,0,0,0
2020-06-01,SAU,Perlis,0,0,0
2020-06-01,SAU,Pulau Pinang,0,0,0
2020-06-01,SAU,Sabah,0,0,0
2020-06-01,SAU,Sarawak,0,0,0
2020-06-01,SAU,Selangor,6,3,3
2020-06-01,SAU,W.P. Labuan,0,0,0
2020-06-01,SDN,Johor,0,0,0
2020-06-01,SDN,Kedah,0,0,0
2020-06-01,SDN,Kelantan,0,0,0
2020-06-01,SDN,Perlis,0,0,0
2020-06-01,SDN,Pulau Pinang,0,0,0
2020-06-01,SDN,Sabah,0,0,0
2020-06-01,SDN,Sarawak,0,0,0
2020-06-01,SDN,Selangor,0,0,0
2020-06-01,SDN,W.P. Labuan,0,0,0
2020-06-01,SEN,Johor,0,0,0
2020-06-01,SEN,Kedah,0,0,0
2020-06-01,SEN,Kelantan,0,0,0
2020-06-01,SEN,Perak,0,0,0
2020-06-01,SEN,Perlis,0,0,0
2020-06-01,SEN,Pulau Pinang,0,0,0
2020-06-01,SEN,Sabah,0,0,0
2020-06-01,SEN,Sarawak,0,0,0
2020-06-01,SEN,Selangor,0,0,0
2020-06-01,SGP,Johor,109,94,15
2020-06-01,SGP,Kedah,0,0,0
2020-06-01,SGP,Kelantan,0,0,0
2020-06-01,SGP,Melaka,0,0,0
2020-06-01,SGP,Negeri Sembilan,0,0,0
2020-06-01,SGP,Pahang,0,0,0
2020-06-01,SGP,Perak,3,1,2
2020-06-01,SGP,Perlis,0,0,0
2020-06-01,SGP,Pulau Pinang,0,0,0
2020-06-01,SGP,Sabah,0,0,0
2020-06-01,SGP,Sarawak,2,2,0
2020-06-01,SGP,Selangor,36,22,14
2020-06-01,SGP,Terengganu,0,0,0
2020-06-01,SGP,W.P. Labuan,0,0,0
2020-06-01,SGS,Johor,0,0,0
2020-06-01,SGS,Sabah,0,0,0
2020-06-01,SGS,Selangor,0,0,0
2020-06-01,SHN,Sarawak,0,0,0
2020-06-01,SLB,Johor,0,0,0
2020-06-01,SLB,Perlis,0,0,0
2020-06-01,SLB,Pulau Pinang,0,0,0
2020-06-01,SLB,Sabah,0,0,0
2020-06-01,SLB,Sarawak,0,0,0
2020-06-01,SLB,Selangor,0,0,0
2020-06-01,SLB,W.P. Labuan,0,0,0
2020-06-01,SLE,Johor,0,0,0
2020-06-01,SLE,Kedah,0,0,0
2020-06-01,SLE,Perak,0,0,0
2020-06-01,SLE,Pulau Pinang,0,0,0
2020-06-01,SLE,Sabah,0,0,0
2020-06-01,SLE,Selangor,0,0,0
2020-06-01,SLV,Johor,0,0,0
2020-06-01,SLV,Kedah,0,0,0
2020-06-01,SLV,Perak,0,0,0
2020-06-01,SLV,Perlis,0,0,0
2020-06-01,SLV,Pulau Pinang,0,0,0
2020-06-01,SLV,Sabah,0,0,0
2020-06-01,SLV,Selangor,0,0,0
2020-06-01,SLV,W.P. Labuan,0,0,0
2020-06-01,SMR,Johor,0,0,0
2020-06-01,SMR,Selangor,0,0,0
2020-06-01,SOM,Johor,0,0,0
2020-06-01,SOM,Kedah,0,0,0
2020-06-01,SOM,Kelantan,0,0,0
2020-06-01,SOM,Perlis,0,0,0
2020-06-01,SOM,Sabah,0,0,0
2020-06-01,SOM,Sarawak,0,0,0
2020-06-01,SOM,Selangor,0,0,0
2020-06-01,SRB,Johor,0,0,0
2020-06-01,SRB,Kedah,0,0,0
2020-06-01,SRB,Kelantan,0,0,0
2020-06-01,SRB,Pahang,0,0,0
2020-06-01,SRB,Perak,0,0,0
2020-06-01,SRB,Perlis,0,0,0
2020-06-01,SRB,Pulau Pinang,0,0,0
2020-06-01,SRB,Sabah,0,0,0
2020-06-01,SRB,Sarawak,0,0,0
2020-06-01,SRB,Selangor,0,0,0
2020-06-01,SSD,Johor,0,0,0
2020-06-01,SSD,Kedah,0,0,0
2020-06-01,SSD,Sarawak,0,0,0
2020-06-01,SSD,Selangor,0,0,0
2020-06-01,SSD,W.P. Labuan,0,0,0
2020-06-01,STP,Selangor,0,0,0
2020-06-01,SUR,Johor,0,0,0
2020-06-01,SUR,Kedah,0,0,0
2020-06-01,SUR,Kelantan,0,0,0
2020-06-01,SUR,Perak,0,0,0
2020-06-01,SUR,Perlis,0,0,0
2020-06-01,SUR,Pulau Pinang,0,0,0
2020-06-01,SUR,Sabah,0,0,0
2020-06-01,SUR,Sarawak,0,0,0
2020-06-01,SUR,Selangor,0,0,0
2020-06-01,SVK,Johor,0,0,0
2020-06-01,SVK,Kedah,0,0,0
2020-06-01,SVK,Kelantan,0,0,0
2020-06-01,SVK,Negeri Sembilan,0,0,0
2020-06-01,SVK,Pahang,0,0,0
2020-06-01,SVK,Perak,0,0,0
2020-06-01,SVK,Perlis,0,0,0
2020-06-01,SVK,Pulau Pinang,0,0,0
2020-06-01,SVK,Sabah,0,0,0
2020-06-01,SVK,Sarawak,0,0,0
2020-06-01,SVK,Selangor,0,0,0
2020-06-01,SVK,W.P. Labuan,0,0,0
2020-06-01,SVN,Johor,0,0,0
2020-06-01,SVN,Kedah,0,0,0
2020-06-01,SVN,Kelantan,0,0,0
2020-06-01,SVN,Perak,0,0,0
2020-06-01,SVN,Perlis,0,0,0
2020-06-01,SVN,Pulau Pinang,0,0,0
2020-06-01,SVN,Sabah,0,0,0
2020-06-01,SVN,Sarawak,0,0,0
2020-06-01,SVN,Selangor,0,0,0
2020-06-01,SVN,W.P. Labuan,0,0,0
2020-06-01,SWE,Johor,0,0,0
2020-06-01,SWE,Kedah,0,0,0
2020-06-01,SWE,Kelantan,0,0,0
2020-06-01,SWE,Melaka,0,0,0
2020-06-01,SWE,Negeri Sembilan,0,0,0
2020-06-01,SWE,Pahang,0,0,0
2020-06-01,SWE,Perak,0,0,0
2020-06-01,SWE,Perlis,0,0,0
2020-06-01,SWE,Pulau Pinang,0,0,0
2020-06-01,SWE,Sabah,0,0,0
2020-06-01,SWE,Sarawak,0,0,0
2020-06-01,SWE,Selangor,0,0,0
2020-06-01,SWE,W.P. Labuan,0,0,0
2020-06-01,SWZ,Johor,0,0,0
2020-06-01,SWZ,Kedah,0,0,0
2020-06-01,SWZ,Pulau Pinang,0,0,0
2020-06-01,SWZ,Sabah,0,0,0
2020-06-01,SWZ,Selangor,0,0,0
2020-06-01,SYC,Johor,0,0,0
2020-06-01,SYC,Kedah,0,0,0
2020-06-01,SYC,Pulau Pinang,0,0,0
2020-06-01,SYC,Sabah,0,0,0
2020-06-01,SYC,Sarawak,0,0,0
2020-06-01,SYC,Selangor,0,0,0
2020-06-01,SYR,Johor,0,0,0
2020-06-01,SYR,Kedah,0,0,0
2020-06-01,SYR,Kelantan,0,0,0
2020-06-01,SYR,Pahang,0,0,0
2020-06-01,SYR,Perlis,0,0,0
2020-06-01,SYR,Pulau Pinang,0,0,0
2020-06-01,SYR,Sabah,0,0,0
2020-06-01,SYR,Sarawak,0,0,0
2020-06-01,SYR,Selangor,0,0,0
2020-06-01,SYR,W.P. Labuan,0,0,0
2020-06-01,TCA,Perlis,0,0,0
2020-06-01,TCD,Johor,0,0,0
2020-06-01,TCD,Kedah,0,0,0
2020-06-01,TCD,Perlis,0,0,0
2020-06-01,TCD,Selangor,0,0,0
2020-06-01,TGO,Johor,0,0,0
2020-06-01,TGO,Perak,0,0,0
2020-06-01,TGO,Pulau Pinang,0,0,0
2020-06-01,TGO,Selangor,0,0,0
2020-06-01,THA,Johor,135,134,1
2020-06-01,THA,Kedah,11733,10992,741
2020-06-01,THA,Kelantan,15,3,12
2020-06-01,THA,Melaka,0,0,0
2020-06-01,THA,Negeri Sembilan,0,0,0
2020-06-01,THA,Pahang,0,0,0
2020-06-01,THA,Perak,2,1,1
2020-06-01,THA,Perlis,3,0,3
2020-06-01,THA,Pulau Pinang,0,0,0
2020-06-01,THA,Sabah,0,0,0
2020-06-01,THA,Sarawak,13,13,0
2020-06-01,THA,Selangor,3,0,3
2020-06-01,THA,Terengganu,0,0,0
2020-06-01,THA,W.P. Labuan,0,0,0
2020-06-01,TJK,Johor,0,0,0
2020-06-01,TJK,Kedah,0,0,0
2020-06-01,TJK,Perlis,0,0,0
2020-06-01,TJK,Pulau Pinang,0,0,0
2020-06-01,TJK,Sabah,0,0,0
2020-06-01,TJK,Selangor,1,1,0
2020-06-01,TKL,Selangor,0,0,0
2020-06-01,TKM,Johor,0,0,0
2020-06-01,TKM,Kedah,0,0,0
2020-06-01,TKM,Kelantan,0,0,0
2020-06-01,TKM,Perlis,0,0,0
2020-06-01,TKM,Pulau Pinang,0,0,0
2020-06-01,TKM,Sabah,0,0,0
2020-06-01,TKM,Sarawak,0,0,0
2020-06-01,TKM,Selangor,0,0,0
2020-06-01,TLS,Johor,0,0,0
2020-06-01,TLS,Kedah,0,0,0
2020-06-01,TLS,Perlis,0,0,0
2020-06-01,TLS,Pulau Pinang,0,0,0
2020-06-01,TLS,Sabah,0,0,0
2020-06-01,TLS,Sarawak,0,0,0
2020-06-01,TLS,Selangor,0,0,0
2020-06-01,TON,Johor,0,0,0
2020-06-01,TON,Pulau Pinang,0,0,0
2020-06-01,TON,Sarawak,0,0,0
2020-06-01,TON,Selangor,0,0,0
2020-06-01,TTO,Johor,0,0,0
2020-06-01,TTO,Kedah,0,0,0
2020-06-01,TTO,Pahang,0,0,0
2020-06-01,TTO,Pulau Pinang,0,0,0
2020-06-01,TTO,Sabah,0,0,0
2020-06-01,TTO,Sarawak,0,0,0
2020-06-01,TTO,Selangor,0,0,0
2020-06-01,TUN,Johor,0,0,0
2020-06-01,TUN,Kedah,0,0,0
2020-06-01,TUN,Kelantan,0,0,0
2020-06-01,TUN,Melaka,0,0,0
2020-06-01,TUN,Perak,0,0,0
2020-06-01,TUN,Perlis,0,0,0
2020-06-01,TUN,Pulau Pinang,0,0,0
2020-06-01,TUN,Sabah,0,0,0
2020-06-01,TUN,Sarawak,0,0,0
2020-06-01,TUN,Selangor,0,0,0
2020-06-01,TUN,W.P. Labuan,0,0,0
2020-06-01,TUR,Johor,0,0,0
2020-06-01,TUR,Kedah,0,0,0
2020-06-01,TUR,Kelantan,0,0,0
2020-06-01,TUR,Melaka,0,0,0
2020-06-01,TUR,Negeri Sembilan,0,0,0
2020-06-01,TUR,Pahang,0,0,0
2020-06-01,TUR,Perak,0,0,0
2020-06-01,TUR,Perlis,0,0,0
2020-06-01,TUR,Pulau Pinang,0,0,0
2020-06-01,TUR,Sabah,0,0,0
2020-06-01,TUR,Sarawak,0,0,0
2020-06-01,TUR,Selangor,8,5,3
2020-06-01,TUR,W.P. Labuan,0,0,0
2020-06-01,TUV,Selangor,0,0,0
2020-06-01,TWN,Johor,1,1,0
2020-06-01,TWN,Kedah,0,0,0
2020-06-01,TWN,Kelantan,0,0,0
2020-06-01,TWN,Melaka,0,0,0
2020-06-01,TWN,Negeri Sembilan,0,0,0
2020-06-01,TWN,Pahang,0,0,0
2020-06-01,TWN,Perak,0,0,0
2020-06-01,TWN,Perlis,0,0,0
2020-06-01,TWN,Pulau Pinang,0,0,0
2020-06-01,TWN,Sabah,0,0,0
2020-06-01,TWN,Sarawak,0,0,0
2020-06-01,TWN,Selangor,11,6,5
2020-06-01,TWN,W.P. Labuan,0,0,0
2020-06-01,TZA,Johor,0,0,0
2020-06-01,TZA,Kedah,0,0,0
2020-06-01,TZA,Perak,0,0,0
2020-06-01,TZA,Perlis,0,0,0
2020-06-01,TZA,Pulau Pinang,0,0,0
2020-06-01,TZA,Sabah,0,0,0
2020-06-01,TZA,Sarawak,0,0,0
2020-06-01,TZA,Selangor,0,0,0
2020-06-01,UGA,Johor,0,0,0
2020-06-01,UGA,Kedah,0,0,0
2020-06-01,UGA,Perak,0,0,0
2020-06-01,UGA,Perlis,0,0,0
2020-06-01,UGA,Pulau Pinang,0,0,0
2020-06-01,UGA,Sabah,0,0,0
2020-06-01,UGA,Sarawak,0,0,0
2020-06-01,UGA,Selangor,0,0,0
2020-06-01,UKR,Johor,2,2,0
2020-06-01,UKR,Kedah,0,0,0
2020-06-01,UKR,Kelantan,0,0,0
2020-06-01,UKR,Melaka,0,0,0
2020-06-01,UKR,Negeri Sembilan,0,0,0
2020-06-01,UKR,Pahang,0,0,0
2020-06-01,UKR,Perak,0,0,0
2020-06-01,UKR,Perlis,0,0,0
2020-06-01,UKR,Pulau Pinang,0,0,0
2020-06-01,UKR,Sabah,0,0,0
2020-06-01,UKR,Sarawak,0,0,0
2020-06-01,UKR,Selangor,10,9,1
2020-06-01,UKR,W.P. Labuan,0,0,0
2020-06-01,URY,Johor,0,0,0
2020-06-01,URY,Kedah,0,0,0
2020-06-01,URY,Kelantan,0,0,0
2020-06-01,URY,Perak,0,0,0
2020-06-01,URY,Perlis,0,0,0
2020-06-01,URY,Pulau Pinang,0,0,0
2020-06-01,URY,Sabah,0,0,0
2020-06-01,URY,Sarawak,0,0,0
2020-06-01,URY,Selangor,0,0,0
2020-06-01,URY,W.P. Labuan,0,0,0
2020-06-01,USA,Johor,13,11,2
2020-06-01,USA,Kedah,0,0,0
2020-06-01,USA,Kelantan,0,0,0
2020-06-01,USA,Melaka,0,0,0
2020-06-01,USA,Negeri Sembilan,0,0,0
2020-06-01,USA,Pahang,0,0,0
2020-06-01,USA,Perak,0,0,0
2020-06-01,USA,Perlis,0,0,0
2020-06-01,USA,Pulau Pinang,3,3,0
2020-06-01,USA,Sabah,0,0,0
2020-06-01,USA,Sarawak,0,0,0
2020-06-01,USA,Selangor,34,25,9
2020-06-01,USA,Terengganu,0,0,0
2020-06-01,USA,W.P. Labuan,0,0,0
2020-06-01,UZB,Johor,0,0,0
2020-06-01,UZB,Kedah,0,0,0
2020-06-01,UZB,Kelantan,0,0,0
2020-06-01,UZB,Perak,0,0,0
2020-06-01,UZB,Perlis,0,0,0
2020-06-01,UZB,Pulau Pinang,0,0,0
2020-06-01,UZB,Sabah,0,0,0
2020-06-01,UZB,Sarawak,0,0,0
2020-06-01,UZB,Selangor,0,0,0
2020-06-01,VAT,Johor,0,0,0
2020-06-01,VAT,Sarawak,0,0,0
2020-06-01,VAT,Selangor,0,0,0
2020-06-01,VCT,Johor,0,0,0
2020-06-01,VCT,Kedah,0,0,0
2020-06-01,VCT,Pulau Pinang,0,0,0
2020-06-01,VCT,Sarawak,0,0,0
2020-06-01,VCT,Selangor,0,0,0
2020-06-01,VEN,Johor,0,0,0
2020-06-01,VEN,Kedah,0,0,0
2020-06-01,VEN,Kelantan,0,0,0
2020-06-01,VEN,Melaka,0,0,0
2020-06-01,VEN,Perak,0,0,0
2020-06-01,VEN,Perlis,0,0,0
2020-06-01,VEN,Pulau Pinang,0,0,0
2020-06-01,VEN,Sabah,0,0,0
2020-06-01,VEN,Sarawak,0,0,0
2020-06-01,VEN,Selangor,2,1,1
2020-06-01,VEN,W.P. Labuan,0,0,0
2020-06-01,VNM,Johor,1,0,1
2020-06-01,VNM,Kedah,0,0,0
2020-06-01,VNM,Kelantan,0,0,0
2020-06-01,VNM,Melaka,0,0,0
2020-06-01,VNM,Negeri Sembilan,0,0,0
2020-06-01,VNM,Pahang,0,0,0
2020-06-01,VNM,Perak,0,0,0
2020-06-01,VNM,Perlis,0,0,0
2020-06-01,VNM,Pulau Pinang,0,0,0
2020-06-01,VNM,Sabah,0,0,0
2020-06-01,VNM,Sarawak,0,0,0
2020-06-01,VNM,Selangor,31,30,1
2020-06-01,VNM,Terengganu,0,0,0
2020-06-01,VNM,W.P. Labuan,0,0,0
2020-06-01,VUT,Johor,0,0,0
2020-06-01,VUT,Kedah,0,0,0
2020-06-01,VUT,Pulau Pinang,0,0,0
2020-06-01,VUT,Sabah,0,0,0
2020-06-01,VUT,Sarawak,0,0,0
2020-06-01,VUT,Selangor,0,0,0
2020-06-01,WSM,Johor,0,0,0
2020-06-01,WSM,Sarawak,0,0,0
2020-06-01,WSM,Selangor,0,0,0
2020-06-01,XXX,Johor,0,0,0
2020-06-01,XXX,Kedah,0,0,0
2020-06-01,XXX,Kelantan,0,0,0
2020-06-01,XXX,Melaka,0,0,0
2020-06-01,XXX,Pahang,0,0,0
2020-06-01,XXX,Perak,0,0,0
2020-06-01,XXX,Perlis,0,0,0
2020-06-01,XXX,Pulau Pinang,0,0,0
2020-06-01,XXX,Sabah,0,0,0
2020-06-01,XXX,Sarawak,0,0,0
2020-06-01,XXX,Selangor,4,2,2
2020-06-01,XXX,W.P. Labuan,0,0,0
2020-06-01,YEM,Johor,0,0,0
2020-06-01,YEM,Kedah,0,0,0
2020-06-01,YEM,Kelantan,0,0,0
2020-06-01,YEM,Melaka,0,0,0
2020-06-01,YEM,Pahang,0,0,0
2020-06-01,YEM,Perak,0,0,0
2020-06-01,YEM,Perlis,0,0,0
2020-06-01,YEM,Pulau Pinang,0,0,0
2020-06-01,YEM,Sabah,0,0,0
2020-06-01,YEM,Sarawak,0,0,0
2020-06-01,YEM,Selangor,0,0,0
2020-06-01,YEM,W.P. Labuan,0,0,0
2020-06-01,ZAF,Johor,0,0,0
2020-06-01,ZAF,Kedah,0,0,0
2020-06-01,ZAF,Kelantan,0,0,0
2020-06-01,ZAF,Melaka,0,0,0
2020-06-01,ZAF,Pahang,0,0,0
2020-06-01,ZAF,Perak,0,0,0
2020-06-01,ZAF,Perlis,0,0,0
2020-06-01,ZAF,Pulau Pinang,0,0,0
2020-06-01,ZAF,Sabah,0,0,0
2020-06-01,ZAF,Sarawak,0,0,0
2020-06-01,ZAF,Selangor,14,6,8
2020-06-01,ZAF,Terengganu,0,0,0
2020-06-01,ZAF,W.P. Labuan,0,0,0
2020-06-01,ZAR,Selangor,0,0,0
2020-06-01,ZMB,Johor,0,0,0
2020-06-01,ZMB,Kedah,0,0,0
2020-06-01,ZMB,Perak,0,0,0
2020-06-01,ZMB,Perlis,0,0,0
2020-06-01,ZMB,Pulau Pinang,0,0,0
2020-06-01,ZMB,Sabah,0,0,0
2020-06-01,ZMB,Sarawak,0,0,0
2020-06-01,ZMB,Selangor,0,0,0
2020-06-01,ZWE,Johor,0,0,0
2020-06-01,ZWE,Kedah,0,0,0
2020-06-01,ZWE,Kelantan,0,0,0
2020-06-01,ZWE,Perak,0,0,0
2020-06-01,ZWE,Perlis,0,0,0
2020-06-01,ZWE,Pulau Pinang,0,0,0
2020-06-01,ZWE,Sabah,0,0,0
2020-06-01,ZWE,Sarawak,0,0,0
2020-06-01,ZWE,Selangor,0,0,0
2020-07-01,ABW,Kedah,0,0,0
2020-07-01,ABW,Pulau Pinang,0,0,0
2020-07-01,AFG,Johor,0,0,0
2020-07-01,AFG,Kedah,0,0,0
2020-07-01,AFG,Perlis,0,0,0
2020-07-01,AFG,Pulau Pinang,0,0,0
2020-07-01,AFG,Sarawak,0,0,0
2020-07-01,AFG,Selangor,6,3,3
2020-07-01,AGO,Johor,0,0,0
2020-07-01,AGO,Kedah,0,0,0
2020-07-01,AGO,Sabah,0,0,0
2020-07-01,AGO,Selangor,0,0,0
2020-07-01,AIA,Selangor,0,0,0
2020-07-01,ALB,Johor,0,0,0
2020-07-01,ALB,Kedah,0,0,0
2020-07-01,ALB,Perak,0,0,0
2020-07-01,ALB,Perlis,0,0,0
2020-07-01,ALB,Pulau Pinang,0,0,0
2020-07-01,ALB,Sabah,0,0,0
2020-07-01,ALB,Sarawak,0,0,0
2020-07-01,ALB,Selangor,0,0,0
2020-07-01,AND,Johor,0,0,0
2020-07-01,AND,Kedah,0,0,0
2020-07-01,AND,Perlis,0,0,0
2020-07-01,AND,Pulau Pinang,0,0,0
2020-07-01,AND,Selangor,0,0,0
2020-07-01,ANT,Selangor,0,0,0
2020-07-01,ARE,Johor,0,0,0
2020-07-01,ARE,Kedah,0,0,0
2020-07-01,ARE,Kelantan,0,0,0
2020-07-01,ARE,Perak,0,0,0
2020-07-01,ARE,Perlis,0,0,0
2020-07-01,ARE,Pulau Pinang,0,0,0
2020-07-01,ARE,Sabah,0,0,0
2020-07-01,ARE,Sarawak,0,0,0
2020-07-01,ARE,Selangor,5,1,4
2020-07-01,ARG,Johor,0,0,0
2020-07-01,ARG,Kedah,0,0,0
2020-07-01,ARG,Kelantan,0,0,0
2020-07-01,ARG,Melaka,0,0,0
2020-07-01,ARG,Perak,0,0,0
2020-07-01,ARG,Perlis,0,0,0
2020-07-01,ARG,Pulau Pinang,0,0,0
2020-07-01,ARG,Sabah,0,0,0
2020-07-01,ARG,Sarawak,0,0,0
2020-07-01,ARG,Selangor,4,2,2
2020-07-01,ARG,W.P. Labuan,0,0,0
2020-07-01,ARM,Johor,0,0,0
2020-07-01,ARM,Kedah,0,0,0
2020-07-01,ARM,Kelantan,0,0,0
2020-07-01,ARM,Perak,0,0,0
2020-07-01,ARM,Perlis,0,0,0
2020-07-01,ARM,Pulau Pinang,0,0,0
2020-07-01,ARM,Sabah,0,0,0
2020-07-01,ARM,Sarawak,0,0,0
2020-07-01,ARM,Selangor,0,0,0
2020-07-01,ATA,Selangor,0,0,0
2020-07-01,ATG,Johor,0,0,0
2020-07-01,ATG,Kedah,0,0,0
2020-07-01,ATG,Pulau Pinang,0,0,0
2020-07-01,ATG,Sarawak,0,0,0
2020-07-01,ATG,Selangor,0,0,0
2020-07-01,AUS,Johor,5,5,0
2020-07-01,AUS,Kedah,1,1,0
2020-07-01,AUS,Kelantan,0,0,0
2020-07-01,AUS,Melaka,0,0,0
2020-07-01,AUS,Negeri Sembilan,0,0,0
2020-07-01,AUS,Pahang,0,0,0
2020-07-01,AUS,Perak,0,0,0
2020-07-01,AUS,Perlis,0,0,0
2020-07-01,AUS,Pulau Pinang,0,0,0
2020-07-01,AUS,Sabah,0,0,0
2020-07-01,AUS,Sarawak,3,3,0
2020-07-01,AUS,Selangor,162,111,51
2020-07-01,AUS,Terengganu,0,0,0
2020-07-01,AUS,W.P. Labuan,1,1,0
2020-07-01,AUT,Johor,0,0,0
2020-07-01,AUT,Kedah,0,0,0
2020-07-01,AUT,Kelantan,0,0,0
2020-07-01,AUT,Melaka,0,0,0
2020-07-01,AUT,Negeri Sembilan,0,0,0
2020-07-01,AUT,Pahang,0,0,0
2020-07-01,AUT,Perak,0,0,0
2020-07-01,AUT,Perlis,0,0,0
2020-07-01,AUT,Pulau Pinang,0,0,0
2020-07-01,AUT,Sabah,0,0,0
2020-07-01,AUT,Sarawak,0,0,0
2020-07-01,AUT,Selangor,13,9,4
2020-07-01,AUT,Terengganu,0,0,0
2020-07-01,AUT,W.P. Labuan,0,0,0
2020-07-01,AZE,Johor,0,0,0
2020-07-01,AZE,Kedah,0,0,0
2020-07-01,AZE,Kelantan,0,0,0
2020-07-01,AZE,Melaka,0,0,0
2020-07-01,AZE,Perlis,0,0,0
2020-07-01,AZE,Pulau Pinang,0,0,0
2020-07-01,AZE,Sabah,0,0,0
2020-07-01,AZE,Sarawak,0,0,0
2020-07-01,AZE,Selangor,1,1,0
2020-07-01,AZE,W.P. Labuan,0,0,0
2020-07-01,BDI,Pulau Pinang,0,0,0
2020-07-01,BDI,Sarawak,0,0,0
2020-07-01,BDI,Selangor,0,0,0
2020-07-01,BEL,Johor,0,0,0
2020-07-01,BEL,Kedah,0,0,0
2020-07-01,BEL,Kelantan,0,0,0
2020-07-01,BEL,Melaka,0,0,0
2020-07-01,BEL,Negeri Sembilan,0,0,0
2020-07-01,BEL,Pahang,0,0,0
2020-07-01,BEL,Perak,0,0,0
2020-07-01,BEL,Perlis,0,0,0
2020-07-01,BEL,Pulau Pinang,0,0,0
2020-07-01,BEL,Sabah,0,0,0
2020-07-01,BEL,Sarawak,0,0,0
2020-07-01,BEL,Selangor,12,10,2
2020-07-01,BEL,W.P. Labuan,0,0,0
2020-07-01,BEN,Johor,0,0,0
2020-07-01,BEN,Kedah,0,0,0
2020-07-01,BEN,Perak,0,0,0
2020-07-01,BEN,Pulau Pinang,0,0,0
2020-07-01,BEN,Sabah,0,0,0
2020-07-01,BEN,Sarawak,0,0,0
2020-07-01,BEN,Selangor,0,0,0
2020-07-01,BFA,Perak,0,0,0
2020-07-01,BFA,Pulau Pinang,0,0,0
2020-07-01,BFA,Selangor,0,0,0
2020-07-01,BGD,Johor,2,2,0
2020-07-01,BGD,Kedah,0,0,0
2020-07-01,BGD,Kelantan,0,0,0
2020-07-01,BGD,Melaka,0,0,0
2020-07-01,BGD,Negeri Sembilan,0,0,0
2020-07-01,BGD,Pahang,0,0,0
2020-07-01,BGD,Perak,0,0,0
2020-07-01,BGD,Perlis,0,0,0
2020-07-01,BGD,Pulau Pinang,0,0,0
2020-07-01,BGD,Sabah,0,0,0
2020-07-01,BGD,Sarawak,0,0,0
2020-07-01,BGD,Selangor,106,70,36
2020-07-01,BGD,W.P. Labuan,0,0,0
2020-07-01,BGR,Johor,1,1,0
2020-07-01,BGR,Kedah,0,0,0
2020-07-01,BGR,Kelantan,0,0,0
2020-07-01,BGR,Pahang,0,0,0
2020-07-01,BGR,Perak,0,0,0
2020-07-01,BGR,Perlis,0,0,0
2020-07-01,BGR,Pulau Pinang,0,0,0
2020-07-01,BGR,Sabah,0,0,0
2020-07-01,BGR,Sarawak,0,0,0
2020-07-01,BGR,Selangor,24,24,0
2020-07-01,BGR,W.P. Labuan,0,0,0
2020-07-01,BHR,Johor,0,0,0
2020-07-01,BHR,Kedah,0,0,0
2020-07-01,BHR,Kelantan,0,0,0
2020-07-01,BHR,Perlis,0,0,0
2020-07-01,BHR,Pulau Pinang,0,0,0
2020-07-01,BHR,Sabah,0,0,0
2020-07-01,BHR,Sarawak,0,0,0
2020-07-01,BHR,Selangor,0,0,0
2020-07-01,BHS,Johor,0,0,0
2020-07-01,BHS,Kedah,0,0,0
2020-07-01,BHS,Perak,0,0,0
2020-07-01,BHS,Sabah,0,0,0
2020-07-01,BHS,Sarawak,0,0,0
2020-07-01,BHS,Selangor,0,0,0
2020-07-01,BIH,Johor,0,0,0
2020-07-01,BIH,Kedah,0,0,0
2020-07-01,BIH,Perlis,0,0,0
2020-07-01,BIH,Pulau Pinang,0,0,0
2020-07-01,BIH,Sabah,0,0,0
2020-07-01,BIH,Sarawak,0,0,0
2020-07-01,BIH,Selangor,1,1,0
2020-07-01,BLR,Johor,0,0,0
2020-07-01,BLR,Kedah,0,0,0
2020-07-01,BLR,Kelantan,0,0,0
2020-07-01,BLR,Pahang,0,0,0
2020-07-01,BLR,Perak,0,0,0
2020-07-01,BLR,Perlis,0,0,0
2020-07-01,BLR,Pulau Pinang,0,0,0
2020-07-01,BLR,Sabah,0,0,0
2020-07-01,BLR,Sarawak,0,0,0
2020-07-01,BLR,Selangor,1,1,0
2020-07-01,BLR,W.P. Labuan,0,0,0
2020-07-01,BLZ,Johor,0,0,0
2020-07-01,BLZ,Pulau Pinang,0,0,0
2020-07-01,BLZ,Sarawak,0,0,0
2020-07-01,BLZ,Selangor,0,0,0
2020-07-01,BMU,Selangor,0,0,0
2020-07-01,BOL,Johor,0,0,0
2020-07-01,BOL,Kedah,0,0,0
2020-07-01,BOL,Melaka,0,0,0
2020-07-01,BOL,Perak,0,0,0
2020-07-01,BOL,Perlis,0,0,0
2020-07-01,BOL,Pulau Pinang,0,0,0
2020-07-01,BOL,Sabah,0,0,0
2020-07-01,BOL,Sarawak,0,0,0
2020-07-01,BOL,Selangor,0,0,0
2020-07-01,BRA,Johor,0,0,0
2020-07-01,BRA,Kedah,0,0,0
2020-07-01,BRA,Kelantan,0,0,0
2020-07-01,BRA,Melaka,0,0,0
2020-07-01,BRA,Pahang,0,0,0
2020-07-01,BRA,Perak,0,0,0
2020-07-01,BRA,Perlis,0,0,0
2020-07-01,BRA,Pulau Pinang,0,0,0
2020-07-01,BRA,Sabah,0,0,0
2020-07-01,BRA,Sarawak,0,0,0
2020-07-01,BRA,Selangor,16,13,3
2020-07-01,BRA,W.P. Labuan,0,0,0
2020-07-01,BRB,Johor,0,0,0
2020-07-01,BRB,Kedah,0,0,0
2020-07-01,BRB,Perlis,0,0,0
2020-07-01,BRB,Pulau Pinang,0,0,0
2020-07-01,BRB,Selangor,1,0,1
2020-07-01,BRN,Johor,0,0,0
2020-07-01,BRN,Kedah,0,0,0
2020-07-01,BRN,Kelantan,0,0,0
2020-07-01,BRN,Melaka,0,0,0
2020-07-01,BRN,Pahang,0,0,0
2020-07-01,BRN,Perak,0,0,0
2020-07-01,BRN,Perlis,0,0,0
2020-07-01,BRN,Pulau Pinang,0,0,0
2020-07-01,BRN,Sabah,0,0,0
2020-07-01,BRN,Sarawak,339,315,24
2020-07-01,BRN,Selangor,10,1,9
2020-07-01,BRN,W.P. Labuan,1,0,1
2020-07-01,BTN,Johor,0,0,0
2020-07-01,BTN,Kedah,0,0,0
2020-07-01,BTN,Perak,0,0,0
2020-07-01,BTN,Perlis,0,0,0
2020-07-01,BTN,Pulau Pinang,0,0,0
2020-07-01,BTN,Sabah,0,0,0
2020-07-01,BTN,Sarawak,0,0,0
2020-07-01,BTN,Selangor,0,0,0
2020-07-01,BWA,Johor,0,0,0
2020-07-01,BWA,Kedah,0,0,0
2020-07-01,BWA,Perlis,0,0,0
2020-07-01,BWA,Pulau Pinang,0,0,0
2020-07-01,BWA,Sabah,0,0,0
2020-07-01,BWA,Sarawak,0,0,0
2020-07-01,BWA,Selangor,0,0,0
2020-07-01,CAF,Kedah,0,0,0
2020-07-01,CAF,Selangor,0,0,0
2020-07-01,CAN,Johor,0,0,0
2020-07-01,CAN,Kedah,0,0,0
2020-07-01,CAN,Kelantan,0,0,0
2020-07-01,CAN,Melaka,0,0,0
2020-07-01,CAN,Negeri Sembilan,0,0,0
2020-07-01,CAN,Pahang,0,0,0
2020-07-01,CAN,Perak,0,0,0
2020-07-01,CAN,Perlis,0,0,0
2020-07-01,CAN,Pulau Pinang,0,0,0
2020-07-01,CAN,Sabah,0,0,0
2020-07-01,CAN,Sarawak,0,0,0
2020-07-01,CAN,Selangor,37,27,10
2020-07-01,CAN,Terengganu,0,0,0
2020-07-01,CAN,W.P. Labuan,0,0,0
2020-07-01,CCK,Selangor,0,0,0
2020-07-01,CHE,Johor,0,0,0
2020-07-01,CHE,Kedah,0,0,0
2020-07-01,CHE,Kelantan,0,0,0
2020-07-01,CHE,Melaka,0,0,0
2020-07-01,CHE,Negeri Sembilan,0,0,0
2020-07-01,CHE,Pahang,0,0,0
2020-07-01,CHE,Perak,0,0,0
2020-07-01,CHE,Perlis,0,0,0
2020-07-01,CHE,Pulau Pinang,0,0,0
2020-07-01,CHE,Sabah,0,0,0
2020-07-01,CHE,Sarawak,0,0,0
2020-07-01,CHE,Selangor,18,14,4
2020-07-01,CHE,W.P. Labuan,0,0,0
2020-07-01,CHL,Johor,0,0,0
2020-07-01,CHL,Kedah,0,0,0
2020-07-01,CHL,Kelantan,0,0,0
2020-07-01,CHL,Melaka,0,0,0
2020-07-01,CHL,Pahang,0,0,0
2020-07-01,CHL,Perak,0,0,0
2020-07-01,CHL,Perlis,0,0,0
2020-07-01,CHL,Pulau Pinang,0,0,0
2020-07-01,CHL,Sabah,0,0,0
2020-07-01,CHL,Sarawak,0,0,0
2020-07-01,CHL,Selangor,0,0,0
2020-07-01,CHN,Johor,11,3,8
2020-07-01,CHN,Kedah,0,0,0
2020-07-01,CHN,Kelantan,0,0,0
2020-07-01,CHN,Melaka,0,0,0
2020-07-01,CHN,Pahang,0,0,0
2020-07-01,CHN,Perak,0,0,0
2020-07-01,CHN,Perlis,0,0,0
2020-07-01,CHN,Pulau Pinang,0,0,0
2020-07-01,CHN,Sabah,2,1,1
2020-07-01,CHN,Sarawak,5,0,5
2020-07-01,CHN,Selangor,485,326,159
2020-07-01,CHN,Terengganu,0,0,0
2020-07-01,CHN,W.P. Labuan,2,0,2
2020-07-01,CIV,Johor,0,0,0
2020-07-01,CIV,Kedah,0,0,0
2020-07-01,CIV,Pulau Pinang,0,0,0
2020-07-01,CIV,Sabah,0,0,0
2020-07-01,CIV,Sarawak,0,0,0
2020-07-01,CIV,Selangor,0,0,0
2020-07-01,CMR,Johor,0,0,0
2020-07-01,CMR,Kedah,0,0,0
2020-07-01,CMR,Pulau Pinang,0,0,0
2020-07-01,CMR,Sabah,0,0,0
2020-07-01,CMR,Sarawak,0,0,0
2020-07-01,CMR,Selangor,0,0,0
2020-07-01,COD,Johor,0,0,0
2020-07-01,COD,Pulau Pinang,0,0,0
2020-07-01,COD,Sarawak,0,0,0
2020-07-01,COD,Selangor,0,0,0
2020-07-01,COG,Johor,0,0,0
2020-07-01,COG,Kedah,0,0,0
2020-07-01,COG,Selangor,0,0,0
2020-07-01,COK,Selangor,0,0,0
2020-07-01,COL,Johor,0,0,0
2020-07-01,COL,Kedah,0,0,0
2020-07-01,COL,Perak,0,0,0
2020-07-01,COL,Pulau Pinang,0,0,0
2020-07-01,COL,Sabah,0,0,0
2020-07-01,COL,Sarawak,0,0,0
2020-07-01,COL,Selangor,3,1,2
2020-07-01,COL,W.P. Labuan,0,0,0
2020-07-01,COM,Johor,0,0,0
2020-07-01,COM,Kedah,0,0,0
2020-07-01,COM,Selangor,0,0,0
2020-07-01,CPV,Johor,0,0,0
2020-07-01,CPV,Kedah,0,0,0
2020-07-01,CPV,Pulau Pinang,0,0,0
2020-07-01,CPV,Sabah,0,0,0
2020-07-01,CPV,Selangor,0,0,0
2020-07-01,CRI,Johor,0,0,0
2020-07-01,CRI,Kedah,0,0,0
2020-07-01,CRI,Perak,0,0,0
2020-07-01,CRI,Perlis,0,0,0
2020-07-01,CRI,Pulau Pinang,0,0,0
2020-07-01,CRI,Sabah,0,0,0
2020-07-01,CRI,Sarawak,0,0,0
2020-07-01,CRI,Selangor,0,0,0
2020-07-01,CUB,Johor,0,0,0
2020-07-01,CUB,Kedah,0,0,0
2020-07-01,CUB,Perlis,0,0,0
2020-07-01,CUB,Pulau Pinang,0,0,0
2020-07-01,CUB,Sabah,0,0,0
2020-07-01,CUB,Sarawak,0,0,0
2020-07-01,CUB,Selangor,0,0,0
2020-07-01,CYP,Johor,0,0,0
2020-07-01,CYP,Kedah,0,0,0
2020-07-01,CYP,Perak,0,0,0
2020-07-01,CYP,Perlis,0,0,0
2020-07-01,CYP,Pulau Pinang,0,0,0
2020-07-01,CYP,Sabah,0,0,0
2020-07-01,CYP,Sarawak,0,0,0
2020-07-01,CYP,Selangor,2,2,0
2020-07-01,CZE,Johor,0,0,0
2020-07-01,CZE,Kedah,0,0,0
2020-07-01,CZE,Kelantan,0,0,0
2020-07-01,CZE,Melaka,0,0,0
2020-07-01,CZE,Negeri Sembilan,0,0,0
2020-07-01,CZE,Perak,0,0,0
2020-07-01,CZE,Perlis,0,0,0
2020-07-01,CZE,Pulau Pinang,0,0,0
2020-07-01,CZE,Sabah,0,0,0
2020-07-01,CZE,Sarawak,0,0,0
2020-07-01,CZE,Selangor,7,5,2
2020-07-01,CZE,W.P. Labuan,0,0,0
2020-07-01,DEU,Johor,0,0,0
2020-07-01,DEU,Kedah,0,0,0
2020-07-01,DEU,Kelantan,0,0,0
2020-07-01,DEU,Melaka,0,0,0
2020-07-01,DEU,Negeri Sembilan,0,0,0
2020-07-01,DEU,Pahang,0,0,0
2020-07-01,DEU,Perak,0,0,0
2020-07-01,DEU,Perlis,0,0,0
2020-07-01,DEU,Pulau Pinang,0,0,0
2020-07-01,DEU,Sabah,2,0,2
2020-07-01,DEU,Sarawak,0,0,0
2020-07-01,DEU,Selangor,115,75,40
2020-07-01,DEU,Terengganu,0,0,0
2020-07-01,DEU,W.P. Labuan,0,0,0
2020-07-01,DJI,Johor,0,0,0
2020-07-01,DJI,Selangor,0,0,0
2020-07-01,DMA,Johor,0,0,0
2020-07-01,DMA,Kedah,0,0,0
2020-07-01,DMA,Pulau Pinang,0,0,0
2020-07-01,DMA,Sabah,0,0,0
2020-07-01,DMA,Sarawak,0,0,0
2020-07-01,DMA,Selangor,0,0,0
2020-07-01,DMA,W.P. Labuan,0,0,0
2020-07-01,DNK,Johor,0,0,0
2020-07-01,DNK,Kedah,0,0,0
2020-07-01,DNK,Kelantan,0,0,0
2020-07-01,DNK,Melaka,0,0,0
2020-07-01,DNK,Negeri Sembilan,0,0,0
2020-07-01,DNK,Pahang,0,0,0
2020-07-01,DNK,Perak,0,0,0
2020-07-01,DNK,Perlis,0,0,0
2020-07-01,DNK,Pulau Pinang,0,0,0
2020-07-01,DNK,Sabah,0,0,0
2020-07-01,DNK,Sarawak,0,0,0
2020-07-01,DNK,Selangor,35,30,5
2020-07-01,DNK,W.P. Labuan,0,0,0
2020-07-01,DOM,Johor,0,0,0
2020-07-01,DOM,Kedah,0,0,0
2020-07-01,DOM,Perak,0,0,0
2020-07-01,DOM,Perlis,0,0,0
2020-07-01,DOM,Pulau Pinang,0,0,0
2020-07-01,DOM,Sabah,0,0,0
2020-07-01,DOM,Sarawak,0,0,0
2020-07-01,DOM,Selangor,1,1,0
2020-07-01,DZA,Johor,0,0,0
2020-07-01,DZA,Kedah,0,0,0
2020-07-01,DZA,Kelantan,0,0,0
2020-07-01,DZA,Melaka,0,0,0
2020-07-01,DZA,Perak,0,0,0
2020-07-01,DZA,Perlis,0,0,0
2020-07-01,DZA,Pulau Pinang,0,0,0
2020-07-01,DZA,Sabah,0,0,0
2020-07-01,DZA,Sarawak,0,0,0
2020-07-01,DZA,Selangor,4,2,2
2020-07-01,DZA,W.P. Labuan,0,0,0
2020-07-01,ECU,Johor,0,0,0
2020-07-01,ECU,Kedah,0,0,0
2020-07-01,ECU,Perak,0,0,0
2020-07-01,ECU,Perlis,0,0,0
2020-07-01,ECU,Pulau Pinang,0,0,0
2020-07-01,ECU,Sabah,0,0,0
2020-07-01,ECU,Sarawak,0,0,0
2020-07-01,ECU,Selangor,1,0,1
2020-07-01,EGY,Johor,0,0,0
2020-07-01,EGY,Kedah,0,0,0
2020-07-01,EGY,Kelantan,0,0,0
2020-07-01,EGY,Melaka,0,0,0
2020-07-01,EGY,Pahang,0,0,0
2020-07-01,EGY,Perak,0,0,0
2020-07-01,EGY,Perlis,0,0,0
2020-07-01,EGY,Pulau Pinang,0,0,0
2020-07-01,EGY,Sabah,0,0,0
2020-07-01,EGY,Sarawak,0,0,0
2020-07-01,EGY,Selangor,27,18,9
2020-07-01,EGY,Terengganu,0,0,0
2020-07-01,EGY,W.P. Labuan,0,0,0
2020-07-01,ERI,Johor,0,0,0
2020-07-01,ERI,Pulau Pinang,0,0,0
2020-07-01,ERI,Sabah,0,0,0
2020-07-01,ERI,Selangor,0,0,0
2020-07-01,ESP,Johor,0,0,0
2020-07-01,ESP,Kedah,0,0,0
2020-07-01,ESP,Kelantan,0,0,0
2020-07-01,ESP,Melaka,0,0,0
2020-07-01,ESP,Negeri Sembilan,0,0,0
2020-07-01,ESP,Pahang,0,0,0
2020-07-01,ESP,Perak,0,0,0
2020-07-01,ESP,Perlis,0,0,0
2020-07-01,ESP,Pulau Pinang,0,0,0
2020-07-01,ESP,Sabah,0,0,0
2020-07-01,ESP,Sarawak,0,0,0
2020-07-01,ESP,Selangor,22,18,4
2020-07-01,ESP,W.P. Labuan,0,0,0
2020-07-01,EST,Johor,0,0,0
2020-07-01,EST,Kedah,0,0,0
2020-07-01,EST,Kelantan,0,0,0
2020-07-01,EST,Pahang,0,0,0
2020-07-01,EST,Perak,0,0,0
2020-07-01,EST,Perlis,0,0,0
2020-07-01,EST,Pulau Pinang,1,1,0
2020-07-01,EST,Sabah,0,0,0
2020-07-01,EST,Sarawak,0,0,0
2020-07-01,EST,Selangor,5,5,0
2020-07-01,EST,W.P. Labuan,0,0,0
2020-07-01,ETH,Johor,0,0,0
2020-07-01,ETH,Kedah,0,0,0
2020-07-01,ETH,Pulau Pinang,0,0,0
2020-07-01,ETH,Sarawak,0,0,0
2020-07-01,ETH,Selangor,3,3,0
2020-07-01,FIN,Johor,0,0,0
2020-07-01,FIN,Kedah,0,0,0
2020-07-01,FIN,Kelantan,0,0,0
2020-07-01,FIN,Melaka,0,0,0
2020-07-01,FIN,Negeri Sembilan,0,0,0
2020-07-01,FIN,Pahang,0,0,0
2020-07-01,FIN,Perak,0,0,0
2020-07-01,FIN,Perlis,0,0,0
2020-07-01,FIN,Pulau Pinang,0,0,0
2020-07-01,FIN,Sabah,0,0,0
2020-07-01,FIN,Sarawak,0,0,0
2020-07-01,FIN,Selangor,8,6,2
2020-07-01,FIN,W.P. Labuan,0,0,0
2020-07-01,FJI,Johor,0,0,0
2020-07-01,FJI,Kedah,0,0,0
2020-07-01,FJI,Kelantan,0,0,0
2020-07-01,FJI,Perak,0,0,0
2020-07-01,FJI,Perlis,0,0,0
2020-07-01,FJI,Pulau Pinang,0,0,0
2020-07-01,FJI,Sabah,0,0,0
2020-07-01,FJI,Sarawak,0,0,0
2020-07-01,FJI,Selangor,0,0,0
2020-07-01,FRA,Johor,1,1,0
2020-07-01,FRA,Kedah,1,1,0
2020-07-01,FRA,Kelantan,0,0,0
2020-07-01,FRA,Melaka,0,0,0
2020-07-01,FRA,Negeri Sembilan,0,0,0
2020-07-01,FRA,Pahang,0,0,0
2020-07-01,FRA,Perak,0,0,0
2020-07-01,FRA,Perlis,0,0,0
2020-07-01,FRA,Pulau Pinang,0,0,0
2020-07-01,FRA,Sabah,0,0,0
2020-07-01,FRA,Sarawak,0,0,0
2020-07-01,FRA,Selangor,62,40,22
2020-07-01,FRA,Terengganu,0,0,0
2020-07-01,FRA,W.P. Labuan,0,0,0
2020-07-01,FSM,Johor,0,0,0
2020-07-01,FSM,Pulau Pinang,0,0,0
2020-07-01,FSM,Selangor,0,0,0
2020-07-01,GAB,Johor,0,0,0
2020-07-01,GAB,Pulau Pinang,0,0,0
2020-07-01,GAB,Sarawak,0,0,0
2020-07-01,GAB,Selangor,0,0,0
2020-07-01,GBR,Johor,1,1,0
2020-07-01,GBR,Kedah,0,0,0
2020-07-01,GBR,Kelantan,0,0,0
2020-07-01,GBR,Melaka,0,0,0
2020-07-01,GBR,Negeri Sembilan,0,0,0
2020-07-01,GBR,Pahang,0,0,0
2020-07-01,GBR,Perak,0,0,0
2020-07-01,GBR,Perlis,0,0,0
2020-07-01,GBR,Pulau Pinang,1,1,0
2020-07-01,GBR,Sabah,2,2,0
2020-07-01,GBR,Sarawak,2,2,0
2020-07-01,GBR,Selangor,265,197,68
2020-07-01,GBR,Terengganu,0,0,0
2020-07-01,GBR,W.P. Labuan,0,0,0
2020-07-01,GEO,Johor,0,0,0
2020-07-01,GEO,Kedah,0,0,0
2020-07-01,GEO,Melaka,0,0,0
2020-07-01,GEO,Perak,0,0,0
2020-07-01,GEO,Perlis,0,0,0
2020-07-01,GEO,Pulau Pinang,0,0,0
2020-07-01,GEO,Sabah,0,0,0
2020-07-01,GEO,Sarawak,0,0,0
2020-07-01,GEO,Selangor,30,30,0
2020-07-01,GHA,Johor,0,0,0
2020-07-01,GHA,Kedah,0,0,0
2020-07-01,GHA,Kelantan,0,0,0
2020-07-01,GHA,Pulau Pinang,0,0,0
2020-07-01,GHA,Sabah,0,0,0
2020-07-01,GHA,Sarawak,0,0,0
2020-07-01,GHA,Selangor,0,0,0
2020-07-01,GIB,Johor,0,0,0
2020-07-01,GIB,Sarawak,0,0,0
2020-07-01,GIN,Johor,0,0,0
2020-07-01,GIN,Kedah,0,0,0
2020-07-01,GIN,Kelantan,0,0,0
2020-07-01,GIN,Perlis,0,0,0
2020-07-01,GIN,Pulau Pinang,0,0,0
2020-07-01,GIN,Sabah,0,0,0
2020-07-01,GIN,Sarawak,0,0,0
2020-07-01,GIN,Selangor,0,0,0
2020-07-01,GLP,Selangor,0,0,0
2020-07-01,GMB,Johor,0,0,0
2020-07-01,GMB,Kedah,0,0,0
2020-07-01,GMB,Kelantan,0,0,0
2020-07-01,GMB,Pulau Pinang,0,0,0
2020-07-01,GMB,Sabah,0,0,0
2020-07-01,GMB,Sarawak,0,0,0
2020-07-01,GMB,Selangor,1,0,1
2020-07-01,GNB,Johor,0,0,0
2020-07-01,GNB,Selangor,0,0,0
2020-07-01,GNQ,Johor,0,0,0
2020-07-01,GNQ,Selangor,0,0,0
2020-07-01,GRC,Johor,4,4,0
2020-07-01,GRC,Kedah,0,0,0
2020-07-01,GRC,Kelantan,0,0,0
2020-07-01,GRC,Melaka,0,0,0
2020-07-01,GRC,Negeri Sembilan,0,0,0
2020-07-01,GRC,Pahang,0,0,0
2020-07-01,GRC,Perak,0,0,0
2020-07-01,GRC,Perlis,0,0,0
2020-07-01,GRC,Pulau Pinang,0,0,0
2020-07-01,GRC,Sabah,0,0,0
2020-07-01,GRC,Sarawak,0,0,0
2020-07-01,GRC,Selangor,31,28,3
2020-07-01,GRD,Johor,0,0,0
2020-07-01,GRD,Kedah,0,0,0
2020-07-01,GRD,Pulau Pinang,0,0,0
2020-07-01,GRD,Sabah,0,0,0
2020-07-01,GRD,Sarawak,0,0,0
2020-07-01,GRD,Selangor,0,0,0
2020-07-01,GRL,Johor,0,0,0
2020-07-01,GRL,Selangor,0,0,0
2020-07-01,GTM,Johor,0,0,0
2020-07-01,GTM,Kedah,0,0,0
2020-07-01,GTM,Pahang,0,0,0
2020-07-01,GTM,Perak,0,0,0
2020-07-01,GTM,Pulau Pinang,0,0,0
2020-07-01,GTM,Sabah,0,0,0
2020-07-01,GTM,Sarawak,0,0,0
2020-07-01,GTM,Selangor,0,0,0
2020-07-01,GTM,W.P. Labuan,0,0,0
2020-07-01,GUY,Johor,0,0,0
2020-07-01,GUY,Kedah,0,0,0
2020-07-01,GUY,Pulau Pinang,0,0,0
2020-07-01,GUY,Sarawak,0,0,0
2020-07-01,GUY,Selangor,0,0,0
2020-07-01,HKG,Johor,0,0,0
2020-07-01,HKG,Kedah,0,0,0
2020-07-01,HKG,Kelantan,0,0,0
2020-07-01,HKG,Pahang,0,0,0
2020-07-01,HKG,Perak,0,0,0
2020-07-01,HKG,Perlis,0,0,0
2020-07-01,HKG,Pulau Pinang,0,0,0
2020-07-01,HKG,Sabah,0,0,0
2020-07-01,HKG,Sarawak,7,6,1
2020-07-01,HKG,Selangor,0,0,0
2020-07-01,HKG,Terengganu,0,0,0
2020-07-01,HMD,Johor,0,0,0
2020-07-01,HND,Johor,0,0,0
2020-07-01,HND,Kedah,0,0,0
2020-07-01,HND,Perak,0,0,0
2020-07-01,HND,Pulau Pinang,0,0,0
2020-07-01,HND,Sabah,0,0,0
2020-07-01,HND,Sarawak,0,0,0
2020-07-01,HND,Selangor,2,2,0
2020-07-01,HRV,Johor,7,7,0
2020-07-01,HRV,Kedah,0,0,0
2020-07-01,HRV,Kelantan,0,0,0
2020-07-01,HRV,Melaka,0,0,0
2020-07-01,HRV,Pahang,0,0,0
2020-07-01,HRV,Perak,0,0,0
2020-07-01,HRV,Perlis,0,0,0
2020-07-01,HRV,Pulau Pinang,0,0,0
2020-07-01,HRV,Sabah,0,0,0
2020-07-01,HRV,Sarawak,0,0,0
2020-07-01,HRV,Selangor,37,37,0
2020-07-01,HTI,Johor,0,0,0
2020-07-01,HTI,Kedah,0,0,0
2020-07-01,HTI,Kelantan,0,0,0
2020-07-01,HTI,Perak,0,0,0
2020-07-01,HTI,Pulau Pinang,0,0,0
2020-07-01,HTI,Sabah,0,0,0
2020-07-01,HTI,Selangor,0,0,0
2020-07-01,HUN,Johor,1,1,0
2020-07-01,HUN,Kedah,0,0,0
2020-07-01,HUN,Kelantan,0,0,0
2020-07-01,HUN,Pahang,0,0,0
2020-07-01,HUN,Perak,0,0,0
2020-07-01,HUN,Perlis,0,0,0
2020-07-01,HUN,Pulau Pinang,0,0,0
2020-07-01,HUN,Sabah,0,0,0
2020-07-01,HUN,Sarawak,0,0,0
2020-07-01,HUN,Selangor,6,2,4
2020-07-01,HUN,W.P. Labuan,0,0,0
2020-07-01,IDN,Johor,214,163,51
2020-07-01,IDN,Kedah,8,7,1
2020-07-01,IDN,Kelantan,0,0,0
2020-07-01,IDN,Melaka,0,0,0
2020-07-01,IDN,Negeri Sembilan,0,0,0
2020-07-01,IDN,Pahang,0,0,0
2020-07-01,IDN,Perak,0,0,0
2020-07-01,IDN,Perlis,1,1,0
2020-07-01,IDN,Pulau Pinang,14,2,12
2020-07-01,IDN,Sabah,56,20,36
2020-07-01,IDN,Sarawak,733,687,46
2020-07-01,IDN,Selangor,716,478,238
2020-07-01,IDN,Terengganu,0,0,0
2020-07-01,IDN,W.P. Labuan,0,0,0
2020-07-01,IND,Johor,71,71,0
2020-07-01,IND,Kedah,0,0,0
2020-07-01,IND,Kelantan,0,0,0
2020-07-01,IND,Melaka,0,0,0
2020-07-01,IND,Negeri Sembilan,0,0,0
2020-07-01,IND,Pahang,0,0,0
2020-07-01,IND,Perak,0,0,0
2020-07-01,IND,Perlis,0,0,0
2020-07-01,IND,Pulau Pinang,0,0,0
2020-07-01,IND,Sabah,0,0,0
2020-07-01,IND,Sarawak,1,0,1
2020-07-01,IND,Selangor,699,485,214
2020-07-01,IND,Terengganu,0,0,0
2020-07-01,IND,W.P. Labuan,0,0,0
2020-07-01,IOT,Pulau Pinang,0,0,0
2020-07-01,IOT,Selangor,0,0,0
2020-07-01,IRL,Johor,2,2,0
2020-07-01,IRL,Kedah,0,0,0
2020-07-01,IRL,Kelantan,0,0,0
2020-07-01,IRL,Negeri Sembilan,0,0,0
2020-07-01,IRL,Pahang,0,0,0
2020-07-01,IRL,Perak,0,0,0
2020-07-01,IRL,Perlis,0,0,0
2020-07-01,IRL,Pulau Pinang,0,0,0
2020-07-01,IRL,Sabah,0,0,0
2020-07-01,IRL,Sarawak,0,0,0
2020-07-01,IRL,Selangor,14,9,5
2020-07-01,IRL,Terengganu,0,0,0
2020-07-01,IRL,W.P. Labuan,0,0,0
2020-07-01,IRN,Johor,0,0,0
2020-07-01,IRN,Kedah,0,0,0
2020-07-01,IRN,Kelantan,0,0,0
2020-07-01,IRN,Perak,0,0,0
2020-07-01,IRN,Perlis,0,0,0
2020-07-01,IRN,Pulau Pinang,0,0,0
2020-07-01,IRN,Sabah,0,0,0
2020-07-01,IRN,Sarawak,0,0,0
2020-07-01,IRN,Selangor,28,14,14
2020-07-01,IRN,W.P. Labuan,0,0,0
2020-07-01,IRQ,Johor,0,0,0
2020-07-01,IRQ,Kedah,0,0,0
2020-07-01,IRQ,Kelantan,0,0,0
2020-07-01,IRQ,Melaka,0,0,0
2020-07-01,IRQ,Pahang,0,0,0
2020-07-01,IRQ,Perak,0,0,0
2020-07-01,IRQ,Perlis,0,0,0
2020-07-01,IRQ,Pulau Pinang,0,0,0
2020-07-01,IRQ,Sabah,0,0,0
2020-07-01,IRQ,Sarawak,0,0,0
2020-07-01,IRQ,Selangor,7,6,1
2020-07-01,ISL,Johor,0,0,0
2020-07-01,ISL,Kedah,0,0,0
2020-07-01,ISL,Kelantan,0,0,0
2020-07-01,ISL,Perak,0,0,0
2020-07-01,ISL,Perlis,0,0,0
2020-07-01,ISL,Pulau Pinang,0,0,0
2020-07-01,ISL,Sabah,0,0,0
2020-07-01,ISL,Sarawak,0,0,0
2020-07-01,ISL,Selangor,5,5,0
2020-07-01,ISL,W.P. Labuan,0,0,0
2020-07-01,ISR,Pulau Pinang,0,0,0
2020-07-01,ITA,Johor,3,3,0
2020-07-01,ITA,Kedah,0,0,0
2020-07-01,ITA,Kelantan,0,0,0
2020-07-01,ITA,Melaka,0,0,0
2020-07-01,ITA,Negeri Sembilan,0,0,0
2020-07-01,ITA,Pahang,0,0,0
2020-07-01,ITA,Perak,0,0,0
2020-07-01,ITA,Perlis,0,0,0
2020-07-01,ITA,Pulau Pinang,0,0,0
2020-07-01,ITA,Sabah,0,0,0
2020-07-01,ITA,Sarawak,0,0,0
2020-07-01,ITA,Selangor,29,22,7
2020-07-01,ITA,W.P. Labuan,0,0,0
2020-07-01,JAM,Johor,0,0,0
2020-07-01,JAM,Kedah,0,0,0
2020-07-01,JAM,Perak,0,0,0
2020-07-01,JAM,Pulau Pinang,0,0,0
2020-07-01,JAM,Sabah,0,0,0
2020-07-01,JAM,Sarawak,0,0,0
2020-07-01,JAM,Selangor,0,0,0
2020-07-01,JAM,W.P. Labuan,0,0,0
2020-07-01,JOR,Johor,0,0,0
2020-07-01,JOR,Kedah,0,0,0
2020-07-01,JOR,Kelantan,0,0,0
2020-07-01,JOR,Melaka,0,0,0
2020-07-01,JOR,Perlis,0,0,0
2020-07-01,JOR,Pulau Pinang,0,0,0
2020-07-01,JOR,Sabah,0,0,0
2020-07-01,JOR,Sarawak,0,0,0
2020-07-01,JOR,Selangor,0,0,0
2020-07-01,JOR,W.P. Labuan,0,0,0
2020-07-01,JPN,Johor,0,0,0
2020-07-01,JPN,Kedah,0,0,0
2020-07-01,JPN,Kelantan,0,0,0
2020-07-01,JPN,Melaka,0,0,0
2020-07-01,JPN,Negeri Sembilan,0,0,0
2020-07-01,JPN,Pahang,0,0,0
2020-07-01,JPN,Perak,0,0,0
2020-07-01,JPN,Perlis,0,0,0
2020-07-01,JPN,Pulau Pinang,1,1,0
2020-07-01,JPN,Sabah,1,0,1
2020-07-01,JPN,Sarawak,1,1,0
2020-07-01,JPN,Selangor,439,307,132
2020-07-01,JPN,W.P. Labuan,0,0,0
2020-07-01,KAZ,Johor,0,0,0
2020-07-01,KAZ,Kedah,0,0,0
2020-07-01,KAZ,Kelantan,0,0,0
2020-07-01,KAZ,Melaka,0,0,0
2020-07-01,KAZ,Perak,0,0,0
2020-07-01,KAZ,Perlis,0,0,0
2020-07-01,KAZ,Pulau Pinang,0,0,0
2020-07-01,KAZ,Sabah,0,0,0
2020-07-01,KAZ,Sarawak,0,0,0
2020-07-01,KAZ,Selangor,17,10,7
2020-07-01,KAZ,W.P. Labuan,0,0,0
2020-07-01,KEN,Johor,0,0,0
2020-07-01,KEN,Kedah,0,0,0
2020-07-01,KEN,Kelantan,0,0,0
2020-07-01,KEN,Perak,0,0,0
2020-07-01,KEN,Perlis,0,0,0
2020-07-01,KEN,Pulau Pinang,0,0,0
2020-07-01,KEN,Sabah,0,0,0
2020-07-01,KEN,Sarawak,0,0,0
2020-07-01,KEN,Selangor,1,0,1
2020-07-01,KGZ,Johor,0,0,0
2020-07-01,KGZ,Kedah,0,0,0
2020-07-01,KGZ,Kelantan,0,0,0
2020-07-01,KGZ,Perak,0,0,0
2020-07-01,KGZ,Perlis,0,0,0
2020-07-01,KGZ,Pulau Pinang,0,0,0
2020-07-01,KGZ,Sabah,0,0,0
2020-07-01,KGZ,Sarawak,0,0,0
2020-07-01,KGZ,Selangor,4,4,0
2020-07-01,KHM,Johor,0,0,0
2020-07-01,KHM,Kedah,0,0,0
2020-07-01,KHM,Kelantan,0,0,0
2020-07-01,KHM,Melaka,0,0,0
2020-07-01,KHM,Negeri Sembilan,0,0,0
2020-07-01,KHM,Pahang,0,0,0
2020-07-01,KHM,Perak,0,0,0
2020-07-01,KHM,Perlis,0,0,0
2020-07-01,KHM,Pulau Pinang,0,0,0
2020-07-01,KHM,Sabah,0,0,0
2020-07-01,KHM,Sarawak,0,0,0
2020-07-01,KHM,Selangor,15,2,13
2020-07-01,KHM,W.P. Labuan,0,0,0
2020-07-01,KIR,Johor,0,0,0
2020-07-01,KIR,Sabah,0,0,0
2020-07-01,KIR,Selangor,0,0,0
2020-07-01,KNA,Johor,0,0,0
2020-07-01,KNA,Kedah,0,0,0
2020-07-01,KNA,Perlis,0,0,0
2020-07-01,KNA,Pulau Pinang,0,0,0
2020-07-01,KNA,Sabah,0,0,0
2020-07-01,KNA,Selangor,0,0,0
2020-07-01,KNA,W.P. Labuan,0,0,0
2020-07-01,KOR,Johor,1,0,1
2020-07-01,KOR,Kedah,0,0,0
2020-07-01,KOR,Kelantan,0,0,0
2020-07-01,KOR,Melaka,0,0,0
2020-07-01,KOR,Negeri Sembilan,0,0,0
2020-07-01,KOR,Pahang,0,0,0
2020-07-01,KOR,Perak,0,0,0
2020-07-01,KOR,Perlis,0,0,0
2020-07-01,KOR,Pulau Pinang,2,2,0
2020-07-01,KOR,Sabah,1,0,1
2020-07-01,KOR,Sarawak,3,0,3
2020-07-01,KOR,Selangor,228,153,75
2020-07-01,KOR,Terengganu,0,0,0
2020-07-01,KOR,W.P. Labuan,0,0,0
2020-07-01,KWT,Johor,0,0,0
2020-07-01,KWT,Kedah,0,0,0
2020-07-01,KWT,Kelantan,0,0,0
2020-07-01,KWT,Perak,0,0,0
2020-07-01,KWT,Perlis,0,0,0
2020-07-01,KWT,Pulau Pinang,0,0,0
2020-07-01,KWT,Sabah,0,0,0
2020-07-01,KWT,Sarawak,0,0,0
2020-07-01,KWT,Selangor,0,0,0
2020-07-01,KWT,W.P. Labuan,0,0,0
2020-07-01,LAO,Johor,0,0,0
2020-07-01,LAO,Kedah,1,0,1
2020-07-01,LAO,Kelantan,0,0,0
2020-07-01,LAO,Melaka,0,0,0
2020-07-01,LAO,Perak,0,0,0
2020-07-01,LAO,Perlis,0,0,0
2020-07-01,LAO,Pulau Pinang,0,0,0
2020-07-01,LAO,Sabah,0,0,0
2020-07-01,LAO,Sarawak,0,0,0
2020-07-01,LAO,Selangor,8,0,8
2020-07-01,LAO,W.P. Labuan,0,0,0
2020-07-01,LBN,Johor,2,2,0
2020-07-01,LBN,Kedah,0,0,0
2020-07-01,LBN,Kelantan,0,0,0
2020-07-01,LBN,Pahang,0,0,0
2020-07-01,LBN,Perak,0,0,0
2020-07-01,LBN,Perlis,0,0,0
2020-07-01,LBN,Pulau Pinang,0,0,0
2020-07-01,LBN,Sabah,0,0,0
2020-07-01,LBN,Sarawak,0,0,0
2020-07-01,LBN,Selangor,1,1,0
2020-07-01,LBN,W.P. Labuan,0,0,0
2020-07-01,LBR,Johor,0,0,0
2020-07-01,LBR,Kedah,0,0,0
2020-07-01,LBR,Sabah,0,0,0
2020-07-01,LBR,Sarawak,0,0,0
2020-07-01,LBR,Selangor,1,1,0
2020-07-01,LBY,Johor,0,0,0
2020-07-01,LBY,Kedah,0,0,0
2020-07-01,LBY,Perlis,0,0,0
2020-07-01,LBY,Pulau Pinang,0,0,0
2020-07-01,LBY,Sabah,0,0,0
2020-07-01,LBY,Sarawak,0,0,0
2020-07-01,LBY,Selangor,1,1,0
2020-07-01,LCA,Johor,0,0,0
2020-07-01,LCA,Kedah,0,0,0
2020-07-01,LCA,Pulau Pinang,0,0,0
2020-07-01,LCA,Sarawak,0,0,0
2020-07-01,LCA,Selangor,0,0,0
2020-07-01,LIE,Johor,0,0,0
2020-07-01,LIE,Kedah,0,0,0
2020-07-01,LIE,Perlis,0,0,0
2020-07-01,LIE,Pulau Pinang,0,0,0
2020-07-01,LIE,Sabah,0,0,0
2020-07-01,LIE,Sarawak,0,0,0
2020-07-01,LIE,Selangor,0,0,0
2020-07-01,LKA,Johor,3,3,0
2020-07-01,LKA,Kedah,0,0,0
2020-07-01,LKA,Kelantan,0,0,0
2020-07-01,LKA,Melaka,0,0,0
2020-07-01,LKA,Pahang,0,0,0
2020-07-01,LKA,Perak,0,0,0
2020-07-01,LKA,Perlis,0,0,0
2020-07-01,LKA,Pulau Pinang,0,0,0
2020-07-01,LKA,Sabah,1,0,1
2020-07-01,LKA,Sarawak,0,0,0
2020-07-01,LKA,Selangor,7,5,2
2020-07-01,LKA,W.P. Labuan,0,0,0
2020-07-01,LSO,Johor,0,0,0
2020-07-01,LSO,Kedah,0,0,0
2020-07-01,LSO,Pulau Pinang,0,0,0
2020-07-01,LSO,Sarawak,0,0,0
2020-07-01,LSO,Selangor,0,0,0
2020-07-01,LTU,Johor,0,0,0
2020-07-01,LTU,Kedah,0,0,0
2020-07-01,LTU,Kelantan,0,0,0
2020-07-01,LTU,Pahang,0,0,0
2020-07-01,LTU,Perak,0,0,0
2020-07-01,LTU,Perlis,0,0,0
2020-07-01,LTU,Pulau Pinang,0,0,0
2020-07-01,LTU,Sabah,0,0,0
2020-07-01,LTU,Sarawak,0,0,0
2020-07-01,LTU,Selangor,4,4,0
2020-07-01,LTU,W.P. Labuan,0,0,0
2020-07-01,LUX,Johor,0,0,0
2020-07-01,LUX,Kedah,0,0,0
2020-07-01,LUX,Kelantan,0,0,0
2020-07-01,LUX,Perak,0,0,0
2020-07-01,LUX,Perlis,0,0,0
2020-07-01,LUX,Pulau Pinang,0,0,0
2020-07-01,LUX,Sabah,0,0,0
2020-07-01,LUX,Sarawak,0,0,0
2020-07-01,LUX,Selangor,0,0,0
2020-07-01,LVA,Johor,0,0,0
2020-07-01,LVA,Kedah,0,0,0
2020-07-01,LVA,Kelantan,0,0,0
2020-07-01,LVA,Pahang,0,0,0
2020-07-01,LVA,Perak,0,0,0
2020-07-01,LVA,Perlis,0,0,0
2020-07-01,LVA,Pulau Pinang,0,0,0
2020-07-01,LVA,Sabah,0,0,0
2020-07-01,LVA,Sarawak,0,0,0
2020-07-01,LVA,Selangor,7,7,0
2020-07-01,LVA,W.P. Labuan,0,0,0
2020-07-01,MAC,Johor,0,0,0
2020-07-01,MAC,Pahang,0,0,0
2020-07-01,MAC,Perak,0,0,0
2020-07-01,MAC,Selangor,0,0,0
2020-07-01,MAC,W.P. Labuan,0,0,0
2020-07-01,MAR,Johor,0,0,0
2020-07-01,MAR,Kedah,0,0,0
2020-07-01,MAR,Kelantan,0,0,0
2020-07-01,MAR,Melaka,0,0,0
2020-07-01,MAR,Pahang,0,0,0
2020-07-01,MAR,Perak,0,0,0
2020-07-01,MAR,Perlis,0,0,0
2020-07-01,MAR,Pulau Pinang,0,0,0
2020-07-01,MAR,Sabah,0,0,0
2020-07-01,MAR,Sarawak,1,1,0
2020-07-01,MAR,Selangor,4,2,2
2020-07-01,MAR,W.P. Labuan,0,0,0
2020-07-01,MCO,Johor,0,0,0
2020-07-01,MCO,Kedah,0,0,0
2020-07-01,MCO,Sabah,0,0,0
2020-07-01,MCO,Selangor,0,0,0
2020-07-01,MDA,Johor,0,0,0
2020-07-01,MDA,Kedah,0,0,0
2020-07-01,MDA,Kelantan,0,0,0
2020-07-01,MDA,Negeri Sembilan,0,0,0
2020-07-01,MDA,Perlis,0,0,0
2020-07-01,MDA,Pulau Pinang,0,0,0
2020-07-01,MDA,Sabah,0,0,0
2020-07-01,MDA,Sarawak,0,0,0
2020-07-01,MDA,Selangor,2,2,0
2020-07-01,MDG,Johor,0,0,0
2020-07-01,MDG,Kedah,0,0,0
2020-07-01,MDG,Perak,0,0,0
2020-07-01,MDG,Perlis,0,0,0
2020-07-01,MDG,Pulau Pinang,0,0,0
2020-07-01,MDG,Sabah,0,0,0
2020-07-01,MDG,Sarawak,0,0,0
2020-07-01,MDG,Selangor,3,1,2
2020-07-01,MDV,Johor,0,0,0
2020-07-01,MDV,Kedah,0,0,0
2020-07-01,MDV,Kelantan,0,0,0
2020-07-01,MDV,Perak,0,0,0
2020-07-01,MDV,Perlis,0,0,0
2020-07-01,MDV,Pulau Pinang,0,0,0
2020-07-01,MDV,Sabah,0,0,0
2020-07-01,MDV,Sarawak,0,0,0
2020-07-01,MDV,Selangor,1,0,1
2020-07-01,MEX,Johor,0,0,0
2020-07-01,MEX,Kedah,0,0,0
2020-07-01,MEX,Kelantan,0,0,0
2020-07-01,MEX,Pahang,0,0,0
2020-07-01,MEX,Perak,0,0,0
2020-07-01,MEX,Perlis,0,0,0
2020-07-01,MEX,Pulau Pinang,0,0,0
2020-07-01,MEX,Sabah,0,0,0
2020-07-01,MEX,Sarawak,0,0,0
2020-07-01,MEX,Selangor,10,9,1
2020-07-01,MEX,W.P. Labuan,0,0,0
2020-07-01,MHL,Johor,0,0,0
2020-07-01,MHL,Kedah,0,0,0
2020-07-01,MHL,Perak,0,0,0
2020-07-01,MHL,Pulau Pinang,0,0,0
2020-07-01,MHL,Sabah,0,0,0
2020-07-01,MHL,Selangor,0,0,0
2020-07-01,MKD,Johor,0,0,0
2020-07-01,MKD,Kedah,0,0,0
2020-07-01,MKD,Perak,0,0,0
2020-07-01,MKD,Pulau Pinang,0,0,0
2020-07-01,MKD,Sabah,0,0,0
2020-07-01,MKD,Sarawak,0,0,0
2020-07-01,MKD,Selangor,0,0,0
2020-07-01,MLI,Johor,0,0,0
2020-07-01,MLI,Sabah,0,0,0
2020-07-01,MLI,Selangor,0,0,0
2020-07-01,MLT,Johor,0,0,0
2020-07-01,MLT,Kedah,0,0,0
2020-07-01,MLT,Kelantan,0,0,0
2020-07-01,MLT,Perak,0,0,0
2020-07-01,MLT,Perlis,0,0,0
2020-07-01,MLT,Pulau Pinang,0,0,0
2020-07-01,MLT,Sabah,0,0,0
2020-07-01,MLT,Sarawak,0,0,0
2020-07-01,MLT,Selangor,0,0,0
2020-07-01,MLT,W.P. Labuan,0,0,0
2020-07-01,MMR,Johor,0,0,0
2020-07-01,MMR,Kedah,0,0,0
2020-07-01,MMR,Kelantan,0,0,0
2020-07-01,MMR,Negeri Sembilan,0,0,0
2020-07-01,MMR,Pahang,0,0,0
2020-07-01,MMR,Perak,0,0,0
2020-07-01,MMR,Perlis,0,0,0
2020-07-01,MMR,Pulau Pinang,0,0,0
2020-07-01,MMR,Sabah,0,0,0
2020-07-01,MMR,Sarawak,0,0,0
2020-07-01,MMR,Selangor,13,4,9
2020-07-01,MMR,Terengganu,0,0,0
2020-07-01,MMR,W.P. Labuan,0,0,0
2020-07-01,MNE,Johor,4,4,0
2020-07-01,MNE,Kedah,0,0,0
2020-07-01,MNE,Pulau Pinang,0,0,0
2020-07-01,MNE,Sabah,0,0,0
2020-07-01,MNE,Sarawak,0,0,0
2020-07-01,MNE,Selangor,6,6,0
2020-07-01,MNG,Johor,0,0,0
2020-07-01,MNG,Kedah,0,0,0
2020-07-01,MNG,Kelantan,0,0,0
2020-07-01,MNG,Perak,0,0,0
2020-07-01,MNG,Perlis,0,0,0
2020-07-01,MNG,Pulau Pinang,0,0,0
2020-07-01,MNG,Sabah,0,0,0
2020-07-01,MNG,Sarawak,0,0,0
2020-07-01,MNG,Selangor,0,0,0
2020-07-01,MNP,Selangor,0,0,0
2020-07-01,MOZ,Johor,0,0,0
2020-07-01,MOZ,Kedah,0,0,0
2020-07-01,MOZ,Perak,0,0,0
2020-07-01,MOZ,Pulau Pinang,0,0,0
2020-07-01,MOZ,Sabah,0,0,0
2020-07-01,MOZ,Sarawak,0,0,0
2020-07-01,MOZ,Selangor,0,0,0
2020-07-01,MRT,Johor,0,0,0
2020-07-01,MRT,Kedah,0,0,0
2020-07-01,MRT,Pulau Pinang,0,0,0
2020-07-01,MRT,Sabah,0,0,0
2020-07-01,MRT,Sarawak,0,0,0
2020-07-01,MRT,Selangor,0,0,0
2020-07-01,MUS,Johor,0,0,0
2020-07-01,MUS,Kedah,0,0,0
2020-07-01,MUS,Kelantan,0,0,0
2020-07-01,MUS,Pahang,0,0,0
2020-07-01,MUS,Perak,0,0,0
2020-07-01,MUS,Perlis,0,0,0
2020-07-01,MUS,Pulau Pinang,0,0,0
2020-07-01,MUS,Sabah,0,0,0
2020-07-01,MUS,Sarawak,0,0,0
2020-07-01,MUS,Selangor,1,1,0
2020-07-01,MWI,Johor,0,0,0
2020-07-01,MWI,Pulau Pinang,0,0,0
2020-07-01,MWI,Sabah,0,0,0
2020-07-01,MWI,Sarawak,0,0,0
2020-07-01,MWI,Selangor,0,0,0
2020-07-01,MYT,Selangor,0,0,0
2020-07-01,NAM,Johor,0,0,0
2020-07-01,NAM,Kedah,0,0,0
2020-07-01,NAM,Perak,0,0,0
2020-07-01,NAM,Perlis,0,0,0
2020-07-01,NAM,Pulau Pinang,0,0,0
2020-07-01,NAM,Sabah,0,0,0
2020-07-01,NAM,Sarawak,0,0,0
2020-07-01,NAM,Selangor,0,0,0
2020-07-01,NCL,Selangor,0,0,0
2020-07-01,NER,Johor,0,0,0
2020-07-01,NER,Sabah,0,0,0
2020-07-01,NER,Selangor,0,0,0
2020-07-01,NGA,Johor,0,0,0
2020-07-01,NGA,Kedah,0,0,0
2020-07-01,NGA,Perlis,0,0,0
2020-07-01,NGA,Pulau Pinang,0,0,0
2020-07-01,NGA,Sabah,0,0,0
2020-07-01,NGA,Sarawak,1,1,0
2020-07-01,NGA,Selangor,18,14,4
2020-07-01,NIC,Johor,0,0,0
2020-07-01,NIC,Kedah,0,0,0
2020-07-01,NIC,Pulau Pinang,0,0,0
2020-07-01,NIC,Sabah,0,0,0
2020-07-01,NIC,Selangor,0,0,0
2020-07-01,NLD,Johor,0,0,0
2020-07-01,NLD,Kedah,0,0,0
2020-07-01,NLD,Kelantan,0,0,0
2020-07-01,NLD,Melaka,0,0,0
2020-07-01,NLD,Negeri Sembilan,0,0,0
2020-07-01,NLD,Pahang,0,0,0
2020-07-01,NLD,Perak,0,0,0
2020-07-01,NLD,Perlis,0,0,0
2020-07-01,NLD,Pulau Pinang,0,0,0
2020-07-01,NLD,Sabah,0,0,0
2020-07-01,NLD,Sarawak,0,0,0
2020-07-01,NLD,Selangor,63,49,14
2020-07-01,NLD,Terengganu,0,0,0
2020-07-01,NLD,W.P. Labuan,0,0,0
2020-07-01,NOR,Johor,0,0,0
2020-07-01,NOR,Kedah,0,0,0
2020-07-01,NOR,Kelantan,0,0,0
2020-07-01,NOR,Melaka,0,0,0
2020-07-01,NOR,Pahang,0,0,0
2020-07-01,NOR,Perak,0,0,0
2020-07-01,NOR,Perlis,0,0,0
2020-07-01,NOR,Pulau Pinang,0,0,0
2020-07-01,NOR,Sabah,0,0,0
2020-07-01,NOR,Sarawak,0,0,0
2020-07-01,NOR,Selangor,15,12,3
2020-07-01,NOR,W.P. Labuan,0,0,0
2020-07-01,NPL,Johor,0,0,0
2020-07-01,NPL,Kedah,0,0,0
2020-07-01,NPL,Pahang,0,0,0
2020-07-01,NPL,Perak,0,0,0
2020-07-01,NPL,Perlis,0,0,0
2020-07-01,NPL,Pulau Pinang,0,0,0
2020-07-01,NPL,Sabah,0,0,0
2020-07-01,NPL,Sarawak,0,0,0
2020-07-01,NPL,Selangor,8,8,0
2020-07-01,NPL,W.P. Labuan,0,0,0
2020-07-01,NRU,Johor,0,0,0
2020-07-01,NRU,Pulau Pinang,0,0,0
2020-07-01,NRU,Selangor,0,0,0
2020-07-01,NZL,Johor,0,0,0
2020-07-01,NZL,Kedah,3,2,1
2020-07-01,NZL,Kelantan,0,0,0
2020-07-01,NZL,Melaka,0,0,0
2020-07-01,NZL,Negeri Sembilan,0,0,0
2020-07-01,NZL,Pahang,0,0,0
2020-07-01,NZL,Perak,0,0,0
2020-07-01,NZL,Perlis,0,0,0
2020-07-01,NZL,Pulau Pinang,0,0,0
2020-07-01,NZL,Sabah,0,0,0
2020-07-01,NZL,Sarawak,0,0,0
2020-07-01,NZL,Selangor,30,18,12
2020-07-01,NZL,Terengganu,0,0,0
2020-07-01,NZL,W.P. Labuan,0,0,0
2020-07-01,OMN,Johor,0,0,0
2020-07-01,OMN,Kedah,0,0,0
2020-07-01,OMN,Kelantan,0,0,0
2020-07-01,OMN,Melaka,0,0,0
2020-07-01,OMN,Perak,0,0,0
2020-07-01,OMN,Perlis,0,0,0
2020-07-01,OMN,Pulau Pinang,0,0,0
2020-07-01,OMN,Sabah,0,0,0
2020-07-01,OMN,Sarawak,0,0,0
2020-07-01,OMN,Selangor,1,1,0
2020-07-01,PAK,Johor,3,3,0
2020-07-01,PAK,Kedah,0,0,0
2020-07-01,PAK,Kelantan,0,0,0
2020-07-01,PAK,Melaka,0,0,0
2020-07-01,PAK,Negeri Sembilan,0,0,0
2020-07-01,PAK,Pahang,0,0,0
2020-07-01,PAK,Perak,0,0,0
2020-07-01,PAK,Perlis,1,1,0
2020-07-01,PAK,Pulau Pinang,0,0,0
2020-07-01,PAK,Sabah,1,1,0
2020-07-01,PAK,Sarawak,1,1,0
2020-07-01,PAK,Selangor,282,228,54
2020-07-01,PAK,W.P. Labuan,0,0,0
2020-07-01,PAN,Johor,0,0,0
2020-07-01,PAN,Kedah,0,0,0
2020-07-01,PAN,Perak,0,0,0
2020-07-01,PAN,Perlis,0,0,0
2020-07-01,PAN,Pulau Pinang,0,0,0
2020-07-01,PAN,Sabah,0,0,0
2020-07-01,PAN,Sarawak,0,0,0
2020-07-01,PAN,Selangor,1,1,0
2020-07-01,PER,Johor,0,0,0
2020-07-01,PER,Kedah,0,0,0
2020-07-01,PER,Kelantan,0,0,0
2020-07-01,PER,Pahang,0,0,0
2020-07-01,PER,Perak,0,0,0
2020-07-01,PER,Perlis,0,0,0
2020-07-01,PER,Pulau Pinang,0,0,0
2020-07-01,PER,Sabah,0,0,0
2020-07-01,PER,Sarawak,0,0,0
2020-07-01,PER,Selangor,3,3,0
2020-07-01,PER,W.P. Labuan,0,0,0
2020-07-01,PHL,Johor,69,69,0
2020-07-01,PHL,Kedah,1,0,1
2020-07-01,PHL,Kelantan,0,0,0
2020-07-01,PHL,Melaka,0,0,0
2020-07-01,PHL,Negeri Sembilan,0,0,0
2020-07-01,PHL,Pahang,0,0,0
2020-07-01,PHL,Perak,0,0,0
2020-07-01,PHL,Perlis,0,0,0
2020-07-01,PHL,Pulau Pinang,0,0,0
2020-07-01,PHL,Sabah,24,3,21
2020-07-01,PHL,Sarawak,73,70,3
2020-07-01,PHL,Selangor,255,212,43
2020-07-01,PHL,Terengganu,0,0,0
2020-07-01,PHL,W.P. Labuan,7,7,0
2020-07-01,PLW,Johor,0,0,0
2020-07-01,PLW,Pulau Pinang,0,0,0
2020-07-01,PLW,Selangor,0,0,0
2020-07-01,PNG,Johor,0,0,0
2020-07-01,PNG,Kedah,0,0,0
2020-07-01,PNG,Kelantan,0,0,0
2020-07-01,PNG,Perak,0,0,0
2020-07-01,PNG,Pulau Pinang,0,0,0
2020-07-01,PNG,Sabah,0,0,0
2020-07-01,PNG,Sarawak,0,0,0
2020-07-01,PNG,Selangor,0,0,0
2020-07-01,POL,Johor,1,1,0
2020-07-01,POL,Kedah,0,0,0
2020-07-01,POL,Kelantan,0,0,0
2020-07-01,POL,Melaka,0,0,0
2020-07-01,POL,Negeri Sembilan,0,0,0
2020-07-01,POL,Pahang,0,0,0
2020-07-01,POL,Perak,0,0,0
2020-07-01,POL,Perlis,0,0,0
2020-07-01,POL,Pulau Pinang,0,0,0
2020-07-01,POL,Sabah,0,0,0
2020-07-01,POL,Sarawak,0,0,0
2020-07-01,POL,Selangor,18,15,3
2020-07-01,POL,Terengganu,0,0,0
2020-07-01,POL,W.P. Labuan,0,0,0
2020-07-01,PRK,Selangor,0,0,0
2020-07-01,PRT,Johor,0,0,0
2020-07-01,PRT,Kedah,0,0,0
2020-07-01,PRT,Kelantan,0,0,0
2020-07-01,PRT,Melaka,0,0,0
2020-07-01,PRT,Pahang,0,0,0
2020-07-01,PRT,Perak,0,0,0
2020-07-01,PRT,Perlis,0,0,0
2020-07-01,PRT,Pulau Pinang,0,0,0
2020-07-01,PRT,Sabah,0,0,0
2020-07-01,PRT,Sarawak,0,0,0
2020-07-01,PRT,Selangor,2,2,0
2020-07-01,PRT,W.P. Labuan,0,0,0
2020-07-01,PRY,Johor,0,0,0
2020-07-01,PRY,Kedah,0,0,0
2020-07-01,PRY,Perak,0,0,0
2020-07-01,PRY,Perlis,0,0,0
2020-07-01,PRY,Pulau Pinang,0,0,0
2020-07-01,PRY,Sabah,0,0,0
2020-07-01,PRY,Sarawak,0,0,0
2020-07-01,PRY,Selangor,0,0,0
2020-07-01,PSE,Johor,0,0,0
2020-07-01,PSE,Kedah,0,0,0
2020-07-01,PSE,Kelantan,0,0,0
2020-07-01,PSE,Melaka,0,0,0
2020-07-01,PSE,Perak,0,0,0
2020-07-01,PSE,Perlis,0,0,0
2020-07-01,PSE,Pulau Pinang,0,0,0
2020-07-01,PSE,Sabah,0,0,0
2020-07-01,PSE,Sarawak,0,0,0
2020-07-01,PSE,Selangor,0,0,0
2020-07-01,QAT,Johor,0,0,0
2020-07-01,QAT,Kedah,0,0,0
2020-07-01,QAT,Perlis,0,0,0
2020-07-01,QAT,Pulau Pinang,0,0,0
2020-07-01,QAT,Sabah,0,0,0
2020-07-01,QAT,Sarawak,0,0,0
2020-07-01,QAT,Selangor,0,0,0
2020-07-01,REU,Johor,0,0,0
2020-07-01,REU,Sarawak,0,0,0
2020-07-01,ROU,Johor,5,5,0
2020-07-01,ROU,Kedah,0,0,0
2020-07-01,ROU,Kelantan,0,0,0
2020-07-01,ROU,Negeri Sembilan,0,0,0
2020-07-01,ROU,Pahang,0,0,0
2020-07-01,ROU,Perak,0,0,0
2020-07-01,ROU,Perlis,0,0,0
2020-07-01,ROU,Pulau Pinang,0,0,0
2020-07-01,ROU,Sabah,0,0,0
2020-07-01,ROU,Sarawak,0,0,0
2020-07-01,ROU,Selangor,25,21,4
2020-07-01,ROU,W.P. Labuan,0,0,0
2020-07-01,RUS,Johor,50,49,1
2020-07-01,RUS,Kedah,0,0,0
2020-07-01,RUS,Kelantan,0,0,0
2020-07-01,RUS,Melaka,0,0,0
2020-07-01,RUS,Negeri Sembilan,0,0,0
2020-07-01,RUS,Pahang,0,0,0
2020-07-01,RUS,Perak,0,0,0
2020-07-01,RUS,Perlis,0,0,0
2020-07-01,RUS,Pulau Pinang,0,0,0
2020-07-01,RUS,Sabah,0,0,0
2020-07-01,RUS,Sarawak,2,0,2
2020-07-01,RUS,Selangor,135,130,5
2020-07-01,RUS,W.P. Labuan,0,0,0
2020-07-01,RWA,Johor,0,0,0
2020-07-01,RWA,Kedah,0,0,0
2020-07-01,RWA,Pulau Pinang,0,0,0
2020-07-01,RWA,Selangor,0,0,0
2020-07-01,SAU,Johor,0,0,0
2020-07-01,SAU,Kedah,0,0,0
2020-07-01,SAU,Kelantan,0,0,0
2020-07-01,SAU,Melaka,0,0,0
2020-07-01,SAU,Perak,0,0,0
2020-07-01,SAU,Perlis,0,0,0
2020-07-01,SAU,Pulau Pinang,0,0,0
2020-07-01,SAU,Sabah,0,0,0
2020-07-01,SAU,Sarawak,0,0,0
2020-07-01,SAU,Selangor,12,6,6
2020-07-01,SAU,W.P. Labuan,0,0,0
2020-07-01,SDN,Johor,0,0,0
2020-07-01,SDN,Kedah,0,0,0
2020-07-01,SDN,Kelantan,0,0,0
2020-07-01,SDN,Perlis,0,0,0
2020-07-01,SDN,Pulau Pinang,0,0,0
2020-07-01,SDN,Sabah,0,0,0
2020-07-01,SDN,Sarawak,0,0,0
2020-07-01,SDN,Selangor,2,2,0
2020-07-01,SDN,W.P. Labuan,0,0,0
2020-07-01,SEN,Johor,0,0,0
2020-07-01,SEN,Kedah,0,0,0
2020-07-01,SEN,Kelantan,0,0,0
2020-07-01,SEN,Perak,0,0,0
2020-07-01,SEN,Perlis,0,0,0
2020-07-01,SEN,Pulau Pinang,0,0,0
2020-07-01,SEN,Sabah,0,0,0
2020-07-01,SEN,Sarawak,0,0,0
2020-07-01,SEN,Selangor,2,1,1
2020-07-01,SGP,Johor,226,164,62
2020-07-01,SGP,Kedah,1,1,0
2020-07-01,SGP,Kelantan,0,0,0
2020-07-01,SGP,Melaka,0,0,0
2020-07-01,SGP,Negeri Sembilan,0,0,0
2020-07-01,SGP,Pahang,0,0,0
2020-07-01,SGP,Perak,3,1,2
2020-07-01,SGP,Perlis,0,0,0
2020-07-01,SGP,Pulau Pinang,5,3,2
2020-07-01,SGP,Sabah,2,1,1
2020-07-01,SGP,Sarawak,6,3,3
2020-07-01,SGP,Selangor,107,67,40
2020-07-01,SGP,Terengganu,0,0,0
2020-07-01,SGP,W.P. Labuan,0,0,0
2020-07-01,SGS,Johor,0,0,0
2020-07-01,SGS,Sabah,0,0,0
2020-07-01,SGS,Selangor,0,0,0
2020-07-01,SHN,Sarawak,0,0,0
2020-07-01,SLB,Johor,0,0,0
2020-07-01,SLB,Perlis,0,0,0
2020-07-01,SLB,Pulau Pinang,0,0,0
2020-07-01,SLB,Sabah,0,0,0
2020-07-01,SLB,Sarawak,0,0,0
2020-07-01,SLB,Selangor,0,0,0
2020-07-01,SLB,W.P. Labuan,0,0,0
2020-07-01,SLE,Johor,0,0,0
2020-07-01,SLE,Kedah,0,0,0
2020-07-01,SLE,Perak,0,0,0
2020-07-01,SLE,Pulau Pinang,0,0,0
2020-07-01,SLE,Sabah,0,0,0
2020-07-01,SLE,Selangor,0,0,0
2020-07-01,SLV,Johor,0,0,0
2020-07-01,SLV,Kedah,0,0,0
2020-07-01,SLV,Perak,0,0,0
2020-07-01,SLV,Perlis,0,0,0
2020-07-01,SLV,Pulau Pinang,0,0,0
2020-07-01,SLV,Sabah,0,0,0
2020-07-01,SLV,Selangor,0,0,0
2020-07-01,SLV,W.P. Labuan,0,0,0
2020-07-01,SMR,Johor,0,0,0
2020-07-01,SMR,Selangor,0,0,0
2020-07-01,SOM,Johor,0,0,0
2020-07-01,SOM,Kedah,0,0,0
2020-07-01,SOM,Kelantan,0,0,0
2020-07-01,SOM,Perlis,0,0,0
2020-07-01,SOM,Sabah,0,0,0
2020-07-01,SOM,Sarawak,0,0,0
2020-07-01,SOM,Selangor,0,0,0
2020-07-01,SRB,Johor,0,0,0
2020-07-01,SRB,Kedah,0,0,0
2020-07-01,SRB,Kelantan,0,0,0
2020-07-01,SRB,Pahang,0,0,0
2020-07-01,SRB,Perak,0,0,0
2020-07-01,SRB,Perlis,0,0,0
2020-07-01,SRB,Pulau Pinang,0,0,0
2020-07-01,SRB,Sabah,0,0,0
2020-07-01,SRB,Sarawak,0,0,0
2020-07-01,SRB,Selangor,1,0,1
2020-07-01,SSD,Johor,0,0,0
2020-07-01,SSD,Kedah,0,0,0
2020-07-01,SSD,Sarawak,0,0,0
2020-07-01,SSD,Selangor,0,0,0
2020-07-01,SSD,W.P. Labuan,0,0,0
2020-07-01,STP,Selangor,0,0,0
2020-07-01,SUR,Johor,0,0,0
2020-07-01,SUR,Kedah,0,0,0
2020-07-01,SUR,Kelantan,0,0,0
2020-07-01,SUR,Perak,0,0,0
2020-07-01,SUR,Perlis,0,0,0
2020-07-01,SUR,Pulau Pinang,0,0,0
2020-07-01,SUR,Sabah,0,0,0
2020-07-01,SUR,Sarawak,0,0,0
2020-07-01,SUR,Selangor,0,0,0
2020-07-01,SVK,Johor,0,0,0
2020-07-01,SVK,Kedah,0,0,0
2020-07-01,SVK,Kelantan,0,0,0
2020-07-01,SVK,Negeri Sembilan,0,0,0
2020-07-01,SVK,Pahang,0,0,0
2020-07-01,SVK,Perak,0,0,0
2020-07-01,SVK,Perlis,0,0,0
2020-07-01,SVK,Pulau Pinang,0,0,0
2020-07-01,SVK,Sabah,0,0,0
2020-07-01,SVK,Sarawak,0,0,0
2020-07-01,SVK,Selangor,7,7,0
2020-07-01,SVK,W.P. Labuan,0,0,0
2020-07-01,SVN,Johor,0,0,0
2020-07-01,SVN,Kedah,0,0,0
2020-07-01,SVN,Kelantan,0,0,0
2020-07-01,SVN,Perak,0,0,0
2020-07-01,SVN,Perlis,0,0,0
2020-07-01,SVN,Pulau Pinang,0,0,0
2020-07-01,SVN,Sabah,0,0,0
2020-07-01,SVN,Sarawak,0,0,0
2020-07-01,SVN,Selangor,2,0,2
2020-07-01,SVN,W.P. Labuan,0,0,0
2020-07-01,SWE,Johor,0,0,0
2020-07-01,SWE,Kedah,0,0,0
2020-07-01,SWE,Kelantan,0,0,0
2020-07-01,SWE,Melaka,0,0,0
2020-07-01,SWE,Negeri Sembilan,0,0,0
2020-07-01,SWE,Pahang,0,0,0
2020-07-01,SWE,Perak,0,0,0
2020-07-01,SWE,Perlis,0,0,0
2020-07-01,SWE,Pulau Pinang,0,0,0
2020-07-01,SWE,Sabah,0,0,0
2020-07-01,SWE,Sarawak,0,0,0
2020-07-01,SWE,Selangor,39,30,9
2020-07-01,SWE,W.P. Labuan,0,0,0
2020-07-01,SWZ,Johor,0,0,0
2020-07-01,SWZ,Kedah,0,0,0
2020-07-01,SWZ,Pulau Pinang,0,0,0
2020-07-01,SWZ,Sabah,0,0,0
2020-07-01,SWZ,Selangor,0,0,0
2020-07-01,SYC,Johor,0,0,0
2020-07-01,SYC,Kedah,0,0,0
2020-07-01,SYC,Pulau Pinang,0,0,0
2020-07-01,SYC,Sabah,0,0,0
2020-07-01,SYC,Sarawak,0,0,0
2020-07-01,SYC,Selangor,0,0,0
2020-07-01,SYR,Johor,0,0,0
2020-07-01,SYR,Kedah,0,0,0
2020-07-01,SYR,Kelantan,0,0,0
2020-07-01,SYR,Pahang,0,0,0
2020-07-01,SYR,Perlis,0,0,0
2020-07-01,SYR,Pulau Pinang,0,0,0
2020-07-01,SYR,Sabah,0,0,0
2020-07-01,SYR,Sarawak,0,0,0
2020-07-01,SYR,Selangor,1,1,0
2020-07-01,SYR,W.P. Labuan,0,0,0
2020-07-01,TCA,Perlis,0,0,0
2020-07-01,TCD,Johor,0,0,0
2020-07-01,TCD,Kedah,0,0,0
2020-07-01,TCD,Perlis,0,0,0
2020-07-01,TCD,Selangor,0,0,0
2020-07-01,TGO,Johor,0,0,0
2020-07-01,TGO,Perak,0,0,0
2020-07-01,TGO,Pulau Pinang,0,0,0
2020-07-01,TGO,Selangor,0,0,0
2020-07-01,THA,Johor,79,79,0
2020-07-01,THA,Kedah,10004,9337,667
2020-07-01,THA,Kelantan,9,1,8
2020-07-01,THA,Melaka,0,0,0
2020-07-01,THA,Negeri Sembilan,0,0,0
2020-07-01,THA,Pahang,0,0,0
2020-07-01,THA,Perak,7,0,7
2020-07-01,THA,Perlis,2562,2509,53
2020-07-01,THA,Pulau Pinang,0,0,0
2020-07-01,THA,Sabah,0,0,0
2020-07-01,THA,Sarawak,15,15,0
2020-07-01,THA,Selangor,46,9,37
2020-07-01,THA,Terengganu,0,0,0
2020-07-01,THA,W.P. Labuan,0,0,0
2020-07-01,TJK,Johor,0,0,0
2020-07-01,TJK,Kedah,0,0,0
2020-07-01,TJK,Perlis,0,0,0
2020-07-01,TJK,Pulau Pinang,0,0,0
2020-07-01,TJK,Sabah,0,0,0
2020-07-01,TJK,Selangor,0,0,0
2020-07-01,TKL,Selangor,0,0,0
2020-07-01,TKM,Johor,0,0,0
2020-07-01,TKM,Kedah,0,0,0
2020-07-01,TKM,Kelantan,0,0,0
2020-07-01,TKM,Perlis,0,0,0
2020-07-01,TKM,Pulau Pinang,0,0,0
2020-07-01,TKM,Sabah,0,0,0
2020-07-01,TKM,Sarawak,0,0,0
2020-07-01,TKM,Selangor,0,0,0
2020-07-01,TLS,Johor,0,0,0
2020-07-01,TLS,Kedah,0,0,0
2020-07-01,TLS,Perlis,0,0,0
2020-07-01,TLS,Pulau Pinang,0,0,0
2020-07-01,TLS,Sabah,0,0,0
2020-07-01,TLS,Sarawak,0,0,0
2020-07-01,TLS,Selangor,5,1,4
2020-07-01,TON,Johor,0,0,0
2020-07-01,TON,Pulau Pinang,0,0,0
2020-07-01,TON,Sarawak,0,0,0
2020-07-01,TON,Selangor,0,0,0
2020-07-01,TTO,Johor,0,0,0
2020-07-01,TTO,Kedah,0,0,0
2020-07-01,TTO,Pahang,0,0,0
2020-07-01,TTO,Pulau Pinang,0,0,0
2020-07-01,TTO,Sabah,0,0,0
2020-07-01,TTO,Sarawak,0,0,0
2020-07-01,TTO,Selangor,0,0,0
2020-07-01,TUN,Johor,0,0,0
2020-07-01,TUN,Kedah,0,0,0
2020-07-01,TUN,Kelantan,0,0,0
2020-07-01,TUN,Melaka,0,0,0
2020-07-01,TUN,Perak,0,0,0
2020-07-01,TUN,Perlis,0,0,0
2020-07-01,TUN,Pulau Pinang,0,0,0
2020-07-01,TUN,Sabah,0,0,0
2020-07-01,TUN,Sarawak,0,0,0
2020-07-01,TUN,Selangor,2,0,2
2020-07-01,TUN,W.P. Labuan,0,0,0
2020-07-01,TUR,Johor,2,2,0
2020-07-01,TUR,Kedah,0,0,0
2020-07-01,TUR,Kelantan,0,0,0
2020-07-01,TUR,Melaka,0,0,0
2020-07-01,TUR,Negeri Sembilan,0,0,0
2020-07-01,TUR,Pahang,0,0,0
2020-07-01,TUR,Perak,0,0,0
2020-07-01,TUR,Perlis,0,0,0
2020-07-01,TUR,Pulau Pinang,0,0,0
2020-07-01,TUR,Sabah,1,1,0
2020-07-01,TUR,Sarawak,0,0,0
2020-07-01,TUR,Selangor,54,32,22
2020-07-01,TUR,W.P. Labuan,0,0,0
2020-07-01,TUV,Selangor,0,0,0
2020-07-01,TWN,Johor,1,1,0
2020-07-01,TWN,Kedah,0,0,0
2020-07-01,TWN,Kelantan,0,0,0
2020-07-01,TWN,Melaka,0,0,0
2020-07-01,TWN,Negeri Sembilan,0,0,0
2020-07-01,TWN,Pahang,0,0,0
2020-07-01,TWN,Perak,0,0,0
2020-07-01,TWN,Perlis,0,0,0
2020-07-01,TWN,Pulau Pinang,0,0,0
2020-07-01,TWN,Sabah,0,0,0
2020-07-01,TWN,Sarawak,0,0,0
2020-07-01,TWN,Selangor,70,46,24
2020-07-01,TWN,W.P. Labuan,0,0,0
2020-07-01,TZA,Johor,0,0,0
2020-07-01,TZA,Kedah,0,0,0
2020-07-01,TZA,Perak,0,0,0
2020-07-01,TZA,Perlis,0,0,0
2020-07-01,TZA,Pulau Pinang,0,0,0
2020-07-01,TZA,Sabah,0,0,0
2020-07-01,TZA,Sarawak,0,0,0
2020-07-01,TZA,Selangor,0,0,0
2020-07-01,UGA,Johor,0,0,0
2020-07-01,UGA,Kedah,0,0,0
2020-07-01,UGA,Perak,0,0,0
2020-07-01,UGA,Perlis,0,0,0
2020-07-01,UGA,Pulau Pinang,0,0,0
2020-07-01,UGA,Sabah,0,0,0
2020-07-01,UGA,Sarawak,0,0,0
2020-07-01,UGA,Selangor,0,0,0
2020-07-01,UKR,Johor,40,40,0
2020-07-01,UKR,Kedah,0,0,0
2020-07-01,UKR,Kelantan,0,0,0
2020-07-01,UKR,Melaka,0,0,0
2020-07-01,UKR,Negeri Sembilan,0,0,0
2020-07-01,UKR,Pahang,0,0,0
2020-07-01,UKR,Perak,0,0,0
2020-07-01,UKR,Perlis,0,0,0
2020-07-01,UKR,Pulau Pinang,0,0,0
2020-07-01,UKR,Sabah,0,0,0
2020-07-01,UKR,Sarawak,0,0,0
2020-07-01,UKR,Selangor,164,164,0
2020-07-01,UKR,W.P. Labuan,0,0,0
2020-07-01,URY,Johor,0,0,0
2020-07-01,URY,Kedah,0,0,0
2020-07-01,URY,Kelantan,0,0,0
2020-07-01,URY,Perak,0,0,0
2020-07-01,URY,Perlis,0,0,0
2020-07-01,URY,Pulau Pinang,0,0,0
2020-07-01,URY,Sabah,0,0,0
2020-07-01,URY,Sarawak,0,0,0
2020-07-01,URY,Selangor,0,0,0
2020-07-01,URY,W.P. Labuan,0,0,0
2020-07-01,USA,Johor,0,0,0
2020-07-01,USA,Kedah,0,0,0
2020-07-01,USA,Kelantan,0,0,0
2020-07-01,USA,Melaka,0,0,0
2020-07-01,USA,Negeri Sembilan,0,0,0
2020-07-01,USA,Pahang,0,0,0
2020-07-01,USA,Perak,0,0,0
2020-07-01,USA,Perlis,0,0,0
2020-07-01,USA,Pulau Pinang,0,0,0
2020-07-01,USA,Sabah,2,2,0
2020-07-01,USA,Sarawak,0,0,0
2020-07-01,USA,Selangor,193,134,59
2020-07-01,USA,Terengganu,0,0,0
2020-07-01,USA,W.P. Labuan,0,0,0
2020-07-01,UZB,Johor,0,0,0
2020-07-01,UZB,Kedah,0,0,0
2020-07-01,UZB,Kelantan,0,0,0
2020-07-01,UZB,Perak,0,0,0
2020-07-01,UZB,Perlis,0,0,0
2020-07-01,UZB,Pulau Pinang,0,0,0
2020-07-01,UZB,Sabah,0,0,0
2020-07-01,UZB,Sarawak,0,0,0
2020-07-01,UZB,Selangor,1,0,1
2020-07-01,VAT,Johor,0,0,0
2020-07-01,VAT,Sarawak,0,0,0
2020-07-01,VAT,Selangor,0,0,0
2020-07-01,VCT,Johor,0,0,0
2020-07-01,VCT,Kedah,0,0,0
2020-07-01,VCT,Pulau Pinang,0,0,0
2020-07-01,VCT,Sarawak,0,0,0
2020-07-01,VCT,Selangor,0,0,0
2020-07-01,VEN,Johor,0,0,0
2020-07-01,VEN,Kedah,0,0,0
2020-07-01,VEN,Kelantan,0,0,0
2020-07-01,VEN,Melaka,0,0,0
2020-07-01,VEN,Perak,0,0,0
2020-07-01,VEN,Perlis,0,0,0
2020-07-01,VEN,Pulau Pinang,0,0,0
2020-07-01,VEN,Sabah,0,0,0
2020-07-01,VEN,Sarawak,0,0,0
2020-07-01,VEN,Selangor,1,1,0
2020-07-01,VEN,W.P. Labuan,0,0,0
2020-07-01,VNM,Johor,2,0,2
2020-07-01,VNM,Kedah,0,0,0
2020-07-01,VNM,Kelantan,0,0,0
2020-07-01,VNM,Melaka,0,0,0
2020-07-01,VNM,Negeri Sembilan,0,0,0
2020-07-01,VNM,Pahang,0,0,0
2020-07-01,VNM,Perak,0,0,0
2020-07-01,VNM,Perlis,0,0,0
2020-07-01,VNM,Pulau Pinang,0,0,0
2020-07-01,VNM,Sabah,0,0,0
2020-07-01,VNM,Sarawak,0,0,0
2020-07-01,VNM,Selangor,165,4,161
2020-07-01,VNM,Terengganu,0,0,0
2020-07-01,VNM,W.P. Labuan,0,0,0
2020-07-01,VUT,Johor,0,0,0
2020-07-01,VUT,Kedah,0,0,0
2020-07-01,VUT,Pulau Pinang,0,0,0
2020-07-01,VUT,Sabah,0,0,0
2020-07-01,VUT,Sarawak,0,0,0
2020-07-01,VUT,Selangor,0,0,0
2020-07-01,WSM,Johor,0,0,0
2020-07-01,WSM,Sarawak,0,0,0
2020-07-01,WSM,Selangor,0,0,0
2020-07-01,XXX,Johor,0,0,0
2020-07-01,XXX,Kedah,0,0,0
2020-07-01,XXX,Kelantan,0,0,0
2020-07-01,XXX,Melaka,0,0,0
2020-07-01,XXX,Pahang,0,0,0
2020-07-01,XXX,Perak,0,0,0
2020-07-01,XXX,Perlis,0,0,0
2020-07-01,XXX,Pulau Pinang,0,0,0
2020-07-01,XXX,Sabah,0,0,0
2020-07-01,XXX,Sarawak,0,0,0
2020-07-01,XXX,Selangor,16,14,2
2020-07-01,XXX,W.P. Labuan,0,0,0
2020-07-01,YEM,Johor,0,0,0
2020-07-01,YEM,Kedah,0,0,0
2020-07-01,YEM,Kelantan,0,0,0
2020-07-01,YEM,Melaka,0,0,0
2020-07-01,YEM,Pahang,0,0,0
2020-07-01,YEM,Perak,0,0,0
2020-07-01,YEM,Perlis,0,0,0
2020-07-01,YEM,Pulau Pinang,0,0,0
2020-07-01,YEM,Sabah,0,0,0
2020-07-01,YEM,Sarawak,0,0,0
2020-07-01,YEM,Selangor,8,8,0
2020-07-01,YEM,W.P. Labuan,0,0,0
2020-07-01,ZAF,Johor,0,0,0
2020-07-01,ZAF,Kedah,0,0,0
2020-07-01,ZAF,Kelantan,0,0,0
2020-07-01,ZAF,Melaka,0,0,0
2020-07-01,ZAF,Pahang,0,0,0
2020-07-01,ZAF,Perak,0,0,0
2020-07-01,ZAF,Perlis,0,0,0
2020-07-01,ZAF,Pulau Pinang,0,0,0
2020-07-01,ZAF,Sabah,0,0,0
2020-07-01,ZAF,Sarawak,0,0,0
2020-07-01,ZAF,Selangor,12,7,5
2020-07-01,ZAF,Terengganu,0,0,0
2020-07-01,ZAF,W.P. Labuan,0,0,0
2020-07-01,ZAR,Selangor,0,0,0
2020-07-01,ZMB,Johor,0,0,0
2020-07-01,ZMB,Kedah,0,0,0
2020-07-01,ZMB,Perak,0,0,0
2020-07-01,ZMB,Perlis,0,0,0
2020-07-01,ZMB,Pulau Pinang,0,0,0
2020-07-01,ZMB,Sabah,0,0,0
2020-07-01,ZMB,Sarawak,0,0,0
2020-07-01,ZMB,Selangor,1,1,0
2020-07-01,ZWE,Johor,0,0,0
2020-07-01,ZWE,Kedah,0,0,0
2020-07-01,ZWE,Kelantan,0,0,0
2020-07-01,ZWE,Perak,0,0,0
2020-07-01,ZWE,Perlis,0,0,0
2020-07-01,ZWE,Pulau Pinang,0,0,0
2020-07-01,ZWE,Sabah,0,0,0
2020-07-01,ZWE,Sarawak,0,0,0
2020-07-01,ZWE,Selangor,1,1,0
2020-08-01,ABW,Kedah,0,0,0
2020-08-01,ABW,Pulau Pinang,0,0,0
2020-08-01,AFG,Johor,0,0,0
2020-08-01,AFG,Kedah,0,0,0
2020-08-01,AFG,Perlis,0,0,0
2020-08-01,AFG,Pulau Pinang,0,0,0
2020-08-01,AFG,Sarawak,0,0,0
2020-08-01,AFG,Selangor,2,2,0
2020-08-01,AGO,Johor,0,0,0
2020-08-01,AGO,Kedah,0,0,0
2020-08-01,AGO,Sabah,0,0,0
2020-08-01,AGO,Selangor,0,0,0
2020-08-01,AIA,Selangor,0,0,0
2020-08-01,ALB,Johor,0,0,0
2020-08-01,ALB,Kedah,0,0,0
2020-08-01,ALB,Perak,0,0,0
2020-08-01,ALB,Perlis,0,0,0
2020-08-01,ALB,Pulau Pinang,0,0,0
2020-08-01,ALB,Sabah,0,0,0
2020-08-01,ALB,Sarawak,0,0,0
2020-08-01,ALB,Selangor,0,0,0
2020-08-01,AND,Johor,0,0,0
2020-08-01,AND,Kedah,0,0,0
2020-08-01,AND,Perlis,0,0,0
2020-08-01,AND,Pulau Pinang,0,0,0
2020-08-01,AND,Selangor,0,0,0
2020-08-01,ANT,Selangor,0,0,0
2020-08-01,ARE,Johor,0,0,0
2020-08-01,ARE,Kedah,0,0,0
2020-08-01,ARE,Kelantan,0,0,0
2020-08-01,ARE,Perak,0,0,0
2020-08-01,ARE,Perlis,0,0,0
2020-08-01,ARE,Pulau Pinang,0,0,0
2020-08-01,ARE,Sabah,0,0,0
2020-08-01,ARE,Sarawak,0,0,0
2020-08-01,ARE,Selangor,8,5,3
2020-08-01,ARG,Johor,0,0,0
2020-08-01,ARG,Kedah,0,0,0
2020-08-01,ARG,Kelantan,0,0,0
2020-08-01,ARG,Melaka,0,0,0
2020-08-01,ARG,Perak,0,0,0
2020-08-01,ARG,Perlis,0,0,0
2020-08-01,ARG,Pulau Pinang,0,0,0
2020-08-01,ARG,Sabah,0,0,0
2020-08-01,ARG,Sarawak,0,0,0
2020-08-01,ARG,Selangor,2,0,2
2020-08-01,ARG,W.P. Labuan,0,0,0
2020-08-01,ARM,Johor,0,0,0
2020-08-01,ARM,Kedah,0,0,0
2020-08-01,ARM,Kelantan,0,0,0
2020-08-01,ARM,Perak,0,0,0
2020-08-01,ARM,Perlis,0,0,0
2020-08-01,ARM,Pulau Pinang,0,0,0
2020-08-01,ARM,Sabah,0,0,0
2020-08-01,ARM,Sarawak,0,0,0
2020-08-01,ARM,Selangor,0,0,0
2020-08-01,ATA,Selangor,0,0,0
2020-08-01,ATG,Johor,0,0,0
2020-08-01,ATG,Kedah,0,0,0
2020-08-01,ATG,Pulau Pinang,0,0,0
2020-08-01,ATG,Sarawak,0,0,0
2020-08-01,ATG,Selangor,0,0,0
2020-08-01,AUS,Johor,6,6,0
2020-08-01,AUS,Kedah,0,0,0
2020-08-01,AUS,Kelantan,0,0,0
2020-08-01,AUS,Melaka,0,0,0
2020-08-01,AUS,Negeri Sembilan,0,0,0
2020-08-01,AUS,Pahang,0,0,0
2020-08-01,AUS,Perak,0,0,0
2020-08-01,AUS,Perlis,0,0,0
2020-08-01,AUS,Pulau Pinang,0,0,0
2020-08-01,AUS,Sabah,2,1,1
2020-08-01,AUS,Sarawak,1,1,0
2020-08-01,AUS,Selangor,116,75,41
2020-08-01,AUS,Terengganu,0,0,0
2020-08-01,AUS,W.P. Labuan,0,0,0
2020-08-01,AUT,Johor,0,0,0
2020-08-01,AUT,Kedah,0,0,0
2020-08-01,AUT,Kelantan,0,0,0
2020-08-01,AUT,Melaka,0,0,0
2020-08-01,AUT,Negeri Sembilan,0,0,0
2020-08-01,AUT,Pahang,0,0,0
2020-08-01,AUT,Perak,0,0,0
2020-08-01,AUT,Perlis,0,0,0
2020-08-01,AUT,Pulau Pinang,0,0,0
2020-08-01,AUT,Sabah,0,0,0
2020-08-01,AUT,Sarawak,0,0,0
2020-08-01,AUT,Selangor,16,10,6
2020-08-01,AUT,Terengganu,0,0,0
2020-08-01,AUT,W.P. Labuan,0,0,0
2020-08-01,AZE,Johor,0,0,0
2020-08-01,AZE,Kedah,0,0,0
2020-08-01,AZE,Kelantan,0,0,0
2020-08-01,AZE,Melaka,0,0,0
2020-08-01,AZE,Perlis,0,0,0
2020-08-01,AZE,Pulau Pinang,0,0,0
2020-08-01,AZE,Sabah,0,0,0
2020-08-01,AZE,Sarawak,0,0,0
2020-08-01,AZE,Selangor,0,0,0
2020-08-01,AZE,W.P. Labuan,0,0,0
2020-08-01,BDI,Pulau Pinang,0,0,0
2020-08-01,BDI,Sarawak,0,0,0
2020-08-01,BDI,Selangor,0,0,0
2020-08-01,BEL,Johor,0,0,0
2020-08-01,BEL,Kedah,0,0,0
2020-08-01,BEL,Kelantan,0,0,0
2020-08-01,BEL,Melaka,0,0,0
2020-08-01,BEL,Negeri Sembilan,0,0,0
2020-08-01,BEL,Pahang,0,0,0
2020-08-01,BEL,Perak,0,0,0
2020-08-01,BEL,Perlis,0,0,0
2020-08-01,BEL,Pulau Pinang,0,0,0
2020-08-01,BEL,Sabah,0,0,0
2020-08-01,BEL,Sarawak,0,0,0
2020-08-01,BEL,Selangor,9,9,0
2020-08-01,BEL,W.P. Labuan,0,0,0
2020-08-01,BEN,Johor,0,0,0
2020-08-01,BEN,Kedah,0,0,0
2020-08-01,BEN,Perak,0,0,0
2020-08-01,BEN,Pulau Pinang,0,0,0
2020-08-01,BEN,Sabah,0,0,0
2020-08-01,BEN,Sarawak,0,0,0
2020-08-01,BEN,Selangor,0,0,0
2020-08-01,BFA,Perak,0,0,0
2020-08-01,BFA,Pulau Pinang,0,0,0
2020-08-01,BFA,Selangor,0,0,0
2020-08-01,BGD,Johor,5,5,0
2020-08-01,BGD,Kedah,0,0,0
2020-08-01,BGD,Kelantan,0,0,0
2020-08-01,BGD,Melaka,0,0,0
2020-08-01,BGD,Negeri Sembilan,0,0,0
2020-08-01,BGD,Pahang,0,0,0
2020-08-01,BGD,Perak,0,0,0
2020-08-01,BGD,Perlis,0,0,0
2020-08-01,BGD,Pulau Pinang,0,0,0
2020-08-01,BGD,Sabah,0,0,0
2020-08-01,BGD,Sarawak,1,1,0
2020-08-01,BGD,Selangor,170,131,39
2020-08-01,BGD,W.P. Labuan,0,0,0
2020-08-01,BGR,Johor,0,0,0
2020-08-01,BGR,Kedah,0,0,0
2020-08-01,BGR,Kelantan,0,0,0
2020-08-01,BGR,Pahang,0,0,0
2020-08-01,BGR,Perak,0,0,0
2020-08-01,BGR,Perlis,0,0,0
2020-08-01,BGR,Pulau Pinang,1,1,0
2020-08-01,BGR,Sabah,0,0,0
2020-08-01,BGR,Sarawak,0,0,0
2020-08-01,BGR,Selangor,2,2,0
2020-08-01,BGR,W.P. Labuan,0,0,0
2020-08-01,BHR,Johor,0,0,0
2020-08-01,BHR,Kedah,0,0,0
2020-08-01,BHR,Kelantan,0,0,0
2020-08-01,BHR,Perlis,0,0,0
2020-08-01,BHR,Pulau Pinang,0,0,0
2020-08-01,BHR,Sabah,0,0,0
2020-08-01,BHR,Sarawak,0,0,0
2020-08-01,BHR,Selangor,1,1,0
2020-08-01,BHS,Johor,0,0,0
2020-08-01,BHS,Kedah,0,0,0
2020-08-01,BHS,Perak,0,0,0
2020-08-01,BHS,Sabah,0,0,0
2020-08-01,BHS,Sarawak,0,0,0
2020-08-01,BHS,Selangor,0,0,0
2020-08-01,BIH,Johor,0,0,0
2020-08-01,BIH,Kedah,0,0,0
2020-08-01,BIH,Perlis,0,0,0
2020-08-01,BIH,Pulau Pinang,0,0,0
2020-08-01,BIH,Sabah,0,0,0
2020-08-01,BIH,Sarawak,0,0,0
2020-08-01,BIH,Selangor,2,1,1
2020-08-01,BLR,Johor,0,0,0
2020-08-01,BLR,Kedah,0,0,0
2020-08-01,BLR,Kelantan,0,0,0
2020-08-01,BLR,Pahang,0,0,0
2020-08-01,BLR,Perak,0,0,0
2020-08-01,BLR,Perlis,0,0,0
2020-08-01,BLR,Pulau Pinang,0,0,0
2020-08-01,BLR,Sabah,0,0,0
2020-08-01,BLR,Sarawak,0,0,0
2020-08-01,BLR,Selangor,1,1,0
2020-08-01,BLR,W.P. Labuan,0,0,0
2020-08-01,BLZ,Johor,0,0,0
2020-08-01,BLZ,Pulau Pinang,0,0,0
2020-08-01,BLZ,Sarawak,0,0,0
2020-08-01,BLZ,Selangor,0,0,0
2020-08-01,BMU,Selangor,0,0,0
2020-08-01,BOL,Johor,0,0,0
2020-08-01,BOL,Kedah,0,0,0
2020-08-01,BOL,Melaka,0,0,0
2020-08-01,BOL,Perak,0,0,0
2020-08-01,BOL,Perlis,0,0,0
2020-08-01,BOL,Pulau Pinang,0,0,0
2020-08-01,BOL,Sabah,0,0,0
2020-08-01,BOL,Sarawak,0,0,0
2020-08-01,BOL,Selangor,0,0,0
2020-08-01,BRA,Johor,0,0,0
2020-08-01,BRA,Kedah,0,0,0
2020-08-01,BRA,Kelantan,0,0,0
2020-08-01,BRA,Melaka,0,0,0
2020-08-01,BRA,Pahang,0,0,0
2020-08-01,BRA,Perak,0,0,0
2020-08-01,BRA,Perlis,0,0,0
2020-08-01,BRA,Pulau Pinang,0,0,0
2020-08-01,BRA,Sabah,0,0,0
2020-08-01,BRA,Sarawak,0,0,0
2020-08-01,BRA,Selangor,7,4,3
2020-08-01,BRA,W.P. Labuan,0,0,0
2020-08-01,BRB,Johor,0,0,0
2020-08-01,BRB,Kedah,0,0,0
2020-08-01,BRB,Perlis,0,0,0
2020-08-01,BRB,Pulau Pinang,0,0,0
2020-08-01,BRB,Selangor,0,0,0
2020-08-01,BRN,Johor,0,0,0
2020-08-01,BRN,Kedah,0,0,0
2020-08-01,BRN,Kelantan,0,0,0
2020-08-01,BRN,Melaka,0,0,0
2020-08-01,BRN,Pahang,0,0,0
2020-08-01,BRN,Perak,0,0,0
2020-08-01,BRN,Perlis,0,0,0
2020-08-01,BRN,Pulau Pinang,0,0,0
2020-08-01,BRN,Sabah,0,0,0
2020-08-01,BRN,Sarawak,196,185,11
2020-08-01,BRN,Selangor,22,8,14
2020-08-01,BRN,W.P. Labuan,1,0,1
2020-08-01,BTN,Johor,0,0,0
2020-08-01,BTN,Kedah,0,0,0
2020-08-01,BTN,Perak,0,0,0
2020-08-01,BTN,Perlis,0,0,0
2020-08-01,BTN,Pulau Pinang,0,0,0
2020-08-01,BTN,Sabah,0,0,0
2020-08-01,BTN,Sarawak,0,0,0
2020-08-01,BTN,Selangor,0,0,0
2020-08-01,BWA,Johor,0,0,0
2020-08-01,BWA,Kedah,0,0,0
2020-08-01,BWA,Perlis,0,0,0
2020-08-01,BWA,Pulau Pinang,0,0,0
2020-08-01,BWA,Sabah,0,0,0
2020-08-01,BWA,Sarawak,0,0,0
2020-08-01,BWA,Selangor,0,0,0
2020-08-01,CAF,Kedah,0,0,0
2020-08-01,CAF,Selangor,0,0,0
2020-08-01,CAN,Johor,0,0,0
2020-08-01,CAN,Kedah,0,0,0
2020-08-01,CAN,Kelantan,0,0,0
2020-08-01,CAN,Melaka,0,0,0
2020-08-01,CAN,Negeri Sembilan,0,0,0
2020-08-01,CAN,Pahang,0,0,0
2020-08-01,CAN,Perak,0,0,0
2020-08-01,CAN,Perlis,0,0,0
2020-08-01,CAN,Pulau Pinang,0,0,0
2020-08-01,CAN,Sabah,0,0,0
2020-08-01,CAN,Sarawak,1,1,0
2020-08-01,CAN,Selangor,51,28,23
2020-08-01,CAN,Terengganu,0,0,0
2020-08-01,CAN,W.P. Labuan,0,0,0
2020-08-01,CCK,Selangor,0,0,0
2020-08-01,CHE,Johor,0,0,0
2020-08-01,CHE,Kedah,0,0,0
2020-08-01,CHE,Kelantan,0,0,0
2020-08-01,CHE,Melaka,0,0,0
2020-08-01,CHE,Negeri Sembilan,0,0,0
2020-08-01,CHE,Pahang,0,0,0
2020-08-01,CHE,Perak,0,0,0
2020-08-01,CHE,Perlis,0,0,0
2020-08-01,CHE,Pulau Pinang,1,1,0
2020-08-01,CHE,Sabah,0,0,0
2020-08-01,CHE,Sarawak,1,1,0
2020-08-01,CHE,Selangor,8,6,2
2020-08-01,CHE,W.P. Labuan,0,0,0
2020-08-01,CHL,Johor,0,0,0
2020-08-01,CHL,Kedah,0,0,0
2020-08-01,CHL,Kelantan,0,0,0
2020-08-01,CHL,Melaka,0,0,0
2020-08-01,CHL,Pahang,0,0,0
2020-08-01,CHL,Perak,0,0,0
2020-08-01,CHL,Perlis,0,0,0
2020-08-01,CHL,Pulau Pinang,0,0,0
2020-08-01,CHL,Sabah,0,0,0
2020-08-01,CHL,Sarawak,0,0,0
2020-08-01,CHL,Selangor,2,1,1
2020-08-01,CHN,Johor,26,25,1
2020-08-01,CHN,Kedah,0,0,0
2020-08-01,CHN,Kelantan,0,0,0
2020-08-01,CHN,Melaka,0,0,0
2020-08-01,CHN,Pahang,0,0,0
2020-08-01,CHN,Perak,0,0,0
2020-08-01,CHN,Perlis,0,0,0
2020-08-01,CHN,Pulau Pinang,0,0,0
2020-08-01,CHN,Sabah,1,1,0
2020-08-01,CHN,Sarawak,24,21,3
2020-08-01,CHN,Selangor,569,389,180
2020-08-01,CHN,Terengganu,0,0,0
2020-08-01,CHN,W.P. Labuan,1,0,1
2020-08-01,CIV,Johor,0,0,0
2020-08-01,CIV,Kedah,0,0,0
2020-08-01,CIV,Pulau Pinang,0,0,0
2020-08-01,CIV,Sabah,0,0,0
2020-08-01,CIV,Sarawak,0,0,0
2020-08-01,CIV,Selangor,0,0,0
2020-08-01,CMR,Johor,0,0,0
2020-08-01,CMR,Kedah,0,0,0
2020-08-01,CMR,Pulau Pinang,0,0,0
2020-08-01,CMR,Sabah,0,0,0
2020-08-01,CMR,Sarawak,0,0,0
2020-08-01,CMR,Selangor,1,0,1
2020-08-01,COD,Johor,0,0,0
2020-08-01,COD,Pulau Pinang,0,0,0
2020-08-01,COD,Sarawak,0,0,0
2020-08-01,COD,Selangor,1,1,0
2020-08-01,COG,Johor,0,0,0
2020-08-01,COG,Kedah,0,0,0
2020-08-01,COG,Selangor,0,0,0
2020-08-01,COK,Selangor,0,0,0
2020-08-01,COL,Johor,0,0,0
2020-08-01,COL,Kedah,0,0,0
2020-08-01,COL,Perak,0,0,0
2020-08-01,COL,Pulau Pinang,0,0,0
2020-08-01,COL,Sabah,0,0,0
2020-08-01,COL,Sarawak,0,0,0
2020-08-01,COL,Selangor,0,0,0
2020-08-01,COL,W.P. Labuan,0,0,0
2020-08-01,COM,Johor,0,0,0
2020-08-01,COM,Kedah,0,0,0
2020-08-01,COM,Selangor,0,0,0
2020-08-01,CPV,Johor,0,0,0
2020-08-01,CPV,Kedah,0,0,0
2020-08-01,CPV,Pulau Pinang,0,0,0
2020-08-01,CPV,Sabah,0,0,0
2020-08-01,CPV,Selangor,0,0,0
2020-08-01,CRI,Johor,0,0,0
2020-08-01,CRI,Kedah,0,0,0
2020-08-01,CRI,Perak,0,0,0
2020-08-01,CRI,Perlis,0,0,0
2020-08-01,CRI,Pulau Pinang,0,0,0
2020-08-01,CRI,Sabah,0,0,0
2020-08-01,CRI,Sarawak,0,0,0
2020-08-01,CRI,Selangor,3,2,1
2020-08-01,CUB,Johor,0,0,0
2020-08-01,CUB,Kedah,0,0,0
2020-08-01,CUB,Perlis,0,0,0
2020-08-01,CUB,Pulau Pinang,0,0,0
2020-08-01,CUB,Sabah,0,0,0
2020-08-01,CUB,Sarawak,0,0,0
2020-08-01,CUB,Selangor,0,0,0
2020-08-01,CYP,Johor,0,0,0
2020-08-01,CYP,Kedah,0,0,0
2020-08-01,CYP,Perak,0,0,0
2020-08-01,CYP,Perlis,0,0,0
2020-08-01,CYP,Pulau Pinang,0,0,0
2020-08-01,CYP,Sabah,0,0,0
2020-08-01,CYP,Sarawak,0,0,0
2020-08-01,CYP,Selangor,0,0,0
2020-08-01,CZE,Johor,0,0,0
2020-08-01,CZE,Kedah,0,0,0
2020-08-01,CZE,Kelantan,0,0,0
2020-08-01,CZE,Melaka,0,0,0
2020-08-01,CZE,Negeri Sembilan,0,0,0
2020-08-01,CZE,Perak,0,0,0
2020-08-01,CZE,Perlis,0,0,0
2020-08-01,CZE,Pulau Pinang,0,0,0
2020-08-01,CZE,Sabah,0,0,0
2020-08-01,CZE,Sarawak,0,0,0
2020-08-01,CZE,Selangor,7,6,1
2020-08-01,CZE,W.P. Labuan,0,0,0
2020-08-01,DEU,Johor,0,0,0
2020-08-01,DEU,Kedah,0,0,0
2020-08-01,DEU,Kelantan,0,0,0
2020-08-01,DEU,Melaka,0,0,0
2020-08-01,DEU,Negeri Sembilan,0,0,0
2020-08-01,DEU,Pahang,0,0,0
2020-08-01,DEU,Perak,0,0,0
2020-08-01,DEU,Perlis,0,0,0
2020-08-01,DEU,Pulau Pinang,0,0,0
2020-08-01,DEU,Sabah,0,0,0
2020-08-01,DEU,Sarawak,0,0,0
2020-08-01,DEU,Selangor,67,49,18
2020-08-01,DEU,Terengganu,0,0,0
2020-08-01,DEU,W.P. Labuan,0,0,0
2020-08-01,DJI,Johor,0,0,0
2020-08-01,DJI,Selangor,0,0,0
2020-08-01,DMA,Johor,0,0,0
2020-08-01,DMA,Kedah,0,0,0
2020-08-01,DMA,Pulau Pinang,0,0,0
2020-08-01,DMA,Sabah,0,0,0
2020-08-01,DMA,Sarawak,0,0,0
2020-08-01,DMA,Selangor,0,0,0
2020-08-01,DMA,W.P. Labuan,0,0,0
2020-08-01,DNK,Johor,0,0,0
2020-08-01,DNK,Kedah,0,0,0
2020-08-01,DNK,Kelantan,0,0,0
2020-08-01,DNK,Melaka,0,0,0
2020-08-01,DNK,Negeri Sembilan,0,0,0
2020-08-01,DNK,Pahang,0,0,0
2020-08-01,DNK,Perak,0,0,0
2020-08-01,DNK,Perlis,0,0,0
2020-08-01,DNK,Pulau Pinang,0,0,0
2020-08-01,DNK,Sabah,0,0,0
2020-08-01,DNK,Sarawak,0,0,0
2020-08-01,DNK,Selangor,20,10,10
2020-08-01,DNK,W.P. Labuan,0,0,0
2020-08-01,DOM,Johor,0,0,0
2020-08-01,DOM,Kedah,0,0,0
2020-08-01,DOM,Perak,0,0,0
2020-08-01,DOM,Perlis,0,0,0
2020-08-01,DOM,Pulau Pinang,0,0,0
2020-08-01,DOM,Sabah,0,0,0
2020-08-01,DOM,Sarawak,0,0,0
2020-08-01,DOM,Selangor,0,0,0
2020-08-01,DZA,Johor,0,0,0
2020-08-01,DZA,Kedah,0,0,0
2020-08-01,DZA,Kelantan,0,0,0
2020-08-01,DZA,Melaka,0,0,0
2020-08-01,DZA,Perak,0,0,0
2020-08-01,DZA,Perlis,0,0,0
2020-08-01,DZA,Pulau Pinang,0,0,0
2020-08-01,DZA,Sabah,0,0,0
2020-08-01,DZA,Sarawak,0,0,0
2020-08-01,DZA,Selangor,5,4,1
2020-08-01,DZA,W.P. Labuan,0,0,0
2020-08-01,ECU,Johor,0,0,0
2020-08-01,ECU,Kedah,0,0,0
2020-08-01,ECU,Perak,0,0,0
2020-08-01,ECU,Perlis,0,0,0
2020-08-01,ECU,Pulau Pinang,0,0,0
2020-08-01,ECU,Sabah,0,0,0
2020-08-01,ECU,Sarawak,0,0,0
2020-08-01,ECU,Selangor,0,0,0
2020-08-01,EGY,Johor,0,0,0
2020-08-01,EGY,Kedah,0,0,0
2020-08-01,EGY,Kelantan,0,0,0
2020-08-01,EGY,Melaka,0,0,0
2020-08-01,EGY,Pahang,0,0,0
2020-08-01,EGY,Perak,0,0,0
2020-08-01,EGY,Perlis,0,0,0
2020-08-01,EGY,Pulau Pinang,0,0,0
2020-08-01,EGY,Sabah,1,1,0
2020-08-01,EGY,Sarawak,0,0,0
2020-08-01,EGY,Selangor,29,21,8
2020-08-01,EGY,Terengganu,0,0,0
2020-08-01,EGY,W.P. Labuan,0,0,0
2020-08-01,ERI,Johor,0,0,0
2020-08-01,ERI,Pulau Pinang,0,0,0
2020-08-01,ERI,Sabah,0,0,0
2020-08-01,ERI,Selangor,0,0,0
2020-08-01,ESP,Johor,0,0,0
2020-08-01,ESP,Kedah,0,0,0
2020-08-01,ESP,Kelantan,0,0,0
2020-08-01,ESP,Melaka,0,0,0
2020-08-01,ESP,Negeri Sembilan,0,0,0
2020-08-01,ESP,Pahang,0,0,0
2020-08-01,ESP,Perak,0,0,0
2020-08-01,ESP,Perlis,0,0,0
2020-08-01,ESP,Pulau Pinang,0,0,0
2020-08-01,ESP,Sabah,0,0,0
2020-08-01,ESP,Sarawak,0,0,0
2020-08-01,ESP,Selangor,19,10,9
2020-08-01,ESP,W.P. Labuan,0,0,0
2020-08-01,EST,Johor,0,0,0
2020-08-01,EST,Kedah,0,0,0
2020-08-01,EST,Kelantan,0,0,0
2020-08-01,EST,Pahang,0,0,0
2020-08-01,EST,Perak,0,0,0
2020-08-01,EST,Perlis,0,0,0
2020-08-01,EST,Pulau Pinang,0,0,0
2020-08-01,EST,Sabah,0,0,0
2020-08-01,EST,Sarawak,0,0,0
2020-08-01,EST,Selangor,1,1,0
2020-08-01,EST,W.P. Labuan,0,0,0
2020-08-01,ETH,Johor,0,0,0
2020-08-01,ETH,Kedah,0,0,0
2020-08-01,ETH,Pulau Pinang,0,0,0
2020-08-01,ETH,Sarawak,0,0,0
2020-08-01,ETH,Selangor,2,1,1
2020-08-01,FIN,Johor,0,0,0
2020-08-01,FIN,Kedah,0,0,0
2020-08-01,FIN,Kelantan,0,0,0
2020-08-01,FIN,Melaka,0,0,0
2020-08-01,FIN,Negeri Sembilan,0,0,0
2020-08-01,FIN,Pahang,0,0,0
2020-08-01,FIN,Perak,0,0,0
2020-08-01,FIN,Perlis,0,0,0
2020-08-01,FIN,Pulau Pinang,0,0,0
2020-08-01,FIN,Sabah,0,0,0
2020-08-01,FIN,Sarawak,0,0,0
2020-08-01,FIN,Selangor,10,5,5
2020-08-01,FIN,W.P. Labuan,0,0,0
2020-08-01,FJI,Johor,0,0,0
2020-08-01,FJI,Kedah,0,0,0
2020-08-01,FJI,Kelantan,0,0,0
2020-08-01,FJI,Perak,0,0,0
2020-08-01,FJI,Perlis,0,0,0
2020-08-01,FJI,Pulau Pinang,0,0,0
2020-08-01,FJI,Sabah,0,0,0
2020-08-01,FJI,Sarawak,0,0,0
2020-08-01,FJI,Selangor,1,1,0
2020-08-01,FRA,Johor,0,0,0
2020-08-01,FRA,Kedah,0,0,0
2020-08-01,FRA,Kelantan,0,0,0
2020-08-01,FRA,Melaka,0,0,0
2020-08-01,FRA,Negeri Sembilan,0,0,0
2020-08-01,FRA,Pahang,0,0,0
2020-08-01,FRA,Perak,0,0,0
2020-08-01,FRA,Perlis,0,0,0
2020-08-01,FRA,Pulau Pinang,0,0,0
2020-08-01,FRA,Sabah,1,1,0
2020-08-01,FRA,Sarawak,0,0,0
2020-08-01,FRA,Selangor,120,72,48
2020-08-01,FRA,Terengganu,0,0,0
2020-08-01,FRA,W.P. Labuan,0,0,0
2020-08-01,FSM,Johor,0,0,0
2020-08-01,FSM,Pulau Pinang,0,0,0
2020-08-01,FSM,Selangor,0,0,0
2020-08-01,GAB,Johor,0,0,0
2020-08-01,GAB,Pulau Pinang,0,0,0
2020-08-01,GAB,Sarawak,0,0,0
2020-08-01,GAB,Selangor,1,1,0
2020-08-01,GBR,Johor,6,5,1
2020-08-01,GBR,Kedah,0,0,0
2020-08-01,GBR,Kelantan,0,0,0
2020-08-01,GBR,Melaka,0,0,0
2020-08-01,GBR,Negeri Sembilan,0,0,0
2020-08-01,GBR,Pahang,0,0,0
2020-08-01,GBR,Perak,1,1,0
2020-08-01,GBR,Perlis,0,0,0
2020-08-01,GBR,Pulau Pinang,0,0,0
2020-08-01,GBR,Sabah,3,1,2
2020-08-01,GBR,Sarawak,2,0,2
2020-08-01,GBR,Selangor,353,217,136
2020-08-01,GBR,Terengganu,0,0,0
2020-08-01,GBR,W.P. Labuan,0,0,0
2020-08-01,GEO,Johor,0,0,0
2020-08-01,GEO,Kedah,0,0,0
2020-08-01,GEO,Melaka,0,0,0
2020-08-01,GEO,Perak,0,0,0
2020-08-01,GEO,Perlis,0,0,0
2020-08-01,GEO,Pulau Pinang,0,0,0
2020-08-01,GEO,Sabah,0,0,0
2020-08-01,GEO,Sarawak,0,0,0
2020-08-01,GEO,Selangor,3,3,0
2020-08-01,GHA,Johor,0,0,0
2020-08-01,GHA,Kedah,0,0,0
2020-08-01,GHA,Kelantan,0,0,0
2020-08-01,GHA,Pulau Pinang,0,0,0
2020-08-01,GHA,Sabah,0,0,0
2020-08-01,GHA,Sarawak,0,0,0
2020-08-01,GHA,Selangor,0,0,0
2020-08-01,GIB,Johor,0,0,0
2020-08-01,GIB,Sarawak,0,0,0
2020-08-01,GIN,Johor,0,0,0
2020-08-01,GIN,Kedah,0,0,0
2020-08-01,GIN,Kelantan,0,0,0
2020-08-01,GIN,Perlis,0,0,0
2020-08-01,GIN,Pulau Pinang,0,0,0
2020-08-01,GIN,Sabah,0,0,0
2020-08-01,GIN,Sarawak,0,0,0
2020-08-01,GIN,Selangor,0,0,0
2020-08-01,GLP,Selangor,0,0,0
2020-08-01,GMB,Johor,0,0,0
2020-08-01,GMB,Kedah,0,0,0
2020-08-01,GMB,Kelantan,0,0,0
2020-08-01,GMB,Pulau Pinang,0,0,0
2020-08-01,GMB,Sabah,0,0,0
2020-08-01,GMB,Sarawak,0,0,0
2020-08-01,GMB,Selangor,0,0,0
2020-08-01,GNB,Johor,0,0,0
2020-08-01,GNB,Selangor,0,0,0
2020-08-01,GNQ,Johor,0,0,0
2020-08-01,GNQ,Selangor,0,0,0
2020-08-01,GRC,Johor,0,0,0
2020-08-01,GRC,Kedah,0,0,0
2020-08-01,GRC,Kelantan,0,0,0
2020-08-01,GRC,Melaka,0,0,0
2020-08-01,GRC,Negeri Sembilan,0,0,0
2020-08-01,GRC,Pahang,0,0,0
2020-08-01,GRC,Perak,0,0,0
2020-08-01,GRC,Perlis,0,0,0
2020-08-01,GRC,Pulau Pinang,0,0,0
2020-08-01,GRC,Sabah,0,0,0
2020-08-01,GRC,Sarawak,0,0,0
2020-08-01,GRC,Selangor,15,14,1
2020-08-01,GRD,Johor,0,0,0
2020-08-01,GRD,Kedah,0,0,0
2020-08-01,GRD,Pulau Pinang,0,0,0
2020-08-01,GRD,Sabah,0,0,0
2020-08-01,GRD,Sarawak,0,0,0
2020-08-01,GRD,Selangor,0,0,0
2020-08-01,GRL,Johor,0,0,0
2020-08-01,GRL,Selangor,0,0,0
2020-08-01,GTM,Johor,0,0,0
2020-08-01,GTM,Kedah,0,0,0
2020-08-01,GTM,Pahang,0,0,0
2020-08-01,GTM,Perak,0,0,0
2020-08-01,GTM,Pulau Pinang,0,0,0
2020-08-01,GTM,Sabah,0,0,0
2020-08-01,GTM,Sarawak,0,0,0
2020-08-01,GTM,Selangor,0,0,0
2020-08-01,GTM,W.P. Labuan,0,0,0
2020-08-01,GUY,Johor,0,0,0
2020-08-01,GUY,Kedah,0,0,0
2020-08-01,GUY,Pulau Pinang,0,0,0
2020-08-01,GUY,Sarawak,0,0,0
2020-08-01,GUY,Selangor,0,0,0
2020-08-01,HKG,Johor,0,0,0
2020-08-01,HKG,Kedah,0,0,0
2020-08-01,HKG,Kelantan,0,0,0
2020-08-01,HKG,Pahang,0,0,0
2020-08-01,HKG,Perak,1,0,1
2020-08-01,HKG,Perlis,0,0,0
2020-08-01,HKG,Pulau Pinang,0,0,0
2020-08-01,HKG,Sabah,0,0,0
2020-08-01,HKG,Sarawak,1,1,0
2020-08-01,HKG,Selangor,0,0,0
2020-08-01,HKG,Terengganu,0,0,0
2020-08-01,HMD,Johor,0,0,0
2020-08-01,HND,Johor,0,0,0
2020-08-01,HND,Kedah,0,0,0
2020-08-01,HND,Perak,0,0,0
2020-08-01,HND,Pulau Pinang,0,0,0
2020-08-01,HND,Sabah,0,0,0
2020-08-01,HND,Sarawak,0,0,0
2020-08-01,HND,Selangor,0,0,0
2020-08-01,HRV,Johor,4,4,0
2020-08-01,HRV,Kedah,0,0,0
2020-08-01,HRV,Kelantan,0,0,0
2020-08-01,HRV,Melaka,0,0,0
2020-08-01,HRV,Pahang,0,0,0
2020-08-01,HRV,Perak,0,0,0
2020-08-01,HRV,Perlis,0,0,0
2020-08-01,HRV,Pulau Pinang,0,0,0
2020-08-01,HRV,Sabah,0,0,0
2020-08-01,HRV,Sarawak,0,0,0
2020-08-01,HRV,Selangor,20,19,1
2020-08-01,HTI,Johor,0,0,0
2020-08-01,HTI,Kedah,0,0,0
2020-08-01,HTI,Kelantan,0,0,0
2020-08-01,HTI,Perak,0,0,0
2020-08-01,HTI,Pulau Pinang,0,0,0
2020-08-01,HTI,Sabah,0,0,0
2020-08-01,HTI,Selangor,0,0,0
2020-08-01,HUN,Johor,0,0,0
2020-08-01,HUN,Kedah,0,0,0
2020-08-01,HUN,Kelantan,0,0,0
2020-08-01,HUN,Pahang,0,0,0
2020-08-01,HUN,Perak,0,0,0
2020-08-01,HUN,Perlis,0,0,0
2020-08-01,HUN,Pulau Pinang,0,0,0
2020-08-01,HUN,Sabah,0,0,0
2020-08-01,HUN,Sarawak,0,0,0
2020-08-01,HUN,Selangor,8,5,3
2020-08-01,HUN,W.P. Labuan,0,0,0
2020-08-01,IDN,Johor,162,139,23
2020-08-01,IDN,Kedah,3,3,0
2020-08-01,IDN,Kelantan,0,0,0
2020-08-01,IDN,Melaka,0,0,0
2020-08-01,IDN,Negeri Sembilan,0,0,0
2020-08-01,IDN,Pahang,0,0,0
2020-08-01,IDN,Perak,0,0,0
2020-08-01,IDN,Perlis,5,4,1
2020-08-01,IDN,Pulau Pinang,5,2,3
2020-08-01,IDN,Sabah,9,3,6
2020-08-01,IDN,Sarawak,516,456,60
2020-08-01,IDN,Selangor,589,351,238
2020-08-01,IDN,Terengganu,0,0,0
2020-08-01,IDN,W.P. Labuan,0,0,0
2020-08-01,IND,Johor,75,74,1
2020-08-01,IND,Kedah,0,0,0
2020-08-01,IND,Kelantan,0,0,0
2020-08-01,IND,Melaka,0,0,0
2020-08-01,IND,Negeri Sembilan,0,0,0
2020-08-01,IND,Pahang,0,0,0
2020-08-01,IND,Perak,0,0,0
2020-08-01,IND,Perlis,0,0,0
2020-08-01,IND,Pulau Pinang,0,0,0
2020-08-01,IND,Sabah,1,0,1
2020-08-01,IND,Sarawak,0,0,0
2020-08-01,IND,Selangor,689,427,262
2020-08-01,IND,Terengganu,0,0,0
2020-08-01,IND,W.P. Labuan,0,0,0
2020-08-01,IOT,Pulau Pinang,0,0,0
2020-08-01,IOT,Selangor,0,0,0
2020-08-01,IRL,Johor,0,0,0
2020-08-01,IRL,Kedah,0,0,0
2020-08-01,IRL,Kelantan,0,0,0
2020-08-01,IRL,Negeri Sembilan,0,0,0
2020-08-01,IRL,Pahang,0,0,0
2020-08-01,IRL,Perak,0,0,0
2020-08-01,IRL,Perlis,0,0,0
2020-08-01,IRL,Pulau Pinang,0,0,0
2020-08-01,IRL,Sabah,0,0,0
2020-08-01,IRL,Sarawak,0,0,0
2020-08-01,IRL,Selangor,22,14,8
2020-08-01,IRL,Terengganu,0,0,0
2020-08-01,IRL,W.P. Labuan,0,0,0
2020-08-01,IRN,Johor,0,0,0
2020-08-01,IRN,Kedah,0,0,0
2020-08-01,IRN,Kelantan,0,0,0
2020-08-01,IRN,Perak,0,0,0
2020-08-01,IRN,Perlis,0,0,0
2020-08-01,IRN,Pulau Pinang,0,0,0
2020-08-01,IRN,Sabah,0,0,0
2020-08-01,IRN,Sarawak,1,0,1
2020-08-01,IRN,Selangor,23,10,13
2020-08-01,IRN,W.P. Labuan,0,0,0
2020-08-01,IRQ,Johor,0,0,0
2020-08-01,IRQ,Kedah,0,0,0
2020-08-01,IRQ,Kelantan,0,0,0
2020-08-01,IRQ,Melaka,0,0,0
2020-08-01,IRQ,Pahang,0,0,0
2020-08-01,IRQ,Perak,0,0,0
2020-08-01,IRQ,Perlis,0,0,0
2020-08-01,IRQ,Pulau Pinang,0,0,0
2020-08-01,IRQ,Sabah,0,0,0
2020-08-01,IRQ,Sarawak,0,0,0
2020-08-01,IRQ,Selangor,10,10,0
2020-08-01,ISL,Johor,0,0,0
2020-08-01,ISL,Kedah,0,0,0
2020-08-01,ISL,Kelantan,0,0,0
2020-08-01,ISL,Perak,0,0,0
2020-08-01,ISL,Perlis,0,0,0
2020-08-01,ISL,Pulau Pinang,0,0,0
2020-08-01,ISL,Sabah,0,0,0
2020-08-01,ISL,Sarawak,0,0,0
2020-08-01,ISL,Selangor,0,0,0
2020-08-01,ISL,W.P. Labuan,0,0,0
2020-08-01,ISR,Pulau Pinang,0,0,0
2020-08-01,ITA,Johor,0,0,0
2020-08-01,ITA,Kedah,0,0,0
2020-08-01,ITA,Kelantan,0,0,0
2020-08-01,ITA,Melaka,0,0,0
2020-08-01,ITA,Negeri Sembilan,0,0,0
2020-08-01,ITA,Pahang,0,0,0
2020-08-01,ITA,Perak,1,1,0
2020-08-01,ITA,Perlis,0,0,0
2020-08-01,ITA,Pulau Pinang,0,0,0
2020-08-01,ITA,Sabah,0,0,0
2020-08-01,ITA,Sarawak,0,0,0
2020-08-01,ITA,Selangor,17,15,2
2020-08-01,ITA,W.P. Labuan,0,0,0
2020-08-01,JAM,Johor,0,0,0
2020-08-01,JAM,Kedah,0,0,0
2020-08-01,JAM,Perak,0,0,0
2020-08-01,JAM,Pulau Pinang,0,0,0
2020-08-01,JAM,Sabah,0,0,0
2020-08-01,JAM,Sarawak,0,0,0
2020-08-01,JAM,Selangor,0,0,0
2020-08-01,JAM,W.P. Labuan,0,0,0
2020-08-01,JOR,Johor,0,0,0
2020-08-01,JOR,Kedah,0,0,0
2020-08-01,JOR,Kelantan,0,0,0
2020-08-01,JOR,Melaka,0,0,0
2020-08-01,JOR,Perlis,0,0,0
2020-08-01,JOR,Pulau Pinang,0,0,0
2020-08-01,JOR,Sabah,1,1,0
2020-08-01,JOR,Sarawak,0,0,0
2020-08-01,JOR,Selangor,6,4,2
2020-08-01,JOR,W.P. Labuan,0,0,0
2020-08-01,JPN,Johor,6,6,0
2020-08-01,JPN,Kedah,1,1,0
2020-08-01,JPN,Kelantan,0,0,0
2020-08-01,JPN,Melaka,0,0,0
2020-08-01,JPN,Negeri Sembilan,0,0,0
2020-08-01,JPN,Pahang,0,0,0
2020-08-01,JPN,Perak,0,0,0
2020-08-01,JPN,Perlis,0,0,0
2020-08-01,JPN,Pulau Pinang,0,0,0
2020-08-01,JPN,Sabah,2,1,1
2020-08-01,JPN,Sarawak,0,0,0
2020-08-01,JPN,Selangor,408,274,134
2020-08-01,JPN,W.P. Labuan,0,0,0
2020-08-01,KAZ,Johor,0,0,0
2020-08-01,KAZ,Kedah,0,0,0
2020-08-01,KAZ,Kelantan,0,0,0
2020-08-01,KAZ,Melaka,0,0,0
2020-08-01,KAZ,Perak,0,0,0
2020-08-01,KAZ,Perlis,0,0,0
2020-08-01,KAZ,Pulau Pinang,0,0,0
2020-08-01,KAZ,Sabah,1,0,1
2020-08-01,KAZ,Sarawak,0,0,0
2020-08-01,KAZ,Selangor,18,10,8
2020-08-01,KAZ,W.P. Labuan,0,0,0
2020-08-01,KEN,Johor,0,0,0
2020-08-01,KEN,Kedah,0,0,0
2020-08-01,KEN,Kelantan,0,0,0
2020-08-01,KEN,Perak,0,0,0
2020-08-01,KEN,Perlis,0,0,0
2020-08-01,KEN,Pulau Pinang,0,0,0
2020-08-01,KEN,Sabah,0,0,0
2020-08-01,KEN,Sarawak,0,0,0
2020-08-01,KEN,Selangor,9,3,6
2020-08-01,KGZ,Johor,0,0,0
2020-08-01,KGZ,Kedah,0,0,0
2020-08-01,KGZ,Kelantan,0,0,0
2020-08-01,KGZ,Perak,0,0,0
2020-08-01,KGZ,Perlis,0,0,0
2020-08-01,KGZ,Pulau Pinang,0,0,0
2020-08-01,KGZ,Sabah,0,0,0
2020-08-01,KGZ,Sarawak,0,0,0
2020-08-01,KGZ,Selangor,1,1,0
2020-08-01,KHM,Johor,0,0,0
2020-08-01,KHM,Kedah,0,0,0
2020-08-01,KHM,Kelantan,0,0,0
2020-08-01,KHM,Melaka,0,0,0
2020-08-01,KHM,Negeri Sembilan,0,0,0
2020-08-01,KHM,Pahang,0,0,0
2020-08-01,KHM,Perak,0,0,0
2020-08-01,KHM,Perlis,0,0,0
2020-08-01,KHM,Pulau Pinang,0,0,0
2020-08-01,KHM,Sabah,0,0,0
2020-08-01,KHM,Sarawak,0,0,0
2020-08-01,KHM,Selangor,1,0,1
2020-08-01,KHM,W.P. Labuan,0,0,0
2020-08-01,KIR,Johor,0,0,0
2020-08-01,KIR,Sabah,0,0,0
2020-08-01,KIR,Selangor,0,0,0
2020-08-01,KNA,Johor,0,0,0
2020-08-01,KNA,Kedah,0,0,0
2020-08-01,KNA,Perlis,0,0,0
2020-08-01,KNA,Pulau Pinang,0,0,0
2020-08-01,KNA,Sabah,0,0,0
2020-08-01,KNA,Selangor,0,0,0
2020-08-01,KNA,W.P. Labuan,0,0,0
2020-08-01,KOR,Johor,2,2,0
2020-08-01,KOR,Kedah,0,0,0
2020-08-01,KOR,Kelantan,0,0,0
2020-08-01,KOR,Melaka,0,0,0
2020-08-01,KOR,Negeri Sembilan,0,0,0
2020-08-01,KOR,Pahang,0,0,0
2020-08-01,KOR,Perak,0,0,0
2020-08-01,KOR,Perlis,0,0,0
2020-08-01,KOR,Pulau Pinang,0,0,0
2020-08-01,KOR,Sabah,4,1,3
2020-08-01,KOR,Sarawak,2,2,0
2020-08-01,KOR,Selangor,358,172,186
2020-08-01,KOR,Terengganu,0,0,0
2020-08-01,KOR,W.P. Labuan,0,0,0
2020-08-01,KWT,Johor,0,0,0
2020-08-01,KWT,Kedah,0,0,0
2020-08-01,KWT,Kelantan,0,0,0
2020-08-01,KWT,Perak,0,0,0
2020-08-01,KWT,Perlis,0,0,0
2020-08-01,KWT,Pulau Pinang,0,0,0
2020-08-01,KWT,Sabah,0,0,0
2020-08-01,KWT,Sarawak,0,0,0
2020-08-01,KWT,Selangor,1,1,0
2020-08-01,KWT,W.P. Labuan,0,0,0
2020-08-01,LAO,Johor,0,0,0
2020-08-01,LAO,Kedah,0,0,0
2020-08-01,LAO,Kelantan,0,0,0
2020-08-01,LAO,Melaka,0,0,0
2020-08-01,LAO,Perak,0,0,0
2020-08-01,LAO,Perlis,0,0,0
2020-08-01,LAO,Pulau Pinang,1,1,0
2020-08-01,LAO,Sabah,0,0,0
2020-08-01,LAO,Sarawak,0,0,0
2020-08-01,LAO,Selangor,0,0,0
2020-08-01,LAO,W.P. Labuan,0,0,0
2020-08-01,LBN,Johor,0,0,0
2020-08-01,LBN,Kedah,0,0,0
2020-08-01,LBN,Kelantan,0,0,0
2020-08-01,LBN,Pahang,0,0,0
2020-08-01,LBN,Perak,0,0,0
2020-08-01,LBN,Perlis,0,0,0
2020-08-01,LBN,Pulau Pinang,0,0,0
2020-08-01,LBN,Sabah,0,0,0
2020-08-01,LBN,Sarawak,0,0,0
2020-08-01,LBN,Selangor,0,0,0
2020-08-01,LBN,W.P. Labuan,0,0,0
2020-08-01,LBR,Johor,0,0,0
2020-08-01,LBR,Kedah,0,0,0
2020-08-01,LBR,Sabah,0,0,0
2020-08-01,LBR,Sarawak,0,0,0
2020-08-01,LBR,Selangor,0,0,0
2020-08-01,LBY,Johor,0,0,0
2020-08-01,LBY,Kedah,0,0,0
2020-08-01,LBY,Perlis,0,0,0
2020-08-01,LBY,Pulau Pinang,0,0,0
2020-08-01,LBY,Sabah,0,0,0
2020-08-01,LBY,Sarawak,0,0,0
2020-08-01,LBY,Selangor,1,1,0
2020-08-01,LCA,Johor,0,0,0
2020-08-01,LCA,Kedah,0,0,0
2020-08-01,LCA,Pulau Pinang,0,0,0
2020-08-01,LCA,Sarawak,0,0,0
2020-08-01,LCA,Selangor,0,0,0
2020-08-01,LIE,Johor,0,0,0
2020-08-01,LIE,Kedah,0,0,0
2020-08-01,LIE,Perlis,0,0,0
2020-08-01,LIE,Pulau Pinang,0,0,0
2020-08-01,LIE,Sabah,0,0,0
2020-08-01,LIE,Sarawak,0,0,0
2020-08-01,LIE,Selangor,0,0,0
2020-08-01,LKA,Johor,1,1,0
2020-08-01,LKA,Kedah,0,0,0
2020-08-01,LKA,Kelantan,0,0,0
2020-08-01,LKA,Melaka,0,0,0
2020-08-01,LKA,Pahang,0,0,0
2020-08-01,LKA,Perak,0,0,0
2020-08-01,LKA,Perlis,0,0,0
2020-08-01,LKA,Pulau Pinang,0,0,0
2020-08-01,LKA,Sabah,0,0,0
2020-08-01,LKA,Sarawak,0,0,0
2020-08-01,LKA,Selangor,35,27,8
2020-08-01,LKA,W.P. Labuan,0,0,0
2020-08-01,LSO,Johor,0,0,0
2020-08-01,LSO,Kedah,0,0,0
2020-08-01,LSO,Pulau Pinang,0,0,0
2020-08-01,LSO,Sarawak,0,0,0
2020-08-01,LSO,Selangor,0,0,0
2020-08-01,LTU,Johor,0,0,0
2020-08-01,LTU,Kedah,0,0,0
2020-08-01,LTU,Kelantan,0,0,0
2020-08-01,LTU,Pahang,0,0,0
2020-08-01,LTU,Perak,0,0,0
2020-08-01,LTU,Perlis,0,0,0
2020-08-01,LTU,Pulau Pinang,0,0,0
2020-08-01,LTU,Sabah,0,0,0
2020-08-01,LTU,Sarawak,0,0,0
2020-08-01,LTU,Selangor,8,8,0
2020-08-01,LTU,W.P. Labuan,0,0,0
2020-08-01,LUX,Johor,0,0,0
2020-08-01,LUX,Kedah,0,0,0
2020-08-01,LUX,Kelantan,0,0,0
2020-08-01,LUX,Perak,0,0,0
2020-08-01,LUX,Perlis,0,0,0
2020-08-01,LUX,Pulau Pinang,0,0,0
2020-08-01,LUX,Sabah,0,0,0
2020-08-01,LUX,Sarawak,0,0,0
2020-08-01,LUX,Selangor,0,0,0
2020-08-01,LVA,Johor,0,0,0
2020-08-01,LVA,Kedah,0,0,0
2020-08-01,LVA,Kelantan,0,0,0
2020-08-01,LVA,Pahang,0,0,0
2020-08-01,LVA,Perak,0,0,0
2020-08-01,LVA,Perlis,0,0,0
2020-08-01,LVA,Pulau Pinang,0,0,0
2020-08-01,LVA,Sabah,0,0,0
2020-08-01,LVA,Sarawak,0,0,0
2020-08-01,LVA,Selangor,6,6,0
2020-08-01,LVA,W.P. Labuan,0,0,0
2020-08-01,MAC,Johor,0,0,0
2020-08-01,MAC,Pahang,0,0,0
2020-08-01,MAC,Perak,0,0,0
2020-08-01,MAC,Selangor,0,0,0
2020-08-01,MAC,W.P. Labuan,0,0,0
2020-08-01,MAR,Johor,0,0,0
2020-08-01,MAR,Kedah,0,0,0
2020-08-01,MAR,Kelantan,0,0,0
2020-08-01,MAR,Melaka,0,0,0
2020-08-01,MAR,Pahang,0,0,0
2020-08-01,MAR,Perak,0,0,0
2020-08-01,MAR,Perlis,0,0,0
2020-08-01,MAR,Pulau Pinang,0,0,0
2020-08-01,MAR,Sabah,0,0,0
2020-08-01,MAR,Sarawak,0,0,0
2020-08-01,MAR,Selangor,0,0,0
2020-08-01,MAR,W.P. Labuan,0,0,0
2020-08-01,MCO,Johor,0,0,0
2020-08-01,MCO,Kedah,0,0,0
2020-08-01,MCO,Sabah,0,0,0
2020-08-01,MCO,Selangor,0,0,0
2020-08-01,MDA,Johor,0,0,0
2020-08-01,MDA,Kedah,0,0,0
2020-08-01,MDA,Kelantan,0,0,0
2020-08-01,MDA,Negeri Sembilan,0,0,0
2020-08-01,MDA,Perlis,0,0,0
2020-08-01,MDA,Pulau Pinang,0,0,0
2020-08-01,MDA,Sabah,0,0,0
2020-08-01,MDA,Sarawak,0,0,0
2020-08-01,MDA,Selangor,0,0,0
2020-08-01,MDG,Johor,0,0,0
2020-08-01,MDG,Kedah,0,0,0
2020-08-01,MDG,Perak,0,0,0
2020-08-01,MDG,Perlis,0,0,0
2020-08-01,MDG,Pulau Pinang,0,0,0
2020-08-01,MDG,Sabah,0,0,0
2020-08-01,MDG,Sarawak,0,0,0
2020-08-01,MDG,Selangor,0,0,0
2020-08-01,MDV,Johor,0,0,0
2020-08-01,MDV,Kedah,0,0,0
2020-08-01,MDV,Kelantan,0,0,0
2020-08-01,MDV,Perak,0,0,0
2020-08-01,MDV,Perlis,0,0,0
2020-08-01,MDV,Pulau Pinang,0,0,0
2020-08-01,MDV,Sabah,0,0,0
2020-08-01,MDV,Sarawak,0,0,0
2020-08-01,MDV,Selangor,54,22,32
2020-08-01,MEX,Johor,10,10,0
2020-08-01,MEX,Kedah,0,0,0
2020-08-01,MEX,Kelantan,0,0,0
2020-08-01,MEX,Pahang,0,0,0
2020-08-01,MEX,Perak,0,0,0
2020-08-01,MEX,Perlis,0,0,0
2020-08-01,MEX,Pulau Pinang,0,0,0
2020-08-01,MEX,Sabah,0,0,0
2020-08-01,MEX,Sarawak,0,0,0
2020-08-01,MEX,Selangor,72,6,66
2020-08-01,MEX,W.P. Labuan,0,0,0
2020-08-01,MHL,Johor,0,0,0
2020-08-01,MHL,Kedah,0,0,0
2020-08-01,MHL,Perak,0,0,0
2020-08-01,MHL,Pulau Pinang,0,0,0
2020-08-01,MHL,Sabah,0,0,0
2020-08-01,MHL,Selangor,0,0,0
2020-08-01,MKD,Johor,0,0,0
2020-08-01,MKD,Kedah,0,0,0
2020-08-01,MKD,Perak,0,0,0
2020-08-01,MKD,Pulau Pinang,0,0,0
2020-08-01,MKD,Sabah,0,0,0
2020-08-01,MKD,Sarawak,0,0,0
2020-08-01,MKD,Selangor,0,0,0
2020-08-01,MLI,Johor,0,0,0
2020-08-01,MLI,Sabah,0,0,0
2020-08-01,MLI,Selangor,0,0,0
2020-08-01,MLT,Johor,0,0,0
2020-08-01,MLT,Kedah,0,0,0
2020-08-01,MLT,Kelantan,0,0,0
2020-08-01,MLT,Perak,0,0,0
2020-08-01,MLT,Perlis,0,0,0
2020-08-01,MLT,Pulau Pinang,0,0,0
2020-08-01,MLT,Sabah,0,0,0
2020-08-01,MLT,Sarawak,0,0,0
2020-08-01,MLT,Selangor,4,4,0
2020-08-01,MLT,W.P. Labuan,0,0,0
2020-08-01,MMR,Johor,13,13,0
2020-08-01,MMR,Kedah,0,0,0
2020-08-01,MMR,Kelantan,0,0,0
2020-08-01,MMR,Negeri Sembilan,0,0,0
2020-08-01,MMR,Pahang,0,0,0
2020-08-01,MMR,Perak,0,0,0
2020-08-01,MMR,Perlis,0,0,0
2020-08-01,MMR,Pulau Pinang,0,0,0
2020-08-01,MMR,Sabah,1,0,1
2020-08-01,MMR,Sarawak,0,0,0
2020-08-01,MMR,Selangor,82,73,9
2020-08-01,MMR,Terengganu,0,0,0
2020-08-01,MMR,W.P. Labuan,0,0,0
2020-08-01,MNE,Johor,0,0,0
2020-08-01,MNE,Kedah,0,0,0
2020-08-01,MNE,Pulau Pinang,0,0,0
2020-08-01,MNE,Sabah,0,0,0
2020-08-01,MNE,Sarawak,0,0,0
2020-08-01,MNE,Selangor,1,1,0
2020-08-01,MNG,Johor,0,0,0
2020-08-01,MNG,Kedah,0,0,0
2020-08-01,MNG,Kelantan,0,0,0
2020-08-01,MNG,Perak,0,0,0
2020-08-01,MNG,Perlis,0,0,0
2020-08-01,MNG,Pulau Pinang,0,0,0
2020-08-01,MNG,Sabah,0,0,0
2020-08-01,MNG,Sarawak,0,0,0
2020-08-01,MNG,Selangor,3,0,3
2020-08-01,MNP,Selangor,0,0,0
2020-08-01,MOZ,Johor,0,0,0
2020-08-01,MOZ,Kedah,0,0,0
2020-08-01,MOZ,Perak,0,0,0
2020-08-01,MOZ,Pulau Pinang,0,0,0
2020-08-01,MOZ,Sabah,0,0,0
2020-08-01,MOZ,Sarawak,0,0,0
2020-08-01,MOZ,Selangor,0,0,0
2020-08-01,MRT,Johor,0,0,0
2020-08-01,MRT,Kedah,0,0,0
2020-08-01,MRT,Pulau Pinang,0,0,0
2020-08-01,MRT,Sabah,0,0,0
2020-08-01,MRT,Sarawak,0,0,0
2020-08-01,MRT,Selangor,0,0,0
2020-08-01,MUS,Johor,0,0,0
2020-08-01,MUS,Kedah,0,0,0
2020-08-01,MUS,Kelantan,0,0,0
2020-08-01,MUS,Pahang,0,0,0
2020-08-01,MUS,Perak,0,0,0
2020-08-01,MUS,Perlis,0,0,0
2020-08-01,MUS,Pulau Pinang,0,0,0
2020-08-01,MUS,Sabah,0,0,0
2020-08-01,MUS,Sarawak,0,0,0
2020-08-01,MUS,Selangor,1,0,1
2020-08-01,MWI,Johor,0,0,0
2020-08-01,MWI,Pulau Pinang,0,0,0
2020-08-01,MWI,Sabah,0,0,0
2020-08-01,MWI,Sarawak,0,0,0
2020-08-01,MWI,Selangor,0,0,0
2020-08-01,MYT,Selangor,0,0,0
2020-08-01,NAM,Johor,0,0,0
2020-08-01,NAM,Kedah,0,0,0
2020-08-01,NAM,Perak,0,0,0
2020-08-01,NAM,Perlis,0,0,0
2020-08-01,NAM,Pulau Pinang,0,0,0
2020-08-01,NAM,Sabah,0,0,0
2020-08-01,NAM,Sarawak,0,0,0
2020-08-01,NAM,Selangor,0,0,0
2020-08-01,NCL,Selangor,0,0,0
2020-08-01,NER,Johor,0,0,0
2020-08-01,NER,Sabah,0,0,0
2020-08-01,NER,Selangor,0,0,0
2020-08-01,NGA,Johor,0,0,0
2020-08-01,NGA,Kedah,0,0,0
2020-08-01,NGA,Perlis,0,0,0
2020-08-01,NGA,Pulau Pinang,0,0,0
2020-08-01,NGA,Sabah,0,0,0
2020-08-01,NGA,Sarawak,0,0,0
2020-08-01,NGA,Selangor,10,3,7
2020-08-01,NIC,Johor,0,0,0
2020-08-01,NIC,Kedah,0,0,0
2020-08-01,NIC,Pulau Pinang,0,0,0
2020-08-01,NIC,Sabah,0,0,0
2020-08-01,NIC,Selangor,0,0,0
2020-08-01,NLD,Johor,1,1,0
2020-08-01,NLD,Kedah,0,0,0
2020-08-01,NLD,Kelantan,0,0,0
2020-08-01,NLD,Melaka,0,0,0
2020-08-01,NLD,Negeri Sembilan,0,0,0
2020-08-01,NLD,Pahang,0,0,0
2020-08-01,NLD,Perak,0,0,0
2020-08-01,NLD,Perlis,0,0,0
2020-08-01,NLD,Pulau Pinang,0,0,0
2020-08-01,NLD,Sabah,0,0,0
2020-08-01,NLD,Sarawak,0,0,0
2020-08-01,NLD,Selangor,46,37,9
2020-08-01,NLD,Terengganu,0,0,0
2020-08-01,NLD,W.P. Labuan,0,0,0
2020-08-01,NOR,Johor,3,3,0
2020-08-01,NOR,Kedah,0,0,0
2020-08-01,NOR,Kelantan,0,0,0
2020-08-01,NOR,Melaka,0,0,0
2020-08-01,NOR,Pahang,0,0,0
2020-08-01,NOR,Perak,0,0,0
2020-08-01,NOR,Perlis,0,0,0
2020-08-01,NOR,Pulau Pinang,0,0,0
2020-08-01,NOR,Sabah,1,0,1
2020-08-01,NOR,Sarawak,0,0,0
2020-08-01,NOR,Selangor,19,17,2
2020-08-01,NOR,W.P. Labuan,0,0,0
2020-08-01,NPL,Johor,0,0,0
2020-08-01,NPL,Kedah,0,0,0
2020-08-01,NPL,Pahang,0,0,0
2020-08-01,NPL,Perak,0,0,0
2020-08-01,NPL,Perlis,0,0,0
2020-08-01,NPL,Pulau Pinang,0,0,0
2020-08-01,NPL,Sabah,0,0,0
2020-08-01,NPL,Sarawak,0,0,0
2020-08-01,NPL,Selangor,7,5,2
2020-08-01,NPL,W.P. Labuan,0,0,0
2020-08-01,NRU,Johor,0,0,0
2020-08-01,NRU,Pulau Pinang,0,0,0
2020-08-01,NRU,Selangor,0,0,0
2020-08-01,NZL,Johor,0,0,0
2020-08-01,NZL,Kedah,0,0,0
2020-08-01,NZL,Kelantan,0,0,0
2020-08-01,NZL,Melaka,0,0,0
2020-08-01,NZL,Negeri Sembilan,0,0,0
2020-08-01,NZL,Pahang,0,0,0
2020-08-01,NZL,Perak,0,0,0
2020-08-01,NZL,Perlis,0,0,0
2020-08-01,NZL,Pulau Pinang,0,0,0
2020-08-01,NZL,Sabah,0,0,0
2020-08-01,NZL,Sarawak,0,0,0
2020-08-01,NZL,Selangor,117,107,10
2020-08-01,NZL,Terengganu,0,0,0
2020-08-01,NZL,W.P. Labuan,0,0,0
2020-08-01,OMN,Johor,0,0,0
2020-08-01,OMN,Kedah,0,0,0
2020-08-01,OMN,Kelantan,0,0,0
2020-08-01,OMN,Melaka,0,0,0
2020-08-01,OMN,Perak,0,0,0
2020-08-01,OMN,Perlis,0,0,0
2020-08-01,OMN,Pulau Pinang,0,0,0
2020-08-01,OMN,Sabah,0,0,0
2020-08-01,OMN,Sarawak,0,0,0
2020-08-01,OMN,Selangor,9,5,4
2020-08-01,PAK,Johor,0,0,0
2020-08-01,PAK,Kedah,0,0,0
2020-08-01,PAK,Kelantan,0,0,0
2020-08-01,PAK,Melaka,0,0,0
2020-08-01,PAK,Negeri Sembilan,0,0,0
2020-08-01,PAK,Pahang,0,0,0
2020-08-01,PAK,Perak,0,0,0
2020-08-01,PAK,Perlis,0,0,0
2020-08-01,PAK,Pulau Pinang,0,0,0
2020-08-01,PAK,Sabah,1,1,0
2020-08-01,PAK,Sarawak,0,0,0
2020-08-01,PAK,Selangor,175,150,25
2020-08-01,PAK,W.P. Labuan,0,0,0
2020-08-01,PAN,Johor,0,0,0
2020-08-01,PAN,Kedah,0,0,0
2020-08-01,PAN,Perak,0,0,0
2020-08-01,PAN,Perlis,0,0,0
2020-08-01,PAN,Pulau Pinang,0,0,0
2020-08-01,PAN,Sabah,0,0,0
2020-08-01,PAN,Sarawak,0,0,0
2020-08-01,PAN,Selangor,0,0,0
2020-08-01,PER,Johor,0,0,0
2020-08-01,PER,Kedah,0,0,0
2020-08-01,PER,Kelantan,0,0,0
2020-08-01,PER,Pahang,0,0,0
2020-08-01,PER,Perak,0,0,0
2020-08-01,PER,Perlis,0,0,0
2020-08-01,PER,Pulau Pinang,0,0,0
2020-08-01,PER,Sabah,0,0,0
2020-08-01,PER,Sarawak,0,0,0
2020-08-01,PER,Selangor,5,2,3
2020-08-01,PER,W.P. Labuan,0,0,0
2020-08-01,PHL,Johor,69,66,3
2020-08-01,PHL,Kedah,0,0,0
2020-08-01,PHL,Kelantan,0,0,0
2020-08-01,PHL,Melaka,0,0,0
2020-08-01,PHL,Negeri Sembilan,0,0,0
2020-08-01,PHL,Pahang,0,0,0
2020-08-01,PHL,Perak,0,0,0
2020-08-01,PHL,Perlis,0,0,0
2020-08-01,PHL,Pulau Pinang,1,0,1
2020-08-01,PHL,Sabah,3,2,1
2020-08-01,PHL,Sarawak,39,38,1
2020-08-01,PHL,Selangor,312,271,41
2020-08-01,PHL,Terengganu,0,0,0
2020-08-01,PHL,W.P. Labuan,4,4,0
2020-08-01,PLW,Johor,0,0,0
2020-08-01,PLW,Pulau Pinang,0,0,0
2020-08-01,PLW,Selangor,0,0,0
2020-08-01,PNG,Johor,0,0,0
2020-08-01,PNG,Kedah,0,0,0
2020-08-01,PNG,Kelantan,0,0,0
2020-08-01,PNG,Perak,0,0,0
2020-08-01,PNG,Pulau Pinang,0,0,0
2020-08-01,PNG,Sabah,0,0,0
2020-08-01,PNG,Sarawak,0,0,0
2020-08-01,PNG,Selangor,0,0,0
2020-08-01,POL,Johor,0,0,0
2020-08-01,POL,Kedah,0,0,0
2020-08-01,POL,Kelantan,0,0,0
2020-08-01,POL,Melaka,0,0,0
2020-08-01,POL,Negeri Sembilan,0,0,0
2020-08-01,POL,Pahang,0,0,0
2020-08-01,POL,Perak,0,0,0
2020-08-01,POL,Perlis,0,0,0
2020-08-01,POL,Pulau Pinang,0,0,0
2020-08-01,POL,Sabah,0,0,0
2020-08-01,POL,Sarawak,0,0,0
2020-08-01,POL,Selangor,23,18,5
2020-08-01,POL,Terengganu,0,0,0
2020-08-01,POL,W.P. Labuan,0,0,0
2020-08-01,PRK,Selangor,0,0,0
2020-08-01,PRT,Johor,0,0,0
2020-08-01,PRT,Kedah,0,0,0
2020-08-01,PRT,Kelantan,0,0,0
2020-08-01,PRT,Melaka,0,0,0
2020-08-01,PRT,Pahang,0,0,0
2020-08-01,PRT,Perak,0,0,0
2020-08-01,PRT,Perlis,0,0,0
2020-08-01,PRT,Pulau Pinang,0,0,0
2020-08-01,PRT,Sabah,0,0,0
2020-08-01,PRT,Sarawak,0,0,0
2020-08-01,PRT,Selangor,6,4,2
2020-08-01,PRT,W.P. Labuan,0,0,0
2020-08-01,PRY,Johor,0,0,0
2020-08-01,PRY,Kedah,0,0,0
2020-08-01,PRY,Perak,0,0,0
2020-08-01,PRY,Perlis,0,0,0
2020-08-01,PRY,Pulau Pinang,0,0,0
2020-08-01,PRY,Sabah,0,0,0
2020-08-01,PRY,Sarawak,0,0,0
2020-08-01,PRY,Selangor,0,0,0
2020-08-01,PSE,Johor,0,0,0
2020-08-01,PSE,Kedah,0,0,0
2020-08-01,PSE,Kelantan,0,0,0
2020-08-01,PSE,Melaka,0,0,0
2020-08-01,PSE,Perak,0,0,0
2020-08-01,PSE,Perlis,0,0,0
2020-08-01,PSE,Pulau Pinang,0,0,0
2020-08-01,PSE,Sabah,0,0,0
2020-08-01,PSE,Sarawak,0,0,0
2020-08-01,PSE,Selangor,6,6,0
2020-08-01,QAT,Johor,0,0,0
2020-08-01,QAT,Kedah,0,0,0
2020-08-01,QAT,Perlis,0,0,0
2020-08-01,QAT,Pulau Pinang,0,0,0
2020-08-01,QAT,Sabah,0,0,0
2020-08-01,QAT,Sarawak,0,0,0
2020-08-01,QAT,Selangor,1,1,0
2020-08-01,REU,Johor,0,0,0
2020-08-01,REU,Sarawak,0,0,0
2020-08-01,ROU,Johor,0,0,0
2020-08-01,ROU,Kedah,0,0,0
2020-08-01,ROU,Kelantan,0,0,0
2020-08-01,ROU,Negeri Sembilan,0,0,0
2020-08-01,ROU,Pahang,0,0,0
2020-08-01,ROU,Perak,0,0,0
2020-08-01,ROU,Perlis,0,0,0
2020-08-01,ROU,Pulau Pinang,1,1,0
2020-08-01,ROU,Sabah,0,0,0
2020-08-01,ROU,Sarawak,0,0,0
2020-08-01,ROU,Selangor,16,14,2
2020-08-01,ROU,W.P. Labuan,0,0,0
2020-08-01,RUS,Johor,6,6,0
2020-08-01,RUS,Kedah,0,0,0
2020-08-01,RUS,Kelantan,0,0,0
2020-08-01,RUS,Melaka,0,0,0
2020-08-01,RUS,Negeri Sembilan,0,0,0
2020-08-01,RUS,Pahang,0,0,0
2020-08-01,RUS,Perak,0,0,0
2020-08-01,RUS,Perlis,0,0,0
2020-08-01,RUS,Pulau Pinang,2,2,0
2020-08-01,RUS,Sabah,3,3,0
2020-08-01,RUS,Sarawak,1,0,1
2020-08-01,RUS,Selangor,100,83,17
2020-08-01,RUS,W.P. Labuan,0,0,0
2020-08-01,RWA,Johor,0,0,0
2020-08-01,RWA,Kedah,0,0,0
2020-08-01,RWA,Pulau Pinang,0,0,0
2020-08-01,RWA,Selangor,0,0,0
2020-08-01,SAU,Johor,0,0,0
2020-08-01,SAU,Kedah,0,0,0
2020-08-01,SAU,Kelantan,0,0,0
2020-08-01,SAU,Melaka,0,0,0
2020-08-01,SAU,Perak,0,0,0
2020-08-01,SAU,Perlis,0,0,0
2020-08-01,SAU,Pulau Pinang,0,0,0
2020-08-01,SAU,Sabah,0,0,0
2020-08-01,SAU,Sarawak,0,0,0
2020-08-01,SAU,Selangor,9,5,4
2020-08-01,SAU,W.P. Labuan,0,0,0
2020-08-01,SDN,Johor,0,0,0
2020-08-01,SDN,Kedah,0,0,0
2020-08-01,SDN,Kelantan,0,0,0
2020-08-01,SDN,Perlis,0,0,0
2020-08-01,SDN,Pulau Pinang,0,0,0
2020-08-01,SDN,Sabah,0,0,0
2020-08-01,SDN,Sarawak,0,0,0
2020-08-01,SDN,Selangor,13,11,2
2020-08-01,SDN,W.P. Labuan,0,0,0
2020-08-01,SEN,Johor,0,0,0
2020-08-01,SEN,Kedah,0,0,0
2020-08-01,SEN,Kelantan,0,0,0
2020-08-01,SEN,Perak,0,0,0
2020-08-01,SEN,Perlis,0,0,0
2020-08-01,SEN,Pulau Pinang,0,0,0
2020-08-01,SEN,Sabah,0,0,0
2020-08-01,SEN,Sarawak,0,0,0
2020-08-01,SEN,Selangor,5,3,2
2020-08-01,SGP,Johor,328,288,40
2020-08-01,SGP,Kedah,2,2,0
2020-08-01,SGP,Kelantan,0,0,0
2020-08-01,SGP,Melaka,0,0,0
2020-08-01,SGP,Negeri Sembilan,0,0,0
2020-08-01,SGP,Pahang,0,0,0
2020-08-01,SGP,Perak,1,1,0
2020-08-01,SGP,Perlis,0,0,0
2020-08-01,SGP,Pulau Pinang,14,8,6
2020-08-01,SGP,Sabah,0,0,0
2020-08-01,SGP,Sarawak,8,3,5
2020-08-01,SGP,Selangor,161,115,46
2020-08-01,SGP,Terengganu,0,0,0
2020-08-01,SGP,W.P. Labuan,0,0,0
2020-08-01,SGS,Johor,0,0,0
2020-08-01,SGS,Sabah,0,0,0
2020-08-01,SGS,Selangor,0,0,0
2020-08-01,SHN,Sarawak,0,0,0
2020-08-01,SLB,Johor,0,0,0
2020-08-01,SLB,Perlis,0,0,0
2020-08-01,SLB,Pulau Pinang,0,0,0
2020-08-01,SLB,Sabah,0,0,0
2020-08-01,SLB,Sarawak,0,0,0
2020-08-01,SLB,Selangor,0,0,0
2020-08-01,SLB,W.P. Labuan,0,0,0
2020-08-01,SLE,Johor,0,0,0
2020-08-01,SLE,Kedah,0,0,0
2020-08-01,SLE,Perak,0,0,0
2020-08-01,SLE,Pulau Pinang,0,0,0
2020-08-01,SLE,Sabah,0,0,0
2020-08-01,SLE,Selangor,0,0,0
2020-08-01,SLV,Johor,0,0,0
2020-08-01,SLV,Kedah,0,0,0
2020-08-01,SLV,Perak,0,0,0
2020-08-01,SLV,Perlis,0,0,0
2020-08-01,SLV,Pulau Pinang,0,0,0
2020-08-01,SLV,Sabah,0,0,0
2020-08-01,SLV,Selangor,0,0,0
2020-08-01,SLV,W.P. Labuan,0,0,0
2020-08-01,SMR,Johor,0,0,0
2020-08-01,SMR,Selangor,0,0,0
2020-08-01,SOM,Johor,0,0,0
2020-08-01,SOM,Kedah,0,0,0
2020-08-01,SOM,Kelantan,0,0,0
2020-08-01,SOM,Perlis,0,0,0
2020-08-01,SOM,Sabah,0,0,0
2020-08-01,SOM,Sarawak,0,0,0
2020-08-01,SOM,Selangor,2,2,0
2020-08-01,SRB,Johor,0,0,0
2020-08-01,SRB,Kedah,0,0,0
2020-08-01,SRB,Kelantan,0,0,0
2020-08-01,SRB,Pahang,0,0,0
2020-08-01,SRB,Perak,0,0,0
2020-08-01,SRB,Perlis,0,0,0
2020-08-01,SRB,Pulau Pinang,0,0,0
2020-08-01,SRB,Sabah,0,0,0
2020-08-01,SRB,Sarawak,0,0,0
2020-08-01,SRB,Selangor,3,1,2
2020-08-01,SSD,Johor,0,0,0
2020-08-01,SSD,Kedah,0,0,0
2020-08-01,SSD,Sarawak,0,0,0
2020-08-01,SSD,Selangor,0,0,0
2020-08-01,SSD,W.P. Labuan,0,0,0
2020-08-01,STP,Selangor,0,0,0
2020-08-01,SUR,Johor,0,0,0
2020-08-01,SUR,Kedah,0,0,0
2020-08-01,SUR,Kelantan,0,0,0
2020-08-01,SUR,Perak,0,0,0
2020-08-01,SUR,Perlis,0,0,0
2020-08-01,SUR,Pulau Pinang,0,0,0
2020-08-01,SUR,Sabah,0,0,0
2020-08-01,SUR,Sarawak,0,0,0
2020-08-01,SUR,Selangor,0,0,0
2020-08-01,SVK,Johor,0,0,0
2020-08-01,SVK,Kedah,0,0,0
2020-08-01,SVK,Kelantan,0,0,0
2020-08-01,SVK,Negeri Sembilan,0,0,0
2020-08-01,SVK,Pahang,0,0,0
2020-08-01,SVK,Perak,0,0,0
2020-08-01,SVK,Perlis,0,0,0
2020-08-01,SVK,Pulau Pinang,0,0,0
2020-08-01,SVK,Sabah,0,0,0
2020-08-01,SVK,Sarawak,0,0,0
2020-08-01,SVK,Selangor,9,6,3
2020-08-01,SVK,W.P. Labuan,0,0,0
2020-08-01,SVN,Johor,0,0,0
2020-08-01,SVN,Kedah,0,0,0
2020-08-01,SVN,Kelantan,0,0,0
2020-08-01,SVN,Perak,0,0,0
2020-08-01,SVN,Perlis,0,0,0
2020-08-01,SVN,Pulau Pinang,0,0,0
2020-08-01,SVN,Sabah,0,0,0
2020-08-01,SVN,Sarawak,0,0,0
2020-08-01,SVN,Selangor,1,1,0
2020-08-01,SVN,W.P. Labuan,0,0,0
2020-08-01,SWE,Johor,0,0,0
2020-08-01,SWE,Kedah,0,0,0
2020-08-01,SWE,Kelantan,0,0,0
2020-08-01,SWE,Melaka,0,0,0
2020-08-01,SWE,Negeri Sembilan,0,0,0
2020-08-01,SWE,Pahang,0,0,0
2020-08-01,SWE,Perak,0,0,0
2020-08-01,SWE,Perlis,0,0,0
2020-08-01,SWE,Pulau Pinang,0,0,0
2020-08-01,SWE,Sabah,0,0,0
2020-08-01,SWE,Sarawak,0,0,0
2020-08-01,SWE,Selangor,17,13,4
2020-08-01,SWE,W.P. Labuan,0,0,0
2020-08-01,SWZ,Johor,0,0,0
2020-08-01,SWZ,Kedah,0,0,0
2020-08-01,SWZ,Pulau Pinang,0,0,0
2020-08-01,SWZ,Sabah,0,0,0
2020-08-01,SWZ,Selangor,0,0,0
2020-08-01,SYC,Johor,0,0,0
2020-08-01,SYC,Kedah,0,0,0
2020-08-01,SYC,Pulau Pinang,0,0,0
2020-08-01,SYC,Sabah,0,0,0
2020-08-01,SYC,Sarawak,0,0,0
2020-08-01,SYC,Selangor,0,0,0
2020-08-01,SYR,Johor,0,0,0
2020-08-01,SYR,Kedah,0,0,0
2020-08-01,SYR,Kelantan,0,0,0
2020-08-01,SYR,Pahang,0,0,0
2020-08-01,SYR,Perlis,0,0,0
2020-08-01,SYR,Pulau Pinang,0,0,0
2020-08-01,SYR,Sabah,0,0,0
2020-08-01,SYR,Sarawak,0,0,0
2020-08-01,SYR,Selangor,24,23,1
2020-08-01,SYR,W.P. Labuan,0,0,0
2020-08-01,TCA,Perlis,0,0,0
2020-08-01,TCD,Johor,0,0,0
2020-08-01,TCD,Kedah,0,0,0
2020-08-01,TCD,Perlis,0,0,0
2020-08-01,TCD,Selangor,0,0,0
2020-08-01,TGO,Johor,0,0,0
2020-08-01,TGO,Perak,0,0,0
2020-08-01,TGO,Pulau Pinang,0,0,0
2020-08-01,TGO,Selangor,0,0,0
2020-08-01,THA,Johor,87,87,0
2020-08-01,THA,Kedah,10333,9521,812
2020-08-01,THA,Kelantan,3,1,2
2020-08-01,THA,Melaka,0,0,0
2020-08-01,THA,Negeri Sembilan,0,0,0
2020-08-01,THA,Pahang,0,0,0
2020-08-01,THA,Perak,0,0,0
2020-08-01,THA,Perlis,4315,4191,124
2020-08-01,THA,Pulau Pinang,0,0,0
2020-08-01,THA,Sabah,1,0,1
2020-08-01,THA,Sarawak,13,13,0
2020-08-01,THA,Selangor,170,122,48
2020-08-01,THA,Terengganu,0,0,0
2020-08-01,THA,W.P. Labuan,0,0,0
2020-08-01,TJK,Johor,0,0,0
2020-08-01,TJK,Kedah,0,0,0
2020-08-01,TJK,Perlis,0,0,0
2020-08-01,TJK,Pulau Pinang,0,0,0
2020-08-01,TJK,Sabah,0,0,0
2020-08-01,TJK,Selangor,1,0,1
2020-08-01,TKL,Selangor,0,0,0
2020-08-01,TKM,Johor,0,0,0
2020-08-01,TKM,Kedah,0,0,0
2020-08-01,TKM,Kelantan,0,0,0
2020-08-01,TKM,Perlis,0,0,0
2020-08-01,TKM,Pulau Pinang,0,0,0
2020-08-01,TKM,Sabah,0,0,0
2020-08-01,TKM,Sarawak,0,0,0
2020-08-01,TKM,Selangor,0,0,0
2020-08-01,TLS,Johor,0,0,0
2020-08-01,TLS,Kedah,0,0,0
2020-08-01,TLS,Perlis,0,0,0
2020-08-01,TLS,Pulau Pinang,0,0,0
2020-08-01,TLS,Sabah,0,0,0
2020-08-01,TLS,Sarawak,0,0,0
2020-08-01,TLS,Selangor,2,1,1
2020-08-01,TON,Johor,0,0,0
2020-08-01,TON,Pulau Pinang,0,0,0
2020-08-01,TON,Sarawak,0,0,0
2020-08-01,TON,Selangor,0,0,0
2020-08-01,TTO,Johor,0,0,0
2020-08-01,TTO,Kedah,0,0,0
2020-08-01,TTO,Pahang,0,0,0
2020-08-01,TTO,Pulau Pinang,0,0,0
2020-08-01,TTO,Sabah,0,0,0
2020-08-01,TTO,Sarawak,0,0,0
2020-08-01,TTO,Selangor,0,0,0
2020-08-01,TUN,Johor,0,0,0
2020-08-01,TUN,Kedah,0,0,0
2020-08-01,TUN,Kelantan,0,0,0
2020-08-01,TUN,Melaka,0,0,0
2020-08-01,TUN,Perak,0,0,0
2020-08-01,TUN,Perlis,0,0,0
2020-08-01,TUN,Pulau Pinang,0,0,0
2020-08-01,TUN,Sabah,0,0,0
2020-08-01,TUN,Sarawak,0,0,0
2020-08-01,TUN,Selangor,5,4,1
2020-08-01,TUN,W.P. Labuan,0,0,0
2020-08-01,TUR,Johor,0,0,0
2020-08-01,TUR,Kedah,0,0,0
2020-08-01,TUR,Kelantan,0,0,0
2020-08-01,TUR,Melaka,0,0,0
2020-08-01,TUR,Negeri Sembilan,0,0,0
2020-08-01,TUR,Pahang,0,0,0
2020-08-01,TUR,Perak,0,0,0
2020-08-01,TUR,Perlis,0,0,0
2020-08-01,TUR,Pulau Pinang,0,0,0
2020-08-01,TUR,Sabah,0,0,0
2020-08-01,TUR,Sarawak,0,0,0
2020-08-01,TUR,Selangor,27,16,11
2020-08-01,TUR,W.P. Labuan,0,0,0
2020-08-01,TUV,Selangor,0,0,0
2020-08-01,TWN,Johor,0,0,0
2020-08-01,TWN,Kedah,0,0,0
2020-08-01,TWN,Kelantan,0,0,0
2020-08-01,TWN,Melaka,0,0,0
2020-08-01,TWN,Negeri Sembilan,0,0,0
2020-08-01,TWN,Pahang,0,0,0
2020-08-01,TWN,Perak,0,0,0
2020-08-01,TWN,Perlis,0,0,0
2020-08-01,TWN,Pulau Pinang,8,4,4
2020-08-01,TWN,Sabah,0,0,0
2020-08-01,TWN,Sarawak,0,0,0
2020-08-01,TWN,Selangor,68,42,26
2020-08-01,TWN,W.P. Labuan,0,0,0
2020-08-01,TZA,Johor,0,0,0
2020-08-01,TZA,Kedah,0,0,0
2020-08-01,TZA,Perak,0,0,0
2020-08-01,TZA,Perlis,0,0,0
2020-08-01,TZA,Pulau Pinang,0,0,0
2020-08-01,TZA,Sabah,0,0,0
2020-08-01,TZA,Sarawak,0,0,0
2020-08-01,TZA,Selangor,1,1,0
2020-08-01,UGA,Johor,0,0,0
2020-08-01,UGA,Kedah,0,0,0
2020-08-01,UGA,Perak,0,0,0
2020-08-01,UGA,Perlis,0,0,0
2020-08-01,UGA,Pulau Pinang,0,0,0
2020-08-01,UGA,Sabah,0,0,0
2020-08-01,UGA,Sarawak,0,0,0
2020-08-01,UGA,Selangor,0,0,0
2020-08-01,UKR,Johor,18,18,0
2020-08-01,UKR,Kedah,0,0,0
2020-08-01,UKR,Kelantan,0,0,0
2020-08-01,UKR,Melaka,0,0,0
2020-08-01,UKR,Negeri Sembilan,0,0,0
2020-08-01,UKR,Pahang,0,0,0
2020-08-01,UKR,Perak,0,0,0
2020-08-01,UKR,Perlis,0,0,0
2020-08-01,UKR,Pulau Pinang,2,2,0
2020-08-01,UKR,Sabah,0,0,0
2020-08-01,UKR,Sarawak,0,0,0
2020-08-01,UKR,Selangor,82,81,1
2020-08-01,UKR,W.P. Labuan,0,0,0
2020-08-01,URY,Johor,0,0,0
2020-08-01,URY,Kedah,0,0,0
2020-08-01,URY,Kelantan,0,0,0
2020-08-01,URY,Perak,0,0,0
2020-08-01,URY,Perlis,0,0,0
2020-08-01,URY,Pulau Pinang,0,0,0
2020-08-01,URY,Sabah,0,0,0
2020-08-01,URY,Sarawak,0,0,0
2020-08-01,URY,Selangor,0,0,0
2020-08-01,URY,W.P. Labuan,0,0,0
2020-08-01,USA,Johor,0,0,0
2020-08-01,USA,Kedah,0,0,0
2020-08-01,USA,Kelantan,0,0,0
2020-08-01,USA,Melaka,0,0,0
2020-08-01,USA,Negeri Sembilan,0,0,0
2020-08-01,USA,Pahang,0,0,0
2020-08-01,USA,Perak,0,0,0
2020-08-01,USA,Perlis,0,0,0
2020-08-01,USA,Pulau Pinang,0,0,0
2020-08-01,USA,Sabah,0,0,0
2020-08-01,USA,Sarawak,0,0,0
2020-08-01,USA,Selangor,139,87,52
2020-08-01,USA,Terengganu,0,0,0
2020-08-01,USA,W.P. Labuan,0,0,0
2020-08-01,UZB,Johor,0,0,0
2020-08-01,UZB,Kedah,0,0,0
2020-08-01,UZB,Kelantan,0,0,0
2020-08-01,UZB,Perak,0,0,0
2020-08-01,UZB,Perlis,0,0,0
2020-08-01,UZB,Pulau Pinang,0,0,0
2020-08-01,UZB,Sabah,0,0,0
2020-08-01,UZB,Sarawak,0,0,0
2020-08-01,UZB,Selangor,3,3,0
2020-08-01,VAT,Johor,0,0,0
2020-08-01,VAT,Sarawak,0,0,0
2020-08-01,VAT,Selangor,0,0,0
2020-08-01,VCT,Johor,0,0,0
2020-08-01,VCT,Kedah,0,0,0
2020-08-01,VCT,Pulau Pinang,0,0,0
2020-08-01,VCT,Sarawak,0,0,0
2020-08-01,VCT,Selangor,0,0,0
2020-08-01,VEN,Johor,0,0,0
2020-08-01,VEN,Kedah,0,0,0
2020-08-01,VEN,Kelantan,0,0,0
2020-08-01,VEN,Melaka,0,0,0
2020-08-01,VEN,Perak,0,0,0
2020-08-01,VEN,Perlis,0,0,0
2020-08-01,VEN,Pulau Pinang,0,0,0
2020-08-01,VEN,Sabah,0,0,0
2020-08-01,VEN,Sarawak,0,0,0
2020-08-01,VEN,Selangor,0,0,0
2020-08-01,VEN,W.P. Labuan,0,0,0
2020-08-01,VNM,Johor,3,0,3
2020-08-01,VNM,Kedah,0,0,0
2020-08-01,VNM,Kelantan,0,0,0
2020-08-01,VNM,Melaka,0,0,0
2020-08-01,VNM,Negeri Sembilan,0,0,0
2020-08-01,VNM,Pahang,0,0,0
2020-08-01,VNM,Perak,0,0,0
2020-08-01,VNM,Perlis,0,0,0
2020-08-01,VNM,Pulau Pinang,0,0,0
2020-08-01,VNM,Sabah,0,0,0
2020-08-01,VNM,Sarawak,0,0,0
2020-08-01,VNM,Selangor,106,47,59
2020-08-01,VNM,Terengganu,0,0,0
2020-08-01,VNM,W.P. Labuan,0,0,0
2020-08-01,VUT,Johor,0,0,0
2020-08-01,VUT,Kedah,0,0,0
2020-08-01,VUT,Pulau Pinang,0,0,0
2020-08-01,VUT,Sabah,0,0,0
2020-08-01,VUT,Sarawak,0,0,0
2020-08-01,VUT,Selangor,0,0,0
2020-08-01,WSM,Johor,0,0,0
2020-08-01,WSM,Sarawak,0,0,0
2020-08-01,WSM,Selangor,0,0,0
2020-08-01,XXX,Johor,0,0,0
2020-08-01,XXX,Kedah,0,0,0
2020-08-01,XXX,Kelantan,0,0,0
2020-08-01,XXX,Melaka,0,0,0
2020-08-01,XXX,Pahang,0,0,0
2020-08-01,XXX,Perak,0,0,0
2020-08-01,XXX,Perlis,0,0,0
2020-08-01,XXX,Pulau Pinang,0,0,0
2020-08-01,XXX,Sabah,0,0,0
2020-08-01,XXX,Sarawak,0,0,0
2020-08-01,XXX,Selangor,20,14,6
2020-08-01,XXX,W.P. Labuan,0,0,0
2020-08-01,YEM,Johor,0,0,0
2020-08-01,YEM,Kedah,0,0,0
2020-08-01,YEM,Kelantan,0,0,0
2020-08-01,YEM,Melaka,0,0,0
2020-08-01,YEM,Pahang,0,0,0
2020-08-01,YEM,Perak,0,0,0
2020-08-01,YEM,Perlis,0,0,0
2020-08-01,YEM,Pulau Pinang,0,0,0
2020-08-01,YEM,Sabah,1,1,0
2020-08-01,YEM,Sarawak,0,0,0
2020-08-01,YEM,Selangor,13,11,2
2020-08-01,YEM,W.P. Labuan,0,0,0
2020-08-01,ZAF,Johor,0,0,0
2020-08-01,ZAF,Kedah,0,0,0
2020-08-01,ZAF,Kelantan,0,0,0
2020-08-01,ZAF,Melaka,0,0,0
2020-08-01,ZAF,Pahang,0,0,0
2020-08-01,ZAF,Perak,0,0,0
2020-08-01,ZAF,Perlis,0,0,0
2020-08-01,ZAF,Pulau Pinang,0,0,0
2020-08-01,ZAF,Sabah,0,0,0
2020-08-01,ZAF,Sarawak,0,0,0
2020-08-01,ZAF,Selangor,16,11,5
2020-08-01,ZAF,Terengganu,0,0,0
2020-08-01,ZAF,W.P. Labuan,0,0,0
2020-08-01,ZAR,Selangor,0,0,0
2020-08-01,ZMB,Johor,0,0,0
2020-08-01,ZMB,Kedah,0,0,0
2020-08-01,ZMB,Perak,0,0,0
2020-08-01,ZMB,Perlis,0,0,0
2020-08-01,ZMB,Pulau Pinang,0,0,0
2020-08-01,ZMB,Sabah,0,0,0
2020-08-01,ZMB,Sarawak,1,1,0
2020-08-01,ZMB,Selangor,2,1,1
2020-08-01,ZWE,Johor,0,0,0
2020-08-01,ZWE,Kedah,0,0,0
2020-08-01,ZWE,Kelantan,0,0,0
2020-08-01,ZWE,Perak,0,0,0
2020-08-01,ZWE,Perlis,0,0,0
2020-08-01,ZWE,Pulau Pinang,0,0,0
2020-08-01,ZWE,Sabah,0,0,0
2020-08-01,ZWE,Sarawak,0,0,0
2020-08-01,ZWE,Selangor,1,0,1
2020-09-01,ABW,Kedah,0,0,0
2020-09-01,ABW,Pulau Pinang,0,0,0
2020-09-01,AFG,Johor,0,0,0
2020-09-01,AFG,Kedah,0,0,0
2020-09-01,AFG,Perlis,0,0,0
2020-09-01,AFG,Pulau Pinang,0,0,0
2020-09-01,AFG,Sarawak,0,0,0
2020-09-01,AFG,Selangor,12,7,5
2020-09-01,AGO,Johor,0,0,0
2020-09-01,AGO,Kedah,0,0,0
2020-09-01,AGO,Sabah,0,0,0
2020-09-01,AGO,Selangor,0,0,0
2020-09-01,AIA,Selangor,0,0,0
2020-09-01,ALB,Johor,0,0,0
2020-09-01,ALB,Kedah,0,0,0
2020-09-01,ALB,Perak,0,0,0
2020-09-01,ALB,Perlis,0,0,0
2020-09-01,ALB,Pulau Pinang,0,0,0
2020-09-01,ALB,Sabah,0,0,0
2020-09-01,ALB,Sarawak,0,0,0
2020-09-01,ALB,Selangor,0,0,0
2020-09-01,AND,Johor,0,0,0
2020-09-01,AND,Kedah,0,0,0
2020-09-01,AND,Perlis,0,0,0
2020-09-01,AND,Pulau Pinang,0,0,0
2020-09-01,AND,Selangor,0,0,0
2020-09-01,ANT,Selangor,0,0,0
2020-09-01,ARE,Johor,0,0,0
2020-09-01,ARE,Kedah,0,0,0
2020-09-01,ARE,Kelantan,0,0,0
2020-09-01,ARE,Perak,0,0,0
2020-09-01,ARE,Perlis,0,0,0
2020-09-01,ARE,Pulau Pinang,0,0,0
2020-09-01,ARE,Sabah,0,0,0
2020-09-01,ARE,Sarawak,0,0,0
2020-09-01,ARE,Selangor,1,0,1
2020-09-01,ARG,Johor,1,1,0
2020-09-01,ARG,Kedah,0,0,0
2020-09-01,ARG,Kelantan,0,0,0
2020-09-01,ARG,Melaka,0,0,0
2020-09-01,ARG,Perak,0,0,0
2020-09-01,ARG,Perlis,0,0,0
2020-09-01,ARG,Pulau Pinang,0,0,0
2020-09-01,ARG,Sabah,0,0,0
2020-09-01,ARG,Sarawak,0,0,0
2020-09-01,ARG,Selangor,0,0,0
2020-09-01,ARG,W.P. Labuan,0,0,0
2020-09-01,ARM,Johor,0,0,0
2020-09-01,ARM,Kedah,0,0,0
2020-09-01,ARM,Kelantan,0,0,0
2020-09-01,ARM,Perak,0,0,0
2020-09-01,ARM,Perlis,0,0,0
2020-09-01,ARM,Pulau Pinang,0,0,0
2020-09-01,ARM,Sabah,0,0,0
2020-09-01,ARM,Sarawak,0,0,0
2020-09-01,ARM,Selangor,0,0,0
2020-09-01,ATA,Selangor,0,0,0
2020-09-01,ATG,Johor,0,0,0
2020-09-01,ATG,Kedah,0,0,0
2020-09-01,ATG,Pulau Pinang,0,0,0
2020-09-01,ATG,Sarawak,0,0,0
2020-09-01,ATG,Selangor,0,0,0
2020-09-01,AUS,Johor,5,5,0
2020-09-01,AUS,Kedah,0,0,0
2020-09-01,AUS,Kelantan,0,0,0
2020-09-01,AUS,Melaka,0,0,0
2020-09-01,AUS,Negeri Sembilan,0,0,0
2020-09-01,AUS,Pahang,0,0,0
2020-09-01,AUS,Perak,0,0,0
2020-09-01,AUS,Perlis,0,0,0
2020-09-01,AUS,Pulau Pinang,1,1,0
2020-09-01,AUS,Sabah,0,0,0
2020-09-01,AUS,Sarawak,0,0,0
2020-09-01,AUS,Selangor,129,96,33
2020-09-01,AUS,Terengganu,0,0,0
2020-09-01,AUS,W.P. Labuan,0,0,0
2020-09-01,AUT,Johor,0,0,0
2020-09-01,AUT,Kedah,0,0,0
2020-09-01,AUT,Kelantan,0,0,0
2020-09-01,AUT,Melaka,0,0,0
2020-09-01,AUT,Negeri Sembilan,0,0,0
2020-09-01,AUT,Pahang,0,0,0
2020-09-01,AUT,Perak,0,0,0
2020-09-01,AUT,Perlis,0,0,0
2020-09-01,AUT,Pulau Pinang,0,0,0
2020-09-01,AUT,Sabah,0,0,0
2020-09-01,AUT,Sarawak,0,0,0
2020-09-01,AUT,Selangor,11,8,3
2020-09-01,AUT,Terengganu,0,0,0
2020-09-01,AUT,W.P. Labuan,0,0,0
2020-09-01,AZE,Johor,0,0,0
2020-09-01,AZE,Kedah,0,0,0
2020-09-01,AZE,Kelantan,0,0,0
2020-09-01,AZE,Melaka,0,0,0
2020-09-01,AZE,Perlis,0,0,0
2020-09-01,AZE,Pulau Pinang,0,0,0
2020-09-01,AZE,Sabah,0,0,0
2020-09-01,AZE,Sarawak,0,0,0
2020-09-01,AZE,Selangor,2,1,1
2020-09-01,AZE,W.P. Labuan,0,0,0
2020-09-01,BDI,Pulau Pinang,0,0,0
2020-09-01,BDI,Sarawak,0,0,0
2020-09-01,BDI,Selangor,0,0,0
2020-09-01,BEL,Johor,1,1,0
2020-09-01,BEL,Kedah,0,0,0
2020-09-01,BEL,Kelantan,0,0,0
2020-09-01,BEL,Melaka,0,0,0
2020-09-01,BEL,Negeri Sembilan,0,0,0
2020-09-01,BEL,Pahang,0,0,0
2020-09-01,BEL,Perak,0,0,0
2020-09-01,BEL,Perlis,0,0,0
2020-09-01,BEL,Pulau Pinang,1,1,0
2020-09-01,BEL,Sabah,0,0,0
2020-09-01,BEL,Sarawak,0,0,0
2020-09-01,BEL,Selangor,19,15,4
2020-09-01,BEL,W.P. Labuan,0,0,0
2020-09-01,BEN,Johor,0,0,0
2020-09-01,BEN,Kedah,0,0,0
2020-09-01,BEN,Perak,0,0,0
2020-09-01,BEN,Pulau Pinang,0,0,0
2020-09-01,BEN,Sabah,0,0,0
2020-09-01,BEN,Sarawak,0,0,0
2020-09-01,BEN,Selangor,0,0,0
2020-09-01,BFA,Perak,0,0,0
2020-09-01,BFA,Pulau Pinang,0,0,0
2020-09-01,BFA,Selangor,0,0,0
2020-09-01,BGD,Johor,6,6,0
2020-09-01,BGD,Kedah,0,0,0
2020-09-01,BGD,Kelantan,0,0,0
2020-09-01,BGD,Melaka,0,0,0
2020-09-01,BGD,Negeri Sembilan,0,0,0
2020-09-01,BGD,Pahang,0,0,0
2020-09-01,BGD,Perak,0,0,0
2020-09-01,BGD,Perlis,0,0,0
2020-09-01,BGD,Pulau Pinang,0,0,0
2020-09-01,BGD,Sabah,0,0,0
2020-09-01,BGD,Sarawak,2,2,0
2020-09-01,BGD,Selangor,143,100,43
2020-09-01,BGD,W.P. Labuan,0,0,0
2020-09-01,BGR,Johor,4,4,0
2020-09-01,BGR,Kedah,0,0,0
2020-09-01,BGR,Kelantan,0,0,0
2020-09-01,BGR,Pahang,0,0,0
2020-09-01,BGR,Perak,0,0,0
2020-09-01,BGR,Perlis,0,0,0
2020-09-01,BGR,Pulau Pinang,0,0,0
2020-09-01,BGR,Sabah,0,0,0
2020-09-01,BGR,Sarawak,1,1,0
2020-09-01,BGR,Selangor,15,14,1
2020-09-01,BGR,W.P. Labuan,0,0,0
2020-09-01,BHR,Johor,0,0,0
2020-09-01,BHR,Kedah,0,0,0
2020-09-01,BHR,Kelantan,0,0,0
2020-09-01,BHR,Perlis,0,0,0
2020-09-01,BHR,Pulau Pinang,0,0,0
2020-09-01,BHR,Sabah,0,0,0
2020-09-01,BHR,Sarawak,0,0,0
2020-09-01,BHR,Selangor,3,1,2
2020-09-01,BHS,Johor,0,0,0
2020-09-01,BHS,Kedah,0,0,0
2020-09-01,BHS,Perak,0,0,0
2020-09-01,BHS,Sabah,0,0,0
2020-09-01,BHS,Sarawak,0,0,0
2020-09-01,BHS,Selangor,0,0,0
2020-09-01,BIH,Johor,0,0,0
2020-09-01,BIH,Kedah,0,0,0
2020-09-01,BIH,Perlis,0,0,0
2020-09-01,BIH,Pulau Pinang,0,0,0
2020-09-01,BIH,Sabah,0,0,0
2020-09-01,BIH,Sarawak,0,0,0
2020-09-01,BIH,Selangor,1,0,1
2020-09-01,BLR,Johor,0,0,0
2020-09-01,BLR,Kedah,0,0,0
2020-09-01,BLR,Kelantan,0,0,0
2020-09-01,BLR,Pahang,0,0,0
2020-09-01,BLR,Perak,0,0,0
2020-09-01,BLR,Perlis,0,0,0
2020-09-01,BLR,Pulau Pinang,0,0,0
2020-09-01,BLR,Sabah,0,0,0
2020-09-01,BLR,Sarawak,0,0,0
2020-09-01,BLR,Selangor,0,0,0
2020-09-01,BLR,W.P. Labuan,0,0,0
2020-09-01,BLZ,Johor,0,0,0
2020-09-01,BLZ,Pulau Pinang,0,0,0
2020-09-01,BLZ,Sarawak,0,0,0
2020-09-01,BLZ,Selangor,0,0,0
2020-09-01,BMU,Selangor,0,0,0
2020-09-01,BOL,Johor,0,0,0
2020-09-01,BOL,Kedah,0,0,0
2020-09-01,BOL,Melaka,0,0,0
2020-09-01,BOL,Perak,0,0,0
2020-09-01,BOL,Perlis,0,0,0
2020-09-01,BOL,Pulau Pinang,0,0,0
2020-09-01,BOL,Sabah,0,0,0
2020-09-01,BOL,Sarawak,0,0,0
2020-09-01,BOL,Selangor,2,1,1
2020-09-01,BRA,Johor,0,0,0
2020-09-01,BRA,Kedah,0,0,0
2020-09-01,BRA,Kelantan,0,0,0
2020-09-01,BRA,Melaka,0,0,0
2020-09-01,BRA,Pahang,0,0,0
2020-09-01,BRA,Perak,0,0,0
2020-09-01,BRA,Perlis,0,0,0
2020-09-01,BRA,Pulau Pinang,0,0,0
2020-09-01,BRA,Sabah,0,0,0
2020-09-01,BRA,Sarawak,0,0,0
2020-09-01,BRA,Selangor,5,5,0
2020-09-01,BRA,W.P. Labuan,0,0,0
2020-09-01,BRB,Johor,0,0,0
2020-09-01,BRB,Kedah,0,0,0
2020-09-01,BRB,Perlis,0,0,0
2020-09-01,BRB,Pulau Pinang,0,0,0
2020-09-01,BRB,Selangor,0,0,0
2020-09-01,BRN,Johor,0,0,0
2020-09-01,BRN,Kedah,0,0,0
2020-09-01,BRN,Kelantan,0,0,0
2020-09-01,BRN,Melaka,0,0,0
2020-09-01,BRN,Pahang,0,0,0
2020-09-01,BRN,Perak,0,0,0
2020-09-01,BRN,Perlis,0,0,0
2020-09-01,BRN,Pulau Pinang,0,0,0
2020-09-01,BRN,Sabah,1,1,0
2020-09-01,BRN,Sarawak,323,315,8
2020-09-01,BRN,Selangor,71,47,24
2020-09-01,BRN,W.P. Labuan,1,1,0
2020-09-01,BTN,Johor,0,0,0
2020-09-01,BTN,Kedah,0,0,0
2020-09-01,BTN,Perak,0,0,0
2020-09-01,BTN,Perlis,0,0,0
2020-09-01,BTN,Pulau Pinang,0,0,0
2020-09-01,BTN,Sabah,0,0,0
2020-09-01,BTN,Sarawak,0,0,0
2020-09-01,BTN,Selangor,0,0,0
2020-09-01,BWA,Johor,0,0,0
2020-09-01,BWA,Kedah,0,0,0
2020-09-01,BWA,Perlis,0,0,0
2020-09-01,BWA,Pulau Pinang,0,0,0
2020-09-01,BWA,Sabah,0,0,0
2020-09-01,BWA,Sarawak,0,0,0
2020-09-01,BWA,Selangor,0,0,0
2020-09-01,CAF,Kedah,0,0,0
2020-09-01,CAF,Selangor,0,0,0
2020-09-01,CAN,Johor,0,0,0
2020-09-01,CAN,Kedah,0,0,0
2020-09-01,CAN,Kelantan,0,0,0
2020-09-01,CAN,Melaka,0,0,0
2020-09-01,CAN,Negeri Sembilan,0,0,0
2020-09-01,CAN,Pahang,0,0,0
2020-09-01,CAN,Perak,0,0,0
2020-09-01,CAN,Perlis,0,0,0
2020-09-01,CAN,Pulau Pinang,0,0,0
2020-09-01,CAN,Sabah,0,0,0
2020-09-01,CAN,Sarawak,0,0,0
2020-09-01,CAN,Selangor,70,47,23
2020-09-01,CAN,Terengganu,0,0,0
2020-09-01,CAN,W.P. Labuan,0,0,0
2020-09-01,CCK,Selangor,0,0,0
2020-09-01,CHE,Johor,2,1,1
2020-09-01,CHE,Kedah,0,0,0
2020-09-01,CHE,Kelantan,0,0,0
2020-09-01,CHE,Melaka,0,0,0
2020-09-01,CHE,Negeri Sembilan,0,0,0
2020-09-01,CHE,Pahang,0,0,0
2020-09-01,CHE,Perak,0,0,0
2020-09-01,CHE,Perlis,0,0,0
2020-09-01,CHE,Pulau Pinang,0,0,0
2020-09-01,CHE,Sabah,1,1,0
2020-09-01,CHE,Sarawak,0,0,0
2020-09-01,CHE,Selangor,14,12,2
2020-09-01,CHE,W.P. Labuan,0,0,0
2020-09-01,CHL,Johor,0,0,0
2020-09-01,CHL,Kedah,0,0,0
2020-09-01,CHL,Kelantan,0,0,0
2020-09-01,CHL,Melaka,0,0,0
2020-09-01,CHL,Pahang,0,0,0
2020-09-01,CHL,Perak,0,0,0
2020-09-01,CHL,Perlis,0,0,0
2020-09-01,CHL,Pulau Pinang,0,0,0
2020-09-01,CHL,Sabah,0,0,0
2020-09-01,CHL,Sarawak,0,0,0
2020-09-01,CHL,Selangor,1,0,1
2020-09-01,CHN,Johor,37,32,5
2020-09-01,CHN,Kedah,0,0,0
2020-09-01,CHN,Kelantan,0,0,0
2020-09-01,CHN,Melaka,0,0,0
2020-09-01,CHN,Pahang,0,0,0
2020-09-01,CHN,Perak,0,0,0
2020-09-01,CHN,Perlis,0,0,0
2020-09-01,CHN,Pulau Pinang,0,0,0
2020-09-01,CHN,Sabah,0,0,0
2020-09-01,CHN,Sarawak,33,19,14
2020-09-01,CHN,Selangor,793,549,244
2020-09-01,CHN,Terengganu,0,0,0
2020-09-01,CHN,W.P. Labuan,1,0,1
2020-09-01,CIV,Johor,0,0,0
2020-09-01,CIV,Kedah,0,0,0
2020-09-01,CIV,Pulau Pinang,0,0,0
2020-09-01,CIV,Sabah,0,0,0
2020-09-01,CIV,Sarawak,0,0,0
2020-09-01,CIV,Selangor,1,1,0
2020-09-01,CMR,Johor,0,0,0
2020-09-01,CMR,Kedah,0,0,0
2020-09-01,CMR,Pulau Pinang,0,0,0
2020-09-01,CMR,Sabah,0,0,0
2020-09-01,CMR,Sarawak,0,0,0
2020-09-01,CMR,Selangor,0,0,0
2020-09-01,COD,Johor,0,0,0
2020-09-01,COD,Pulau Pinang,0,0,0
2020-09-01,COD,Sarawak,0,0,0
2020-09-01,COD,Selangor,0,0,0
2020-09-01,COG,Johor,0,0,0
2020-09-01,COG,Kedah,0,0,0
2020-09-01,COG,Selangor,0,0,0
2020-09-01,COK,Selangor,0,0,0
2020-09-01,COL,Johor,0,0,0
2020-09-01,COL,Kedah,0,0,0
2020-09-01,COL,Perak,0,0,0
2020-09-01,COL,Pulau Pinang,0,0,0
2020-09-01,COL,Sabah,0,0,0
2020-09-01,COL,Sarawak,0,0,0
2020-09-01,COL,Selangor,0,0,0
2020-09-01,COL,W.P. Labuan,0,0,0
2020-09-01,COM,Johor,0,0,0
2020-09-01,COM,Kedah,0,0,0
2020-09-01,COM,Selangor,0,0,0
2020-09-01,CPV,Johor,0,0,0
2020-09-01,CPV,Kedah,0,0,0
2020-09-01,CPV,Pulau Pinang,0,0,0
2020-09-01,CPV,Sabah,0,0,0
2020-09-01,CPV,Selangor,0,0,0
2020-09-01,CRI,Johor,0,0,0
2020-09-01,CRI,Kedah,0,0,0
2020-09-01,CRI,Perak,0,0,0
2020-09-01,CRI,Perlis,0,0,0
2020-09-01,CRI,Pulau Pinang,0,0,0
2020-09-01,CRI,Sabah,0,0,0
2020-09-01,CRI,Sarawak,0,0,0
2020-09-01,CRI,Selangor,0,0,0
2020-09-01,CUB,Johor,0,0,0
2020-09-01,CUB,Kedah,0,0,0
2020-09-01,CUB,Perlis,0,0,0
2020-09-01,CUB,Pulau Pinang,0,0,0
2020-09-01,CUB,Sabah,0,0,0
2020-09-01,CUB,Sarawak,0,0,0
2020-09-01,CUB,Selangor,0,0,0
2020-09-01,CYP,Johor,0,0,0
2020-09-01,CYP,Kedah,0,0,0
2020-09-01,CYP,Perak,0,0,0
2020-09-01,CYP,Perlis,0,0,0
2020-09-01,CYP,Pulau Pinang,0,0,0
2020-09-01,CYP,Sabah,0,0,0
2020-09-01,CYP,Sarawak,0,0,0
2020-09-01,CYP,Selangor,1,1,0
2020-09-01,CZE,Johor,0,0,0
2020-09-01,CZE,Kedah,0,0,0
2020-09-01,CZE,Kelantan,0,0,0
2020-09-01,CZE,Melaka,0,0,0
2020-09-01,CZE,Negeri Sembilan,0,0,0
2020-09-01,CZE,Perak,0,0,0
2020-09-01,CZE,Perlis,0,0,0
2020-09-01,CZE,Pulau Pinang,0,0,0
2020-09-01,CZE,Sabah,0,0,0
2020-09-01,CZE,Sarawak,0,0,0
2020-09-01,CZE,Selangor,24,19,5
2020-09-01,CZE,W.P. Labuan,0,0,0
2020-09-01,DEU,Johor,2,2,0
2020-09-01,DEU,Kedah,0,0,0
2020-09-01,DEU,Kelantan,0,0,0
2020-09-01,DEU,Melaka,0,0,0
2020-09-01,DEU,Negeri Sembilan,0,0,0
2020-09-01,DEU,Pahang,0,0,0
2020-09-01,DEU,Perak,0,0,0
2020-09-01,DEU,Perlis,0,0,0
2020-09-01,DEU,Pulau Pinang,0,0,0
2020-09-01,DEU,Sabah,0,0,0
2020-09-01,DEU,Sarawak,0,0,0
2020-09-01,DEU,Selangor,71,57,14
2020-09-01,DEU,Terengganu,0,0,0
2020-09-01,DEU,W.P. Labuan,0,0,0
2020-09-01,DJI,Johor,0,0,0
2020-09-01,DJI,Selangor,0,0,0
2020-09-01,DMA,Johor,0,0,0
2020-09-01,DMA,Kedah,0,0,0
2020-09-01,DMA,Pulau Pinang,0,0,0
2020-09-01,DMA,Sabah,0,0,0
2020-09-01,DMA,Sarawak,0,0,0
2020-09-01,DMA,Selangor,0,0,0
2020-09-01,DMA,W.P. Labuan,0,0,0
2020-09-01,DNK,Johor,2,2,0
2020-09-01,DNK,Kedah,0,0,0
2020-09-01,DNK,Kelantan,0,0,0
2020-09-01,DNK,Melaka,0,0,0
2020-09-01,DNK,Negeri Sembilan,0,0,0
2020-09-01,DNK,Pahang,0,0,0
2020-09-01,DNK,Perak,0,0,0
2020-09-01,DNK,Perlis,0,0,0
2020-09-01,DNK,Pulau Pinang,0,0,0
2020-09-01,DNK,Sabah,0,0,0
2020-09-01,DNK,Sarawak,0,0,0
2020-09-01,DNK,Selangor,17,13,4
2020-09-01,DNK,W.P. Labuan,0,0,0
2020-09-01,DOM,Johor,0,0,0
2020-09-01,DOM,Kedah,0,0,0
2020-09-01,DOM,Perak,0,0,0
2020-09-01,DOM,Perlis,0,0,0
2020-09-01,DOM,Pulau Pinang,0,0,0
2020-09-01,DOM,Sabah,0,0,0
2020-09-01,DOM,Sarawak,0,0,0
2020-09-01,DOM,Selangor,0,0,0
2020-09-01,DZA,Johor,0,0,0
2020-09-01,DZA,Kedah,0,0,0
2020-09-01,DZA,Kelantan,0,0,0
2020-09-01,DZA,Melaka,0,0,0
2020-09-01,DZA,Perak,0,0,0
2020-09-01,DZA,Perlis,0,0,0
2020-09-01,DZA,Pulau Pinang,0,0,0
2020-09-01,DZA,Sabah,0,0,0
2020-09-01,DZA,Sarawak,0,0,0
2020-09-01,DZA,Selangor,2,2,0
2020-09-01,DZA,W.P. Labuan,0,0,0
2020-09-01,ECU,Johor,0,0,0
2020-09-01,ECU,Kedah,0,0,0
2020-09-01,ECU,Perak,0,0,0
2020-09-01,ECU,Perlis,0,0,0
2020-09-01,ECU,Pulau Pinang,0,0,0
2020-09-01,ECU,Sabah,0,0,0
2020-09-01,ECU,Sarawak,0,0,0
2020-09-01,ECU,Selangor,0,0,0
2020-09-01,EGY,Johor,0,0,0
2020-09-01,EGY,Kedah,0,0,0
2020-09-01,EGY,Kelantan,0,0,0
2020-09-01,EGY,Melaka,0,0,0
2020-09-01,EGY,Pahang,0,0,0
2020-09-01,EGY,Perak,0,0,0
2020-09-01,EGY,Perlis,0,0,0
2020-09-01,EGY,Pulau Pinang,0,0,0
2020-09-01,EGY,Sabah,0,0,0
2020-09-01,EGY,Sarawak,0,0,0
2020-09-01,EGY,Selangor,35,28,7
2020-09-01,EGY,Terengganu,0,0,0
2020-09-01,EGY,W.P. Labuan,0,0,0
2020-09-01,ERI,Johor,0,0,0
2020-09-01,ERI,Pulau Pinang,0,0,0
2020-09-01,ERI,Sabah,0,0,0
2020-09-01,ERI,Selangor,0,0,0
2020-09-01,ESP,Johor,0,0,0
2020-09-01,ESP,Kedah,0,0,0
2020-09-01,ESP,Kelantan,0,0,0
2020-09-01,ESP,Melaka,0,0,0
2020-09-01,ESP,Negeri Sembilan,0,0,0
2020-09-01,ESP,Pahang,0,0,0
2020-09-01,ESP,Perak,0,0,0
2020-09-01,ESP,Perlis,0,0,0
2020-09-01,ESP,Pulau Pinang,0,0,0
2020-09-01,ESP,Sabah,0,0,0
2020-09-01,ESP,Sarawak,0,0,0
2020-09-01,ESP,Selangor,8,5,3
2020-09-01,ESP,W.P. Labuan,0,0,0
2020-09-01,EST,Johor,0,0,0
2020-09-01,EST,Kedah,0,0,0
2020-09-01,EST,Kelantan,0,0,0
2020-09-01,EST,Pahang,0,0,0
2020-09-01,EST,Perak,0,0,0
2020-09-01,EST,Perlis,0,0,0
2020-09-01,EST,Pulau Pinang,0,0,0
2020-09-01,EST,Sabah,0,0,0
2020-09-01,EST,Sarawak,0,0,0
2020-09-01,EST,Selangor,0,0,0
2020-09-01,EST,W.P. Labuan,0,0,0
2020-09-01,ETH,Johor,0,0,0
2020-09-01,ETH,Kedah,0,0,0
2020-09-01,ETH,Pulau Pinang,0,0,0
2020-09-01,ETH,Sarawak,0,0,0
2020-09-01,ETH,Selangor,1,1,0
2020-09-01,FIN,Johor,0,0,0
2020-09-01,FIN,Kedah,0,0,0
2020-09-01,FIN,Kelantan,0,0,0
2020-09-01,FIN,Melaka,0,0,0
2020-09-01,FIN,Negeri Sembilan,0,0,0
2020-09-01,FIN,Pahang,0,0,0
2020-09-01,FIN,Perak,0,0,0
2020-09-01,FIN,Perlis,0,0,0
2020-09-01,FIN,Pulau Pinang,0,0,0
2020-09-01,FIN,Sabah,0,0,0
2020-09-01,FIN,Sarawak,0,0,0
2020-09-01,FIN,Selangor,8,4,4
2020-09-01,FIN,W.P. Labuan,0,0,0
2020-09-01,FJI,Johor,0,0,0
2020-09-01,FJI,Kedah,0,0,0
2020-09-01,FJI,Kelantan,0,0,0
2020-09-01,FJI,Perak,0,0,0
2020-09-01,FJI,Perlis,0,0,0
2020-09-01,FJI,Pulau Pinang,0,0,0
2020-09-01,FJI,Sabah,0,0,0
2020-09-01,FJI,Sarawak,0,0,0
2020-09-01,FJI,Selangor,0,0,0
2020-09-01,FRA,Johor,5,5,0
2020-09-01,FRA,Kedah,0,0,0
2020-09-01,FRA,Kelantan,0,0,0
2020-09-01,FRA,Melaka,0,0,0
2020-09-01,FRA,Negeri Sembilan,0,0,0
2020-09-01,FRA,Pahang,0,0,0
2020-09-01,FRA,Perak,0,0,0
2020-09-01,FRA,Perlis,0,0,0
2020-09-01,FRA,Pulau Pinang,0,0,0
2020-09-01,FRA,Sabah,0,0,0
2020-09-01,FRA,Sarawak,0,0,0
2020-09-01,FRA,Selangor,82,55,27
2020-09-01,FRA,Terengganu,0,0,0
2020-09-01,FRA,W.P. Labuan,0,0,0
2020-09-01,FSM,Johor,0,0,0
2020-09-01,FSM,Pulau Pinang,0,0,0
2020-09-01,FSM,Selangor,0,0,0
2020-09-01,GAB,Johor,0,0,0
2020-09-01,GAB,Pulau Pinang,0,0,0
2020-09-01,GAB,Sarawak,0,0,0
2020-09-01,GAB,Selangor,0,0,0
2020-09-01,GBR,Johor,6,6,0
2020-09-01,GBR,Kedah,0,0,0
2020-09-01,GBR,Kelantan,0,0,0
2020-09-01,GBR,Melaka,0,0,0
2020-09-01,GBR,Negeri Sembilan,0,0,0
2020-09-01,GBR,Pahang,0,0,0
2020-09-01,GBR,Perak,0,0,0
2020-09-01,GBR,Perlis,0,0,0
2020-09-01,GBR,Pulau Pinang,0,0,0
2020-09-01,GBR,Sabah,0,0,0
2020-09-01,GBR,Sarawak,2,2,0
2020-09-01,GBR,Selangor,238,184,54
2020-09-01,GBR,Terengganu,0,0,0
2020-09-01,GBR,W.P. Labuan,0,0,0
2020-09-01,GEO,Johor,0,0,0
2020-09-01,GEO,Kedah,0,0,0
2020-09-01,GEO,Melaka,0,0,0
2020-09-01,GEO,Perak,0,0,0
2020-09-01,GEO,Perlis,0,0,0
2020-09-01,GEO,Pulau Pinang,0,0,0
2020-09-01,GEO,Sabah,0,0,0
2020-09-01,GEO,Sarawak,0,0,0
2020-09-01,GEO,Selangor,7,7,0
2020-09-01,GHA,Johor,0,0,0
2020-09-01,GHA,Kedah,0,0,0
2020-09-01,GHA,Kelantan,0,0,0
2020-09-01,GHA,Pulau Pinang,0,0,0
2020-09-01,GHA,Sabah,0,0,0
2020-09-01,GHA,Sarawak,0,0,0
2020-09-01,GHA,Selangor,5,0,5
2020-09-01,GIB,Johor,0,0,0
2020-09-01,GIB,Sarawak,0,0,0
2020-09-01,GIN,Johor,0,0,0
2020-09-01,GIN,Kedah,0,0,0
2020-09-01,GIN,Kelantan,0,0,0
2020-09-01,GIN,Perlis,0,0,0
2020-09-01,GIN,Pulau Pinang,0,0,0
2020-09-01,GIN,Sabah,0,0,0
2020-09-01,GIN,Sarawak,0,0,0
2020-09-01,GIN,Selangor,1,1,0
2020-09-01,GLP,Selangor,0,0,0
2020-09-01,GMB,Johor,0,0,0
2020-09-01,GMB,Kedah,0,0,0
2020-09-01,GMB,Kelantan,0,0,0
2020-09-01,GMB,Pulau Pinang,0,0,0
2020-09-01,GMB,Sabah,0,0,0
2020-09-01,GMB,Sarawak,0,0,0
2020-09-01,GMB,Selangor,0,0,0
2020-09-01,GNB,Johor,0,0,0
2020-09-01,GNB,Selangor,0,0,0
2020-09-01,GNQ,Johor,0,0,0
2020-09-01,GNQ,Selangor,0,0,0
2020-09-01,GRC,Johor,0,0,0
2020-09-01,GRC,Kedah,0,0,0
2020-09-01,GRC,Kelantan,0,0,0
2020-09-01,GRC,Melaka,0,0,0
2020-09-01,GRC,Negeri Sembilan,0,0,0
2020-09-01,GRC,Pahang,0,0,0
2020-09-01,GRC,Perak,0,0,0
2020-09-01,GRC,Perlis,0,0,0
2020-09-01,GRC,Pulau Pinang,0,0,0
2020-09-01,GRC,Sabah,0,0,0
2020-09-01,GRC,Sarawak,0,0,0
2020-09-01,GRC,Selangor,7,6,1
2020-09-01,GRD,Johor,0,0,0
2020-09-01,GRD,Kedah,0,0,0
2020-09-01,GRD,Pulau Pinang,0,0,0
2020-09-01,GRD,Sabah,0,0,0
2020-09-01,GRD,Sarawak,0,0,0
2020-09-01,GRD,Selangor,0,0,0
2020-09-01,GRL,Johor,0,0,0
2020-09-01,GRL,Selangor,0,0,0
2020-09-01,GTM,Johor,0,0,0
2020-09-01,GTM,Kedah,0,0,0
2020-09-01,GTM,Pahang,0,0,0
2020-09-01,GTM,Perak,0,0,0
2020-09-01,GTM,Pulau Pinang,0,0,0
2020-09-01,GTM,Sabah,0,0,0
2020-09-01,GTM,Sarawak,0,0,0
2020-09-01,GTM,Selangor,0,0,0
2020-09-01,GTM,W.P. Labuan,0,0,0
2020-09-01,GUY,Johor,0,0,0
2020-09-01,GUY,Kedah,0,0,0
2020-09-01,GUY,Pulau Pinang,0,0,0
2020-09-01,GUY,Sarawak,0,0,0
2020-09-01,GUY,Selangor,0,0,0
2020-09-01,HKG,Johor,0,0,0
2020-09-01,HKG,Kedah,0,0,0
2020-09-01,HKG,Kelantan,0,0,0
2020-09-01,HKG,Pahang,0,0,0
2020-09-01,HKG,Perak,0,0,0
2020-09-01,HKG,Perlis,0,0,0
2020-09-01,HKG,Pulau Pinang,0,0,0
2020-09-01,HKG,Sabah,0,0,0
2020-09-01,HKG,Sarawak,0,0,0
2020-09-01,HKG,Selangor,0,0,0
2020-09-01,HKG,Terengganu,0,0,0
2020-09-01,HMD,Johor,0,0,0
2020-09-01,HND,Johor,0,0,0
2020-09-01,HND,Kedah,0,0,0
2020-09-01,HND,Perak,0,0,0
2020-09-01,HND,Pulau Pinang,0,0,0
2020-09-01,HND,Sabah,0,0,0
2020-09-01,HND,Sarawak,0,0,0
2020-09-01,HND,Selangor,0,0,0
2020-09-01,HRV,Johor,2,2,0
2020-09-01,HRV,Kedah,0,0,0
2020-09-01,HRV,Kelantan,0,0,0
2020-09-01,HRV,Melaka,0,0,0
2020-09-01,HRV,Pahang,0,0,0
2020-09-01,HRV,Perak,0,0,0
2020-09-01,HRV,Perlis,0,0,0
2020-09-01,HRV,Pulau Pinang,0,0,0
2020-09-01,HRV,Sabah,0,0,0
2020-09-01,HRV,Sarawak,0,0,0
2020-09-01,HRV,Selangor,11,9,2
2020-09-01,HTI,Johor,0,0,0
2020-09-01,HTI,Kedah,0,0,0
2020-09-01,HTI,Kelantan,0,0,0
2020-09-01,HTI,Perak,0,0,0
2020-09-01,HTI,Pulau Pinang,0,0,0
2020-09-01,HTI,Sabah,0,0,0
2020-09-01,HTI,Selangor,0,0,0
2020-09-01,HUN,Johor,0,0,0
2020-09-01,HUN,Kedah,0,0,0
2020-09-01,HUN,Kelantan,0,0,0
2020-09-01,HUN,Pahang,0,0,0
2020-09-01,HUN,Perak,0,0,0
2020-09-01,HUN,Perlis,0,0,0
2020-09-01,HUN,Pulau Pinang,0,0,0
2020-09-01,HUN,Sabah,0,0,0
2020-09-01,HUN,Sarawak,0,0,0
2020-09-01,HUN,Selangor,5,3,2
2020-09-01,HUN,W.P. Labuan,0,0,0
2020-09-01,IDN,Johor,276,251,25
2020-09-01,IDN,Kedah,4,4,0
2020-09-01,IDN,Kelantan,0,0,0
2020-09-01,IDN,Melaka,0,0,0
2020-09-01,IDN,Negeri Sembilan,0,0,0
2020-09-01,IDN,Pahang,0,0,0
2020-09-01,IDN,Perak,0,0,0
2020-09-01,IDN,Perlis,4,4,0
2020-09-01,IDN,Pulau Pinang,3,0,3
2020-09-01,IDN,Sabah,11,4,7
2020-09-01,IDN,Sarawak,401,347,54
2020-09-01,IDN,Selangor,673,496,177
2020-09-01,IDN,Terengganu,0,0,0
2020-09-01,IDN,W.P. Labuan,0,0,0
2020-09-01,IND,Johor,83,82,1
2020-09-01,IND,Kedah,0,0,0
2020-09-01,IND,Kelantan,0,0,0
2020-09-01,IND,Melaka,0,0,0
2020-09-01,IND,Negeri Sembilan,0,0,0
2020-09-01,IND,Pahang,0,0,0
2020-09-01,IND,Perak,0,0,0
2020-09-01,IND,Perlis,0,0,0
2020-09-01,IND,Pulau Pinang,0,0,0
2020-09-01,IND,Sabah,1,1,0
2020-09-01,IND,Sarawak,0,0,0
2020-09-01,IND,Selangor,472,341,131
2020-09-01,IND,Terengganu,0,0,0
2020-09-01,IND,W.P. Labuan,0,0,0
2020-09-01,IOT,Pulau Pinang,0,0,0
2020-09-01,IOT,Selangor,0,0,0
2020-09-01,IRL,Johor,1,1,0
2020-09-01,IRL,Kedah,0,0,0
2020-09-01,IRL,Kelantan,0,0,0
2020-09-01,IRL,Negeri Sembilan,0,0,0
2020-09-01,IRL,Pahang,0,0,0
2020-09-01,IRL,Perak,0,0,0
2020-09-01,IRL,Perlis,0,0,0
2020-09-01,IRL,Pulau Pinang,0,0,0
2020-09-01,IRL,Sabah,0,0,0
2020-09-01,IRL,Sarawak,0,0,0
2020-09-01,IRL,Selangor,11,9,2
2020-09-01,IRL,Terengganu,0,0,0
2020-09-01,IRL,W.P. Labuan,0,0,0
2020-09-01,IRN,Johor,0,0,0
2020-09-01,IRN,Kedah,0,0,0
2020-09-01,IRN,Kelantan,0,0,0
2020-09-01,IRN,Perak,0,0,0
2020-09-01,IRN,Perlis,0,0,0
2020-09-01,IRN,Pulau Pinang,0,0,0
2020-09-01,IRN,Sabah,0,0,0
2020-09-01,IRN,Sarawak,0,0,0
2020-09-01,IRN,Selangor,19,13,6
2020-09-01,IRN,W.P. Labuan,0,0,0
2020-09-01,IRQ,Johor,0,0,0
2020-09-01,IRQ,Kedah,0,0,0
2020-09-01,IRQ,Kelantan,0,0,0
2020-09-01,IRQ,Melaka,0,0,0
2020-09-01,IRQ,Pahang,0,0,0
2020-09-01,IRQ,Perak,0,0,0
2020-09-01,IRQ,Perlis,0,0,0
2020-09-01,IRQ,Pulau Pinang,0,0,0
2020-09-01,IRQ,Sabah,0,0,0
2020-09-01,IRQ,Sarawak,0,0,0
2020-09-01,IRQ,Selangor,16,10,6
2020-09-01,ISL,Johor,0,0,0
2020-09-01,ISL,Kedah,0,0,0
2020-09-01,ISL,Kelantan,0,0,0
2020-09-01,ISL,Perak,0,0,0
2020-09-01,ISL,Perlis,0,0,0
2020-09-01,ISL,Pulau Pinang,0,0,0
2020-09-01,ISL,Sabah,0,0,0
2020-09-01,ISL,Sarawak,0,0,0
2020-09-01,ISL,Selangor,1,0,1
2020-09-01,ISL,W.P. Labuan,0,0,0
2020-09-01,ISR,Pulau Pinang,0,0,0
2020-09-01,ITA,Johor,0,0,0
2020-09-01,ITA,Kedah,0,0,0
2020-09-01,ITA,Kelantan,0,0,0
2020-09-01,ITA,Melaka,0,0,0
2020-09-01,ITA,Negeri Sembilan,0,0,0
2020-09-01,ITA,Pahang,0,0,0
2020-09-01,ITA,Perak,0,0,0
2020-09-01,ITA,Perlis,0,0,0
2020-09-01,ITA,Pulau Pinang,0,0,0
2020-09-01,ITA,Sabah,0,0,0
2020-09-01,ITA,Sarawak,0,0,0
2020-09-01,ITA,Selangor,18,17,1
2020-09-01,ITA,W.P. Labuan,0,0,0
2020-09-01,JAM,Johor,0,0,0
2020-09-01,JAM,Kedah,0,0,0
2020-09-01,JAM,Perak,0,0,0
2020-09-01,JAM,Pulau Pinang,0,0,0
2020-09-01,JAM,Sabah,0,0,0
2020-09-01,JAM,Sarawak,0,0,0
2020-09-01,JAM,Selangor,0,0,0
2020-09-01,JAM,W.P. Labuan,0,0,0
2020-09-01,JOR,Johor,0,0,0
2020-09-01,JOR,Kedah,0,0,0
2020-09-01,JOR,Kelantan,0,0,0
2020-09-01,JOR,Melaka,0,0,0
2020-09-01,JOR,Perlis,0,0,0
2020-09-01,JOR,Pulau Pinang,0,0,0
2020-09-01,JOR,Sabah,0,0,0
2020-09-01,JOR,Sarawak,1,1,0
2020-09-01,JOR,Selangor,7,5,2
2020-09-01,JOR,W.P. Labuan,0,0,0
2020-09-01,JPN,Johor,2,2,0
2020-09-01,JPN,Kedah,0,0,0
2020-09-01,JPN,Kelantan,0,0,0
2020-09-01,JPN,Melaka,0,0,0
2020-09-01,JPN,Negeri Sembilan,0,0,0
2020-09-01,JPN,Pahang,0,0,0
2020-09-01,JPN,Perak,0,0,0
2020-09-01,JPN,Perlis,0,0,0
2020-09-01,JPN,Pulau Pinang,1,1,0
2020-09-01,JPN,Sabah,1,0,1
2020-09-01,JPN,Sarawak,1,1,0
2020-09-01,JPN,Selangor,436,290,146
2020-09-01,JPN,W.P. Labuan,0,0,0
2020-09-01,KAZ,Johor,0,0,0
2020-09-01,KAZ,Kedah,0,0,0
2020-09-01,KAZ,Kelantan,0,0,0
2020-09-01,KAZ,Melaka,0,0,0
2020-09-01,KAZ,Perak,0,0,0
2020-09-01,KAZ,Perlis,0,0,0
2020-09-01,KAZ,Pulau Pinang,0,0,0
2020-09-01,KAZ,Sabah,0,0,0
2020-09-01,KAZ,Sarawak,0,0,0
2020-09-01,KAZ,Selangor,9,4,5
2020-09-01,KAZ,W.P. Labuan,0,0,0
2020-09-01,KEN,Johor,0,0,0
2020-09-01,KEN,Kedah,0,0,0
2020-09-01,KEN,Kelantan,0,0,0
2020-09-01,KEN,Perak,0,0,0
2020-09-01,KEN,Perlis,0,0,0
2020-09-01,KEN,Pulau Pinang,0,0,0
2020-09-01,KEN,Sabah,0,0,0
2020-09-01,KEN,Sarawak,0,0,0
2020-09-01,KEN,Selangor,6,2,4
2020-09-01,KGZ,Johor,0,0,0
2020-09-01,KGZ,Kedah,0,0,0
2020-09-01,KGZ,Kelantan,0,0,0
2020-09-01,KGZ,Perak,0,0,0
2020-09-01,KGZ,Perlis,0,0,0
2020-09-01,KGZ,Pulau Pinang,0,0,0
2020-09-01,KGZ,Sabah,0,0,0
2020-09-01,KGZ,Sarawak,0,0,0
2020-09-01,KGZ,Selangor,3,3,0
2020-09-01,KHM,Johor,0,0,0
2020-09-01,KHM,Kedah,0,0,0
2020-09-01,KHM,Kelantan,0,0,0
2020-09-01,KHM,Melaka,0,0,0
2020-09-01,KHM,Negeri Sembilan,0,0,0
2020-09-01,KHM,Pahang,0,0,0
2020-09-01,KHM,Perak,0,0,0
2020-09-01,KHM,Perlis,0,0,0
2020-09-01,KHM,Pulau Pinang,0,0,0
2020-09-01,KHM,Sabah,0,0,0
2020-09-01,KHM,Sarawak,0,0,0
2020-09-01,KHM,Selangor,5,1,4
2020-09-01,KHM,W.P. Labuan,0,0,0
2020-09-01,KIR,Johor,0,0,0
2020-09-01,KIR,Sabah,0,0,0
2020-09-01,KIR,Selangor,0,0,0
2020-09-01,KNA,Johor,0,0,0
2020-09-01,KNA,Kedah,0,0,0
2020-09-01,KNA,Perlis,0,0,0
2020-09-01,KNA,Pulau Pinang,0,0,0
2020-09-01,KNA,Sabah,0,0,0
2020-09-01,KNA,Selangor,1,1,0
2020-09-01,KNA,W.P. Labuan,0,0,0
2020-09-01,KOR,Johor,17,17,0
2020-09-01,KOR,Kedah,0,0,0
2020-09-01,KOR,Kelantan,0,0,0
2020-09-01,KOR,Melaka,0,0,0
2020-09-01,KOR,Negeri Sembilan,0,0,0
2020-09-01,KOR,Pahang,0,0,0
2020-09-01,KOR,Perak,0,0,0
2020-09-01,KOR,Perlis,0,0,0
2020-09-01,KOR,Pulau Pinang,0,0,0
2020-09-01,KOR,Sabah,1,0,1
2020-09-01,KOR,Sarawak,3,2,1
2020-09-01,KOR,Selangor,359,195,164
2020-09-01,KOR,Terengganu,0,0,0
2020-09-01,KOR,W.P. Labuan,0,0,0
2020-09-01,KWT,Johor,0,0,0
2020-09-01,KWT,Kedah,0,0,0
2020-09-01,KWT,Kelantan,0,0,0
2020-09-01,KWT,Perak,0,0,0
2020-09-01,KWT,Perlis,0,0,0
2020-09-01,KWT,Pulau Pinang,0,0,0
2020-09-01,KWT,Sabah,0,0,0
2020-09-01,KWT,Sarawak,0,0,0
2020-09-01,KWT,Selangor,2,2,0
2020-09-01,KWT,W.P. Labuan,0,0,0
2020-09-01,LAO,Johor,0,0,0
2020-09-01,LAO,Kedah,0,0,0
2020-09-01,LAO,Kelantan,0,0,0
2020-09-01,LAO,Melaka,0,0,0
2020-09-01,LAO,Perak,0,0,0
2020-09-01,LAO,Perlis,0,0,0
2020-09-01,LAO,Pulau Pinang,0,0,0
2020-09-01,LAO,Sabah,0,0,0
2020-09-01,LAO,Sarawak,0,0,0
2020-09-01,LAO,Selangor,1,0,1
2020-09-01,LAO,W.P. Labuan,0,0,0
2020-09-01,LBN,Johor,0,0,0
2020-09-01,LBN,Kedah,0,0,0
2020-09-01,LBN,Kelantan,0,0,0
2020-09-01,LBN,Pahang,0,0,0
2020-09-01,LBN,Perak,0,0,0
2020-09-01,LBN,Perlis,0,0,0
2020-09-01,LBN,Pulau Pinang,0,0,0
2020-09-01,LBN,Sabah,0,0,0
2020-09-01,LBN,Sarawak,0,0,0
2020-09-01,LBN,Selangor,5,4,1
2020-09-01,LBN,W.P. Labuan,0,0,0
2020-09-01,LBR,Johor,0,0,0
2020-09-01,LBR,Kedah,0,0,0
2020-09-01,LBR,Sabah,0,0,0
2020-09-01,LBR,Sarawak,0,0,0
2020-09-01,LBR,Selangor,0,0,0
2020-09-01,LBY,Johor,0,0,0
2020-09-01,LBY,Kedah,0,0,0
2020-09-01,LBY,Perlis,0,0,0
2020-09-01,LBY,Pulau Pinang,0,0,0
2020-09-01,LBY,Sabah,0,0,0
2020-09-01,LBY,Sarawak,0,0,0
2020-09-01,LBY,Selangor,2,1,1
2020-09-01,LCA,Johor,0,0,0
2020-09-01,LCA,Kedah,0,0,0
2020-09-01,LCA,Pulau Pinang,0,0,0
2020-09-01,LCA,Sarawak,0,0,0
2020-09-01,LCA,Selangor,0,0,0
2020-09-01,LIE,Johor,0,0,0
2020-09-01,LIE,Kedah,0,0,0
2020-09-01,LIE,Perlis,0,0,0
2020-09-01,LIE,Pulau Pinang,0,0,0
2020-09-01,LIE,Sabah,0,0,0
2020-09-01,LIE,Sarawak,0,0,0
2020-09-01,LIE,Selangor,0,0,0
2020-09-01,LKA,Johor,4,4,0
2020-09-01,LKA,Kedah,0,0,0
2020-09-01,LKA,Kelantan,0,0,0
2020-09-01,LKA,Melaka,0,0,0
2020-09-01,LKA,Pahang,0,0,0
2020-09-01,LKA,Perak,0,0,0
2020-09-01,LKA,Perlis,0,0,0
2020-09-01,LKA,Pulau Pinang,0,0,0
2020-09-01,LKA,Sabah,0,0,0
2020-09-01,LKA,Sarawak,2,1,1
2020-09-01,LKA,Selangor,35,16,19
2020-09-01,LKA,W.P. Labuan,0,0,0
2020-09-01,LSO,Johor,0,0,0
2020-09-01,LSO,Kedah,0,0,0
2020-09-01,LSO,Pulau Pinang,0,0,0
2020-09-01,LSO,Sarawak,0,0,0
2020-09-01,LSO,Selangor,0,0,0
2020-09-01,LTU,Johor,2,2,0
2020-09-01,LTU,Kedah,0,0,0
2020-09-01,LTU,Kelantan,0,0,0
2020-09-01,LTU,Pahang,0,0,0
2020-09-01,LTU,Perak,0,0,0
2020-09-01,LTU,Perlis,0,0,0
2020-09-01,LTU,Pulau Pinang,0,0,0
2020-09-01,LTU,Sabah,0,0,0
2020-09-01,LTU,Sarawak,0,0,0
2020-09-01,LTU,Selangor,3,3,0
2020-09-01,LTU,W.P. Labuan,0,0,0
2020-09-01,LUX,Johor,0,0,0
2020-09-01,LUX,Kedah,0,0,0
2020-09-01,LUX,Kelantan,0,0,0
2020-09-01,LUX,Perak,0,0,0
2020-09-01,LUX,Perlis,0,0,0
2020-09-01,LUX,Pulau Pinang,0,0,0
2020-09-01,LUX,Sabah,0,0,0
2020-09-01,LUX,Sarawak,0,0,0
2020-09-01,LUX,Selangor,1,1,0
2020-09-01,LVA,Johor,0,0,0
2020-09-01,LVA,Kedah,0,0,0
2020-09-01,LVA,Kelantan,0,0,0
2020-09-01,LVA,Pahang,0,0,0
2020-09-01,LVA,Perak,0,0,0
2020-09-01,LVA,Perlis,0,0,0
2020-09-01,LVA,Pulau Pinang,0,0,0
2020-09-01,LVA,Sabah,0,0,0
2020-09-01,LVA,Sarawak,0,0,0
2020-09-01,LVA,Selangor,5,5,0
2020-09-01,LVA,W.P. Labuan,0,0,0
2020-09-01,MAC,Johor,0,0,0
2020-09-01,MAC,Pahang,0,0,0
2020-09-01,MAC,Perak,0,0,0
2020-09-01,MAC,Selangor,0,0,0
2020-09-01,MAC,W.P. Labuan,0,0,0
2020-09-01,MAR,Johor,0,0,0
2020-09-01,MAR,Kedah,0,0,0
2020-09-01,MAR,Kelantan,0,0,0
2020-09-01,MAR,Melaka,0,0,0
2020-09-01,MAR,Pahang,0,0,0
2020-09-01,MAR,Perak,0,0,0
2020-09-01,MAR,Perlis,0,0,0
2020-09-01,MAR,Pulau Pinang,0,0,0
2020-09-01,MAR,Sabah,0,0,0
2020-09-01,MAR,Sarawak,0,0,0
2020-09-01,MAR,Selangor,5,1,4
2020-09-01,MAR,W.P. Labuan,0,0,0
2020-09-01,MCO,Johor,0,0,0
2020-09-01,MCO,Kedah,0,0,0
2020-09-01,MCO,Sabah,0,0,0
2020-09-01,MCO,Selangor,0,0,0
2020-09-01,MDA,Johor,0,0,0
2020-09-01,MDA,Kedah,0,0,0
2020-09-01,MDA,Kelantan,0,0,0
2020-09-01,MDA,Negeri Sembilan,0,0,0
2020-09-01,MDA,Perlis,0,0,0
2020-09-01,MDA,Pulau Pinang,0,0,0
2020-09-01,MDA,Sabah,0,0,0
2020-09-01,MDA,Sarawak,0,0,0
2020-09-01,MDA,Selangor,1,0,1
2020-09-01,MDG,Johor,0,0,0
2020-09-01,MDG,Kedah,0,0,0
2020-09-01,MDG,Perak,0,0,0
2020-09-01,MDG,Perlis,0,0,0
2020-09-01,MDG,Pulau Pinang,0,0,0
2020-09-01,MDG,Sabah,0,0,0
2020-09-01,MDG,Sarawak,0,0,0
2020-09-01,MDG,Selangor,0,0,0
2020-09-01,MDV,Johor,0,0,0
2020-09-01,MDV,Kedah,0,0,0
2020-09-01,MDV,Kelantan,0,0,0
2020-09-01,MDV,Perak,0,0,0
2020-09-01,MDV,Perlis,0,0,0
2020-09-01,MDV,Pulau Pinang,0,0,0
2020-09-01,MDV,Sabah,0,0,0
2020-09-01,MDV,Sarawak,0,0,0
2020-09-01,MDV,Selangor,50,20,30
2020-09-01,MEX,Johor,0,0,0
2020-09-01,MEX,Kedah,0,0,0
2020-09-01,MEX,Kelantan,0,0,0
2020-09-01,MEX,Pahang,0,0,0
2020-09-01,MEX,Perak,0,0,0
2020-09-01,MEX,Perlis,0,0,0
2020-09-01,MEX,Pulau Pinang,0,0,0
2020-09-01,MEX,Sabah,0,0,0
2020-09-01,MEX,Sarawak,0,0,0
2020-09-01,MEX,Selangor,4,2,2
2020-09-01,MEX,W.P. Labuan,0,0,0
2020-09-01,MHL,Johor,0,0,0
2020-09-01,MHL,Kedah,0,0,0
2020-09-01,MHL,Perak,0,0,0
2020-09-01,MHL,Pulau Pinang,0,0,0
2020-09-01,MHL,Sabah,0,0,0
2020-09-01,MHL,Selangor,0,0,0
2020-09-01,MKD,Johor,0,0,0
2020-09-01,MKD,Kedah,0,0,0
2020-09-01,MKD,Perak,0,0,0
2020-09-01,MKD,Pulau Pinang,0,0,0
2020-09-01,MKD,Sabah,0,0,0
2020-09-01,MKD,Sarawak,0,0,0
2020-09-01,MKD,Selangor,0,0,0
2020-09-01,MLI,Johor,0,0,0
2020-09-01,MLI,Sabah,0,0,0
2020-09-01,MLI,Selangor,1,1,0
2020-09-01,MLT,Johor,0,0,0
2020-09-01,MLT,Kedah,0,0,0
2020-09-01,MLT,Kelantan,0,0,0
2020-09-01,MLT,Perak,0,0,0
2020-09-01,MLT,Perlis,0,0,0
2020-09-01,MLT,Pulau Pinang,0,0,0
2020-09-01,MLT,Sabah,0,0,0
2020-09-01,MLT,Sarawak,0,0,0
2020-09-01,MLT,Selangor,0,0,0
2020-09-01,MLT,W.P. Labuan,0,0,0
2020-09-01,MMR,Johor,12,12,0
2020-09-01,MMR,Kedah,0,0,0
2020-09-01,MMR,Kelantan,0,0,0
2020-09-01,MMR,Negeri Sembilan,0,0,0
2020-09-01,MMR,Pahang,0,0,0
2020-09-01,MMR,Perak,0,0,0
2020-09-01,MMR,Perlis,0,0,0
2020-09-01,MMR,Pulau Pinang,0,0,0
2020-09-01,MMR,Sabah,0,0,0
2020-09-01,MMR,Sarawak,0,0,0
2020-09-01,MMR,Selangor,113,102,11
2020-09-01,MMR,Terengganu,0,0,0
2020-09-01,MMR,W.P. Labuan,0,0,0
2020-09-01,MNE,Johor,0,0,0
2020-09-01,MNE,Kedah,0,0,0
2020-09-01,MNE,Pulau Pinang,0,0,0
2020-09-01,MNE,Sabah,0,0,0
2020-09-01,MNE,Sarawak,0,0,0
2020-09-01,MNE,Selangor,1,0,1
2020-09-01,MNG,Johor,0,0,0
2020-09-01,MNG,Kedah,0,0,0
2020-09-01,MNG,Kelantan,0,0,0
2020-09-01,MNG,Perak,0,0,0
2020-09-01,MNG,Perlis,0,0,0
2020-09-01,MNG,Pulau Pinang,0,0,0
2020-09-01,MNG,Sabah,0,0,0
2020-09-01,MNG,Sarawak,0,0,0
2020-09-01,MNG,Selangor,0,0,0
2020-09-01,MNP,Selangor,0,0,0
2020-09-01,MOZ,Johor,0,0,0
2020-09-01,MOZ,Kedah,0,0,0
2020-09-01,MOZ,Perak,0,0,0
2020-09-01,MOZ,Pulau Pinang,0,0,0
2020-09-01,MOZ,Sabah,0,0,0
2020-09-01,MOZ,Sarawak,0,0,0
2020-09-01,MOZ,Selangor,1,0,1
2020-09-01,MRT,Johor,0,0,0
2020-09-01,MRT,Kedah,0,0,0
2020-09-01,MRT,Pulau Pinang,0,0,0
2020-09-01,MRT,Sabah,0,0,0
2020-09-01,MRT,Sarawak,0,0,0
2020-09-01,MRT,Selangor,1,1,0
2020-09-01,MUS,Johor,0,0,0
2020-09-01,MUS,Kedah,0,0,0
2020-09-01,MUS,Kelantan,0,0,0
2020-09-01,MUS,Pahang,0,0,0
2020-09-01,MUS,Perak,0,0,0
2020-09-01,MUS,Perlis,0,0,0
2020-09-01,MUS,Pulau Pinang,0,0,0
2020-09-01,MUS,Sabah,0,0,0
2020-09-01,MUS,Sarawak,0,0,0
2020-09-01,MUS,Selangor,4,2,2
2020-09-01,MWI,Johor,0,0,0
2020-09-01,MWI,Pulau Pinang,0,0,0
2020-09-01,MWI,Sabah,0,0,0
2020-09-01,MWI,Sarawak,0,0,0
2020-09-01,MWI,Selangor,0,0,0
2020-09-01,MYT,Selangor,0,0,0
2020-09-01,NAM,Johor,0,0,0
2020-09-01,NAM,Kedah,0,0,0
2020-09-01,NAM,Perak,0,0,0
2020-09-01,NAM,Perlis,0,0,0
2020-09-01,NAM,Pulau Pinang,0,0,0
2020-09-01,NAM,Sabah,0,0,0
2020-09-01,NAM,Sarawak,0,0,0
2020-09-01,NAM,Selangor,0,0,0
2020-09-01,NCL,Selangor,0,0,0
2020-09-01,NER,Johor,0,0,0
2020-09-01,NER,Sabah,0,0,0
2020-09-01,NER,Selangor,0,0,0
2020-09-01,NGA,Johor,0,0,0
2020-09-01,NGA,Kedah,0,0,0
2020-09-01,NGA,Perlis,0,0,0
2020-09-01,NGA,Pulau Pinang,0,0,0
2020-09-01,NGA,Sabah,0,0,0
2020-09-01,NGA,Sarawak,0,0,0
2020-09-01,NGA,Selangor,36,33,3
2020-09-01,NIC,Johor,0,0,0
2020-09-01,NIC,Kedah,0,0,0
2020-09-01,NIC,Pulau Pinang,0,0,0
2020-09-01,NIC,Sabah,0,0,0
2020-09-01,NIC,Selangor,0,0,0
2020-09-01,NLD,Johor,3,3,0
2020-09-01,NLD,Kedah,0,0,0
2020-09-01,NLD,Kelantan,0,0,0
2020-09-01,NLD,Melaka,0,0,0
2020-09-01,NLD,Negeri Sembilan,0,0,0
2020-09-01,NLD,Pahang,0,0,0
2020-09-01,NLD,Perak,0,0,0
2020-09-01,NLD,Perlis,0,0,0
2020-09-01,NLD,Pulau Pinang,0,0,0
2020-09-01,NLD,Sabah,0,0,0
2020-09-01,NLD,Sarawak,0,0,0
2020-09-01,NLD,Selangor,46,38,8
2020-09-01,NLD,Terengganu,0,0,0
2020-09-01,NLD,W.P. Labuan,0,0,0
2020-09-01,NOR,Johor,0,0,0
2020-09-01,NOR,Kedah,0,0,0
2020-09-01,NOR,Kelantan,0,0,0
2020-09-01,NOR,Melaka,0,0,0
2020-09-01,NOR,Pahang,0,0,0
2020-09-01,NOR,Perak,0,0,0
2020-09-01,NOR,Perlis,0,0,0
2020-09-01,NOR,Pulau Pinang,0,0,0
2020-09-01,NOR,Sabah,0,0,0
2020-09-01,NOR,Sarawak,0,0,0
2020-09-01,NOR,Selangor,8,6,2
2020-09-01,NOR,W.P. Labuan,0,0,0
2020-09-01,NPL,Johor,0,0,0
2020-09-01,NPL,Kedah,0,0,0
2020-09-01,NPL,Pahang,0,0,0
2020-09-01,NPL,Perak,0,0,0
2020-09-01,NPL,Perlis,0,0,0
2020-09-01,NPL,Pulau Pinang,0,0,0
2020-09-01,NPL,Sabah,0,0,0
2020-09-01,NPL,Sarawak,0,0,0
2020-09-01,NPL,Selangor,22,20,2
2020-09-01,NPL,W.P. Labuan,0,0,0
2020-09-01,NRU,Johor,0,0,0
2020-09-01,NRU,Pulau Pinang,0,0,0
2020-09-01,NRU,Selangor,0,0,0
2020-09-01,NZL,Johor,0,0,0
2020-09-01,NZL,Kedah,0,0,0
2020-09-01,NZL,Kelantan,0,0,0
2020-09-01,NZL,Melaka,0,0,0
2020-09-01,NZL,Negeri Sembilan,0,0,0
2020-09-01,NZL,Pahang,0,0,0
2020-09-01,NZL,Perak,0,0,0
2020-09-01,NZL,Perlis,0,0,0
2020-09-01,NZL,Pulau Pinang,0,0,0
2020-09-01,NZL,Sabah,0,0,0
2020-09-01,NZL,Sarawak,0,0,0
2020-09-01,NZL,Selangor,23,19,4
2020-09-01,NZL,Terengganu,0,0,0
2020-09-01,NZL,W.P. Labuan,0,0,0
2020-09-01,OMN,Johor,0,0,0
2020-09-01,OMN,Kedah,0,0,0
2020-09-01,OMN,Kelantan,0,0,0
2020-09-01,OMN,Melaka,0,0,0
2020-09-01,OMN,Perak,0,0,0
2020-09-01,OMN,Perlis,0,0,0
2020-09-01,OMN,Pulau Pinang,0,0,0
2020-09-01,OMN,Sabah,0,0,0
2020-09-01,OMN,Sarawak,0,0,0
2020-09-01,OMN,Selangor,21,15,6
2020-09-01,PAK,Johor,0,0,0
2020-09-01,PAK,Kedah,0,0,0
2020-09-01,PAK,Kelantan,0,0,0
2020-09-01,PAK,Melaka,0,0,0
2020-09-01,PAK,Negeri Sembilan,0,0,0
2020-09-01,PAK,Pahang,0,0,0
2020-09-01,PAK,Perak,0,0,0
2020-09-01,PAK,Perlis,0,0,0
2020-09-01,PAK,Pulau Pinang,0,0,0
2020-09-01,PAK,Sabah,1,1,0
2020-09-01,PAK,Sarawak,0,0,0
2020-09-01,PAK,Selangor,80,63,17
2020-09-01,PAK,W.P. Labuan,0,0,0
2020-09-01,PAN,Johor,0,0,0
2020-09-01,PAN,Kedah,0,0,0
2020-09-01,PAN,Perak,0,0,0
2020-09-01,PAN,Perlis,0,0,0
2020-09-01,PAN,Pulau Pinang,0,0,0
2020-09-01,PAN,Sabah,0,0,0
2020-09-01,PAN,Sarawak,0,0,0
2020-09-01,PAN,Selangor,0,0,0
2020-09-01,PER,Johor,0,0,0
2020-09-01,PER,Kedah,0,0,0
2020-09-01,PER,Kelantan,0,0,0
2020-09-01,PER,Pahang,0,0,0
2020-09-01,PER,Perak,0,0,0
2020-09-01,PER,Perlis,0,0,0
2020-09-01,PER,Pulau Pinang,0,0,0
2020-09-01,PER,Sabah,0,0,0
2020-09-01,PER,Sarawak,0,0,0
2020-09-01,PER,Selangor,2,2,0
2020-09-01,PER,W.P. Labuan,0,0,0
2020-09-01,PHL,Johor,149,139,10
2020-09-01,PHL,Kedah,0,0,0
2020-09-01,PHL,Kelantan,0,0,0
2020-09-01,PHL,Melaka,0,0,0
2020-09-01,PHL,Negeri Sembilan,0,0,0
2020-09-01,PHL,Pahang,0,0,0
2020-09-01,PHL,Perak,0,0,0
2020-09-01,PHL,Perlis,0,0,0
2020-09-01,PHL,Pulau Pinang,0,0,0
2020-09-01,PHL,Sabah,2,0,2
2020-09-01,PHL,Sarawak,50,42,8
2020-09-01,PHL,Selangor,296,260,36
2020-09-01,PHL,Terengganu,0,0,0
2020-09-01,PHL,W.P. Labuan,8,7,1
2020-09-01,PLW,Johor,0,0,0
2020-09-01,PLW,Pulau Pinang,0,0,0
2020-09-01,PLW,Selangor,0,0,0
2020-09-01,PNG,Johor,0,0,0
2020-09-01,PNG,Kedah,0,0,0
2020-09-01,PNG,Kelantan,0,0,0
2020-09-01,PNG,Perak,0,0,0
2020-09-01,PNG,Pulau Pinang,0,0,0
2020-09-01,PNG,Sabah,0,0,0
2020-09-01,PNG,Sarawak,0,0,0
2020-09-01,PNG,Selangor,0,0,0
2020-09-01,POL,Johor,4,4,0
2020-09-01,POL,Kedah,0,0,0
2020-09-01,POL,Kelantan,0,0,0
2020-09-01,POL,Melaka,0,0,0
2020-09-01,POL,Negeri Sembilan,0,0,0
2020-09-01,POL,Pahang,0,0,0
2020-09-01,POL,Perak,0,0,0
2020-09-01,POL,Perlis,0,0,0
2020-09-01,POL,Pulau Pinang,0,0,0
2020-09-01,POL,Sabah,0,0,0
2020-09-01,POL,Sarawak,0,0,0
2020-09-01,POL,Selangor,19,16,3
2020-09-01,POL,Terengganu,0,0,0
2020-09-01,POL,W.P. Labuan,0,0,0
2020-09-01,PRK,Selangor,0,0,0
2020-09-01,PRT,Johor,1,1,0
2020-09-01,PRT,Kedah,0,0,0
2020-09-01,PRT,Kelantan,0,0,0
2020-09-01,PRT,Melaka,0,0,0
2020-09-01,PRT,Pahang,0,0,0
2020-09-01,PRT,Perak,0,0,0
2020-09-01,PRT,Perlis,0,0,0
2020-09-01,PRT,Pulau Pinang,0,0,0
2020-09-01,PRT,Sabah,0,0,0
2020-09-01,PRT,Sarawak,0,0,0
2020-09-01,PRT,Selangor,9,5,4
2020-09-01,PRT,W.P. Labuan,0,0,0
2020-09-01,PRY,Johor,0,0,0
2020-09-01,PRY,Kedah,0,0,0
2020-09-01,PRY,Perak,0,0,0
2020-09-01,PRY,Perlis,0,0,0
2020-09-01,PRY,Pulau Pinang,0,0,0
2020-09-01,PRY,Sabah,0,0,0
2020-09-01,PRY,Sarawak,0,0,0
2020-09-01,PRY,Selangor,0,0,0
2020-09-01,PSE,Johor,0,0,0
2020-09-01,PSE,Kedah,0,0,0
2020-09-01,PSE,Kelantan,0,0,0
2020-09-01,PSE,Melaka,0,0,0
2020-09-01,PSE,Perak,0,0,0
2020-09-01,PSE,Perlis,0,0,0
2020-09-01,PSE,Pulau Pinang,0,0,0
2020-09-01,PSE,Sabah,0,0,0
2020-09-01,PSE,Sarawak,0,0,0
2020-09-01,PSE,Selangor,9,8,1
2020-09-01,QAT,Johor,0,0,0
2020-09-01,QAT,Kedah,0,0,0
2020-09-01,QAT,Perlis,0,0,0
2020-09-01,QAT,Pulau Pinang,0,0,0
2020-09-01,QAT,Sabah,0,0,0
2020-09-01,QAT,Sarawak,0,0,0
2020-09-01,QAT,Selangor,0,0,0
2020-09-01,REU,Johor,0,0,0
2020-09-01,REU,Sarawak,0,0,0
2020-09-01,ROU,Johor,0,0,0
2020-09-01,ROU,Kedah,0,0,0
2020-09-01,ROU,Kelantan,0,0,0
2020-09-01,ROU,Negeri Sembilan,0,0,0
2020-09-01,ROU,Pahang,0,0,0
2020-09-01,ROU,Perak,0,0,0
2020-09-01,ROU,Perlis,0,0,0
2020-09-01,ROU,Pulau Pinang,0,0,0
2020-09-01,ROU,Sabah,0,0,0
2020-09-01,ROU,Sarawak,1,1,0
2020-09-01,ROU,Selangor,14,13,1
2020-09-01,ROU,W.P. Labuan,0,0,0
2020-09-01,RUS,Johor,3,3,0
2020-09-01,RUS,Kedah,0,0,0
2020-09-01,RUS,Kelantan,0,0,0
2020-09-01,RUS,Melaka,0,0,0
2020-09-01,RUS,Negeri Sembilan,0,0,0
2020-09-01,RUS,Pahang,0,0,0
2020-09-01,RUS,Perak,0,0,0
2020-09-01,RUS,Perlis,0,0,0
2020-09-01,RUS,Pulau Pinang,0,0,0
2020-09-01,RUS,Sabah,0,0,0
2020-09-01,RUS,Sarawak,0,0,0
2020-09-01,RUS,Selangor,51,41,10
2020-09-01,RUS,W.P. Labuan,0,0,0
2020-09-01,RWA,Johor,0,0,0
2020-09-01,RWA,Kedah,0,0,0
2020-09-01,RWA,Pulau Pinang,0,0,0
2020-09-01,RWA,Selangor,0,0,0
2020-09-01,SAU,Johor,0,0,0
2020-09-01,SAU,Kedah,0,0,0
2020-09-01,SAU,Kelantan,0,0,0
2020-09-01,SAU,Melaka,0,0,0
2020-09-01,SAU,Perak,0,0,0
2020-09-01,SAU,Perlis,0,0,0
2020-09-01,SAU,Pulau Pinang,0,0,0
2020-09-01,SAU,Sabah,0,0,0
2020-09-01,SAU,Sarawak,0,0,0
2020-09-01,SAU,Selangor,40,26,14
2020-09-01,SAU,W.P. Labuan,0,0,0
2020-09-01,SDN,Johor,0,0,0
2020-09-01,SDN,Kedah,0,0,0
2020-09-01,SDN,Kelantan,0,0,0
2020-09-01,SDN,Perlis,0,0,0
2020-09-01,SDN,Pulau Pinang,0,0,0
2020-09-01,SDN,Sabah,0,0,0
2020-09-01,SDN,Sarawak,0,0,0
2020-09-01,SDN,Selangor,26,20,6
2020-09-01,SDN,W.P. Labuan,0,0,0
2020-09-01,SEN,Johor,0,0,0
2020-09-01,SEN,Kedah,0,0,0
2020-09-01,SEN,Kelantan,0,0,0
2020-09-01,SEN,Perak,0,0,0
2020-09-01,SEN,Perlis,0,0,0
2020-09-01,SEN,Pulau Pinang,0,0,0
2020-09-01,SEN,Sabah,0,0,0
2020-09-01,SEN,Sarawak,0,0,0
2020-09-01,SEN,Selangor,5,3,2
2020-09-01,SGP,Johor,550,479,71
2020-09-01,SGP,Kedah,0,0,0
2020-09-01,SGP,Kelantan,0,0,0
2020-09-01,SGP,Melaka,0,0,0
2020-09-01,SGP,Negeri Sembilan,0,0,0
2020-09-01,SGP,Pahang,1,1,0
2020-09-01,SGP,Perak,1,1,0
2020-09-01,SGP,Perlis,1,1,0
2020-09-01,SGP,Pulau Pinang,14,14,0
2020-09-01,SGP,Sabah,0,0,0
2020-09-01,SGP,Sarawak,7,4,3
2020-09-01,SGP,Selangor,307,235,72
2020-09-01,SGP,Terengganu,0,0,0
2020-09-01,SGP,W.P. Labuan,0,0,0
2020-09-01,SGS,Johor,0,0,0
2020-09-01,SGS,Sabah,0,0,0
2020-09-01,SGS,Selangor,0,0,0
2020-09-01,SHN,Sarawak,0,0,0
2020-09-01,SLB,Johor,0,0,0
2020-09-01,SLB,Perlis,0,0,0
2020-09-01,SLB,Pulau Pinang,0,0,0
2020-09-01,SLB,Sabah,0,0,0
2020-09-01,SLB,Sarawak,0,0,0
2020-09-01,SLB,Selangor,0,0,0
2020-09-01,SLB,W.P. Labuan,0,0,0
2020-09-01,SLE,Johor,0,0,0
2020-09-01,SLE,Kedah,0,0,0
2020-09-01,SLE,Perak,0,0,0
2020-09-01,SLE,Pulau Pinang,0,0,0
2020-09-01,SLE,Sabah,0,0,0
2020-09-01,SLE,Selangor,0,0,0
2020-09-01,SLV,Johor,0,0,0
2020-09-01,SLV,Kedah,0,0,0
2020-09-01,SLV,Perak,0,0,0
2020-09-01,SLV,Perlis,0,0,0
2020-09-01,SLV,Pulau Pinang,0,0,0
2020-09-01,SLV,Sabah,0,0,0
2020-09-01,SLV,Selangor,1,0,1
2020-09-01,SLV,W.P. Labuan,0,0,0
2020-09-01,SMR,Johor,0,0,0
2020-09-01,SMR,Selangor,0,0,0
2020-09-01,SOM,Johor,0,0,0
2020-09-01,SOM,Kedah,0,0,0
2020-09-01,SOM,Kelantan,0,0,0
2020-09-01,SOM,Perlis,0,0,0
2020-09-01,SOM,Sabah,0,0,0
2020-09-01,SOM,Sarawak,0,0,0
2020-09-01,SOM,Selangor,6,4,2
2020-09-01,SRB,Johor,0,0,0
2020-09-01,SRB,Kedah,0,0,0
2020-09-01,SRB,Kelantan,0,0,0
2020-09-01,SRB,Pahang,0,0,0
2020-09-01,SRB,Perak,0,0,0
2020-09-01,SRB,Perlis,0,0,0
2020-09-01,SRB,Pulau Pinang,0,0,0
2020-09-01,SRB,Sabah,0,0,0
2020-09-01,SRB,Sarawak,0,0,0
2020-09-01,SRB,Selangor,0,0,0
2020-09-01,SSD,Johor,0,0,0
2020-09-01,SSD,Kedah,0,0,0
2020-09-01,SSD,Sarawak,0,0,0
2020-09-01,SSD,Selangor,1,0,1
2020-09-01,SSD,W.P. Labuan,0,0,0
2020-09-01,STP,Selangor,0,0,0
2020-09-01,SUR,Johor,0,0,0
2020-09-01,SUR,Kedah,0,0,0
2020-09-01,SUR,Kelantan,0,0,0
2020-09-01,SUR,Perak,0,0,0
2020-09-01,SUR,Perlis,0,0,0
2020-09-01,SUR,Pulau Pinang,0,0,0
2020-09-01,SUR,Sabah,0,0,0
2020-09-01,SUR,Sarawak,0,0,0
2020-09-01,SUR,Selangor,0,0,0
2020-09-01,SVK,Johor,0,0,0
2020-09-01,SVK,Kedah,0,0,0
2020-09-01,SVK,Kelantan,0,0,0
2020-09-01,SVK,Negeri Sembilan,0,0,0
2020-09-01,SVK,Pahang,0,0,0
2020-09-01,SVK,Perak,0,0,0
2020-09-01,SVK,Perlis,0,0,0
2020-09-01,SVK,Pulau Pinang,0,0,0
2020-09-01,SVK,Sabah,0,0,0
2020-09-01,SVK,Sarawak,0,0,0
2020-09-01,SVK,Selangor,32,29,3
2020-09-01,SVK,W.P. Labuan,0,0,0
2020-09-01,SVN,Johor,0,0,0
2020-09-01,SVN,Kedah,0,0,0
2020-09-01,SVN,Kelantan,0,0,0
2020-09-01,SVN,Perak,0,0,0
2020-09-01,SVN,Perlis,0,0,0
2020-09-01,SVN,Pulau Pinang,0,0,0
2020-09-01,SVN,Sabah,0,0,0
2020-09-01,SVN,Sarawak,0,0,0
2020-09-01,SVN,Selangor,1,1,0
2020-09-01,SVN,W.P. Labuan,0,0,0
2020-09-01,SWE,Johor,0,0,0
2020-09-01,SWE,Kedah,0,0,0
2020-09-01,SWE,Kelantan,0,0,0
2020-09-01,SWE,Melaka,0,0,0
2020-09-01,SWE,Negeri Sembilan,0,0,0
2020-09-01,SWE,Pahang,0,0,0
2020-09-01,SWE,Perak,0,0,0
2020-09-01,SWE,Perlis,0,0,0
2020-09-01,SWE,Pulau Pinang,0,0,0
2020-09-01,SWE,Sabah,0,0,0
2020-09-01,SWE,Sarawak,1,1,0
2020-09-01,SWE,Selangor,9,6,3
2020-09-01,SWE,W.P. Labuan,0,0,0
2020-09-01,SWZ,Johor,0,0,0
2020-09-01,SWZ,Kedah,0,0,0
2020-09-01,SWZ,Pulau Pinang,0,0,0
2020-09-01,SWZ,Sabah,0,0,0
2020-09-01,SWZ,Selangor,0,0,0
2020-09-01,SYC,Johor,0,0,0
2020-09-01,SYC,Kedah,0,0,0
2020-09-01,SYC,Pulau Pinang,0,0,0
2020-09-01,SYC,Sabah,0,0,0
2020-09-01,SYC,Sarawak,0,0,0
2020-09-01,SYC,Selangor,5,1,4
2020-09-01,SYR,Johor,1,1,0
2020-09-01,SYR,Kedah,0,0,0
2020-09-01,SYR,Kelantan,0,0,0
2020-09-01,SYR,Pahang,0,0,0
2020-09-01,SYR,Perlis,0,0,0
2020-09-01,SYR,Pulau Pinang,0,0,0
2020-09-01,SYR,Sabah,0,0,0
2020-09-01,SYR,Sarawak,0,0,0
2020-09-01,SYR,Selangor,42,40,2
2020-09-01,SYR,W.P. Labuan,0,0,0
2020-09-01,TCA,Perlis,0,0,0
2020-09-01,TCD,Johor,0,0,0
2020-09-01,TCD,Kedah,0,0,0
2020-09-01,TCD,Perlis,0,0,0
2020-09-01,TCD,Selangor,0,0,0
2020-09-01,TGO,Johor,0,0,0
2020-09-01,TGO,Perak,0,0,0
2020-09-01,TGO,Pulau Pinang,0,0,0
2020-09-01,TGO,Selangor,0,0,0
2020-09-01,THA,Johor,98,97,1
2020-09-01,THA,Kedah,9291,8590,701
2020-09-01,THA,Kelantan,7,1,6
2020-09-01,THA,Melaka,0,0,0
2020-09-01,THA,Negeri Sembilan,0,0,0
2020-09-01,THA,Pahang,0,0,0
2020-09-01,THA,Perak,2,0,2
2020-09-01,THA,Perlis,5197,5037,160
2020-09-01,THA,Pulau Pinang,0,0,0
2020-09-01,THA,Sabah,1,0,1
2020-09-01,THA,Sarawak,17,14,3
2020-09-01,THA,Selangor,125,66,59
2020-09-01,THA,Terengganu,0,0,0
2020-09-01,THA,W.P. Labuan,0,0,0
2020-09-01,TJK,Johor,0,0,0
2020-09-01,TJK,Kedah,0,0,0
2020-09-01,TJK,Perlis,0,0,0
2020-09-01,TJK,Pulau Pinang,0,0,0
2020-09-01,TJK,Sabah,0,0,0
2020-09-01,TJK,Selangor,0,0,0
2020-09-01,TKL,Selangor,0,0,0
2020-09-01,TKM,Johor,0,0,0
2020-09-01,TKM,Kedah,0,0,0
2020-09-01,TKM,Kelantan,0,0,0
2020-09-01,TKM,Perlis,0,0,0
2020-09-01,TKM,Pulau Pinang,0,0,0
2020-09-01,TKM,Sabah,0,0,0
2020-09-01,TKM,Sarawak,0,0,0
2020-09-01,TKM,Selangor,2,1,1
2020-09-01,TLS,Johor,0,0,0
2020-09-01,TLS,Kedah,0,0,0
2020-09-01,TLS,Perlis,0,0,0
2020-09-01,TLS,Pulau Pinang,0,0,0
2020-09-01,TLS,Sabah,0,0,0
2020-09-01,TLS,Sarawak,0,0,0
2020-09-01,TLS,Selangor,6,3,3
2020-09-01,TON,Johor,0,0,0
2020-09-01,TON,Pulau Pinang,0,0,0
2020-09-01,TON,Sarawak,0,0,0
2020-09-01,TON,Selangor,0,0,0
2020-09-01,TTO,Johor,0,0,0
2020-09-01,TTO,Kedah,0,0,0
2020-09-01,TTO,Pahang,0,0,0
2020-09-01,TTO,Pulau Pinang,0,0,0
2020-09-01,TTO,Sabah,0,0,0
2020-09-01,TTO,Sarawak,0,0,0
2020-09-01,TTO,Selangor,0,0,0
2020-09-01,TUN,Johor,0,0,0
2020-09-01,TUN,Kedah,0,0,0
2020-09-01,TUN,Kelantan,0,0,0
2020-09-01,TUN,Melaka,0,0,0
2020-09-01,TUN,Perak,0,0,0
2020-09-01,TUN,Perlis,0,0,0
2020-09-01,TUN,Pulau Pinang,0,0,0
2020-09-01,TUN,Sabah,0,0,0
2020-09-01,TUN,Sarawak,0,0,0
2020-09-01,TUN,Selangor,6,2,4
2020-09-01,TUN,W.P. Labuan,0,0,0
2020-09-01,TUR,Johor,0,0,0
2020-09-01,TUR,Kedah,0,0,0
2020-09-01,TUR,Kelantan,0,0,0
2020-09-01,TUR,Melaka,0,0,0
2020-09-01,TUR,Negeri Sembilan,0,0,0
2020-09-01,TUR,Pahang,0,0,0
2020-09-01,TUR,Perak,0,0,0
2020-09-01,TUR,Perlis,0,0,0
2020-09-01,TUR,Pulau Pinang,0,0,0
2020-09-01,TUR,Sabah,0,0,0
2020-09-01,TUR,Sarawak,0,0,0
2020-09-01,TUR,Selangor,15,8,7
2020-09-01,TUR,W.P. Labuan,0,0,0
2020-09-01,TUV,Selangor,0,0,0
2020-09-01,TWN,Johor,0,0,0
2020-09-01,TWN,Kedah,0,0,0
2020-09-01,TWN,Kelantan,0,0,0
2020-09-01,TWN,Melaka,0,0,0
2020-09-01,TWN,Negeri Sembilan,0,0,0
2020-09-01,TWN,Pahang,0,0,0
2020-09-01,TWN,Perak,0,0,0
2020-09-01,TWN,Perlis,0,0,0
2020-09-01,TWN,Pulau Pinang,5,3,2
2020-09-01,TWN,Sabah,0,0,0
2020-09-01,TWN,Sarawak,2,1,1
2020-09-01,TWN,Selangor,95,63,32
2020-09-01,TWN,W.P. Labuan,0,0,0
2020-09-01,TZA,Johor,0,0,0
2020-09-01,TZA,Kedah,0,0,0
2020-09-01,TZA,Perak,0,0,0
2020-09-01,TZA,Perlis,0,0,0
2020-09-01,TZA,Pulau Pinang,0,0,0
2020-09-01,TZA,Sabah,0,0,0
2020-09-01,TZA,Sarawak,0,0,0
2020-09-01,TZA,Selangor,7,3,4
2020-09-01,UGA,Johor,0,0,0
2020-09-01,UGA,Kedah,0,0,0
2020-09-01,UGA,Perak,0,0,0
2020-09-01,UGA,Perlis,0,0,0
2020-09-01,UGA,Pulau Pinang,0,0,0
2020-09-01,UGA,Sabah,0,0,0
2020-09-01,UGA,Sarawak,0,0,0
2020-09-01,UGA,Selangor,0,0,0
2020-09-01,UKR,Johor,31,31,0
2020-09-01,UKR,Kedah,0,0,0
2020-09-01,UKR,Kelantan,0,0,0
2020-09-01,UKR,Melaka,0,0,0
2020-09-01,UKR,Negeri Sembilan,0,0,0
2020-09-01,UKR,Pahang,0,0,0
2020-09-01,UKR,Perak,0,0,0
2020-09-01,UKR,Perlis,0,0,0
2020-09-01,UKR,Pulau Pinang,0,0,0
2020-09-01,UKR,Sabah,0,0,0
2020-09-01,UKR,Sarawak,0,0,0
2020-09-01,UKR,Selangor,112,110,2
2020-09-01,UKR,W.P. Labuan,0,0,0
2020-09-01,URY,Johor,0,0,0
2020-09-01,URY,Kedah,0,0,0
2020-09-01,URY,Kelantan,0,0,0
2020-09-01,URY,Perak,0,0,0
2020-09-01,URY,Perlis,0,0,0
2020-09-01,URY,Pulau Pinang,0,0,0
2020-09-01,URY,Sabah,0,0,0
2020-09-01,URY,Sarawak,0,0,0
2020-09-01,URY,Selangor,0,0,0
2020-09-01,URY,W.P. Labuan,0,0,0
2020-09-01,USA,Johor,0,0,0
2020-09-01,USA,Kedah,0,0,0
2020-09-01,USA,Kelantan,0,0,0
2020-09-01,USA,Melaka,0,0,0
2020-09-01,USA,Negeri Sembilan,0,0,0
2020-09-01,USA,Pahang,0,0,0
2020-09-01,USA,Perak,0,0,0
2020-09-01,USA,Perlis,0,0,0
2020-09-01,USA,Pulau Pinang,1,1,0
2020-09-01,USA,Sabah,1,1,0
2020-09-01,USA,Sarawak,0,0,0
2020-09-01,USA,Selangor,179,104,75
2020-09-01,USA,Terengganu,0,0,0
2020-09-01,USA,W.P. Labuan,0,0,0
2020-09-01,UZB,Johor,0,0,0
2020-09-01,UZB,Kedah,0,0,0
2020-09-01,UZB,Kelantan,0,0,0
2020-09-01,UZB,Perak,0,0,0
2020-09-01,UZB,Perlis,0,0,0
2020-09-01,UZB,Pulau Pinang,0,0,0
2020-09-01,UZB,Sabah,0,0,0
2020-09-01,UZB,Sarawak,0,0,0
2020-09-01,UZB,Selangor,9,4,5
2020-09-01,VAT,Johor,0,0,0
2020-09-01,VAT,Sarawak,0,0,0
2020-09-01,VAT,Selangor,1,1,0
2020-09-01,VCT,Johor,0,0,0
2020-09-01,VCT,Kedah,0,0,0
2020-09-01,VCT,Pulau Pinang,0,0,0
2020-09-01,VCT,Sarawak,0,0,0
2020-09-01,VCT,Selangor,0,0,0
2020-09-01,VEN,Johor,0,0,0
2020-09-01,VEN,Kedah,0,0,0
2020-09-01,VEN,Kelantan,0,0,0
2020-09-01,VEN,Melaka,0,0,0
2020-09-01,VEN,Perak,0,0,0
2020-09-01,VEN,Perlis,0,0,0
2020-09-01,VEN,Pulau Pinang,0,0,0
2020-09-01,VEN,Sabah,0,0,0
2020-09-01,VEN,Sarawak,0,0,0
2020-09-01,VEN,Selangor,1,0,1
2020-09-01,VEN,W.P. Labuan,0,0,0
2020-09-01,VNM,Johor,4,0,4
2020-09-01,VNM,Kedah,0,0,0
2020-09-01,VNM,Kelantan,0,0,0
2020-09-01,VNM,Melaka,0,0,0
2020-09-01,VNM,Negeri Sembilan,0,0,0
2020-09-01,VNM,Pahang,0,0,0
2020-09-01,VNM,Perak,0,0,0
2020-09-01,VNM,Perlis,0,0,0
2020-09-01,VNM,Pulau Pinang,0,0,0
2020-09-01,VNM,Sabah,0,0,0
2020-09-01,VNM,Sarawak,1,0,1
2020-09-01,VNM,Selangor,93,26,67
2020-09-01,VNM,Terengganu,0,0,0
2020-09-01,VNM,W.P. Labuan,0,0,0
2020-09-01,VUT,Johor,0,0,0
2020-09-01,VUT,Kedah,0,0,0
2020-09-01,VUT,Pulau Pinang,0,0,0
2020-09-01,VUT,Sabah,0,0,0
2020-09-01,VUT,Sarawak,0,0,0
2020-09-01,VUT,Selangor,1,1,0
2020-09-01,WSM,Johor,0,0,0
2020-09-01,WSM,Sarawak,0,0,0
2020-09-01,WSM,Selangor,0,0,0
2020-09-01,XXX,Johor,0,0,0
2020-09-01,XXX,Kedah,0,0,0
2020-09-01,XXX,Kelantan,0,0,0
2020-09-01,XXX,Melaka,0,0,0
2020-09-01,XXX,Pahang,0,0,0
2020-09-01,XXX,Perak,0,0,0
2020-09-01,XXX,Perlis,0,0,0
2020-09-01,XXX,Pulau Pinang,0,0,0
2020-09-01,XXX,Sabah,0,0,0
2020-09-01,XXX,Sarawak,0,0,0
2020-09-01,XXX,Selangor,9,6,3
2020-09-01,XXX,W.P. Labuan,0,0,0
2020-09-01,YEM,Johor,0,0,0
2020-09-01,YEM,Kedah,0,0,0
2020-09-01,YEM,Kelantan,0,0,0
2020-09-01,YEM,Melaka,0,0,0
2020-09-01,YEM,Pahang,0,0,0
2020-09-01,YEM,Perak,0,0,0
2020-09-01,YEM,Perlis,0,0,0
2020-09-01,YEM,Pulau Pinang,0,0,0
2020-09-01,YEM,Sabah,0,0,0
2020-09-01,YEM,Sarawak,0,0,0
2020-09-01,YEM,Selangor,25,20,5
2020-09-01,YEM,W.P. Labuan,0,0,0
2020-09-01,ZAF,Johor,0,0,0
2020-09-01,ZAF,Kedah,0,0,0
2020-09-01,ZAF,Kelantan,0,0,0
2020-09-01,ZAF,Melaka,0,0,0
2020-09-01,ZAF,Pahang,0,0,0
2020-09-01,ZAF,Perak,0,0,0
2020-09-01,ZAF,Perlis,0,0,0
2020-09-01,ZAF,Pulau Pinang,0,0,0
2020-09-01,ZAF,Sabah,0,0,0
2020-09-01,ZAF,Sarawak,0,0,0
2020-09-01,ZAF,Selangor,23,14,9
2020-09-01,ZAF,Terengganu,0,0,0
2020-09-01,ZAF,W.P. Labuan,0,0,0
2020-09-01,ZAR,Selangor,0,0,0
2020-09-01,ZMB,Johor,0,0,0
2020-09-01,ZMB,Kedah,0,0,0
2020-09-01,ZMB,Perak,0,0,0
2020-09-01,ZMB,Perlis,0,0,0
2020-09-01,ZMB,Pulau Pinang,0,0,0
2020-09-01,ZMB,Sabah,0,0,0
2020-09-01,ZMB,Sarawak,0,0,0
2020-09-01,ZMB,Selangor,8,4,4
2020-09-01,ZWE,Johor,0,0,0
2020-09-01,ZWE,Kedah,0,0,0
2020-09-01,ZWE,Kelantan,0,0,0
2020-09-01,ZWE,Perak,0,0,0
2020-09-01,ZWE,Perlis,0,0,0
2020-09-01,ZWE,Pulau Pinang,0,0,0
2020-09-01,ZWE,Sabah,0,0,0
2020-09-01,ZWE,Sarawak,0,0,0
2020-09-01,ZWE,Selangor,0,0,0
2020-10-01,ABW,Kedah,0,0,0
2020-10-01,ABW,Pulau Pinang,0,0,0
2020-10-01,AFG,Johor,0,0,0
2020-10-01,AFG,Kedah,0,0,0
2020-10-01,AFG,Perlis,0,0,0
2020-10-01,AFG,Pulau Pinang,0,0,0
2020-10-01,AFG,Sarawak,0,0,0
2020-10-01,AFG,Selangor,12,7,5
2020-10-01,AGO,Johor,0,0,0
2020-10-01,AGO,Kedah,0,0,0
2020-10-01,AGO,Sabah,0,0,0
2020-10-01,AGO,Selangor,0,0,0
2020-10-01,AIA,Selangor,0,0,0
2020-10-01,ALB,Johor,0,0,0
2020-10-01,ALB,Kedah,0,0,0
2020-10-01,ALB,Perak,0,0,0
2020-10-01,ALB,Perlis,0,0,0
2020-10-01,ALB,Pulau Pinang,0,0,0
2020-10-01,ALB,Sabah,0,0,0
2020-10-01,ALB,Sarawak,0,0,0
2020-10-01,ALB,Selangor,3,2,1
2020-10-01,AND,Johor,0,0,0
2020-10-01,AND,Kedah,0,0,0
2020-10-01,AND,Perlis,0,0,0
2020-10-01,AND,Pulau Pinang,0,0,0
2020-10-01,AND,Selangor,0,0,0
2020-10-01,ANT,Selangor,0,0,0
2020-10-01,ARE,Johor,0,0,0
2020-10-01,ARE,Kedah,0,0,0
2020-10-01,ARE,Kelantan,0,0,0
2020-10-01,ARE,Perak,0,0,0
2020-10-01,ARE,Perlis,0,0,0
2020-10-01,ARE,Pulau Pinang,0,0,0
2020-10-01,ARE,Sabah,0,0,0
2020-10-01,ARE,Sarawak,0,0,0
2020-10-01,ARE,Selangor,6,4,2
2020-10-01,ARG,Johor,0,0,0
2020-10-01,ARG,Kedah,0,0,0
2020-10-01,ARG,Kelantan,0,0,0
2020-10-01,ARG,Melaka,0,0,0
2020-10-01,ARG,Perak,0,0,0
2020-10-01,ARG,Perlis,0,0,0
2020-10-01,ARG,Pulau Pinang,0,0,0
2020-10-01,ARG,Sabah,0,0,0
2020-10-01,ARG,Sarawak,0,0,0
2020-10-01,ARG,Selangor,1,0,1
2020-10-01,ARG,W.P. Labuan,0,0,0
2020-10-01,ARM,Johor,0,0,0
2020-10-01,ARM,Kedah,0,0,0
2020-10-01,ARM,Kelantan,0,0,0
2020-10-01,ARM,Perak,0,0,0
2020-10-01,ARM,Perlis,0,0,0
2020-10-01,ARM,Pulau Pinang,0,0,0
2020-10-01,ARM,Sabah,0,0,0
2020-10-01,ARM,Sarawak,0,0,0
2020-10-01,ARM,Selangor,0,0,0
2020-10-01,ATA,Selangor,0,0,0
2020-10-01,ATG,Johor,0,0,0
2020-10-01,ATG,Kedah,0,0,0
2020-10-01,ATG,Pulau Pinang,0,0,0
2020-10-01,ATG,Sarawak,0,0,0
2020-10-01,ATG,Selangor,1,1,0
2020-10-01,AUS,Johor,3,3,0
2020-10-01,AUS,Kedah,0,0,0
2020-10-01,AUS,Kelantan,0,0,0
2020-10-01,AUS,Melaka,0,0,0
2020-10-01,AUS,Negeri Sembilan,0,0,0
2020-10-01,AUS,Pahang,0,0,0
2020-10-01,AUS,Perak,0,0,0
2020-10-01,AUS,Perlis,0,0,0
2020-10-01,AUS,Pulau Pinang,5,2,3
2020-10-01,AUS,Sabah,0,0,0
2020-10-01,AUS,Sarawak,4,1,3
2020-10-01,AUS,Selangor,89,60,29
2020-10-01,AUS,Terengganu,0,0,0
2020-10-01,AUS,W.P. Labuan,0,0,0
2020-10-01,AUT,Johor,1,1,0
2020-10-01,AUT,Kedah,0,0,0
2020-10-01,AUT,Kelantan,0,0,0
2020-10-01,AUT,Melaka,0,0,0
2020-10-01,AUT,Negeri Sembilan,0,0,0
2020-10-01,AUT,Pahang,0,0,0
2020-10-01,AUT,Perak,0,0,0
2020-10-01,AUT,Perlis,0,0,0
2020-10-01,AUT,Pulau Pinang,0,0,0
2020-10-01,AUT,Sabah,1,1,0
2020-10-01,AUT,Sarawak,0,0,0
2020-10-01,AUT,Selangor,6,4,2
2020-10-01,AUT,Terengganu,0,0,0
2020-10-01,AUT,W.P. Labuan,0,0,0
2020-10-01,AZE,Johor,0,0,0
2020-10-01,AZE,Kedah,0,0,0
2020-10-01,AZE,Kelantan,0,0,0
2020-10-01,AZE,Melaka,0,0,0
2020-10-01,AZE,Perlis,0,0,0
2020-10-01,AZE,Pulau Pinang,0,0,0
2020-10-01,AZE,Sabah,0,0,0
2020-10-01,AZE,Sarawak,0,0,0
2020-10-01,AZE,Selangor,4,2,2
2020-10-01,AZE,W.P. Labuan,0,0,0
2020-10-01,BDI,Pulau Pinang,0,0,0
2020-10-01,BDI,Sarawak,0,0,0
2020-10-01,BDI,Selangor,0,0,0
2020-10-01,BEL,Johor,0,0,0
2020-10-01,BEL,Kedah,0,0,0
2020-10-01,BEL,Kelantan,0,0,0
2020-10-01,BEL,Melaka,0,0,0
2020-10-01,BEL,Negeri Sembilan,0,0,0
2020-10-01,BEL,Pahang,0,0,0
2020-10-01,BEL,Perak,1,1,0
2020-10-01,BEL,Perlis,0,0,0
2020-10-01,BEL,Pulau Pinang,0,0,0
2020-10-01,BEL,Sabah,0,0,0
2020-10-01,BEL,Sarawak,0,0,0
2020-10-01,BEL,Selangor,20,13,7
2020-10-01,BEL,W.P. Labuan,0,0,0
2020-10-01,BEN,Johor,0,0,0
2020-10-01,BEN,Kedah,0,0,0
2020-10-01,BEN,Perak,0,0,0
2020-10-01,BEN,Pulau Pinang,0,0,0
2020-10-01,BEN,Sabah,0,0,0
2020-10-01,BEN,Sarawak,0,0,0
2020-10-01,BEN,Selangor,0,0,0
2020-10-01,BFA,Perak,0,0,0
2020-10-01,BFA,Pulau Pinang,0,0,0
2020-10-01,BFA,Selangor,0,0,0
2020-10-01,BGD,Johor,2,2,0
2020-10-01,BGD,Kedah,0,0,0
2020-10-01,BGD,Kelantan,0,0,0
2020-10-01,BGD,Melaka,0,0,0
2020-10-01,BGD,Negeri Sembilan,0,0,0
2020-10-01,BGD,Pahang,0,0,0
2020-10-01,BGD,Perak,0,0,0
2020-10-01,BGD,Perlis,0,0,0
2020-10-01,BGD,Pulau Pinang,0,0,0
2020-10-01,BGD,Sabah,0,0,0
2020-10-01,BGD,Sarawak,0,0,0
2020-10-01,BGD,Selangor,61,57,4
2020-10-01,BGD,W.P. Labuan,0,0,0
2020-10-01,BGR,Johor,0,0,0
2020-10-01,BGR,Kedah,0,0,0
2020-10-01,BGR,Kelantan,0,0,0
2020-10-01,BGR,Pahang,0,0,0
2020-10-01,BGR,Perak,0,0,0
2020-10-01,BGR,Perlis,0,0,0
2020-10-01,BGR,Pulau Pinang,0,0,0
2020-10-01,BGR,Sabah,0,0,0
2020-10-01,BGR,Sarawak,0,0,0
2020-10-01,BGR,Selangor,17,16,1
2020-10-01,BGR,W.P. Labuan,0,0,0
2020-10-01,BHR,Johor,0,0,0
2020-10-01,BHR,Kedah,0,0,0
2020-10-01,BHR,Kelantan,0,0,0
2020-10-01,BHR,Perlis,0,0,0
2020-10-01,BHR,Pulau Pinang,0,0,0
2020-10-01,BHR,Sabah,0,0,0
2020-10-01,BHR,Sarawak,0,0,0
2020-10-01,BHR,Selangor,2,1,1
2020-10-01,BHS,Johor,0,0,0
2020-10-01,BHS,Kedah,0,0,0
2020-10-01,BHS,Perak,0,0,0
2020-10-01,BHS,Sabah,0,0,0
2020-10-01,BHS,Sarawak,0,0,0
2020-10-01,BHS,Selangor,0,0,0
2020-10-01,BIH,Johor,0,0,0
2020-10-01,BIH,Kedah,0,0,0
2020-10-01,BIH,Perlis,0,0,0
2020-10-01,BIH,Pulau Pinang,0,0,0
2020-10-01,BIH,Sabah,0,0,0
2020-10-01,BIH,Sarawak,0,0,0
2020-10-01,BIH,Selangor,10,6,4
2020-10-01,BLR,Johor,0,0,0
2020-10-01,BLR,Kedah,0,0,0
2020-10-01,BLR,Kelantan,0,0,0
2020-10-01,BLR,Pahang,0,0,0
2020-10-01,BLR,Perak,0,0,0
2020-10-01,BLR,Perlis,0,0,0
2020-10-01,BLR,Pulau Pinang,0,0,0
2020-10-01,BLR,Sabah,0,0,0
2020-10-01,BLR,Sarawak,0,0,0
2020-10-01,BLR,Selangor,1,0,1
2020-10-01,BLR,W.P. Labuan,0,0,0
2020-10-01,BLZ,Johor,0,0,0
2020-10-01,BLZ,Pulau Pinang,0,0,0
2020-10-01,BLZ,Sarawak,0,0,0
2020-10-01,BLZ,Selangor,1,0,1
2020-10-01,BMU,Selangor,0,0,0
2020-10-01,BOL,Johor,0,0,0
2020-10-01,BOL,Kedah,0,0,0
2020-10-01,BOL,Melaka,0,0,0
2020-10-01,BOL,Perak,0,0,0
2020-10-01,BOL,Perlis,0,0,0
2020-10-01,BOL,Pulau Pinang,0,0,0
2020-10-01,BOL,Sabah,0,0,0
2020-10-01,BOL,Sarawak,0,0,0
2020-10-01,BOL,Selangor,0,0,0
2020-10-01,BRA,Johor,0,0,0
2020-10-01,BRA,Kedah,0,0,0
2020-10-01,BRA,Kelantan,0,0,0
2020-10-01,BRA,Melaka,0,0,0
2020-10-01,BRA,Pahang,0,0,0
2020-10-01,BRA,Perak,0,0,0
2020-10-01,BRA,Perlis,0,0,0
2020-10-01,BRA,Pulau Pinang,0,0,0
2020-10-01,BRA,Sabah,0,0,0
2020-10-01,BRA,Sarawak,0,0,0
2020-10-01,BRA,Selangor,10,8,2
2020-10-01,BRA,W.P. Labuan,0,0,0
2020-10-01,BRB,Johor,0,0,0
2020-10-01,BRB,Kedah,0,0,0
2020-10-01,BRB,Perlis,0,0,0
2020-10-01,BRB,Pulau Pinang,0,0,0
2020-10-01,BRB,Selangor,0,0,0
2020-10-01,BRN,Johor,1,1,0
2020-10-01,BRN,Kedah,0,0,0
2020-10-01,BRN,Kelantan,0,0,0
2020-10-01,BRN,Melaka,0,0,0
2020-10-01,BRN,Pahang,0,0,0
2020-10-01,BRN,Perak,0,0,0
2020-10-01,BRN,Perlis,0,0,0
2020-10-01,BRN,Pulau Pinang,0,0,0
2020-10-01,BRN,Sabah,0,0,0
2020-10-01,BRN,Sarawak,198,188,10
2020-10-01,BRN,Selangor,29,15,14
2020-10-01,BRN,W.P. Labuan,0,0,0
2020-10-01,BTN,Johor,0,0,0
2020-10-01,BTN,Kedah,0,0,0
2020-10-01,BTN,Perak,0,0,0
2020-10-01,BTN,Perlis,0,0,0
2020-10-01,BTN,Pulau Pinang,0,0,0
2020-10-01,BTN,Sabah,0,0,0
2020-10-01,BTN,Sarawak,0,0,0
2020-10-01,BTN,Selangor,1,0,1
2020-10-01,BWA,Johor,0,0,0
2020-10-01,BWA,Kedah,0,0,0
2020-10-01,BWA,Perlis,0,0,0
2020-10-01,BWA,Pulau Pinang,0,0,0
2020-10-01,BWA,Sabah,0,0,0
2020-10-01,BWA,Sarawak,0,0,0
2020-10-01,BWA,Selangor,0,0,0
2020-10-01,CAF,Kedah,0,0,0
2020-10-01,CAF,Selangor,0,0,0
2020-10-01,CAN,Johor,1,1,0
2020-10-01,CAN,Kedah,0,0,0
2020-10-01,CAN,Kelantan,0,0,0
2020-10-01,CAN,Melaka,0,0,0
2020-10-01,CAN,Negeri Sembilan,0,0,0
2020-10-01,CAN,Pahang,0,0,0
2020-10-01,CAN,Perak,0,0,0
2020-10-01,CAN,Perlis,0,0,0
2020-10-01,CAN,Pulau Pinang,2,1,1
2020-10-01,CAN,Sabah,0,0,0
2020-10-01,CAN,Sarawak,0,0,0
2020-10-01,CAN,Selangor,40,26,14
2020-10-01,CAN,Terengganu,0,0,0
2020-10-01,CAN,W.P. Labuan,0,0,0
2020-10-01,CCK,Selangor,0,0,0
2020-10-01,CHE,Johor,0,0,0
2020-10-01,CHE,Kedah,0,0,0
2020-10-01,CHE,Kelantan,0,0,0
2020-10-01,CHE,Melaka,0,0,0
2020-10-01,CHE,Negeri Sembilan,0,0,0
2020-10-01,CHE,Pahang,0,0,0
2020-10-01,CHE,Perak,0,0,0
2020-10-01,CHE,Perlis,0,0,0
2020-10-01,CHE,Pulau Pinang,2,2,0
2020-10-01,CHE,Sabah,0,0,0
2020-10-01,CHE,Sarawak,0,0,0
2020-10-01,CHE,Selangor,21,12,9
2020-10-01,CHE,W.P. Labuan,0,0,0
2020-10-01,CHL,Johor,0,0,0
2020-10-01,CHL,Kedah,0,0,0
2020-10-01,CHL,Kelantan,0,0,0
2020-10-01,CHL,Melaka,0,0,0
2020-10-01,CHL,Pahang,0,0,0
2020-10-01,CHL,Perak,0,0,0
2020-10-01,CHL,Perlis,0,0,0
2020-10-01,CHL,Pulau Pinang,0,0,0
2020-10-01,CHL,Sabah,0,0,0
2020-10-01,CHL,Sarawak,0,0,0
2020-10-01,CHL,Selangor,4,4,0
2020-10-01,CHN,Johor,43,32,11
2020-10-01,CHN,Kedah,0,0,0
2020-10-01,CHN,Kelantan,0,0,0
2020-10-01,CHN,Melaka,0,0,0
2020-10-01,CHN,Pahang,0,0,0
2020-10-01,CHN,Perak,0,0,0
2020-10-01,CHN,Perlis,0,0,0
2020-10-01,CHN,Pulau Pinang,3,2,1
2020-10-01,CHN,Sabah,0,0,0
2020-10-01,CHN,Sarawak,101,55,46
2020-10-01,CHN,Selangor,1142,908,234
2020-10-01,CHN,Terengganu,0,0,0
2020-10-01,CHN,W.P. Labuan,0,0,0
2020-10-01,CIV,Johor,0,0,0
2020-10-01,CIV,Kedah,0,0,0
2020-10-01,CIV,Pulau Pinang,0,0,0
2020-10-01,CIV,Sabah,0,0,0
2020-10-01,CIV,Sarawak,0,0,0
2020-10-01,CIV,Selangor,0,0,0
2020-10-01,CMR,Johor,0,0,0
2020-10-01,CMR,Kedah,0,0,0
2020-10-01,CMR,Pulau Pinang,0,0,0
2020-10-01,CMR,Sabah,0,0,0
2020-10-01,CMR,Sarawak,0,0,0
2020-10-01,CMR,Selangor,0,0,0
2020-10-01,COD,Johor,0,0,0
2020-10-01,COD,Pulau Pinang,0,0,0
2020-10-01,COD,Sarawak,0,0,0
2020-10-01,COD,Selangor,1,0,1
2020-10-01,COG,Johor,0,0,0
2020-10-01,COG,Kedah,0,0,0
2020-10-01,COG,Selangor,0,0,0
2020-10-01,COK,Selangor,0,0,0
2020-10-01,COL,Johor,0,0,0
2020-10-01,COL,Kedah,0,0,0
2020-10-01,COL,Perak,0,0,0
2020-10-01,COL,Pulau Pinang,0,0,0
2020-10-01,COL,Sabah,0,0,0
2020-10-01,COL,Sarawak,0,0,0
2020-10-01,COL,Selangor,1,1,0
2020-10-01,COL,W.P. Labuan,0,0,0
2020-10-01,COM,Johor,0,0,0
2020-10-01,COM,Kedah,0,0,0
2020-10-01,COM,Selangor,2,0,2
2020-10-01,CPV,Johor,0,0,0
2020-10-01,CPV,Kedah,0,0,0
2020-10-01,CPV,Pulau Pinang,0,0,0
2020-10-01,CPV,Sabah,0,0,0
2020-10-01,CPV,Selangor,0,0,0
2020-10-01,CRI,Johor,2,2,0
2020-10-01,CRI,Kedah,0,0,0
2020-10-01,CRI,Perak,0,0,0
2020-10-01,CRI,Perlis,0,0,0
2020-10-01,CRI,Pulau Pinang,0,0,0
2020-10-01,CRI,Sabah,0,0,0
2020-10-01,CRI,Sarawak,0,0,0
2020-10-01,CRI,Selangor,1,1,0
2020-10-01,CUB,Johor,0,0,0
2020-10-01,CUB,Kedah,0,0,0
2020-10-01,CUB,Perlis,0,0,0
2020-10-01,CUB,Pulau Pinang,0,0,0
2020-10-01,CUB,Sabah,0,0,0
2020-10-01,CUB,Sarawak,0,0,0
2020-10-01,CUB,Selangor,0,0,0
2020-10-01,CYP,Johor,0,0,0
2020-10-01,CYP,Kedah,0,0,0
2020-10-01,CYP,Perak,0,0,0
2020-10-01,CYP,Perlis,0,0,0
2020-10-01,CYP,Pulau Pinang,0,0,0
2020-10-01,CYP,Sabah,0,0,0
2020-10-01,CYP,Sarawak,0,0,0
2020-10-01,CYP,Selangor,0,0,0
2020-10-01,CZE,Johor,0,0,0
2020-10-01,CZE,Kedah,0,0,0
2020-10-01,CZE,Kelantan,0,0,0
2020-10-01,CZE,Melaka,0,0,0
2020-10-01,CZE,Negeri Sembilan,0,0,0
2020-10-01,CZE,Perak,0,0,0
2020-10-01,CZE,Perlis,0,0,0
2020-10-01,CZE,Pulau Pinang,0,0,0
2020-10-01,CZE,Sabah,0,0,0
2020-10-01,CZE,Sarawak,0,0,0
2020-10-01,CZE,Selangor,5,4,1
2020-10-01,CZE,W.P. Labuan,0,0,0
2020-10-01,DEU,Johor,1,1,0
2020-10-01,DEU,Kedah,0,0,0
2020-10-01,DEU,Kelantan,0,0,0
2020-10-01,DEU,Melaka,0,0,0
2020-10-01,DEU,Negeri Sembilan,0,0,0
2020-10-01,DEU,Pahang,0,0,0
2020-10-01,DEU,Perak,0,0,0
2020-10-01,DEU,Perlis,0,0,0
2020-10-01,DEU,Pulau Pinang,1,0,1
2020-10-01,DEU,Sabah,0,0,0
2020-10-01,DEU,Sarawak,0,0,0
2020-10-01,DEU,Selangor,110,87,23
2020-10-01,DEU,Terengganu,0,0,0
2020-10-01,DEU,W.P. Labuan,0,0,0
2020-10-01,DJI,Johor,0,0,0
2020-10-01,DJI,Selangor,2,2,0
2020-10-01,DMA,Johor,0,0,0
2020-10-01,DMA,Kedah,0,0,0
2020-10-01,DMA,Pulau Pinang,0,0,0
2020-10-01,DMA,Sabah,0,0,0
2020-10-01,DMA,Sarawak,0,0,0
2020-10-01,DMA,Selangor,0,0,0
2020-10-01,DMA,W.P. Labuan,0,0,0
2020-10-01,DNK,Johor,8,8,0
2020-10-01,DNK,Kedah,0,0,0
2020-10-01,DNK,Kelantan,0,0,0
2020-10-01,DNK,Melaka,0,0,0
2020-10-01,DNK,Negeri Sembilan,0,0,0
2020-10-01,DNK,Pahang,0,0,0
2020-10-01,DNK,Perak,0,0,0
2020-10-01,DNK,Perlis,0,0,0
2020-10-01,DNK,Pulau Pinang,0,0,0
2020-10-01,DNK,Sabah,0,0,0
2020-10-01,DNK,Sarawak,1,1,0
2020-10-01,DNK,Selangor,19,17,2
2020-10-01,DNK,W.P. Labuan,0,0,0
2020-10-01,DOM,Johor,0,0,0
2020-10-01,DOM,Kedah,0,0,0
2020-10-01,DOM,Perak,0,0,0
2020-10-01,DOM,Perlis,0,0,0
2020-10-01,DOM,Pulau Pinang,0,0,0
2020-10-01,DOM,Sabah,0,0,0
2020-10-01,DOM,Sarawak,0,0,0
2020-10-01,DOM,Selangor,0,0,0
2020-10-01,DZA,Johor,0,0,0
2020-10-01,DZA,Kedah,0,0,0
2020-10-01,DZA,Kelantan,0,0,0
2020-10-01,DZA,Melaka,0,0,0
2020-10-01,DZA,Perak,0,0,0
2020-10-01,DZA,Perlis,0,0,0
2020-10-01,DZA,Pulau Pinang,0,0,0
2020-10-01,DZA,Sabah,0,0,0
2020-10-01,DZA,Sarawak,0,0,0
2020-10-01,DZA,Selangor,1,1,0
2020-10-01,DZA,W.P. Labuan,0,0,0
2020-10-01,ECU,Johor,0,0,0
2020-10-01,ECU,Kedah,0,0,0
2020-10-01,ECU,Perak,0,0,0
2020-10-01,ECU,Perlis,0,0,0
2020-10-01,ECU,Pulau Pinang,0,0,0
2020-10-01,ECU,Sabah,0,0,0
2020-10-01,ECU,Sarawak,0,0,0
2020-10-01,ECU,Selangor,0,0,0
2020-10-01,EGY,Johor,0,0,0
2020-10-01,EGY,Kedah,0,0,0
2020-10-01,EGY,Kelantan,0,0,0
2020-10-01,EGY,Melaka,0,0,0
2020-10-01,EGY,Pahang,0,0,0
2020-10-01,EGY,Perak,0,0,0
2020-10-01,EGY,Perlis,0,0,0
2020-10-01,EGY,Pulau Pinang,0,0,0
2020-10-01,EGY,Sabah,0,0,0
2020-10-01,EGY,Sarawak,1,1,0
2020-10-01,EGY,Selangor,52,38,14
2020-10-01,EGY,Terengganu,0,0,0
2020-10-01,EGY,W.P. Labuan,0,0,0
2020-10-01,ERI,Johor,0,0,0
2020-10-01,ERI,Pulau Pinang,0,0,0
2020-10-01,ERI,Sabah,0,0,0
2020-10-01,ERI,Selangor,0,0,0
2020-10-01,ESP,Johor,0,0,0
2020-10-01,ESP,Kedah,0,0,0
2020-10-01,ESP,Kelantan,0,0,0
2020-10-01,ESP,Melaka,0,0,0
2020-10-01,ESP,Negeri Sembilan,0,0,0
2020-10-01,ESP,Pahang,0,0,0
2020-10-01,ESP,Perak,0,0,0
2020-10-01,ESP,Perlis,0,0,0
2020-10-01,ESP,Pulau Pinang,0,0,0
2020-10-01,ESP,Sabah,0,0,0
2020-10-01,ESP,Sarawak,0,0,0
2020-10-01,ESP,Selangor,12,6,6
2020-10-01,ESP,W.P. Labuan,0,0,0
2020-10-01,EST,Johor,0,0,0
2020-10-01,EST,Kedah,0,0,0
2020-10-01,EST,Kelantan,0,0,0
2020-10-01,EST,Pahang,0,0,0
2020-10-01,EST,Perak,0,0,0
2020-10-01,EST,Perlis,0,0,0
2020-10-01,EST,Pulau Pinang,0,0,0
2020-10-01,EST,Sabah,0,0,0
2020-10-01,EST,Sarawak,0,0,0
2020-10-01,EST,Selangor,0,0,0
2020-10-01,EST,W.P. Labuan,0,0,0
2020-10-01,ETH,Johor,0,0,0
2020-10-01,ETH,Kedah,0,0,0
2020-10-01,ETH,Pulau Pinang,0,0,0
2020-10-01,ETH,Sarawak,0,0,0
2020-10-01,ETH,Selangor,0,0,0
2020-10-01,FIN,Johor,0,0,0
2020-10-01,FIN,Kedah,0,0,0
2020-10-01,FIN,Kelantan,0,0,0
2020-10-01,FIN,Melaka,0,0,0
2020-10-01,FIN,Negeri Sembilan,0,0,0
2020-10-01,FIN,Pahang,0,0,0
2020-10-01,FIN,Perak,0,0,0
2020-10-01,FIN,Perlis,0,0,0
2020-10-01,FIN,Pulau Pinang,0,0,0
2020-10-01,FIN,Sabah,0,0,0
2020-10-01,FIN,Sarawak,0,0,0
2020-10-01,FIN,Selangor,2,1,1
2020-10-01,FIN,W.P. Labuan,0,0,0
2020-10-01,FJI,Johor,0,0,0
2020-10-01,FJI,Kedah,0,0,0
2020-10-01,FJI,Kelantan,0,0,0
2020-10-01,FJI,Perak,0,0,0
2020-10-01,FJI,Perlis,0,0,0
2020-10-01,FJI,Pulau Pinang,0,0,0
2020-10-01,FJI,Sabah,0,0,0
2020-10-01,FJI,Sarawak,0,0,0
2020-10-01,FJI,Selangor,0,0,0
2020-10-01,FRA,Johor,2,2,0
2020-10-01,FRA,Kedah,0,0,0
2020-10-01,FRA,Kelantan,0,0,0
2020-10-01,FRA,Melaka,0,0,0
2020-10-01,FRA,Negeri Sembilan,0,0,0
2020-10-01,FRA,Pahang,0,0,0
2020-10-01,FRA,Perak,0,0,0
2020-10-01,FRA,Perlis,0,0,0
2020-10-01,FRA,Pulau Pinang,0,0,0
2020-10-01,FRA,Sabah,0,0,0
2020-10-01,FRA,Sarawak,0,0,0
2020-10-01,FRA,Selangor,78,48,30
2020-10-01,FRA,Terengganu,0,0,0
2020-10-01,FRA,W.P. Labuan,0,0,0
2020-10-01,FSM,Johor,0,0,0
2020-10-01,FSM,Pulau Pinang,0,0,0
2020-10-01,FSM,Selangor,0,0,0
2020-10-01,GAB,Johor,0,0,0
2020-10-01,GAB,Pulau Pinang,0,0,0
2020-10-01,GAB,Sarawak,0,0,0
2020-10-01,GAB,Selangor,0,0,0
2020-10-01,GBR,Johor,4,4,0
2020-10-01,GBR,Kedah,0,0,0
2020-10-01,GBR,Kelantan,0,0,0
2020-10-01,GBR,Melaka,0,0,0
2020-10-01,GBR,Negeri Sembilan,0,0,0
2020-10-01,GBR,Pahang,0,0,0
2020-10-01,GBR,Perak,0,0,0
2020-10-01,GBR,Perlis,0,0,0
2020-10-01,GBR,Pulau Pinang,5,5,0
2020-10-01,GBR,Sabah,1,1,0
2020-10-01,GBR,Sarawak,0,0,0
2020-10-01,GBR,Selangor,209,156,53
2020-10-01,GBR,Terengganu,0,0,0
2020-10-01,GBR,W.P. Labuan,0,0,0
2020-10-01,GEO,Johor,0,0,0
2020-10-01,GEO,Kedah,0,0,0
2020-10-01,GEO,Melaka,0,0,0
2020-10-01,GEO,Perak,0,0,0
2020-10-01,GEO,Perlis,0,0,0
2020-10-01,GEO,Pulau Pinang,0,0,0
2020-10-01,GEO,Sabah,0,0,0
2020-10-01,GEO,Sarawak,0,0,0
2020-10-01,GEO,Selangor,9,8,1
2020-10-01,GHA,Johor,0,0,0
2020-10-01,GHA,Kedah,0,0,0
2020-10-01,GHA,Kelantan,0,0,0
2020-10-01,GHA,Pulau Pinang,0,0,0
2020-10-01,GHA,Sabah,0,0,0
2020-10-01,GHA,Sarawak,0,0,0
2020-10-01,GHA,Selangor,2,1,1
2020-10-01,GIB,Johor,0,0,0
2020-10-01,GIB,Sarawak,0,0,0
2020-10-01,GIN,Johor,0,0,0
2020-10-01,GIN,Kedah,0,0,0
2020-10-01,GIN,Kelantan,0,0,0
2020-10-01,GIN,Perlis,0,0,0
2020-10-01,GIN,Pulau Pinang,0,0,0
2020-10-01,GIN,Sabah,0,0,0
2020-10-01,GIN,Sarawak,0,0,0
2020-10-01,GIN,Selangor,0,0,0
2020-10-01,GLP,Selangor,0,0,0
2020-10-01,GMB,Johor,0,0,0
2020-10-01,GMB,Kedah,0,0,0
2020-10-01,GMB,Kelantan,0,0,0
2020-10-01,GMB,Pulau Pinang,0,0,0
2020-10-01,GMB,Sabah,0,0,0
2020-10-01,GMB,Sarawak,0,0,0
2020-10-01,GMB,Selangor,0,0,0
2020-10-01,GNB,Johor,0,0,0
2020-10-01,GNB,Selangor,0,0,0
2020-10-01,GNQ,Johor,0,0,0
2020-10-01,GNQ,Selangor,0,0,0
2020-10-01,GRC,Johor,0,0,0
2020-10-01,GRC,Kedah,0,0,0
2020-10-01,GRC,Kelantan,0,0,0
2020-10-01,GRC,Melaka,0,0,0
2020-10-01,GRC,Negeri Sembilan,0,0,0
2020-10-01,GRC,Pahang,0,0,0
2020-10-01,GRC,Perak,0,0,0
2020-10-01,GRC,Perlis,0,0,0
2020-10-01,GRC,Pulau Pinang,0,0,0
2020-10-01,GRC,Sabah,0,0,0
2020-10-01,GRC,Sarawak,0,0,0
2020-10-01,GRC,Selangor,14,13,1
2020-10-01,GRD,Johor,0,0,0
2020-10-01,GRD,Kedah,0,0,0
2020-10-01,GRD,Pulau Pinang,0,0,0
2020-10-01,GRD,Sabah,0,0,0
2020-10-01,GRD,Sarawak,0,0,0
2020-10-01,GRD,Selangor,0,0,0
2020-10-01,GRL,Johor,0,0,0
2020-10-01,GRL,Selangor,0,0,0
2020-10-01,GTM,Johor,0,0,0
2020-10-01,GTM,Kedah,0,0,0
2020-10-01,GTM,Pahang,0,0,0
2020-10-01,GTM,Perak,0,0,0
2020-10-01,GTM,Pulau Pinang,0,0,0
2020-10-01,GTM,Sabah,0,0,0
2020-10-01,GTM,Sarawak,0,0,0
2020-10-01,GTM,Selangor,0,0,0
2020-10-01,GTM,W.P. Labuan,0,0,0
2020-10-01,GUY,Johor,0,0,0
2020-10-01,GUY,Kedah,0,0,0
2020-10-01,GUY,Pulau Pinang,0,0,0
2020-10-01,GUY,Sarawak,0,0,0
2020-10-01,GUY,Selangor,0,0,0
2020-10-01,HKG,Johor,0,0,0
2020-10-01,HKG,Kedah,0,0,0
2020-10-01,HKG,Kelantan,0,0,0
2020-10-01,HKG,Pahang,0,0,0
2020-10-01,HKG,Perak,0,0,0
2020-10-01,HKG,Perlis,0,0,0
2020-10-01,HKG,Pulau Pinang,0,0,0
2020-10-01,HKG,Sabah,0,0,0
2020-10-01,HKG,Sarawak,0,0,0
2020-10-01,HKG,Selangor,0,0,0
2020-10-01,HKG,Terengganu,0,0,0
2020-10-01,HMD,Johor,0,0,0
2020-10-01,HND,Johor,0,0,0
2020-10-01,HND,Kedah,0,0,0
2020-10-01,HND,Perak,0,0,0
2020-10-01,HND,Pulau Pinang,0,0,0
2020-10-01,HND,Sabah,0,0,0
2020-10-01,HND,Sarawak,0,0,0
2020-10-01,HND,Selangor,3,3,0
2020-10-01,HRV,Johor,0,0,0
2020-10-01,HRV,Kedah,0,0,0
2020-10-01,HRV,Kelantan,0,0,0
2020-10-01,HRV,Melaka,0,0,0
2020-10-01,HRV,Pahang,0,0,0
2020-10-01,HRV,Perak,0,0,0
2020-10-01,HRV,Perlis,0,0,0
2020-10-01,HRV,Pulau Pinang,0,0,0
2020-10-01,HRV,Sabah,0,0,0
2020-10-01,HRV,Sarawak,0,0,0
2020-10-01,HRV,Selangor,10,9,1
2020-10-01,HTI,Johor,0,0,0
2020-10-01,HTI,Kedah,0,0,0
2020-10-01,HTI,Kelantan,0,0,0
2020-10-01,HTI,Perak,0,0,0
2020-10-01,HTI,Pulau Pinang,0,0,0
2020-10-01,HTI,Sabah,0,0,0
2020-10-01,HTI,Selangor,0,0,0
2020-10-01,HUN,Johor,0,0,0
2020-10-01,HUN,Kedah,0,0,0
2020-10-01,HUN,Kelantan,0,0,0
2020-10-01,HUN,Pahang,0,0,0
2020-10-01,HUN,Perak,0,0,0
2020-10-01,HUN,Perlis,0,0,0
2020-10-01,HUN,Pulau Pinang,0,0,0
2020-10-01,HUN,Sabah,0,0,0
2020-10-01,HUN,Sarawak,0,0,0
2020-10-01,HUN,Selangor,4,2,2
2020-10-01,HUN,W.P. Labuan,0,0,0
2020-10-01,IDN,Johor,238,227,11
2020-10-01,IDN,Kedah,3,3,0
2020-10-01,IDN,Kelantan,0,0,0
2020-10-01,IDN,Melaka,2,1,1
2020-10-01,IDN,Negeri Sembilan,0,0,0
2020-10-01,IDN,Pahang,0,0,0
2020-10-01,IDN,Perak,0,0,0
2020-10-01,IDN,Perlis,7,5,2
2020-10-01,IDN,Pulau Pinang,2,2,0
2020-10-01,IDN,Sabah,0,0,0
2020-10-01,IDN,Sarawak,276,260,16
2020-10-01,IDN,Selangor,445,369,76
2020-10-01,IDN,Terengganu,0,0,0
2020-10-01,IDN,W.P. Labuan,1,1,0
2020-10-01,IND,Johor,39,37,2
2020-10-01,IND,Kedah,0,0,0
2020-10-01,IND,Kelantan,0,0,0
2020-10-01,IND,Melaka,0,0,0
2020-10-01,IND,Negeri Sembilan,0,0,0
2020-10-01,IND,Pahang,0,0,0
2020-10-01,IND,Perak,0,0,0
2020-10-01,IND,Perlis,0,0,0
2020-10-01,IND,Pulau Pinang,0,0,0
2020-10-01,IND,Sabah,0,0,0
2020-10-01,IND,Sarawak,0,0,0
2020-10-01,IND,Selangor,353,305,48
2020-10-01,IND,Terengganu,0,0,0
2020-10-01,IND,W.P. Labuan,0,0,0
2020-10-01,IOT,Pulau Pinang,0,0,0
2020-10-01,IOT,Selangor,0,0,0
2020-10-01,IRL,Johor,0,0,0
2020-10-01,IRL,Kedah,0,0,0
2020-10-01,IRL,Kelantan,0,0,0
2020-10-01,IRL,Negeri Sembilan,0,0,0
2020-10-01,IRL,Pahang,0,0,0
2020-10-01,IRL,Perak,0,0,0
2020-10-01,IRL,Perlis,0,0,0
2020-10-01,IRL,Pulau Pinang,0,0,0
2020-10-01,IRL,Sabah,0,0,0
2020-10-01,IRL,Sarawak,0,0,0
2020-10-01,IRL,Selangor,19,11,8
2020-10-01,IRL,Terengganu,0,0,0
2020-10-01,IRL,W.P. Labuan,0,0,0
2020-10-01,IRN,Johor,0,0,0
2020-10-01,IRN,Kedah,0,0,0
2020-10-01,IRN,Kelantan,0,0,0
2020-10-01,IRN,Perak,0,0,0
2020-10-01,IRN,Perlis,0,0,0
2020-10-01,IRN,Pulau Pinang,0,0,0
2020-10-01,IRN,Sabah,0,0,0
2020-10-01,IRN,Sarawak,0,0,0
2020-10-01,IRN,Selangor,30,13,17
2020-10-01,IRN,W.P. Labuan,0,0,0
2020-10-01,IRQ,Johor,0,0,0
2020-10-01,IRQ,Kedah,0,0,0
2020-10-01,IRQ,Kelantan,0,0,0
2020-10-01,IRQ,Melaka,0,0,0
2020-10-01,IRQ,Pahang,0,0,0
2020-10-01,IRQ,Perak,0,0,0
2020-10-01,IRQ,Perlis,0,0,0
2020-10-01,IRQ,Pulau Pinang,0,0,0
2020-10-01,IRQ,Sabah,0,0,0
2020-10-01,IRQ,Sarawak,0,0,0
2020-10-01,IRQ,Selangor,10,6,4
2020-10-01,ISL,Johor,0,0,0
2020-10-01,ISL,Kedah,0,0,0
2020-10-01,ISL,Kelantan,0,0,0
2020-10-01,ISL,Perak,0,0,0
2020-10-01,ISL,Perlis,0,0,0
2020-10-01,ISL,Pulau Pinang,0,0,0
2020-10-01,ISL,Sabah,0,0,0
2020-10-01,ISL,Sarawak,0,0,0
2020-10-01,ISL,Selangor,0,0,0
2020-10-01,ISL,W.P. Labuan,0,0,0
2020-10-01,ISR,Pulau Pinang,0,0,0
2020-10-01,ITA,Johor,0,0,0
2020-10-01,ITA,Kedah,0,0,0
2020-10-01,ITA,Kelantan,0,0,0
2020-10-01,ITA,Melaka,0,0,0
2020-10-01,ITA,Negeri Sembilan,0,0,0
2020-10-01,ITA,Pahang,0,0,0
2020-10-01,ITA,Perak,0,0,0
2020-10-01,ITA,Perlis,0,0,0
2020-10-01,ITA,Pulau Pinang,0,0,0
2020-10-01,ITA,Sabah,0,0,0
2020-10-01,ITA,Sarawak,0,0,0
2020-10-01,ITA,Selangor,38,34,4
2020-10-01,ITA,W.P. Labuan,0,0,0
2020-10-01,JAM,Johor,0,0,0
2020-10-01,JAM,Kedah,0,0,0
2020-10-01,JAM,Perak,0,0,0
2020-10-01,JAM,Pulau Pinang,0,0,0
2020-10-01,JAM,Sabah,0,0,0
2020-10-01,JAM,Sarawak,0,0,0
2020-10-01,JAM,Selangor,0,0,0
2020-10-01,JAM,W.P. Labuan,0,0,0
2020-10-01,JOR,Johor,0,0,0
2020-10-01,JOR,Kedah,0,0,0
2020-10-01,JOR,Kelantan,0,0,0
2020-10-01,JOR,Melaka,0,0,0
2020-10-01,JOR,Perlis,0,0,0
2020-10-01,JOR,Pulau Pinang,0,0,0
2020-10-01,JOR,Sabah,0,0,0
2020-10-01,JOR,Sarawak,0,0,0
2020-10-01,JOR,Selangor,5,4,1
2020-10-01,JOR,W.P. Labuan,0,0,0
2020-10-01,JPN,Johor,6,6,0
2020-10-01,JPN,Kedah,0,0,0
2020-10-01,JPN,Kelantan,0,0,0
2020-10-01,JPN,Melaka,0,0,0
2020-10-01,JPN,Negeri Sembilan,0,0,0
2020-10-01,JPN,Pahang,0,0,0
2020-10-01,JPN,Perak,0,0,0
2020-10-01,JPN,Perlis,0,0,0
2020-10-01,JPN,Pulau Pinang,3,3,0
2020-10-01,JPN,Sabah,0,0,0
2020-10-01,JPN,Sarawak,0,0,0
2020-10-01,JPN,Selangor,481,323,158
2020-10-01,JPN,W.P. Labuan,0,0,0
2020-10-01,KAZ,Johor,0,0,0
2020-10-01,KAZ,Kedah,0,0,0
2020-10-01,KAZ,Kelantan,0,0,0
2020-10-01,KAZ,Melaka,0,0,0
2020-10-01,KAZ,Perak,0,0,0
2020-10-01,KAZ,Perlis,0,0,0
2020-10-01,KAZ,Pulau Pinang,0,0,0
2020-10-01,KAZ,Sabah,0,0,0
2020-10-01,KAZ,Sarawak,0,0,0
2020-10-01,KAZ,Selangor,2,0,2
2020-10-01,KAZ,W.P. Labuan,0,0,0
2020-10-01,KEN,Johor,0,0,0
2020-10-01,KEN,Kedah,0,0,0
2020-10-01,KEN,Kelantan,0,0,0
2020-10-01,KEN,Perak,0,0,0
2020-10-01,KEN,Perlis,0,0,0
2020-10-01,KEN,Pulau Pinang,0,0,0
2020-10-01,KEN,Sabah,0,0,0
2020-10-01,KEN,Sarawak,0,0,0
2020-10-01,KEN,Selangor,6,2,4
2020-10-01,KGZ,Johor,0,0,0
2020-10-01,KGZ,Kedah,0,0,0
2020-10-01,KGZ,Kelantan,0,0,0
2020-10-01,KGZ,Perak,0,0,0
2020-10-01,KGZ,Perlis,0,0,0
2020-10-01,KGZ,Pulau Pinang,0,0,0
2020-10-01,KGZ,Sabah,0,0,0
2020-10-01,KGZ,Sarawak,0,0,0
2020-10-01,KGZ,Selangor,4,3,1
2020-10-01,KHM,Johor,0,0,0
2020-10-01,KHM,Kedah,0,0,0
2020-10-01,KHM,Kelantan,0,0,0
2020-10-01,KHM,Melaka,0,0,0
2020-10-01,KHM,Negeri Sembilan,0,0,0
2020-10-01,KHM,Pahang,0,0,0
2020-10-01,KHM,Perak,0,0,0
2020-10-01,KHM,Perlis,22,22,0
2020-10-01,KHM,Pulau Pinang,0,0,0
2020-10-01,KHM,Sabah,0,0,0
2020-10-01,KHM,Sarawak,0,0,0
2020-10-01,KHM,Selangor,5,3,2
2020-10-01,KHM,W.P. Labuan,0,0,0
2020-10-01,KIR,Johor,0,0,0
2020-10-01,KIR,Sabah,0,0,0
2020-10-01,KIR,Selangor,12,12,0
2020-10-01,KNA,Johor,0,0,0
2020-10-01,KNA,Kedah,0,0,0
2020-10-01,KNA,Perlis,0,0,0
2020-10-01,KNA,Pulau Pinang,0,0,0
2020-10-01,KNA,Sabah,0,0,0
2020-10-01,KNA,Selangor,2,2,0
2020-10-01,KNA,W.P. Labuan,0,0,0
2020-10-01,KOR,Johor,4,4,0
2020-10-01,KOR,Kedah,0,0,0
2020-10-01,KOR,Kelantan,0,0,0
2020-10-01,KOR,Melaka,0,0,0
2020-10-01,KOR,Negeri Sembilan,0,0,0
2020-10-01,KOR,Pahang,0,0,0
2020-10-01,KOR,Perak,0,0,0
2020-10-01,KOR,Perlis,0,0,0
2020-10-01,KOR,Pulau Pinang,1,1,0
2020-10-01,KOR,Sabah,0,0,0
2020-10-01,KOR,Sarawak,1,1,0
2020-10-01,KOR,Selangor,305,173,132
2020-10-01,KOR,Terengganu,0,0,0
2020-10-01,KOR,W.P. Labuan,0,0,0
2020-10-01,KWT,Johor,0,0,0
2020-10-01,KWT,Kedah,0,0,0
2020-10-01,KWT,Kelantan,0,0,0
2020-10-01,KWT,Perak,0,0,0
2020-10-01,KWT,Perlis,0,0,0
2020-10-01,KWT,Pulau Pinang,0,0,0
2020-10-01,KWT,Sabah,0,0,0
2020-10-01,KWT,Sarawak,0,0,0
2020-10-01,KWT,Selangor,3,3,0
2020-10-01,KWT,W.P. Labuan,0,0,0
2020-10-01,LAO,Johor,0,0,0
2020-10-01,LAO,Kedah,0,0,0
2020-10-01,LAO,Kelantan,0,0,0
2020-10-01,LAO,Melaka,0,0,0
2020-10-01,LAO,Perak,0,0,0
2020-10-01,LAO,Perlis,0,0,0
2020-10-01,LAO,Pulau Pinang,0,0,0
2020-10-01,LAO,Sabah,0,0,0
2020-10-01,LAO,Sarawak,0,0,0
2020-10-01,LAO,Selangor,3,3,0
2020-10-01,LAO,W.P. Labuan,0,0,0
2020-10-01,LBN,Johor,0,0,0
2020-10-01,LBN,Kedah,0,0,0
2020-10-01,LBN,Kelantan,0,0,0
2020-10-01,LBN,Pahang,0,0,0
2020-10-01,LBN,Perak,0,0,0
2020-10-01,LBN,Perlis,0,0,0
2020-10-01,LBN,Pulau Pinang,0,0,0
2020-10-01,LBN,Sabah,0,0,0
2020-10-01,LBN,Sarawak,0,0,0
2020-10-01,LBN,Selangor,3,1,2
2020-10-01,LBN,W.P. Labuan,0,0,0
2020-10-01,LBR,Johor,0,0,0
2020-10-01,LBR,Kedah,0,0,0
2020-10-01,LBR,Sabah,0,0,0
2020-10-01,LBR,Sarawak,0,0,0
2020-10-01,LBR,Selangor,0,0,0
2020-10-01,LBY,Johor,2,2,0
2020-10-01,LBY,Kedah,0,0,0
2020-10-01,LBY,Perlis,0,0,0
2020-10-01,LBY,Pulau Pinang,0,0,0
2020-10-01,LBY,Sabah,0,0,0
2020-10-01,LBY,Sarawak,0,0,0
2020-10-01,LBY,Selangor,3,3,0
2020-10-01,LCA,Johor,0,0,0
2020-10-01,LCA,Kedah,0,0,0
2020-10-01,LCA,Pulau Pinang,0,0,0
2020-10-01,LCA,Sarawak,0,0,0
2020-10-01,LCA,Selangor,1,1,0
2020-10-01,LIE,Johor,0,0,0
2020-10-01,LIE,Kedah,0,0,0
2020-10-01,LIE,Perlis,0,0,0
2020-10-01,LIE,Pulau Pinang,0,0,0
2020-10-01,LIE,Sabah,0,0,0
2020-10-01,LIE,Sarawak,0,0,0
2020-10-01,LIE,Selangor,0,0,0
2020-10-01,LKA,Johor,2,2,0
2020-10-01,LKA,Kedah,0,0,0
2020-10-01,LKA,Kelantan,0,0,0
2020-10-01,LKA,Melaka,0,0,0
2020-10-01,LKA,Pahang,0,0,0
2020-10-01,LKA,Perak,0,0,0
2020-10-01,LKA,Perlis,0,0,0
2020-10-01,LKA,Pulau Pinang,0,0,0
2020-10-01,LKA,Sabah,0,0,0
2020-10-01,LKA,Sarawak,0,0,0
2020-10-01,LKA,Selangor,23,19,4
2020-10-01,LKA,W.P. Labuan,0,0,0
2020-10-01,LSO,Johor,0,0,0
2020-10-01,LSO,Kedah,0,0,0
2020-10-01,LSO,Pulau Pinang,0,0,0
2020-10-01,LSO,Sarawak,0,0,0
2020-10-01,LSO,Selangor,0,0,0
2020-10-01,LTU,Johor,0,0,0
2020-10-01,LTU,Kedah,0,0,0
2020-10-01,LTU,Kelantan,0,0,0
2020-10-01,LTU,Pahang,0,0,0
2020-10-01,LTU,Perak,0,0,0
2020-10-01,LTU,Perlis,0,0,0
2020-10-01,LTU,Pulau Pinang,0,0,0
2020-10-01,LTU,Sabah,0,0,0
2020-10-01,LTU,Sarawak,0,0,0
2020-10-01,LTU,Selangor,7,4,3
2020-10-01,LTU,W.P. Labuan,0,0,0
2020-10-01,LUX,Johor,0,0,0
2020-10-01,LUX,Kedah,0,0,0
2020-10-01,LUX,Kelantan,0,0,0
2020-10-01,LUX,Perak,0,0,0
2020-10-01,LUX,Perlis,0,0,0
2020-10-01,LUX,Pulau Pinang,0,0,0
2020-10-01,LUX,Sabah,0,0,0
2020-10-01,LUX,Sarawak,0,0,0
2020-10-01,LUX,Selangor,2,2,0
2020-10-01,LVA,Johor,0,0,0
2020-10-01,LVA,Kedah,0,0,0
2020-10-01,LVA,Kelantan,0,0,0
2020-10-01,LVA,Pahang,0,0,0
2020-10-01,LVA,Perak,0,0,0
2020-10-01,LVA,Perlis,0,0,0
2020-10-01,LVA,Pulau Pinang,0,0,0
2020-10-01,LVA,Sabah,0,0,0
2020-10-01,LVA,Sarawak,0,0,0
2020-10-01,LVA,Selangor,4,3,1
2020-10-01,LVA,W.P. Labuan,0,0,0
2020-10-01,MAC,Johor,0,0,0
2020-10-01,MAC,Pahang,0,0,0
2020-10-01,MAC,Perak,0,0,0
2020-10-01,MAC,Selangor,0,0,0
2020-10-01,MAC,W.P. Labuan,0,0,0
2020-10-01,MAR,Johor,0,0,0
2020-10-01,MAR,Kedah,0,0,0
2020-10-01,MAR,Kelantan,0,0,0
2020-10-01,MAR,Melaka,0,0,0
2020-10-01,MAR,Pahang,0,0,0
2020-10-01,MAR,Perak,0,0,0
2020-10-01,MAR,Perlis,0,0,0
2020-10-01,MAR,Pulau Pinang,0,0,0
2020-10-01,MAR,Sabah,0,0,0
2020-10-01,MAR,Sarawak,0,0,0
2020-10-01,MAR,Selangor,10,7,3
2020-10-01,MAR,W.P. Labuan,0,0,0
2020-10-01,MCO,Johor,0,0,0
2020-10-01,MCO,Kedah,0,0,0
2020-10-01,MCO,Sabah,0,0,0
2020-10-01,MCO,Selangor,0,0,0
2020-10-01,MDA,Johor,0,0,0
2020-10-01,MDA,Kedah,0,0,0
2020-10-01,MDA,Kelantan,0,0,0
2020-10-01,MDA,Negeri Sembilan,0,0,0
2020-10-01,MDA,Perlis,0,0,0
2020-10-01,MDA,Pulau Pinang,0,0,0
2020-10-01,MDA,Sabah,0,0,0
2020-10-01,MDA,Sarawak,0,0,0
2020-10-01,MDA,Selangor,0,0,0
2020-10-01,MDG,Johor,0,0,0
2020-10-01,MDG,Kedah,0,0,0
2020-10-01,MDG,Perak,0,0,0
2020-10-01,MDG,Perlis,0,0,0
2020-10-01,MDG,Pulau Pinang,0,0,0
2020-10-01,MDG,Sabah,0,0,0
2020-10-01,MDG,Sarawak,0,0,0
2020-10-01,MDG,Selangor,0,0,0
2020-10-01,MDV,Johor,0,0,0
2020-10-01,MDV,Kedah,0,0,0
2020-10-01,MDV,Kelantan,0,0,0
2020-10-01,MDV,Perak,0,0,0
2020-10-01,MDV,Perlis,0,0,0
2020-10-01,MDV,Pulau Pinang,0,0,0
2020-10-01,MDV,Sabah,0,0,0
2020-10-01,MDV,Sarawak,0,0,0
2020-10-01,MDV,Selangor,83,30,53
2020-10-01,MEX,Johor,2,2,0
2020-10-01,MEX,Kedah,0,0,0
2020-10-01,MEX,Kelantan,0,0,0
2020-10-01,MEX,Pahang,0,0,0
2020-10-01,MEX,Perak,0,0,0
2020-10-01,MEX,Perlis,0,0,0
2020-10-01,MEX,Pulau Pinang,0,0,0
2020-10-01,MEX,Sabah,0,0,0
2020-10-01,MEX,Sarawak,0,0,0
2020-10-01,MEX,Selangor,12,10,2
2020-10-01,MEX,W.P. Labuan,0,0,0
2020-10-01,MHL,Johor,0,0,0
2020-10-01,MHL,Kedah,0,0,0
2020-10-01,MHL,Perak,0,0,0
2020-10-01,MHL,Pulau Pinang,0,0,0
2020-10-01,MHL,Sabah,0,0,0
2020-10-01,MHL,Selangor,0,0,0
2020-10-01,MKD,Johor,0,0,0
2020-10-01,MKD,Kedah,0,0,0
2020-10-01,MKD,Perak,0,0,0
2020-10-01,MKD,Pulau Pinang,0,0,0
2020-10-01,MKD,Sabah,0,0,0
2020-10-01,MKD,Sarawak,0,0,0
2020-10-01,MKD,Selangor,4,2,2
2020-10-01,MLI,Johor,0,0,0
2020-10-01,MLI,Sabah,0,0,0
2020-10-01,MLI,Selangor,1,1,0
2020-10-01,MLT,Johor,0,0,0
2020-10-01,MLT,Kedah,0,0,0
2020-10-01,MLT,Kelantan,0,0,0
2020-10-01,MLT,Perak,0,0,0
2020-10-01,MLT,Perlis,0,0,0
2020-10-01,MLT,Pulau Pinang,0,0,0
2020-10-01,MLT,Sabah,0,0,0
2020-10-01,MLT,Sarawak,0,0,0
2020-10-01,MLT,Selangor,1,1,0
2020-10-01,MLT,W.P. Labuan,0,0,0
2020-10-01,MMR,Johor,14,14,0
2020-10-01,MMR,Kedah,0,0,0
2020-10-01,MMR,Kelantan,0,0,0
2020-10-01,MMR,Negeri Sembilan,0,0,0
2020-10-01,MMR,Pahang,0,0,0
2020-10-01,MMR,Perak,0,0,0
2020-10-01,MMR,Perlis,0,0,0
2020-10-01,MMR,Pulau Pinang,2,1,1
2020-10-01,MMR,Sabah,0,0,0
2020-10-01,MMR,Sarawak,0,0,0
2020-10-01,MMR,Selangor,64,56,8
2020-10-01,MMR,Terengganu,0,0,0
2020-10-01,MMR,W.P. Labuan,0,0,0
2020-10-01,MNE,Johor,0,0,0
2020-10-01,MNE,Kedah,0,0,0
2020-10-01,MNE,Pulau Pinang,0,0,0
2020-10-01,MNE,Sabah,0,0,0
2020-10-01,MNE,Sarawak,0,0,0
2020-10-01,MNE,Selangor,0,0,0
2020-10-01,MNG,Johor,0,0,0
2020-10-01,MNG,Kedah,0,0,0
2020-10-01,MNG,Kelantan,0,0,0
2020-10-01,MNG,Perak,0,0,0
2020-10-01,MNG,Perlis,0,0,0
2020-10-01,MNG,Pulau Pinang,0,0,0
2020-10-01,MNG,Sabah,0,0,0
2020-10-01,MNG,Sarawak,0,0,0
2020-10-01,MNG,Selangor,4,2,2
2020-10-01,MNP,Selangor,0,0,0
2020-10-01,MOZ,Johor,0,0,0
2020-10-01,MOZ,Kedah,0,0,0
2020-10-01,MOZ,Perak,0,0,0
2020-10-01,MOZ,Pulau Pinang,0,0,0
2020-10-01,MOZ,Sabah,0,0,0
2020-10-01,MOZ,Sarawak,0,0,0
2020-10-01,MOZ,Selangor,1,0,1
2020-10-01,MRT,Johor,0,0,0
2020-10-01,MRT,Kedah,0,0,0
2020-10-01,MRT,Pulau Pinang,0,0,0
2020-10-01,MRT,Sabah,0,0,0
2020-10-01,MRT,Sarawak,0,0,0
2020-10-01,MRT,Selangor,0,0,0
2020-10-01,MUS,Johor,0,0,0
2020-10-01,MUS,Kedah,0,0,0
2020-10-01,MUS,Kelantan,0,0,0
2020-10-01,MUS,Pahang,0,0,0
2020-10-01,MUS,Perak,0,0,0
2020-10-01,MUS,Perlis,0,0,0
2020-10-01,MUS,Pulau Pinang,0,0,0
2020-10-01,MUS,Sabah,0,0,0
2020-10-01,MUS,Sarawak,0,0,0
2020-10-01,MUS,Selangor,11,5,6
2020-10-01,MWI,Johor,0,0,0
2020-10-01,MWI,Pulau Pinang,0,0,0
2020-10-01,MWI,Sabah,0,0,0
2020-10-01,MWI,Sarawak,0,0,0
2020-10-01,MWI,Selangor,0,0,0
2020-10-01,MYT,Selangor,0,0,0
2020-10-01,NAM,Johor,0,0,0
2020-10-01,NAM,Kedah,0,0,0
2020-10-01,NAM,Perak,0,0,0
2020-10-01,NAM,Perlis,0,0,0
2020-10-01,NAM,Pulau Pinang,0,0,0
2020-10-01,NAM,Sabah,0,0,0
2020-10-01,NAM,Sarawak,0,0,0
2020-10-01,NAM,Selangor,1,1,0
2020-10-01,NCL,Selangor,0,0,0
2020-10-01,NER,Johor,0,0,0
2020-10-01,NER,Sabah,0,0,0
2020-10-01,NER,Selangor,0,0,0
2020-10-01,NGA,Johor,0,0,0
2020-10-01,NGA,Kedah,0,0,0
2020-10-01,NGA,Perlis,0,0,0
2020-10-01,NGA,Pulau Pinang,0,0,0
2020-10-01,NGA,Sabah,0,0,0
2020-10-01,NGA,Sarawak,0,0,0
2020-10-01,NGA,Selangor,24,18,6
2020-10-01,NIC,Johor,0,0,0
2020-10-01,NIC,Kedah,0,0,0
2020-10-01,NIC,Pulau Pinang,0,0,0
2020-10-01,NIC,Sabah,0,0,0
2020-10-01,NIC,Selangor,2,1,1
2020-10-01,NLD,Johor,3,3,0
2020-10-01,NLD,Kedah,0,0,0
2020-10-01,NLD,Kelantan,0,0,0
2020-10-01,NLD,Melaka,0,0,0
2020-10-01,NLD,Negeri Sembilan,0,0,0
2020-10-01,NLD,Pahang,0,0,0
2020-10-01,NLD,Perak,0,0,0
2020-10-01,NLD,Perlis,0,0,0
2020-10-01,NLD,Pulau Pinang,0,0,0
2020-10-01,NLD,Sabah,0,0,0
2020-10-01,NLD,Sarawak,0,0,0
2020-10-01,NLD,Selangor,53,42,11
2020-10-01,NLD,Terengganu,0,0,0
2020-10-01,NLD,W.P. Labuan,0,0,0
2020-10-01,NOR,Johor,0,0,0
2020-10-01,NOR,Kedah,0,0,0
2020-10-01,NOR,Kelantan,0,0,0
2020-10-01,NOR,Melaka,0,0,0
2020-10-01,NOR,Pahang,0,0,0
2020-10-01,NOR,Perak,0,0,0
2020-10-01,NOR,Perlis,0,0,0
2020-10-01,NOR,Pulau Pinang,0,0,0
2020-10-01,NOR,Sabah,0,0,0
2020-10-01,NOR,Sarawak,0,0,0
2020-10-01,NOR,Selangor,8,7,1
2020-10-01,NOR,W.P. Labuan,0,0,0
2020-10-01,NPL,Johor,0,0,0
2020-10-01,NPL,Kedah,0,0,0
2020-10-01,NPL,Pahang,0,0,0
2020-10-01,NPL,Perak,0,0,0
2020-10-01,NPL,Perlis,0,0,0
2020-10-01,NPL,Pulau Pinang,0,0,0
2020-10-01,NPL,Sabah,0,0,0
2020-10-01,NPL,Sarawak,0,0,0
2020-10-01,NPL,Selangor,49,43,6
2020-10-01,NPL,W.P. Labuan,0,0,0
2020-10-01,NRU,Johor,0,0,0
2020-10-01,NRU,Pulau Pinang,0,0,0
2020-10-01,NRU,Selangor,0,0,0
2020-10-01,NZL,Johor,1,1,0
2020-10-01,NZL,Kedah,0,0,0
2020-10-01,NZL,Kelantan,0,0,0
2020-10-01,NZL,Melaka,0,0,0
2020-10-01,NZL,Negeri Sembilan,0,0,0
2020-10-01,NZL,Pahang,0,0,0
2020-10-01,NZL,Perak,0,0,0
2020-10-01,NZL,Perlis,0,0,0
2020-10-01,NZL,Pulau Pinang,0,0,0
2020-10-01,NZL,Sabah,0,0,0
2020-10-01,NZL,Sarawak,0,0,0
2020-10-01,NZL,Selangor,28,21,7
2020-10-01,NZL,Terengganu,0,0,0
2020-10-01,NZL,W.P. Labuan,0,0,0
2020-10-01,OMN,Johor,0,0,0
2020-10-01,OMN,Kedah,0,0,0
2020-10-01,OMN,Kelantan,0,0,0
2020-10-01,OMN,Melaka,0,0,0
2020-10-01,OMN,Perak,0,0,0
2020-10-01,OMN,Perlis,0,0,0
2020-10-01,OMN,Pulau Pinang,0,0,0
2020-10-01,OMN,Sabah,0,0,0
2020-10-01,OMN,Sarawak,0,0,0
2020-10-01,OMN,Selangor,9,7,2
2020-10-01,PAK,Johor,2,2,0
2020-10-01,PAK,Kedah,0,0,0
2020-10-01,PAK,Kelantan,0,0,0
2020-10-01,PAK,Melaka,0,0,0
2020-10-01,PAK,Negeri Sembilan,0,0,0
2020-10-01,PAK,Pahang,0,0,0
2020-10-01,PAK,Perak,0,0,0
2020-10-01,PAK,Perlis,0,0,0
2020-10-01,PAK,Pulau Pinang,0,0,0
2020-10-01,PAK,Sabah,0,0,0
2020-10-01,PAK,Sarawak,0,0,0
2020-10-01,PAK,Selangor,76,45,31
2020-10-01,PAK,W.P. Labuan,0,0,0
2020-10-01,PAN,Johor,0,0,0
2020-10-01,PAN,Kedah,0,0,0
2020-10-01,PAN,Perak,0,0,0
2020-10-01,PAN,Perlis,0,0,0
2020-10-01,PAN,Pulau Pinang,0,0,0
2020-10-01,PAN,Sabah,0,0,0
2020-10-01,PAN,Sarawak,0,0,0
2020-10-01,PAN,Selangor,0,0,0
2020-10-01,PER,Johor,2,2,0
2020-10-01,PER,Kedah,0,0,0
2020-10-01,PER,Kelantan,0,0,0
2020-10-01,PER,Pahang,0,0,0
2020-10-01,PER,Perak,0,0,0
2020-10-01,PER,Perlis,0,0,0
2020-10-01,PER,Pulau Pinang,0,0,0
2020-10-01,PER,Sabah,0,0,0
2020-10-01,PER,Sarawak,0,0,0
2020-10-01,PER,Selangor,0,0,0
2020-10-01,PER,W.P. Labuan,0,0,0
2020-10-01,PHL,Johor,37,36,1
2020-10-01,PHL,Kedah,0,0,0
2020-10-01,PHL,Kelantan,0,0,0
2020-10-01,PHL,Melaka,0,0,0
2020-10-01,PHL,Negeri Sembilan,0,0,0
2020-10-01,PHL,Pahang,0,0,0
2020-10-01,PHL,Perak,0,0,0
2020-10-01,PHL,Perlis,0,0,0
2020-10-01,PHL,Pulau Pinang,2,2,0
2020-10-01,PHL,Sabah,0,0,0
2020-10-01,PHL,Sarawak,32,32,0
2020-10-01,PHL,Selangor,380,346,34
2020-10-01,PHL,Terengganu,0,0,0
2020-10-01,PHL,W.P. Labuan,4,4,0
2020-10-01,PLW,Johor,0,0,0
2020-10-01,PLW,Pulau Pinang,0,0,0
2020-10-01,PLW,Selangor,0,0,0
2020-10-01,PNG,Johor,0,0,0
2020-10-01,PNG,Kedah,0,0,0
2020-10-01,PNG,Kelantan,0,0,0
2020-10-01,PNG,Perak,0,0,0
2020-10-01,PNG,Pulau Pinang,0,0,0
2020-10-01,PNG,Sabah,0,0,0
2020-10-01,PNG,Sarawak,0,0,0
2020-10-01,PNG,Selangor,0,0,0
2020-10-01,POL,Johor,4,4,0
2020-10-01,POL,Kedah,0,0,0
2020-10-01,POL,Kelantan,0,0,0
2020-10-01,POL,Melaka,0,0,0
2020-10-01,POL,Negeri Sembilan,0,0,0
2020-10-01,POL,Pahang,0,0,0
2020-10-01,POL,Perak,0,0,0
2020-10-01,POL,Perlis,0,0,0
2020-10-01,POL,Pulau Pinang,0,0,0
2020-10-01,POL,Sabah,0,0,0
2020-10-01,POL,Sarawak,0,0,0
2020-10-01,POL,Selangor,22,20,2
2020-10-01,POL,Terengganu,0,0,0
2020-10-01,POL,W.P. Labuan,0,0,0
2020-10-01,PRK,Selangor,0,0,0
2020-10-01,PRT,Johor,1,1,0
2020-10-01,PRT,Kedah,0,0,0
2020-10-01,PRT,Kelantan,0,0,0
2020-10-01,PRT,Melaka,0,0,0
2020-10-01,PRT,Pahang,0,0,0
2020-10-01,PRT,Perak,0,0,0
2020-10-01,PRT,Perlis,0,0,0
2020-10-01,PRT,Pulau Pinang,0,0,0
2020-10-01,PRT,Sabah,0,0,0
2020-10-01,PRT,Sarawak,0,0,0
2020-10-01,PRT,Selangor,15,9,6
2020-10-01,PRT,W.P. Labuan,0,0,0
2020-10-01,PRY,Johor,0,0,0
2020-10-01,PRY,Kedah,0,0,0
2020-10-01,PRY,Perak,0,0,0
2020-10-01,PRY,Perlis,0,0,0
2020-10-01,PRY,Pulau Pinang,0,0,0
2020-10-01,PRY,Sabah,0,0,0
2020-10-01,PRY,Sarawak,0,0,0
2020-10-01,PRY,Selangor,0,0,0
2020-10-01,PSE,Johor,0,0,0
2020-10-01,PSE,Kedah,0,0,0
2020-10-01,PSE,Kelantan,0,0,0
2020-10-01,PSE,Melaka,0,0,0
2020-10-01,PSE,Perak,0,0,0
2020-10-01,PSE,Perlis,0,0,0
2020-10-01,PSE,Pulau Pinang,0,0,0
2020-10-01,PSE,Sabah,0,0,0
2020-10-01,PSE,Sarawak,0,0,0
2020-10-01,PSE,Selangor,10,8,2
2020-10-01,QAT,Johor,0,0,0
2020-10-01,QAT,Kedah,0,0,0
2020-10-01,QAT,Perlis,0,0,0
2020-10-01,QAT,Pulau Pinang,0,0,0
2020-10-01,QAT,Sabah,0,0,0
2020-10-01,QAT,Sarawak,0,0,0
2020-10-01,QAT,Selangor,0,0,0
2020-10-01,REU,Johor,0,0,0
2020-10-01,REU,Sarawak,0,0,0
2020-10-01,ROU,Johor,0,0,0
2020-10-01,ROU,Kedah,0,0,0
2020-10-01,ROU,Kelantan,0,0,0
2020-10-01,ROU,Negeri Sembilan,0,0,0
2020-10-01,ROU,Pahang,0,0,0
2020-10-01,ROU,Perak,0,0,0
2020-10-01,ROU,Perlis,0,0,0
2020-10-01,ROU,Pulau Pinang,0,0,0
2020-10-01,ROU,Sabah,0,0,0
2020-10-01,ROU,Sarawak,0,0,0
2020-10-01,ROU,Selangor,18,14,4
2020-10-01,ROU,W.P. Labuan,0,0,0
2020-10-01,RUS,Johor,6,6,0
2020-10-01,RUS,Kedah,0,0,0
2020-10-01,RUS,Kelantan,0,0,0
2020-10-01,RUS,Melaka,0,0,0
2020-10-01,RUS,Negeri Sembilan,0,0,0
2020-10-01,RUS,Pahang,0,0,0
2020-10-01,RUS,Perak,0,0,0
2020-10-01,RUS,Perlis,0,0,0
2020-10-01,RUS,Pulau Pinang,0,0,0
2020-10-01,RUS,Sabah,0,0,0
2020-10-01,RUS,Sarawak,0,0,0
2020-10-01,RUS,Selangor,28,19,9
2020-10-01,RUS,W.P. Labuan,0,0,0
2020-10-01,RWA,Johor,0,0,0
2020-10-01,RWA,Kedah,0,0,0
2020-10-01,RWA,Pulau Pinang,0,0,0
2020-10-01,RWA,Selangor,0,0,0
2020-10-01,SAU,Johor,0,0,0
2020-10-01,SAU,Kedah,0,0,0
2020-10-01,SAU,Kelantan,0,0,0
2020-10-01,SAU,Melaka,0,0,0
2020-10-01,SAU,Perak,0,0,0
2020-10-01,SAU,Perlis,0,0,0
2020-10-01,SAU,Pulau Pinang,0,0,0
2020-10-01,SAU,Sabah,0,0,0
2020-10-01,SAU,Sarawak,0,0,0
2020-10-01,SAU,Selangor,105,63,42
2020-10-01,SAU,W.P. Labuan,0,0,0
2020-10-01,SDN,Johor,0,0,0
2020-10-01,SDN,Kedah,0,0,0
2020-10-01,SDN,Kelantan,0,0,0
2020-10-01,SDN,Perlis,0,0,0
2020-10-01,SDN,Pulau Pinang,0,0,0
2020-10-01,SDN,Sabah,0,0,0
2020-10-01,SDN,Sarawak,0,0,0
2020-10-01,SDN,Selangor,28,21,7
2020-10-01,SDN,W.P. Labuan,0,0,0
2020-10-01,SEN,Johor,0,0,0
2020-10-01,SEN,Kedah,0,0,0
2020-10-01,SEN,Kelantan,0,0,0
2020-10-01,SEN,Perak,0,0,0
2020-10-01,SEN,Perlis,0,0,0
2020-10-01,SEN,Pulau Pinang,0,0,0
2020-10-01,SEN,Sabah,0,0,0
2020-10-01,SEN,Sarawak,0,0,0
2020-10-01,SEN,Selangor,1,0,1
2020-10-01,SGP,Johor,596,524,72
2020-10-01,SGP,Kedah,2,1,1
2020-10-01,SGP,Kelantan,0,0,0
2020-10-01,SGP,Melaka,0,0,0
2020-10-01,SGP,Negeri Sembilan,0,0,0
2020-10-01,SGP,Pahang,0,0,0
2020-10-01,SGP,Perak,2,1,1
2020-10-01,SGP,Perlis,0,0,0
2020-10-01,SGP,Pulau Pinang,30,22,8
2020-10-01,SGP,Sabah,0,0,0
2020-10-01,SGP,Sarawak,5,4,1
2020-10-01,SGP,Selangor,226,169,57
2020-10-01,SGP,Terengganu,0,0,0
2020-10-01,SGP,W.P. Labuan,0,0,0
2020-10-01,SGS,Johor,0,0,0
2020-10-01,SGS,Sabah,0,0,0
2020-10-01,SGS,Selangor,0,0,0
2020-10-01,SHN,Sarawak,0,0,0
2020-10-01,SLB,Johor,0,0,0
2020-10-01,SLB,Perlis,0,0,0
2020-10-01,SLB,Pulau Pinang,0,0,0
2020-10-01,SLB,Sabah,0,0,0
2020-10-01,SLB,Sarawak,0,0,0
2020-10-01,SLB,Selangor,0,0,0
2020-10-01,SLB,W.P. Labuan,0,0,0
2020-10-01,SLE,Johor,0,0,0
2020-10-01,SLE,Kedah,0,0,0
2020-10-01,SLE,Perak,0,0,0
2020-10-01,SLE,Pulau Pinang,0,0,0
2020-10-01,SLE,Sabah,0,0,0
2020-10-01,SLE,Selangor,0,0,0
2020-10-01,SLV,Johor,0,0,0
2020-10-01,SLV,Kedah,0,0,0
2020-10-01,SLV,Perak,0,0,0
2020-10-01,SLV,Perlis,0,0,0
2020-10-01,SLV,Pulau Pinang,0,0,0
2020-10-01,SLV,Sabah,0,0,0
2020-10-01,SLV,Selangor,0,0,0
2020-10-01,SLV,W.P. Labuan,0,0,0
2020-10-01,SMR,Johor,0,0,0
2020-10-01,SMR,Selangor,0,0,0
2020-10-01,SOM,Johor,0,0,0
2020-10-01,SOM,Kedah,0,0,0
2020-10-01,SOM,Kelantan,0,0,0
2020-10-01,SOM,Perlis,0,0,0
2020-10-01,SOM,Sabah,0,0,0
2020-10-01,SOM,Sarawak,0,0,0
2020-10-01,SOM,Selangor,2,2,0
2020-10-01,SRB,Johor,2,2,0
2020-10-01,SRB,Kedah,0,0,0
2020-10-01,SRB,Kelantan,0,0,0
2020-10-01,SRB,Pahang,0,0,0
2020-10-01,SRB,Perak,0,0,0
2020-10-01,SRB,Perlis,0,0,0
2020-10-01,SRB,Pulau Pinang,0,0,0
2020-10-01,SRB,Sabah,0,0,0
2020-10-01,SRB,Sarawak,0,0,0
2020-10-01,SRB,Selangor,4,1,3
2020-10-01,SSD,Johor,0,0,0
2020-10-01,SSD,Kedah,0,0,0
2020-10-01,SSD,Sarawak,0,0,0
2020-10-01,SSD,Selangor,0,0,0
2020-10-01,SSD,W.P. Labuan,0,0,0
2020-10-01,STP,Selangor,0,0,0
2020-10-01,SUR,Johor,0,0,0
2020-10-01,SUR,Kedah,0,0,0
2020-10-01,SUR,Kelantan,0,0,0
2020-10-01,SUR,Perak,0,0,0
2020-10-01,SUR,Perlis,0,0,0
2020-10-01,SUR,Pulau Pinang,0,0,0
2020-10-01,SUR,Sabah,0,0,0
2020-10-01,SUR,Sarawak,0,0,0
2020-10-01,SUR,Selangor,0,0,0
2020-10-01,SVK,Johor,0,0,0
2020-10-01,SVK,Kedah,0,0,0
2020-10-01,SVK,Kelantan,0,0,0
2020-10-01,SVK,Negeri Sembilan,0,0,0
2020-10-01,SVK,Pahang,0,0,0
2020-10-01,SVK,Perak,0,0,0
2020-10-01,SVK,Perlis,0,0,0
2020-10-01,SVK,Pulau Pinang,0,0,0
2020-10-01,SVK,Sabah,0,0,0
2020-10-01,SVK,Sarawak,0,0,0
2020-10-01,SVK,Selangor,17,15,2
2020-10-01,SVK,W.P. Labuan,0,0,0
2020-10-01,SVN,Johor,0,0,0
2020-10-01,SVN,Kedah,0,0,0
2020-10-01,SVN,Kelantan,0,0,0
2020-10-01,SVN,Perak,0,0,0
2020-10-01,SVN,Perlis,0,0,0
2020-10-01,SVN,Pulau Pinang,0,0,0
2020-10-01,SVN,Sabah,0,0,0
2020-10-01,SVN,Sarawak,0,0,0
2020-10-01,SVN,Selangor,0,0,0
2020-10-01,SVN,W.P. Labuan,0,0,0
2020-10-01,SWE,Johor,1,1,0
2020-10-01,SWE,Kedah,0,0,0
2020-10-01,SWE,Kelantan,0,0,0
2020-10-01,SWE,Melaka,0,0,0
2020-10-01,SWE,Negeri Sembilan,0,0,0
2020-10-01,SWE,Pahang,0,0,0
2020-10-01,SWE,Perak,0,0,0
2020-10-01,SWE,Perlis,0,0,0
2020-10-01,SWE,Pulau Pinang,0,0,0
2020-10-01,SWE,Sabah,0,0,0
2020-10-01,SWE,Sarawak,0,0,0
2020-10-01,SWE,Selangor,21,15,6
2020-10-01,SWE,W.P. Labuan,0,0,0
2020-10-01,SWZ,Johor,0,0,0
2020-10-01,SWZ,Kedah,0,0,0
2020-10-01,SWZ,Pulau Pinang,0,0,0
2020-10-01,SWZ,Sabah,0,0,0
2020-10-01,SWZ,Selangor,0,0,0
2020-10-01,SYC,Johor,0,0,0
2020-10-01,SYC,Kedah,0,0,0
2020-10-01,SYC,Pulau Pinang,0,0,0
2020-10-01,SYC,Sabah,0,0,0
2020-10-01,SYC,Sarawak,0,0,0
2020-10-01,SYC,Selangor,3,2,1
2020-10-01,SYR,Johor,0,0,0
2020-10-01,SYR,Kedah,0,0,0
2020-10-01,SYR,Kelantan,0,0,0
2020-10-01,SYR,Pahang,0,0,0
2020-10-01,SYR,Perlis,0,0,0
2020-10-01,SYR,Pulau Pinang,0,0,0
2020-10-01,SYR,Sabah,0,0,0
2020-10-01,SYR,Sarawak,0,0,0
2020-10-01,SYR,Selangor,29,27,2
2020-10-01,SYR,W.P. Labuan,0,0,0
2020-10-01,TCA,Perlis,0,0,0
2020-10-01,TCD,Johor,0,0,0
2020-10-01,TCD,Kedah,0,0,0
2020-10-01,TCD,Perlis,0,0,0
2020-10-01,TCD,Selangor,0,0,0
2020-10-01,TGO,Johor,0,0,0
2020-10-01,TGO,Perak,0,0,0
2020-10-01,TGO,Pulau Pinang,0,0,0
2020-10-01,TGO,Selangor,1,0,1
2020-10-01,THA,Johor,106,105,1
2020-10-01,THA,Kedah,9601,8863,738
2020-10-01,THA,Kelantan,1,0,1
2020-10-01,THA,Melaka,0,0,0
2020-10-01,THA,Negeri Sembilan,0,0,0
2020-10-01,THA,Pahang,0,0,0
2020-10-01,THA,Perak,1,0,1
2020-10-01,THA,Perlis,5460,5248,212
2020-10-01,THA,Pulau Pinang,0,0,0
2020-10-01,THA,Sabah,0,0,0
2020-10-01,THA,Sarawak,17,16,1
2020-10-01,THA,Selangor,139,69,70
2020-10-01,THA,Terengganu,0,0,0
2020-10-01,THA,W.P. Labuan,0,0,0
2020-10-01,TJK,Johor,0,0,0
2020-10-01,TJK,Kedah,0,0,0
2020-10-01,TJK,Perlis,0,0,0
2020-10-01,TJK,Pulau Pinang,0,0,0
2020-10-01,TJK,Sabah,0,0,0
2020-10-01,TJK,Selangor,1,0,1
2020-10-01,TKL,Selangor,0,0,0
2020-10-01,TKM,Johor,0,0,0
2020-10-01,TKM,Kedah,0,0,0
2020-10-01,TKM,Kelantan,0,0,0
2020-10-01,TKM,Perlis,0,0,0
2020-10-01,TKM,Pulau Pinang,0,0,0
2020-10-01,TKM,Sabah,0,0,0
2020-10-01,TKM,Sarawak,0,0,0
2020-10-01,TKM,Selangor,0,0,0
2020-10-01,TLS,Johor,0,0,0
2020-10-01,TLS,Kedah,0,0,0
2020-10-01,TLS,Perlis,0,0,0
2020-10-01,TLS,Pulau Pinang,0,0,0
2020-10-01,TLS,Sabah,0,0,0
2020-10-01,TLS,Sarawak,0,0,0
2020-10-01,TLS,Selangor,0,0,0
2020-10-01,TON,Johor,0,0,0
2020-10-01,TON,Pulau Pinang,0,0,0
2020-10-01,TON,Sarawak,0,0,0
2020-10-01,TON,Selangor,0,0,0
2020-10-01,TTO,Johor,0,0,0
2020-10-01,TTO,Kedah,0,0,0
2020-10-01,TTO,Pahang,0,0,0
2020-10-01,TTO,Pulau Pinang,0,0,0
2020-10-01,TTO,Sabah,0,0,0
2020-10-01,TTO,Sarawak,0,0,0
2020-10-01,TTO,Selangor,0,0,0
2020-10-01,TUN,Johor,0,0,0
2020-10-01,TUN,Kedah,0,0,0
2020-10-01,TUN,Kelantan,0,0,0
2020-10-01,TUN,Melaka,0,0,0
2020-10-01,TUN,Perak,0,0,0
2020-10-01,TUN,Perlis,0,0,0
2020-10-01,TUN,Pulau Pinang,0,0,0
2020-10-01,TUN,Sabah,0,0,0
2020-10-01,TUN,Sarawak,0,0,0
2020-10-01,TUN,Selangor,7,3,4
2020-10-01,TUN,W.P. Labuan,0,0,0
2020-10-01,TUR,Johor,0,0,0
2020-10-01,TUR,Kedah,0,0,0
2020-10-01,TUR,Kelantan,0,0,0
2020-10-01,TUR,Melaka,0,0,0
2020-10-01,TUR,Negeri Sembilan,0,0,0
2020-10-01,TUR,Pahang,0,0,0
2020-10-01,TUR,Perak,0,0,0
2020-10-01,TUR,Perlis,0,0,0
2020-10-01,TUR,Pulau Pinang,0,0,0
2020-10-01,TUR,Sabah,0,0,0
2020-10-01,TUR,Sarawak,0,0,0
2020-10-01,TUR,Selangor,20,18,2
2020-10-01,TUR,W.P. Labuan,0,0,0
2020-10-01,TUV,Selangor,0,0,0
2020-10-01,TWN,Johor,9,6,3
2020-10-01,TWN,Kedah,0,0,0
2020-10-01,TWN,Kelantan,0,0,0
2020-10-01,TWN,Melaka,0,0,0
2020-10-01,TWN,Negeri Sembilan,0,0,0
2020-10-01,TWN,Pahang,0,0,0
2020-10-01,TWN,Perak,0,0,0
2020-10-01,TWN,Perlis,0,0,0
2020-10-01,TWN,Pulau Pinang,7,3,4
2020-10-01,TWN,Sabah,0,0,0
2020-10-01,TWN,Sarawak,3,3,0
2020-10-01,TWN,Selangor,123,87,36
2020-10-01,TWN,W.P. Labuan,0,0,0
2020-10-01,TZA,Johor,0,0,0
2020-10-01,TZA,Kedah,0,0,0
2020-10-01,TZA,Perak,0,0,0
2020-10-01,TZA,Perlis,0,0,0
2020-10-01,TZA,Pulau Pinang,0,0,0
2020-10-01,TZA,Sabah,0,0,0
2020-10-01,TZA,Sarawak,0,0,0
2020-10-01,TZA,Selangor,2,1,1
2020-10-01,UGA,Johor,0,0,0
2020-10-01,UGA,Kedah,0,0,0
2020-10-01,UGA,Perak,0,0,0
2020-10-01,UGA,Perlis,0,0,0
2020-10-01,UGA,Pulau Pinang,0,0,0
2020-10-01,UGA,Sabah,0,0,0
2020-10-01,UGA,Sarawak,0,0,0
2020-10-01,UGA,Selangor,0,0,0
2020-10-01,UKR,Johor,4,4,0
2020-10-01,UKR,Kedah,0,0,0
2020-10-01,UKR,Kelantan,0,0,0
2020-10-01,UKR,Melaka,0,0,0
2020-10-01,UKR,Negeri Sembilan,0,0,0
2020-10-01,UKR,Pahang,0,0,0
2020-10-01,UKR,Perak,0,0,0
2020-10-01,UKR,Perlis,0,0,0
2020-10-01,UKR,Pulau Pinang,0,0,0
2020-10-01,UKR,Sabah,0,0,0
2020-10-01,UKR,Sarawak,0,0,0
2020-10-01,UKR,Selangor,63,60,3
2020-10-01,UKR,W.P. Labuan,0,0,0
2020-10-01,URY,Johor,0,0,0
2020-10-01,URY,Kedah,0,0,0
2020-10-01,URY,Kelantan,0,0,0
2020-10-01,URY,Perak,0,0,0
2020-10-01,URY,Perlis,0,0,0
2020-10-01,URY,Pulau Pinang,0,0,0
2020-10-01,URY,Sabah,0,0,0
2020-10-01,URY,Sarawak,0,0,0
2020-10-01,URY,Selangor,0,0,0
2020-10-01,URY,W.P. Labuan,0,0,0
2020-10-01,USA,Johor,3,3,0
2020-10-01,USA,Kedah,0,0,0
2020-10-01,USA,Kelantan,0,0,0
2020-10-01,USA,Melaka,0,0,0
2020-10-01,USA,Negeri Sembilan,0,0,0
2020-10-01,USA,Pahang,0,0,0
2020-10-01,USA,Perak,1,0,1
2020-10-01,USA,Perlis,0,0,0
2020-10-01,USA,Pulau Pinang,1,0,1
2020-10-01,USA,Sabah,0,0,0
2020-10-01,USA,Sarawak,0,0,0
2020-10-01,USA,Selangor,106,82,24
2020-10-01,USA,Terengganu,0,0,0
2020-10-01,USA,W.P. Labuan,0,0,0
2020-10-01,UZB,Johor,0,0,0
2020-10-01,UZB,Kedah,0,0,0
2020-10-01,UZB,Kelantan,0,0,0
2020-10-01,UZB,Perak,0,0,0
2020-10-01,UZB,Perlis,0,0,0
2020-10-01,UZB,Pulau Pinang,0,0,0
2020-10-01,UZB,Sabah,0,0,0
2020-10-01,UZB,Sarawak,0,0,0
2020-10-01,UZB,Selangor,5,4,1
2020-10-01,VAT,Johor,0,0,0
2020-10-01,VAT,Sarawak,0,0,0
2020-10-01,VAT,Selangor,0,0,0
2020-10-01,VCT,Johor,0,0,0
2020-10-01,VCT,Kedah,0,0,0
2020-10-01,VCT,Pulau Pinang,0,0,0
2020-10-01,VCT,Sarawak,0,0,0
2020-10-01,VCT,Selangor,0,0,0
2020-10-01,VEN,Johor,0,0,0
2020-10-01,VEN,Kedah,0,0,0
2020-10-01,VEN,Kelantan,0,0,0
2020-10-01,VEN,Melaka,0,0,0
2020-10-01,VEN,Perak,0,0,0
2020-10-01,VEN,Perlis,0,0,0
2020-10-01,VEN,Pulau Pinang,0,0,0
2020-10-01,VEN,Sabah,0,0,0
2020-10-01,VEN,Sarawak,0,0,0
2020-10-01,VEN,Selangor,1,1,0
2020-10-01,VEN,W.P. Labuan,0,0,0
2020-10-01,VNM,Johor,0,0,0
2020-10-01,VNM,Kedah,0,0,0
2020-10-01,VNM,Kelantan,0,0,0
2020-10-01,VNM,Melaka,0,0,0
2020-10-01,VNM,Negeri Sembilan,0,0,0
2020-10-01,VNM,Pahang,0,0,0
2020-10-01,VNM,Perak,0,0,0
2020-10-01,VNM,Perlis,0,0,0
2020-10-01,VNM,Pulau Pinang,0,0,0
2020-10-01,VNM,Sabah,0,0,0
2020-10-01,VNM,Sarawak,3,0,3
2020-10-01,VNM,Selangor,95,42,53
2020-10-01,VNM,Terengganu,0,0,0
2020-10-01,VNM,W.P. Labuan,0,0,0
2020-10-01,VUT,Johor,0,0,0
2020-10-01,VUT,Kedah,0,0,0
2020-10-01,VUT,Pulau Pinang,0,0,0
2020-10-01,VUT,Sabah,0,0,0
2020-10-01,VUT,Sarawak,0,0,0
2020-10-01,VUT,Selangor,0,0,0
2020-10-01,WSM,Johor,0,0,0
2020-10-01,WSM,Sarawak,0,0,0
2020-10-01,WSM,Selangor,0,0,0
2020-10-01,XXX,Johor,0,0,0
2020-10-01,XXX,Kedah,0,0,0
2020-10-01,XXX,Kelantan,0,0,0
2020-10-01,XXX,Melaka,0,0,0
2020-10-01,XXX,Pahang,0,0,0
2020-10-01,XXX,Perak,0,0,0
2020-10-01,XXX,Perlis,0,0,0
2020-10-01,XXX,Pulau Pinang,0,0,0
2020-10-01,XXX,Sabah,0,0,0
2020-10-01,XXX,Sarawak,0,0,0
2020-10-01,XXX,Selangor,14,9,5
2020-10-01,XXX,W.P. Labuan,0,0,0
2020-10-01,YEM,Johor,0,0,0
2020-10-01,YEM,Kedah,0,0,0
2020-10-01,YEM,Kelantan,0,0,0
2020-10-01,YEM,Melaka,0,0,0
2020-10-01,YEM,Pahang,0,0,0
2020-10-01,YEM,Perak,0,0,0
2020-10-01,YEM,Perlis,0,0,0
2020-10-01,YEM,Pulau Pinang,0,0,0
2020-10-01,YEM,Sabah,0,0,0
2020-10-01,YEM,Sarawak,0,0,0
2020-10-01,YEM,Selangor,26,19,7
2020-10-01,YEM,W.P. Labuan,0,0,0
2020-10-01,ZAF,Johor,2,2,0
2020-10-01,ZAF,Kedah,0,0,0
2020-10-01,ZAF,Kelantan,0,0,0
2020-10-01,ZAF,Melaka,0,0,0
2020-10-01,ZAF,Pahang,0,0,0
2020-10-01,ZAF,Perak,0,0,0
2020-10-01,ZAF,Perlis,0,0,0
2020-10-01,ZAF,Pulau Pinang,0,0,0
2020-10-01,ZAF,Sabah,0,0,0
2020-10-01,ZAF,Sarawak,0,0,0
2020-10-01,ZAF,Selangor,30,23,7
2020-10-01,ZAF,Terengganu,0,0,0
2020-10-01,ZAF,W.P. Labuan,0,0,0
2020-10-01,ZAR,Selangor,0,0,0
2020-10-01,ZMB,Johor,0,0,0
2020-10-01,ZMB,Kedah,0,0,0
2020-10-01,ZMB,Perak,0,0,0
2020-10-01,ZMB,Perlis,0,0,0
2020-10-01,ZMB,Pulau Pinang,0,0,0
2020-10-01,ZMB,Sabah,0,0,0
2020-10-01,ZMB,Sarawak,0,0,0
2020-10-01,ZMB,Selangor,2,1,1
2020-10-01,ZWE,Johor,0,0,0
2020-10-01,ZWE,Kedah,0,0,0
2020-10-01,ZWE,Kelantan,0,0,0
2020-10-01,ZWE,Perak,0,0,0
2020-10-01,ZWE,Perlis,0,0,0
2020-10-01,ZWE,Pulau Pinang,0,0,0
2020-10-01,ZWE,Sabah,0,0,0
2020-10-01,ZWE,Sarawak,0,0,0
2020-10-01,ZWE,Selangor,8,3,5
2020-11-01,ABW,Kedah,0,0,0
2020-11-01,ABW,Pulau Pinang,0,0,0
2020-11-01,AFG,Johor,0,0,0
2020-11-01,AFG,Kedah,0,0,0
2020-11-01,AFG,Perlis,0,0,0
2020-11-01,AFG,Pulau Pinang,0,0,0
2020-11-01,AFG,Sarawak,0,0,0
2020-11-01,AFG,Selangor,4,4,0
2020-11-01,AGO,Johor,0,0,0
2020-11-01,AGO,Kedah,0,0,0
2020-11-01,AGO,Sabah,0,0,0
2020-11-01,AGO,Selangor,0,0,0
2020-11-01,AIA,Selangor,0,0,0
2020-11-01,ALB,Johor,0,0,0
2020-11-01,ALB,Kedah,0,0,0
2020-11-01,ALB,Perak,0,0,0
2020-11-01,ALB,Perlis,0,0,0
2020-11-01,ALB,Pulau Pinang,0,0,0
2020-11-01,ALB,Sabah,0,0,0
2020-11-01,ALB,Sarawak,0,0,0
2020-11-01,ALB,Selangor,0,0,0
2020-11-01,AND,Johor,0,0,0
2020-11-01,AND,Kedah,0,0,0
2020-11-01,AND,Perlis,0,0,0
2020-11-01,AND,Pulau Pinang,0,0,0
2020-11-01,AND,Selangor,0,0,0
2020-11-01,ANT,Selangor,0,0,0
2020-11-01,ARE,Johor,0,0,0
2020-11-01,ARE,Kedah,0,0,0
2020-11-01,ARE,Kelantan,0,0,0
2020-11-01,ARE,Perak,0,0,0
2020-11-01,ARE,Perlis,0,0,0
2020-11-01,ARE,Pulau Pinang,0,0,0
2020-11-01,ARE,Sabah,0,0,0
2020-11-01,ARE,Sarawak,0,0,0
2020-11-01,ARE,Selangor,0,0,0
2020-11-01,ARG,Johor,0,0,0
2020-11-01,ARG,Kedah,0,0,0
2020-11-01,ARG,Kelantan,0,0,0
2020-11-01,ARG,Melaka,0,0,0
2020-11-01,ARG,Perak,0,0,0
2020-11-01,ARG,Perlis,0,0,0
2020-11-01,ARG,Pulau Pinang,0,0,0
2020-11-01,ARG,Sabah,0,0,0
2020-11-01,ARG,Sarawak,0,0,0
2020-11-01,ARG,Selangor,3,3,0
2020-11-01,ARG,W.P. Labuan,0,0,0
2020-11-01,ARM,Johor,0,0,0
2020-11-01,ARM,Kedah,0,0,0
2020-11-01,ARM,Kelantan,0,0,0
2020-11-01,ARM,Perak,0,0,0
2020-11-01,ARM,Perlis,0,0,0
2020-11-01,ARM,Pulau Pinang,0,0,0
2020-11-01,ARM,Sabah,0,0,0
2020-11-01,ARM,Sarawak,0,0,0
2020-11-01,ARM,Selangor,0,0,0
2020-11-01,ATA,Selangor,0,0,0
2020-11-01,ATG,Johor,0,0,0
2020-11-01,ATG,Kedah,0,0,0
2020-11-01,ATG,Pulau Pinang,0,0,0
2020-11-01,ATG,Sarawak,0,0,0
2020-11-01,ATG,Selangor,0,0,0
2020-11-01,AUS,Johor,41,38,3
2020-11-01,AUS,Kedah,0,0,0
2020-11-01,AUS,Kelantan,0,0,0
2020-11-01,AUS,Melaka,0,0,0
2020-11-01,AUS,Negeri Sembilan,0,0,0
2020-11-01,AUS,Pahang,0,0,0
2020-11-01,AUS,Perak,0,0,0
2020-11-01,AUS,Perlis,0,0,0
2020-11-01,AUS,Pulau Pinang,5,5,0
2020-11-01,AUS,Sabah,3,3,0
2020-11-01,AUS,Sarawak,0,0,0
2020-11-01,AUS,Selangor,126,87,39
2020-11-01,AUS,Terengganu,0,0,0
2020-11-01,AUS,W.P. Labuan,0,0,0
2020-11-01,AUT,Johor,0,0,0
2020-11-01,AUT,Kedah,0,0,0
2020-11-01,AUT,Kelantan,0,0,0
2020-11-01,AUT,Melaka,0,0,0
2020-11-01,AUT,Negeri Sembilan,0,0,0
2020-11-01,AUT,Pahang,0,0,0
2020-11-01,AUT,Perak,0,0,0
2020-11-01,AUT,Perlis,0,0,0
2020-11-01,AUT,Pulau Pinang,0,0,0
2020-11-01,AUT,Sabah,0,0,0
2020-11-01,AUT,Sarawak,0,0,0
2020-11-01,AUT,Selangor,4,4,0
2020-11-01,AUT,Terengganu,0,0,0
2020-11-01,AUT,W.P. Labuan,0,0,0
2020-11-01,AZE,Johor,0,0,0
2020-11-01,AZE,Kedah,0,0,0
2020-11-01,AZE,Kelantan,0,0,0
2020-11-01,AZE,Melaka,0,0,0
2020-11-01,AZE,Perlis,0,0,0
2020-11-01,AZE,Pulau Pinang,0,0,0
2020-11-01,AZE,Sabah,0,0,0
2020-11-01,AZE,Sarawak,0,0,0
2020-11-01,AZE,Selangor,2,2,0
2020-11-01,AZE,W.P. Labuan,0,0,0
2020-11-01,BDI,Pulau Pinang,0,0,0
2020-11-01,BDI,Sarawak,0,0,0
2020-11-01,BDI,Selangor,0,0,0
2020-11-01,BEL,Johor,0,0,0
2020-11-01,BEL,Kedah,0,0,0
2020-11-01,BEL,Kelantan,0,0,0
2020-11-01,BEL,Melaka,0,0,0
2020-11-01,BEL,Negeri Sembilan,0,0,0
2020-11-01,BEL,Pahang,0,0,0
2020-11-01,BEL,Perak,0,0,0
2020-11-01,BEL,Perlis,0,0,0
2020-11-01,BEL,Pulau Pinang,0,0,0
2020-11-01,BEL,Sabah,0,0,0
2020-11-01,BEL,Sarawak,0,0,0
2020-11-01,BEL,Selangor,13,11,2
2020-11-01,BEL,W.P. Labuan,0,0,0
2020-11-01,BEN,Johor,0,0,0
2020-11-01,BEN,Kedah,0,0,0
2020-11-01,BEN,Perak,0,0,0
2020-11-01,BEN,Pulau Pinang,0,0,0
2020-11-01,BEN,Sabah,0,0,0
2020-11-01,BEN,Sarawak,0,0,0
2020-11-01,BEN,Selangor,0,0,0
2020-11-01,BFA,Perak,0,0,0
2020-11-01,BFA,Pulau Pinang,0,0,0
2020-11-01,BFA,Selangor,0,0,0
2020-11-01,BGD,Johor,0,0,0
2020-11-01,BGD,Kedah,0,0,0
2020-11-01,BGD,Kelantan,0,0,0
2020-11-01,BGD,Melaka,0,0,0
2020-11-01,BGD,Negeri Sembilan,0,0,0
2020-11-01,BGD,Pahang,0,0,0
2020-11-01,BGD,Perak,0,0,0
2020-11-01,BGD,Perlis,0,0,0
2020-11-01,BGD,Pulau Pinang,0,0,0
2020-11-01,BGD,Sabah,0,0,0
2020-11-01,BGD,Sarawak,3,3,0
2020-11-01,BGD,Selangor,66,56,10
2020-11-01,BGD,W.P. Labuan,0,0,0
2020-11-01,BGR,Johor,0,0,0
2020-11-01,BGR,Kedah,0,0,0
2020-11-01,BGR,Kelantan,0,0,0
2020-11-01,BGR,Pahang,0,0,0
2020-11-01,BGR,Perak,0,0,0
2020-11-01,BGR,Perlis,0,0,0
2020-11-01,BGR,Pulau Pinang,0,0,0
2020-11-01,BGR,Sabah,0,0,0
2020-11-01,BGR,Sarawak,0,0,0
2020-11-01,BGR,Selangor,9,8,1
2020-11-01,BGR,W.P. Labuan,0,0,0
2020-11-01,BHR,Johor,0,0,0
2020-11-01,BHR,Kedah,0,0,0
2020-11-01,BHR,Kelantan,0,0,0
2020-11-01,BHR,Perlis,0,0,0
2020-11-01,BHR,Pulau Pinang,0,0,0
2020-11-01,BHR,Sabah,0,0,0
2020-11-01,BHR,Sarawak,0,0,0
2020-11-01,BHR,Selangor,2,2,0
2020-11-01,BHS,Johor,0,0,0
2020-11-01,BHS,Kedah,0,0,0
2020-11-01,BHS,Perak,0,0,0
2020-11-01,BHS,Sabah,0,0,0
2020-11-01,BHS,Sarawak,0,0,0
2020-11-01,BHS,Selangor,0,0,0
2020-11-01,BIH,Johor,0,0,0
2020-11-01,BIH,Kedah,0,0,0
2020-11-01,BIH,Perlis,0,0,0
2020-11-01,BIH,Pulau Pinang,0,0,0
2020-11-01,BIH,Sabah,0,0,0
2020-11-01,BIH,Sarawak,0,0,0
2020-11-01,BIH,Selangor,3,2,1
2020-11-01,BLR,Johor,0,0,0
2020-11-01,BLR,Kedah,0,0,0
2020-11-01,BLR,Kelantan,0,0,0
2020-11-01,BLR,Pahang,0,0,0
2020-11-01,BLR,Perak,0,0,0
2020-11-01,BLR,Perlis,0,0,0
2020-11-01,BLR,Pulau Pinang,0,0,0
2020-11-01,BLR,Sabah,0,0,0
2020-11-01,BLR,Sarawak,0,0,0
2020-11-01,BLR,Selangor,2,0,2
2020-11-01,BLR,W.P. Labuan,0,0,0
2020-11-01,BLZ,Johor,0,0,0
2020-11-01,BLZ,Pulau Pinang,0,0,0
2020-11-01,BLZ,Sarawak,0,0,0
2020-11-01,BLZ,Selangor,1,1,0
2020-11-01,BMU,Selangor,0,0,0
2020-11-01,BOL,Johor,0,0,0
2020-11-01,BOL,Kedah,0,0,0
2020-11-01,BOL,Melaka,0,0,0
2020-11-01,BOL,Perak,0,0,0
2020-11-01,BOL,Perlis,0,0,0
2020-11-01,BOL,Pulau Pinang,0,0,0
2020-11-01,BOL,Sabah,0,0,0
2020-11-01,BOL,Sarawak,0,0,0
2020-11-01,BOL,Selangor,0,0,0
2020-11-01,BRA,Johor,1,0,1
2020-11-01,BRA,Kedah,0,0,0
2020-11-01,BRA,Kelantan,0,0,0
2020-11-01,BRA,Melaka,0,0,0
2020-11-01,BRA,Pahang,0,0,0
2020-11-01,BRA,Perak,0,0,0
2020-11-01,BRA,Perlis,0,0,0
2020-11-01,BRA,Pulau Pinang,0,0,0
2020-11-01,BRA,Sabah,0,0,0
2020-11-01,BRA,Sarawak,0,0,0
2020-11-01,BRA,Selangor,4,4,0
2020-11-01,BRA,W.P. Labuan,0,0,0
2020-11-01,BRB,Johor,0,0,0
2020-11-01,BRB,Kedah,0,0,0
2020-11-01,BRB,Perlis,0,0,0
2020-11-01,BRB,Pulau Pinang,0,0,0
2020-11-01,BRB,Selangor,0,0,0
2020-11-01,BRN,Johor,0,0,0
2020-11-01,BRN,Kedah,0,0,0
2020-11-01,BRN,Kelantan,0,0,0
2020-11-01,BRN,Melaka,0,0,0
2020-11-01,BRN,Pahang,0,0,0
2020-11-01,BRN,Perak,0,0,0
2020-11-01,BRN,Perlis,0,0,0
2020-11-01,BRN,Pulau Pinang,0,0,0
2020-11-01,BRN,Sabah,0,0,0
2020-11-01,BRN,Sarawak,322,312,10
2020-11-01,BRN,Selangor,8,5,3
2020-11-01,BRN,W.P. Labuan,4,3,1
2020-11-01,BTN,Johor,0,0,0
2020-11-01,BTN,Kedah,0,0,0
2020-11-01,BTN,Perak,0,0,0
2020-11-01,BTN,Perlis,0,0,0
2020-11-01,BTN,Pulau Pinang,0,0,0
2020-11-01,BTN,Sabah,0,0,0
2020-11-01,BTN,Sarawak,0,0,0
2020-11-01,BTN,Selangor,0,0,0
2020-11-01,BWA,Johor,0,0,0
2020-11-01,BWA,Kedah,0,0,0
2020-11-01,BWA,Perlis,0,0,0
2020-11-01,BWA,Pulau Pinang,0,0,0
2020-11-01,BWA,Sabah,0,0,0
2020-11-01,BWA,Sarawak,0,0,0
2020-11-01,BWA,Selangor,0,0,0
2020-11-01,CAF,Kedah,0,0,0
2020-11-01,CAF,Selangor,0,0,0
2020-11-01,CAN,Johor,0,0,0
2020-11-01,CAN,Kedah,0,0,0
2020-11-01,CAN,Kelantan,0,0,0
2020-11-01,CAN,Melaka,0,0,0
2020-11-01,CAN,Negeri Sembilan,0,0,0
2020-11-01,CAN,Pahang,0,0,0
2020-11-01,CAN,Perak,2,1,1
2020-11-01,CAN,Perlis,0,0,0
2020-11-01,CAN,Pulau Pinang,1,1,0
2020-11-01,CAN,Sabah,0,0,0
2020-11-01,CAN,Sarawak,0,0,0
2020-11-01,CAN,Selangor,49,33,16
2020-11-01,CAN,Terengganu,0,0,0
2020-11-01,CAN,W.P. Labuan,0,0,0
2020-11-01,CCK,Selangor,0,0,0
2020-11-01,CHE,Johor,0,0,0
2020-11-01,CHE,Kedah,0,0,0
2020-11-01,CHE,Kelantan,0,0,0
2020-11-01,CHE,Melaka,0,0,0
2020-11-01,CHE,Negeri Sembilan,0,0,0
2020-11-01,CHE,Pahang,0,0,0
2020-11-01,CHE,Perak,0,0,0
2020-11-01,CHE,Perlis,0,0,0
2020-11-01,CHE,Pulau Pinang,0,0,0
2020-11-01,CHE,Sabah,0,0,0
2020-11-01,CHE,Sarawak,0,0,0
2020-11-01,CHE,Selangor,16,11,5
2020-11-01,CHE,W.P. Labuan,0,0,0
2020-11-01,CHL,Johor,0,0,0
2020-11-01,CHL,Kedah,0,0,0
2020-11-01,CHL,Kelantan,0,0,0
2020-11-01,CHL,Melaka,0,0,0
2020-11-01,CHL,Pahang,0,0,0
2020-11-01,CHL,Perak,0,0,0
2020-11-01,CHL,Perlis,0,0,0
2020-11-01,CHL,Pulau Pinang,0,0,0
2020-11-01,CHL,Sabah,0,0,0
2020-11-01,CHL,Sarawak,0,0,0
2020-11-01,CHL,Selangor,0,0,0
2020-11-01,CHN,Johor,26,23,3
2020-11-01,CHN,Kedah,0,0,0
2020-11-01,CHN,Kelantan,0,0,0
2020-11-01,CHN,Melaka,0,0,0
2020-11-01,CHN,Pahang,0,0,0
2020-11-01,CHN,Perak,0,0,0
2020-11-01,CHN,Perlis,0,0,0
2020-11-01,CHN,Pulau Pinang,2,0,2
2020-11-01,CHN,Sabah,0,0,0
2020-11-01,CHN,Sarawak,231,188,43
2020-11-01,CHN,Selangor,1374,1094,280
2020-11-01,CHN,Terengganu,0,0,0
2020-11-01,CHN,W.P. Labuan,0,0,0
2020-11-01,CIV,Johor,0,0,0
2020-11-01,CIV,Kedah,0,0,0
2020-11-01,CIV,Pulau Pinang,0,0,0
2020-11-01,CIV,Sabah,0,0,0
2020-11-01,CIV,Sarawak,0,0,0
2020-11-01,CIV,Selangor,0,0,0
2020-11-01,CMR,Johor,0,0,0
2020-11-01,CMR,Kedah,0,0,0
2020-11-01,CMR,Pulau Pinang,0,0,0
2020-11-01,CMR,Sabah,0,0,0
2020-11-01,CMR,Sarawak,0,0,0
2020-11-01,CMR,Selangor,0,0,0
2020-11-01,COD,Johor,0,0,0
2020-11-01,COD,Pulau Pinang,0,0,0
2020-11-01,COD,Sarawak,0,0,0
2020-11-01,COD,Selangor,0,0,0
2020-11-01,COG,Johor,0,0,0
2020-11-01,COG,Kedah,0,0,0
2020-11-01,COG,Selangor,0,0,0
2020-11-01,COK,Selangor,0,0,0
2020-11-01,COL,Johor,0,0,0
2020-11-01,COL,Kedah,0,0,0
2020-11-01,COL,Perak,0,0,0
2020-11-01,COL,Pulau Pinang,0,0,0
2020-11-01,COL,Sabah,0,0,0
2020-11-01,COL,Sarawak,0,0,0
2020-11-01,COL,Selangor,3,0,3
2020-11-01,COL,W.P. Labuan,0,0,0
2020-11-01,COM,Johor,0,0,0
2020-11-01,COM,Kedah,0,0,0
2020-11-01,COM,Selangor,2,0,2
2020-11-01,CPV,Johor,0,0,0
2020-11-01,CPV,Kedah,0,0,0
2020-11-01,CPV,Pulau Pinang,0,0,0
2020-11-01,CPV,Sabah,0,0,0
2020-11-01,CPV,Selangor,0,0,0
2020-11-01,CRI,Johor,0,0,0
2020-11-01,CRI,Kedah,0,0,0
2020-11-01,CRI,Perak,0,0,0
2020-11-01,CRI,Perlis,0,0,0
2020-11-01,CRI,Pulau Pinang,0,0,0
2020-11-01,CRI,Sabah,0,0,0
2020-11-01,CRI,Sarawak,0,0,0
2020-11-01,CRI,Selangor,0,0,0
2020-11-01,CUB,Johor,0,0,0
2020-11-01,CUB,Kedah,0,0,0
2020-11-01,CUB,Perlis,0,0,0
2020-11-01,CUB,Pulau Pinang,0,0,0
2020-11-01,CUB,Sabah,0,0,0
2020-11-01,CUB,Sarawak,0,0,0
2020-11-01,CUB,Selangor,0,0,0
2020-11-01,CYP,Johor,0,0,0
2020-11-01,CYP,Kedah,0,0,0
2020-11-01,CYP,Perak,0,0,0
2020-11-01,CYP,Perlis,0,0,0
2020-11-01,CYP,Pulau Pinang,0,0,0
2020-11-01,CYP,Sabah,0,0,0
2020-11-01,CYP,Sarawak,0,0,0
2020-11-01,CYP,Selangor,0,0,0
2020-11-01,CZE,Johor,0,0,0
2020-11-01,CZE,Kedah,0,0,0
2020-11-01,CZE,Kelantan,0,0,0
2020-11-01,CZE,Melaka,0,0,0
2020-11-01,CZE,Negeri Sembilan,0,0,0
2020-11-01,CZE,Perak,0,0,0
2020-11-01,CZE,Perlis,0,0,0
2020-11-01,CZE,Pulau Pinang,0,0,0
2020-11-01,CZE,Sabah,0,0,0
2020-11-01,CZE,Sarawak,0,0,0
2020-11-01,CZE,Selangor,8,7,1
2020-11-01,CZE,W.P. Labuan,0,0,0
2020-11-01,DEU,Johor,6,6,0
2020-11-01,DEU,Kedah,0,0,0
2020-11-01,DEU,Kelantan,0,0,0
2020-11-01,DEU,Melaka,0,0,0
2020-11-01,DEU,Negeri Sembilan,0,0,0
2020-11-01,DEU,Pahang,0,0,0
2020-11-01,DEU,Perak,0,0,0
2020-11-01,DEU,Perlis,0,0,0
2020-11-01,DEU,Pulau Pinang,1,0,1
2020-11-01,DEU,Sabah,0,0,0
2020-11-01,DEU,Sarawak,0,0,0
2020-11-01,DEU,Selangor,48,40,8
2020-11-01,DEU,Terengganu,0,0,0
2020-11-01,DEU,W.P. Labuan,0,0,0
2020-11-01,DJI,Johor,0,0,0
2020-11-01,DJI,Selangor,0,0,0
2020-11-01,DMA,Johor,0,0,0
2020-11-01,DMA,Kedah,0,0,0
2020-11-01,DMA,Pulau Pinang,0,0,0
2020-11-01,DMA,Sabah,0,0,0
2020-11-01,DMA,Sarawak,0,0,0
2020-11-01,DMA,Selangor,0,0,0
2020-11-01,DMA,W.P. Labuan,0,0,0
2020-11-01,DNK,Johor,4,2,2
2020-11-01,DNK,Kedah,0,0,0
2020-11-01,DNK,Kelantan,0,0,0
2020-11-01,DNK,Melaka,0,0,0
2020-11-01,DNK,Negeri Sembilan,0,0,0
2020-11-01,DNK,Pahang,0,0,0
2020-11-01,DNK,Perak,0,0,0
2020-11-01,DNK,Perlis,0,0,0
2020-11-01,DNK,Pulau Pinang,0,0,0
2020-11-01,DNK,Sabah,0,0,0
2020-11-01,DNK,Sarawak,0,0,0
2020-11-01,DNK,Selangor,20,17,3
2020-11-01,DNK,W.P. Labuan,0,0,0
2020-11-01,DOM,Johor,0,0,0
2020-11-01,DOM,Kedah,0,0,0
2020-11-01,DOM,Perak,0,0,0
2020-11-01,DOM,Perlis,0,0,0
2020-11-01,DOM,Pulau Pinang,0,0,0
2020-11-01,DOM,Sabah,0,0,0
2020-11-01,DOM,Sarawak,0,0,0
2020-11-01,DOM,Selangor,0,0,0
2020-11-01,DZA,Johor,0,0,0
2020-11-01,DZA,Kedah,0,0,0
2020-11-01,DZA,Kelantan,0,0,0
2020-11-01,DZA,Melaka,0,0,0
2020-11-01,DZA,Perak,0,0,0
2020-11-01,DZA,Perlis,0,0,0
2020-11-01,DZA,Pulau Pinang,0,0,0
2020-11-01,DZA,Sabah,0,0,0
2020-11-01,DZA,Sarawak,0,0,0
2020-11-01,DZA,Selangor,4,3,1
2020-11-01,DZA,W.P. Labuan,0,0,0
2020-11-01,ECU,Johor,0,0,0
2020-11-01,ECU,Kedah,0,0,0
2020-11-01,ECU,Perak,0,0,0
2020-11-01,ECU,Perlis,0,0,0
2020-11-01,ECU,Pulau Pinang,0,0,0
2020-11-01,ECU,Sabah,0,0,0
2020-11-01,ECU,Sarawak,0,0,0
2020-11-01,ECU,Selangor,1,1,0
2020-11-01,EGY,Johor,0,0,0
2020-11-01,EGY,Kedah,0,0,0
2020-11-01,EGY,Kelantan,0,0,0
2020-11-01,EGY,Melaka,0,0,0
2020-11-01,EGY,Pahang,0,0,0
2020-11-01,EGY,Perak,0,0,0
2020-11-01,EGY,Perlis,0,0,0
2020-11-01,EGY,Pulau Pinang,0,0,0
2020-11-01,EGY,Sabah,0,0,0
2020-11-01,EGY,Sarawak,0,0,0
2020-11-01,EGY,Selangor,28,23,5
2020-11-01,EGY,Terengganu,0,0,0
2020-11-01,EGY,W.P. Labuan,0,0,0
2020-11-01,ERI,Johor,0,0,0
2020-11-01,ERI,Pulau Pinang,0,0,0
2020-11-01,ERI,Sabah,0,0,0
2020-11-01,ERI,Selangor,0,0,0
2020-11-01,ESP,Johor,0,0,0
2020-11-01,ESP,Kedah,0,0,0
2020-11-01,ESP,Kelantan,0,0,0
2020-11-01,ESP,Melaka,0,0,0
2020-11-01,ESP,Negeri Sembilan,0,0,0
2020-11-01,ESP,Pahang,0,0,0
2020-11-01,ESP,Perak,0,0,0
2020-11-01,ESP,Perlis,0,0,0
2020-11-01,ESP,Pulau Pinang,0,0,0
2020-11-01,ESP,Sabah,0,0,0
2020-11-01,ESP,Sarawak,0,0,0
2020-11-01,ESP,Selangor,14,12,2
2020-11-01,ESP,W.P. Labuan,0,0,0
2020-11-01,EST,Johor,0,0,0
2020-11-01,EST,Kedah,0,0,0
2020-11-01,EST,Kelantan,0,0,0
2020-11-01,EST,Pahang,0,0,0
2020-11-01,EST,Perak,0,0,0
2020-11-01,EST,Perlis,0,0,0
2020-11-01,EST,Pulau Pinang,0,0,0
2020-11-01,EST,Sabah,0,0,0
2020-11-01,EST,Sarawak,0,0,0
2020-11-01,EST,Selangor,3,3,0
2020-11-01,EST,W.P. Labuan,0,0,0
2020-11-01,ETH,Johor,0,0,0
2020-11-01,ETH,Kedah,0,0,0
2020-11-01,ETH,Pulau Pinang,0,0,0
2020-11-01,ETH,Sarawak,0,0,0
2020-11-01,ETH,Selangor,0,0,0
2020-11-01,FIN,Johor,0,0,0
2020-11-01,FIN,Kedah,0,0,0
2020-11-01,FIN,Kelantan,0,0,0
2020-11-01,FIN,Melaka,0,0,0
2020-11-01,FIN,Negeri Sembilan,0,0,0
2020-11-01,FIN,Pahang,0,0,0
2020-11-01,FIN,Perak,0,0,0
2020-11-01,FIN,Perlis,0,0,0
2020-11-01,FIN,Pulau Pinang,0,0,0
2020-11-01,FIN,Sabah,0,0,0
2020-11-01,FIN,Sarawak,0,0,0
2020-11-01,FIN,Selangor,5,5,0
2020-11-01,FIN,W.P. Labuan,0,0,0
2020-11-01,FJI,Johor,0,0,0
2020-11-01,FJI,Kedah,0,0,0
2020-11-01,FJI,Kelantan,0,0,0
2020-11-01,FJI,Perak,0,0,0
2020-11-01,FJI,Perlis,0,0,0
2020-11-01,FJI,Pulau Pinang,0,0,0
2020-11-01,FJI,Sabah,0,0,0
2020-11-01,FJI,Sarawak,0,0,0
2020-11-01,FJI,Selangor,1,0,1
2020-11-01,FRA,Johor,2,2,0
2020-11-01,FRA,Kedah,0,0,0
2020-11-01,FRA,Kelantan,0,0,0
2020-11-01,FRA,Melaka,0,0,0
2020-11-01,FRA,Negeri Sembilan,0,0,0
2020-11-01,FRA,Pahang,0,0,0
2020-11-01,FRA,Perak,0,0,0
2020-11-01,FRA,Perlis,0,0,0
2020-11-01,FRA,Pulau Pinang,0,0,0
2020-11-01,FRA,Sabah,0,0,0
2020-11-01,FRA,Sarawak,0,0,0
2020-11-01,FRA,Selangor,44,35,9
2020-11-01,FRA,Terengganu,0,0,0
2020-11-01,FRA,W.P. Labuan,0,0,0
2020-11-01,FSM,Johor,0,0,0
2020-11-01,FSM,Pulau Pinang,0,0,0
2020-11-01,FSM,Selangor,0,0,0
2020-11-01,GAB,Johor,0,0,0
2020-11-01,GAB,Pulau Pinang,0,0,0
2020-11-01,GAB,Sarawak,0,0,0
2020-11-01,GAB,Selangor,0,0,0
2020-11-01,GBR,Johor,37,37,0
2020-11-01,GBR,Kedah,0,0,0
2020-11-01,GBR,Kelantan,0,0,0
2020-11-01,GBR,Melaka,0,0,0
2020-11-01,GBR,Negeri Sembilan,0,0,0
2020-11-01,GBR,Pahang,0,0,0
2020-11-01,GBR,Perak,1,0,1
2020-11-01,GBR,Perlis,0,0,0
2020-11-01,GBR,Pulau Pinang,5,4,1
2020-11-01,GBR,Sabah,0,0,0
2020-11-01,GBR,Sarawak,0,0,0
2020-11-01,GBR,Selangor,199,160,39
2020-11-01,GBR,Terengganu,0,0,0
2020-11-01,GBR,W.P. Labuan,0,0,0
2020-11-01,GEO,Johor,2,2,0
2020-11-01,GEO,Kedah,0,0,0
2020-11-01,GEO,Melaka,0,0,0
2020-11-01,GEO,Perak,0,0,0
2020-11-01,GEO,Perlis,0,0,0
2020-11-01,GEO,Pulau Pinang,0,0,0
2020-11-01,GEO,Sabah,0,0,0
2020-11-01,GEO,Sarawak,0,0,0
2020-11-01,GEO,Selangor,5,3,2
2020-11-01,GHA,Johor,0,0,0
2020-11-01,GHA,Kedah,0,0,0
2020-11-01,GHA,Kelantan,0,0,0
2020-11-01,GHA,Pulau Pinang,0,0,0
2020-11-01,GHA,Sabah,0,0,0
2020-11-01,GHA,Sarawak,0,0,0
2020-11-01,GHA,Selangor,2,1,1
2020-11-01,GIB,Johor,0,0,0
2020-11-01,GIB,Sarawak,0,0,0
2020-11-01,GIN,Johor,0,0,0
2020-11-01,GIN,Kedah,0,0,0
2020-11-01,GIN,Kelantan,0,0,0
2020-11-01,GIN,Perlis,0,0,0
2020-11-01,GIN,Pulau Pinang,0,0,0
2020-11-01,GIN,Sabah,0,0,0
2020-11-01,GIN,Sarawak,0,0,0
2020-11-01,GIN,Selangor,0,0,0
2020-11-01,GLP,Selangor,0,0,0
2020-11-01,GMB,Johor,0,0,0
2020-11-01,GMB,Kedah,0,0,0
2020-11-01,GMB,Kelantan,0,0,0
2020-11-01,GMB,Pulau Pinang,0,0,0
2020-11-01,GMB,Sabah,0,0,0
2020-11-01,GMB,Sarawak,0,0,0
2020-11-01,GMB,Selangor,1,0,1
2020-11-01,GNB,Johor,0,0,0
2020-11-01,GNB,Selangor,0,0,0
2020-11-01,GNQ,Johor,0,0,0
2020-11-01,GNQ,Selangor,0,0,0
2020-11-01,GRC,Johor,0,0,0
2020-11-01,GRC,Kedah,0,0,0
2020-11-01,GRC,Kelantan,0,0,0
2020-11-01,GRC,Melaka,0,0,0
2020-11-01,GRC,Negeri Sembilan,0,0,0
2020-11-01,GRC,Pahang,0,0,0
2020-11-01,GRC,Perak,0,0,0
2020-11-01,GRC,Perlis,0,0,0
2020-11-01,GRC,Pulau Pinang,0,0,0
2020-11-01,GRC,Sabah,0,0,0
2020-11-01,GRC,Sarawak,0,0,0
2020-11-01,GRC,Selangor,5,3,2
2020-11-01,GRD,Johor,0,0,0
2020-11-01,GRD,Kedah,0,0,0
2020-11-01,GRD,Pulau Pinang,0,0,0
2020-11-01,GRD,Sabah,0,0,0
2020-11-01,GRD,Sarawak,0,0,0
2020-11-01,GRD,Selangor,0,0,0
2020-11-01,GRL,Johor,0,0,0
2020-11-01,GRL,Selangor,0,0,0
2020-11-01,GTM,Johor,0,0,0
2020-11-01,GTM,Kedah,0,0,0
2020-11-01,GTM,Pahang,0,0,0
2020-11-01,GTM,Perak,0,0,0
2020-11-01,GTM,Pulau Pinang,0,0,0
2020-11-01,GTM,Sabah,0,0,0
2020-11-01,GTM,Sarawak,0,0,0
2020-11-01,GTM,Selangor,0,0,0
2020-11-01,GTM,W.P. Labuan,0,0,0
2020-11-01,GUY,Johor,0,0,0
2020-11-01,GUY,Kedah,0,0,0
2020-11-01,GUY,Pulau Pinang,0,0,0
2020-11-01,GUY,Sarawak,0,0,0
2020-11-01,GUY,Selangor,0,0,0
2020-11-01,HKG,Johor,0,0,0
2020-11-01,HKG,Kedah,0,0,0
2020-11-01,HKG,Kelantan,0,0,0
2020-11-01,HKG,Pahang,0,0,0
2020-11-01,HKG,Perak,0,0,0
2020-11-01,HKG,Perlis,0,0,0
2020-11-01,HKG,Pulau Pinang,0,0,0
2020-11-01,HKG,Sabah,0,0,0
2020-11-01,HKG,Sarawak,0,0,0
2020-11-01,HKG,Selangor,2,1,1
2020-11-01,HKG,Terengganu,0,0,0
2020-11-01,HMD,Johor,0,0,0
2020-11-01,HND,Johor,0,0,0
2020-11-01,HND,Kedah,0,0,0
2020-11-01,HND,Perak,0,0,0
2020-11-01,HND,Pulau Pinang,0,0,0
2020-11-01,HND,Sabah,0,0,0
2020-11-01,HND,Sarawak,0,0,0
2020-11-01,HND,Selangor,0,0,0
2020-11-01,HRV,Johor,0,0,0
2020-11-01,HRV,Kedah,0,0,0
2020-11-01,HRV,Kelantan,0,0,0
2020-11-01,HRV,Melaka,0,0,0
2020-11-01,HRV,Pahang,0,0,0
2020-11-01,HRV,Perak,0,0,0
2020-11-01,HRV,Perlis,0,0,0
2020-11-01,HRV,Pulau Pinang,0,0,0
2020-11-01,HRV,Sabah,0,0,0
2020-11-01,HRV,Sarawak,0,0,0
2020-11-01,HRV,Selangor,14,14,0
2020-11-01,HTI,Johor,0,0,0
2020-11-01,HTI,Kedah,0,0,0
2020-11-01,HTI,Kelantan,0,0,0
2020-11-01,HTI,Perak,0,0,0
2020-11-01,HTI,Pulau Pinang,0,0,0
2020-11-01,HTI,Sabah,0,0,0
2020-11-01,HTI,Selangor,0,0,0
2020-11-01,HUN,Johor,0,0,0
2020-11-01,HUN,Kedah,0,0,0
2020-11-01,HUN,Kelantan,0,0,0
2020-11-01,HUN,Pahang,0,0,0
2020-11-01,HUN,Perak,0,0,0
2020-11-01,HUN,Perlis,0,0,0
2020-11-01,HUN,Pulau Pinang,0,0,0
2020-11-01,HUN,Sabah,0,0,0
2020-11-01,HUN,Sarawak,0,0,0
2020-11-01,HUN,Selangor,5,5,0
2020-11-01,HUN,W.P. Labuan,0,0,0
2020-11-01,IDN,Johor,224,195,29
2020-11-01,IDN,Kedah,0,0,0
2020-11-01,IDN,Kelantan,0,0,0
2020-11-01,IDN,Melaka,0,0,0
2020-11-01,IDN,Negeri Sembilan,0,0,0
2020-11-01,IDN,Pahang,0,0,0
2020-11-01,IDN,Perak,0,0,0
2020-11-01,IDN,Perlis,6,5,1
2020-11-01,IDN,Pulau Pinang,4,2,2
2020-11-01,IDN,Sabah,1,0,1
2020-11-01,IDN,Sarawak,362,361,1
2020-11-01,IDN,Selangor,364,251,113
2020-11-01,IDN,Terengganu,0,0,0
2020-11-01,IDN,W.P. Labuan,3,3,0
2020-11-01,IND,Johor,34,34,0
2020-11-01,IND,Kedah,0,0,0
2020-11-01,IND,Kelantan,0,0,0
2020-11-01,IND,Melaka,0,0,0
2020-11-01,IND,Negeri Sembilan,0,0,0
2020-11-01,IND,Pahang,0,0,0
2020-11-01,IND,Perak,0,0,0
2020-11-01,IND,Perlis,0,0,0
2020-11-01,IND,Pulau Pinang,1,1,0
2020-11-01,IND,Sabah,0,0,0
2020-11-01,IND,Sarawak,0,0,0
2020-11-01,IND,Selangor,392,336,56
2020-11-01,IND,Terengganu,0,0,0
2020-11-01,IND,W.P. Labuan,0,0,0
2020-11-01,IOT,Pulau Pinang,0,0,0
2020-11-01,IOT,Selangor,0,0,0
2020-11-01,IRL,Johor,0,0,0
2020-11-01,IRL,Kedah,0,0,0
2020-11-01,IRL,Kelantan,0,0,0
2020-11-01,IRL,Negeri Sembilan,0,0,0
2020-11-01,IRL,Pahang,0,0,0
2020-11-01,IRL,Perak,0,0,0
2020-11-01,IRL,Perlis,0,0,0
2020-11-01,IRL,Pulau Pinang,1,1,0
2020-11-01,IRL,Sabah,0,0,0
2020-11-01,IRL,Sarawak,0,0,0
2020-11-01,IRL,Selangor,16,11,5
2020-11-01,IRL,Terengganu,0,0,0
2020-11-01,IRL,W.P. Labuan,0,0,0
2020-11-01,IRN,Johor,0,0,0
2020-11-01,IRN,Kedah,0,0,0
2020-11-01,IRN,Kelantan,0,0,0
2020-11-01,IRN,Perak,0,0,0
2020-11-01,IRN,Perlis,0,0,0
2020-11-01,IRN,Pulau Pinang,0,0,0
2020-11-01,IRN,Sabah,0,0,0
2020-11-01,IRN,Sarawak,0,0,0
2020-11-01,IRN,Selangor,26,13,13
2020-11-01,IRN,W.P. Labuan,0,0,0
2020-11-01,IRQ,Johor,0,0,0
2020-11-01,IRQ,Kedah,0,0,0
2020-11-01,IRQ,Kelantan,0,0,0
2020-11-01,IRQ,Melaka,0,0,0
2020-11-01,IRQ,Pahang,0,0,0
2020-11-01,IRQ,Perak,0,0,0
2020-11-01,IRQ,Perlis,0,0,0
2020-11-01,IRQ,Pulau Pinang,0,0,0
2020-11-01,IRQ,Sabah,0,0,0
2020-11-01,IRQ,Sarawak,0,0,0
2020-11-01,IRQ,Selangor,11,8,3
2020-11-01,ISL,Johor,0,0,0
2020-11-01,ISL,Kedah,0,0,0
2020-11-01,ISL,Kelantan,0,0,0
2020-11-01,ISL,Perak,0,0,0
2020-11-01,ISL,Perlis,0,0,0
2020-11-01,ISL,Pulau Pinang,0,0,0
2020-11-01,ISL,Sabah,0,0,0
2020-11-01,ISL,Sarawak,0,0,0
2020-11-01,ISL,Selangor,0,0,0
2020-11-01,ISL,W.P. Labuan,0,0,0
2020-11-01,ISR,Pulau Pinang,0,0,0
2020-11-01,ITA,Johor,0,0,0
2020-11-01,ITA,Kedah,0,0,0
2020-11-01,ITA,Kelantan,0,0,0
2020-11-01,ITA,Melaka,0,0,0
2020-11-01,ITA,Negeri Sembilan,0,0,0
2020-11-01,ITA,Pahang,0,0,0
2020-11-01,ITA,Perak,0,0,0
2020-11-01,ITA,Perlis,0,0,0
2020-11-01,ITA,Pulau Pinang,0,0,0
2020-11-01,ITA,Sabah,1,1,0
2020-11-01,ITA,Sarawak,0,0,0
2020-11-01,ITA,Selangor,17,16,1
2020-11-01,ITA,W.P. Labuan,0,0,0
2020-11-01,JAM,Johor,0,0,0
2020-11-01,JAM,Kedah,0,0,0
2020-11-01,JAM,Perak,0,0,0
2020-11-01,JAM,Pulau Pinang,0,0,0
2020-11-01,JAM,Sabah,0,0,0
2020-11-01,JAM,Sarawak,0,0,0
2020-11-01,JAM,Selangor,1,0,1
2020-11-01,JAM,W.P. Labuan,0,0,0
2020-11-01,JOR,Johor,0,0,0
2020-11-01,JOR,Kedah,0,0,0
2020-11-01,JOR,Kelantan,0,0,0
2020-11-01,JOR,Melaka,0,0,0
2020-11-01,JOR,Perlis,0,0,0
2020-11-01,JOR,Pulau Pinang,0,0,0
2020-11-01,JOR,Sabah,0,0,0
2020-11-01,JOR,Sarawak,0,0,0
2020-11-01,JOR,Selangor,3,3,0
2020-11-01,JOR,W.P. Labuan,0,0,0
2020-11-01,JPN,Johor,3,3,0
2020-11-01,JPN,Kedah,0,0,0
2020-11-01,JPN,Kelantan,0,0,0
2020-11-01,JPN,Melaka,0,0,0
2020-11-01,JPN,Negeri Sembilan,0,0,0
2020-11-01,JPN,Pahang,0,0,0
2020-11-01,JPN,Perak,0,0,0
2020-11-01,JPN,Perlis,0,0,0
2020-11-01,JPN,Pulau Pinang,12,8,4
2020-11-01,JPN,Sabah,0,0,0
2020-11-01,JPN,Sarawak,6,5,1
2020-11-01,JPN,Selangor,342,226,116
2020-11-01,JPN,W.P. Labuan,0,0,0
2020-11-01,KAZ,Johor,0,0,0
2020-11-01,KAZ,Kedah,0,0,0
2020-11-01,KAZ,Kelantan,0,0,0
2020-11-01,KAZ,Melaka,0,0,0
2020-11-01,KAZ,Perak,0,0,0
2020-11-01,KAZ,Perlis,0,0,0
2020-11-01,KAZ,Pulau Pinang,0,0,0
2020-11-01,KAZ,Sabah,0,0,0
2020-11-01,KAZ,Sarawak,0,0,0
2020-11-01,KAZ,Selangor,8,4,4
2020-11-01,KAZ,W.P. Labuan,0,0,0
2020-11-01,KEN,Johor,0,0,0
2020-11-01,KEN,Kedah,0,0,0
2020-11-01,KEN,Kelantan,0,0,0
2020-11-01,KEN,Perak,0,0,0
2020-11-01,KEN,Perlis,0,0,0
2020-11-01,KEN,Pulau Pinang,0,0,0
2020-11-01,KEN,Sabah,0,0,0
2020-11-01,KEN,Sarawak,0,0,0
2020-11-01,KEN,Selangor,1,1,0
2020-11-01,KGZ,Johor,0,0,0
2020-11-01,KGZ,Kedah,0,0,0
2020-11-01,KGZ,Kelantan,0,0,0
2020-11-01,KGZ,Perak,0,0,0
2020-11-01,KGZ,Perlis,0,0,0
2020-11-01,KGZ,Pulau Pinang,0,0,0
2020-11-01,KGZ,Sabah,0,0,0
2020-11-01,KGZ,Sarawak,0,0,0
2020-11-01,KGZ,Selangor,1,0,1
2020-11-01,KHM,Johor,0,0,0
2020-11-01,KHM,Kedah,0,0,0
2020-11-01,KHM,Kelantan,0,0,0
2020-11-01,KHM,Melaka,0,0,0
2020-11-01,KHM,Negeri Sembilan,0,0,0
2020-11-01,KHM,Pahang,0,0,0
2020-11-01,KHM,Perak,0,0,0
2020-11-01,KHM,Perlis,0,0,0
2020-11-01,KHM,Pulau Pinang,0,0,0
2020-11-01,KHM,Sabah,0,0,0
2020-11-01,KHM,Sarawak,0,0,0
2020-11-01,KHM,Selangor,9,3,6
2020-11-01,KHM,W.P. Labuan,0,0,0
2020-11-01,KIR,Johor,0,0,0
2020-11-01,KIR,Sabah,0,0,0
2020-11-01,KIR,Selangor,10,10,0
2020-11-01,KNA,Johor,0,0,0
2020-11-01,KNA,Kedah,0,0,0
2020-11-01,KNA,Perlis,0,0,0
2020-11-01,KNA,Pulau Pinang,0,0,0
2020-11-01,KNA,Sabah,0,0,0
2020-11-01,KNA,Selangor,0,0,0
2020-11-01,KNA,W.P. Labuan,0,0,0
2020-11-01,KOR,Johor,1,1,0
2020-11-01,KOR,Kedah,0,0,0
2020-11-01,KOR,Kelantan,0,0,0
2020-11-01,KOR,Melaka,0,0,0
2020-11-01,KOR,Negeri Sembilan,0,0,0
2020-11-01,KOR,Pahang,0,0,0
2020-11-01,KOR,Perak,0,0,0
2020-11-01,KOR,Perlis,0,0,0
2020-11-01,KOR,Pulau Pinang,0,0,0
2020-11-01,KOR,Sabah,0,0,0
2020-11-01,KOR,Sarawak,9,7,2
2020-11-01,KOR,Selangor,225,153,72
2020-11-01,KOR,Terengganu,0,0,0
2020-11-01,KOR,W.P. Labuan,0,0,0
2020-11-01,KWT,Johor,0,0,0
2020-11-01,KWT,Kedah,0,0,0
2020-11-01,KWT,Kelantan,0,0,0
2020-11-01,KWT,Perak,0,0,0
2020-11-01,KWT,Perlis,0,0,0
2020-11-01,KWT,Pulau Pinang,0,0,0
2020-11-01,KWT,Sabah,0,0,0
2020-11-01,KWT,Sarawak,0,0,0
2020-11-01,KWT,Selangor,0,0,0
2020-11-01,KWT,W.P. Labuan,0,0,0
2020-11-01,LAO,Johor,0,0,0
2020-11-01,LAO,Kedah,0,0,0
2020-11-01,LAO,Kelantan,0,0,0
2020-11-01,LAO,Melaka,0,0,0
2020-11-01,LAO,Perak,0,0,0
2020-11-01,LAO,Perlis,0,0,0
2020-11-01,LAO,Pulau Pinang,0,0,0
2020-11-01,LAO,Sabah,0,0,0
2020-11-01,LAO,Sarawak,0,0,0
2020-11-01,LAO,Selangor,3,1,2
2020-11-01,LAO,W.P. Labuan,0,0,0
2020-11-01,LBN,Johor,0,0,0
2020-11-01,LBN,Kedah,0,0,0
2020-11-01,LBN,Kelantan,0,0,0
2020-11-01,LBN,Pahang,0,0,0
2020-11-01,LBN,Perak,0,0,0
2020-11-01,LBN,Perlis,0,0,0
2020-11-01,LBN,Pulau Pinang,0,0,0
2020-11-01,LBN,Sabah,0,0,0
2020-11-01,LBN,Sarawak,0,0,0
2020-11-01,LBN,Selangor,2,2,0
2020-11-01,LBN,W.P. Labuan,0,0,0
2020-11-01,LBR,Johor,0,0,0
2020-11-01,LBR,Kedah,0,0,0
2020-11-01,LBR,Sabah,0,0,0
2020-11-01,LBR,Sarawak,0,0,0
2020-11-01,LBR,Selangor,1,1,0
2020-11-01,LBY,Johor,0,0,0
2020-11-01,LBY,Kedah,0,0,0
2020-11-01,LBY,Perlis,0,0,0
2020-11-01,LBY,Pulau Pinang,0,0,0
2020-11-01,LBY,Sabah,0,0,0
2020-11-01,LBY,Sarawak,0,0,0
2020-11-01,LBY,Selangor,1,0,1
2020-11-01,LCA,Johor,0,0,0
2020-11-01,LCA,Kedah,0,0,0
2020-11-01,LCA,Pulau Pinang,0,0,0
2020-11-01,LCA,Sarawak,0,0,0
2020-11-01,LCA,Selangor,0,0,0
2020-11-01,LIE,Johor,0,0,0
2020-11-01,LIE,Kedah,0,0,0
2020-11-01,LIE,Perlis,0,0,0
2020-11-01,LIE,Pulau Pinang,0,0,0
2020-11-01,LIE,Sabah,0,0,0
2020-11-01,LIE,Sarawak,0,0,0
2020-11-01,LIE,Selangor,0,0,0
2020-11-01,LKA,Johor,0,0,0
2020-11-01,LKA,Kedah,0,0,0
2020-11-01,LKA,Kelantan,0,0,0
2020-11-01,LKA,Melaka,0,0,0
2020-11-01,LKA,Pahang,0,0,0
2020-11-01,LKA,Perak,0,0,0
2020-11-01,LKA,Perlis,0,0,0
2020-11-01,LKA,Pulau Pinang,0,0,0
2020-11-01,LKA,Sabah,0,0,0
2020-11-01,LKA,Sarawak,0,0,0
2020-11-01,LKA,Selangor,21,12,9
2020-11-01,LKA,W.P. Labuan,0,0,0
2020-11-01,LSO,Johor,0,0,0
2020-11-01,LSO,Kedah,0,0,0
2020-11-01,LSO,Pulau Pinang,0,0,0
2020-11-01,LSO,Sarawak,0,0,0
2020-11-01,LSO,Selangor,0,0,0
2020-11-01,LTU,Johor,0,0,0
2020-11-01,LTU,Kedah,0,0,0
2020-11-01,LTU,Kelantan,0,0,0
2020-11-01,LTU,Pahang,0,0,0
2020-11-01,LTU,Perak,0,0,0
2020-11-01,LTU,Perlis,0,0,0
2020-11-01,LTU,Pulau Pinang,0,0,0
2020-11-01,LTU,Sabah,0,0,0
2020-11-01,LTU,Sarawak,0,0,0
2020-11-01,LTU,Selangor,3,3,0
2020-11-01,LTU,W.P. Labuan,0,0,0
2020-11-01,LUX,Johor,0,0,0
2020-11-01,LUX,Kedah,0,0,0
2020-11-01,LUX,Kelantan,0,0,0
2020-11-01,LUX,Perak,0,0,0
2020-11-01,LUX,Perlis,0,0,0
2020-11-01,LUX,Pulau Pinang,0,0,0
2020-11-01,LUX,Sabah,0,0,0
2020-11-01,LUX,Sarawak,0,0,0
2020-11-01,LUX,Selangor,0,0,0
2020-11-01,LVA,Johor,0,0,0
2020-11-01,LVA,Kedah,0,0,0
2020-11-01,LVA,Kelantan,0,0,0
2020-11-01,LVA,Pahang,0,0,0
2020-11-01,LVA,Perak,0,0,0
2020-11-01,LVA,Perlis,0,0,0
2020-11-01,LVA,Pulau Pinang,0,0,0
2020-11-01,LVA,Sabah,0,0,0
2020-11-01,LVA,Sarawak,0,0,0
2020-11-01,LVA,Selangor,2,2,0
2020-11-01,LVA,W.P. Labuan,0,0,0
2020-11-01,MAC,Johor,0,0,0
2020-11-01,MAC,Pahang,0,0,0
2020-11-01,MAC,Perak,0,0,0
2020-11-01,MAC,Selangor,0,0,0
2020-11-01,MAC,W.P. Labuan,0,0,0
2020-11-01,MAR,Johor,0,0,0
2020-11-01,MAR,Kedah,0,0,0
2020-11-01,MAR,Kelantan,0,0,0
2020-11-01,MAR,Melaka,0,0,0
2020-11-01,MAR,Pahang,0,0,0
2020-11-01,MAR,Perak,0,0,0
2020-11-01,MAR,Perlis,0,0,0
2020-11-01,MAR,Pulau Pinang,0,0,0
2020-11-01,MAR,Sabah,0,0,0
2020-11-01,MAR,Sarawak,0,0,0
2020-11-01,MAR,Selangor,7,3,4
2020-11-01,MAR,W.P. Labuan,0,0,0
2020-11-01,MCO,Johor,0,0,0
2020-11-01,MCO,Kedah,0,0,0
2020-11-01,MCO,Sabah,0,0,0
2020-11-01,MCO,Selangor,0,0,0
2020-11-01,MDA,Johor,0,0,0
2020-11-01,MDA,Kedah,0,0,0
2020-11-01,MDA,Kelantan,0,0,0
2020-11-01,MDA,Negeri Sembilan,0,0,0
2020-11-01,MDA,Perlis,0,0,0
2020-11-01,MDA,Pulau Pinang,0,0,0
2020-11-01,MDA,Sabah,0,0,0
2020-11-01,MDA,Sarawak,0,0,0
2020-11-01,MDA,Selangor,0,0,0
2020-11-01,MDG,Johor,0,0,0
2020-11-01,MDG,Kedah,0,0,0
2020-11-01,MDG,Perak,0,0,0
2020-11-01,MDG,Perlis,0,0,0
2020-11-01,MDG,Pulau Pinang,0,0,0
2020-11-01,MDG,Sabah,0,0,0
2020-11-01,MDG,Sarawak,0,0,0
2020-11-01,MDG,Selangor,0,0,0
2020-11-01,MDV,Johor,0,0,0
2020-11-01,MDV,Kedah,0,0,0
2020-11-01,MDV,Kelantan,0,0,0
2020-11-01,MDV,Perak,0,0,0
2020-11-01,MDV,Perlis,0,0,0
2020-11-01,MDV,Pulau Pinang,0,0,0
2020-11-01,MDV,Sabah,0,0,0
2020-11-01,MDV,Sarawak,0,0,0
2020-11-01,MDV,Selangor,16,12,4
2020-11-01,MEX,Johor,0,0,0
2020-11-01,MEX,Kedah,0,0,0
2020-11-01,MEX,Kelantan,0,0,0
2020-11-01,MEX,Pahang,0,0,0
2020-11-01,MEX,Perak,0,0,0
2020-11-01,MEX,Perlis,0,0,0
2020-11-01,MEX,Pulau Pinang,0,0,0
2020-11-01,MEX,Sabah,0,0,0
2020-11-01,MEX,Sarawak,0,0,0
2020-11-01,MEX,Selangor,6,4,2
2020-11-01,MEX,W.P. Labuan,0,0,0
2020-11-01,MHL,Johor,0,0,0
2020-11-01,MHL,Kedah,0,0,0
2020-11-01,MHL,Perak,0,0,0
2020-11-01,MHL,Pulau Pinang,0,0,0
2020-11-01,MHL,Sabah,0,0,0
2020-11-01,MHL,Selangor,0,0,0
2020-11-01,MKD,Johor,0,0,0
2020-11-01,MKD,Kedah,0,0,0
2020-11-01,MKD,Perak,0,0,0
2020-11-01,MKD,Pulau Pinang,0,0,0
2020-11-01,MKD,Sabah,0,0,0
2020-11-01,MKD,Sarawak,0,0,0
2020-11-01,MKD,Selangor,0,0,0
2020-11-01,MLI,Johor,0,0,0
2020-11-01,MLI,Sabah,0,0,0
2020-11-01,MLI,Selangor,0,0,0
2020-11-01,MLT,Johor,0,0,0
2020-11-01,MLT,Kedah,0,0,0
2020-11-01,MLT,Kelantan,0,0,0
2020-11-01,MLT,Perak,0,0,0
2020-11-01,MLT,Perlis,0,0,0
2020-11-01,MLT,Pulau Pinang,0,0,0
2020-11-01,MLT,Sabah,0,0,0
2020-11-01,MLT,Sarawak,0,0,0
2020-11-01,MLT,Selangor,0,0,0
2020-11-01,MLT,W.P. Labuan,0,0,0
2020-11-01,MMR,Johor,39,39,0
2020-11-01,MMR,Kedah,0,0,0
2020-11-01,MMR,Kelantan,0,0,0
2020-11-01,MMR,Negeri Sembilan,0,0,0
2020-11-01,MMR,Pahang,0,0,0
2020-11-01,MMR,Perak,0,0,0
2020-11-01,MMR,Perlis,0,0,0
2020-11-01,MMR,Pulau Pinang,0,0,0
2020-11-01,MMR,Sabah,0,0,0
2020-11-01,MMR,Sarawak,0,0,0
2020-11-01,MMR,Selangor,122,104,18
2020-11-01,MMR,Terengganu,0,0,0
2020-11-01,MMR,W.P. Labuan,0,0,0
2020-11-01,MNE,Johor,0,0,0
2020-11-01,MNE,Kedah,0,0,0
2020-11-01,MNE,Pulau Pinang,0,0,0
2020-11-01,MNE,Sabah,0,0,0
2020-11-01,MNE,Sarawak,0,0,0
2020-11-01,MNE,Selangor,1,1,0
2020-11-01,MNG,Johor,0,0,0
2020-11-01,MNG,Kedah,0,0,0
2020-11-01,MNG,Kelantan,0,0,0
2020-11-01,MNG,Perak,0,0,0
2020-11-01,MNG,Perlis,0,0,0
2020-11-01,MNG,Pulau Pinang,0,0,0
2020-11-01,MNG,Sabah,0,0,0
2020-11-01,MNG,Sarawak,0,0,0
2020-11-01,MNG,Selangor,2,0,2
2020-11-01,MNP,Selangor,0,0,0
2020-11-01,MOZ,Johor,0,0,0
2020-11-01,MOZ,Kedah,0,0,0
2020-11-01,MOZ,Perak,0,0,0
2020-11-01,MOZ,Pulau Pinang,0,0,0
2020-11-01,MOZ,Sabah,0,0,0
2020-11-01,MOZ,Sarawak,0,0,0
2020-11-01,MOZ,Selangor,0,0,0
2020-11-01,MRT,Johor,0,0,0
2020-11-01,MRT,Kedah,0,0,0
2020-11-01,MRT,Pulau Pinang,0,0,0
2020-11-01,MRT,Sabah,0,0,0
2020-11-01,MRT,Sarawak,0,0,0
2020-11-01,MRT,Selangor,0,0,0
2020-11-01,MUS,Johor,1,1,0
2020-11-01,MUS,Kedah,0,0,0
2020-11-01,MUS,Kelantan,0,0,0
2020-11-01,MUS,Pahang,0,0,0
2020-11-01,MUS,Perak,0,0,0
2020-11-01,MUS,Perlis,0,0,0
2020-11-01,MUS,Pulau Pinang,0,0,0
2020-11-01,MUS,Sabah,0,0,0
2020-11-01,MUS,Sarawak,0,0,0
2020-11-01,MUS,Selangor,5,3,2
2020-11-01,MWI,Johor,0,0,0
2020-11-01,MWI,Pulau Pinang,0,0,0
2020-11-01,MWI,Sabah,0,0,0
2020-11-01,MWI,Sarawak,0,0,0
2020-11-01,MWI,Selangor,1,1,0
2020-11-01,MYT,Selangor,0,0,0
2020-11-01,NAM,Johor,0,0,0
2020-11-01,NAM,Kedah,0,0,0
2020-11-01,NAM,Perak,0,0,0
2020-11-01,NAM,Perlis,0,0,0
2020-11-01,NAM,Pulau Pinang,0,0,0
2020-11-01,NAM,Sabah,0,0,0
2020-11-01,NAM,Sarawak,0,0,0
2020-11-01,NAM,Selangor,0,0,0
2020-11-01,NCL,Selangor,0,0,0
2020-11-01,NER,Johor,0,0,0
2020-11-01,NER,Sabah,0,0,0
2020-11-01,NER,Selangor,0,0,0
2020-11-01,NGA,Johor,0,0,0
2020-11-01,NGA,Kedah,0,0,0
2020-11-01,NGA,Perlis,0,0,0
2020-11-01,NGA,Pulau Pinang,0,0,0
2020-11-01,NGA,Sabah,0,0,0
2020-11-01,NGA,Sarawak,0,0,0
2020-11-01,NGA,Selangor,64,55,9
2020-11-01,NIC,Johor,0,0,0
2020-11-01,NIC,Kedah,0,0,0
2020-11-01,NIC,Pulau Pinang,0,0,0
2020-11-01,NIC,Sabah,0,0,0
2020-11-01,NIC,Selangor,0,0,0
2020-11-01,NLD,Johor,1,1,0
2020-11-01,NLD,Kedah,0,0,0
2020-11-01,NLD,Kelantan,0,0,0
2020-11-01,NLD,Melaka,0,0,0
2020-11-01,NLD,Negeri Sembilan,0,0,0
2020-11-01,NLD,Pahang,0,0,0
2020-11-01,NLD,Perak,0,0,0
2020-11-01,NLD,Perlis,0,0,0
2020-11-01,NLD,Pulau Pinang,5,4,1
2020-11-01,NLD,Sabah,0,0,0
2020-11-01,NLD,Sarawak,0,0,0
2020-11-01,NLD,Selangor,47,41,6
2020-11-01,NLD,Terengganu,0,0,0
2020-11-01,NLD,W.P. Labuan,0,0,0
2020-11-01,NOR,Johor,0,0,0
2020-11-01,NOR,Kedah,0,0,0
2020-11-01,NOR,Kelantan,0,0,0
2020-11-01,NOR,Melaka,0,0,0
2020-11-01,NOR,Pahang,0,0,0
2020-11-01,NOR,Perak,0,0,0
2020-11-01,NOR,Perlis,0,0,0
2020-11-01,NOR,Pulau Pinang,0,0,0
2020-11-01,NOR,Sabah,0,0,0
2020-11-01,NOR,Sarawak,0,0,0
2020-11-01,NOR,Selangor,13,12,1
2020-11-01,NOR,W.P. Labuan,0,0,0
2020-11-01,NPL,Johor,0,0,0
2020-11-01,NPL,Kedah,0,0,0
2020-11-01,NPL,Pahang,0,0,0
2020-11-01,NPL,Perak,0,0,0
2020-11-01,NPL,Perlis,0,0,0
2020-11-01,NPL,Pulau Pinang,0,0,0
2020-11-01,NPL,Sabah,0,0,0
2020-11-01,NPL,Sarawak,0,0,0
2020-11-01,NPL,Selangor,163,159,4
2020-11-01,NPL,W.P. Labuan,0,0,0
2020-11-01,NRU,Johor,0,0,0
2020-11-01,NRU,Pulau Pinang,0,0,0
2020-11-01,NRU,Selangor,0,0,0
2020-11-01,NZL,Johor,3,3,0
2020-11-01,NZL,Kedah,0,0,0
2020-11-01,NZL,Kelantan,0,0,0
2020-11-01,NZL,Melaka,0,0,0
2020-11-01,NZL,Negeri Sembilan,0,0,0
2020-11-01,NZL,Pahang,0,0,0
2020-11-01,NZL,Perak,0,0,0
2020-11-01,NZL,Perlis,0,0,0
2020-11-01,NZL,Pulau Pinang,1,1,0
2020-11-01,NZL,Sabah,0,0,0
2020-11-01,NZL,Sarawak,0,0,0
2020-11-01,NZL,Selangor,19,16,3
2020-11-01,NZL,Terengganu,0,0,0
2020-11-01,NZL,W.P. Labuan,0,0,0
2020-11-01,OMN,Johor,0,0,0
2020-11-01,OMN,Kedah,0,0,0
2020-11-01,OMN,Kelantan,0,0,0
2020-11-01,OMN,Melaka,0,0,0
2020-11-01,OMN,Perak,0,0,0
2020-11-01,OMN,Perlis,0,0,0
2020-11-01,OMN,Pulau Pinang,0,0,0
2020-11-01,OMN,Sabah,0,0,0
2020-11-01,OMN,Sarawak,0,0,0
2020-11-01,OMN,Selangor,16,12,4
2020-11-01,PAK,Johor,0,0,0
2020-11-01,PAK,Kedah,0,0,0
2020-11-01,PAK,Kelantan,0,0,0
2020-11-01,PAK,Melaka,0,0,0
2020-11-01,PAK,Negeri Sembilan,0,0,0
2020-11-01,PAK,Pahang,0,0,0
2020-11-01,PAK,Perak,0,0,0
2020-11-01,PAK,Perlis,0,0,0
2020-11-01,PAK,Pulau Pinang,0,0,0
2020-11-01,PAK,Sabah,0,0,0
2020-11-01,PAK,Sarawak,1,1,0
2020-11-01,PAK,Selangor,73,69,4
2020-11-01,PAK,W.P. Labuan,0,0,0
2020-11-01,PAN,Johor,0,0,0
2020-11-01,PAN,Kedah,0,0,0
2020-11-01,PAN,Perak,0,0,0
2020-11-01,PAN,Perlis,0,0,0
2020-11-01,PAN,Pulau Pinang,0,0,0
2020-11-01,PAN,Sabah,0,0,0
2020-11-01,PAN,Sarawak,0,0,0
2020-11-01,PAN,Selangor,0,0,0
2020-11-01,PER,Johor,0,0,0
2020-11-01,PER,Kedah,0,0,0
2020-11-01,PER,Kelantan,0,0,0
2020-11-01,PER,Pahang,0,0,0
2020-11-01,PER,Perak,0,0,0
2020-11-01,PER,Perlis,0,0,0
2020-11-01,PER,Pulau Pinang,0,0,0
2020-11-01,PER,Sabah,0,0,0
2020-11-01,PER,Sarawak,0,0,0
2020-11-01,PER,Selangor,1,1,0
2020-11-01,PER,W.P. Labuan,0,0,0
2020-11-01,PHL,Johor,45,42,3
2020-11-01,PHL,Kedah,0,0,0
2020-11-01,PHL,Kelantan,0,0,0
2020-11-01,PHL,Melaka,0,0,0
2020-11-01,PHL,Negeri Sembilan,0,0,0
2020-11-01,PHL,Pahang,0,0,0
2020-11-01,PHL,Perak,1,1,0
2020-11-01,PHL,Perlis,0,0,0
2020-11-01,PHL,Pulau Pinang,0,0,0
2020-11-01,PHL,Sabah,0,0,0
2020-11-01,PHL,Sarawak,62,62,0
2020-11-01,PHL,Selangor,261,227,34
2020-11-01,PHL,Terengganu,0,0,0
2020-11-01,PHL,W.P. Labuan,5,5,0
2020-11-01,PLW,Johor,0,0,0
2020-11-01,PLW,Pulau Pinang,0,0,0
2020-11-01,PLW,Selangor,0,0,0
2020-11-01,PNG,Johor,0,0,0
2020-11-01,PNG,Kedah,0,0,0
2020-11-01,PNG,Kelantan,0,0,0
2020-11-01,PNG,Perak,0,0,0
2020-11-01,PNG,Pulau Pinang,0,0,0
2020-11-01,PNG,Sabah,0,0,0
2020-11-01,PNG,Sarawak,0,0,0
2020-11-01,PNG,Selangor,0,0,0
2020-11-01,POL,Johor,0,0,0
2020-11-01,POL,Kedah,0,0,0
2020-11-01,POL,Kelantan,0,0,0
2020-11-01,POL,Melaka,0,0,0
2020-11-01,POL,Negeri Sembilan,0,0,0
2020-11-01,POL,Pahang,0,0,0
2020-11-01,POL,Perak,0,0,0
2020-11-01,POL,Perlis,0,0,0
2020-11-01,POL,Pulau Pinang,0,0,0
2020-11-01,POL,Sabah,0,0,0
2020-11-01,POL,Sarawak,0,0,0
2020-11-01,POL,Selangor,19,18,1
2020-11-01,POL,Terengganu,0,0,0
2020-11-01,POL,W.P. Labuan,0,0,0
2020-11-01,PRK,Selangor,0,0,0
2020-11-01,PRT,Johor,1,1,0
2020-11-01,PRT,Kedah,0,0,0
2020-11-01,PRT,Kelantan,0,0,0
2020-11-01,PRT,Melaka,0,0,0
2020-11-01,PRT,Pahang,0,0,0
2020-11-01,PRT,Perak,0,0,0
2020-11-01,PRT,Perlis,0,0,0
2020-11-01,PRT,Pulau Pinang,0,0,0
2020-11-01,PRT,Sabah,0,0,0
2020-11-01,PRT,Sarawak,0,0,0
2020-11-01,PRT,Selangor,8,5,3
2020-11-01,PRT,W.P. Labuan,0,0,0
2020-11-01,PRY,Johor,0,0,0
2020-11-01,PRY,Kedah,0,0,0
2020-11-01,PRY,Perak,0,0,0
2020-11-01,PRY,Perlis,0,0,0
2020-11-01,PRY,Pulau Pinang,0,0,0
2020-11-01,PRY,Sabah,0,0,0
2020-11-01,PRY,Sarawak,0,0,0
2020-11-01,PRY,Selangor,0,0,0
2020-11-01,PSE,Johor,0,0,0
2020-11-01,PSE,Kedah,0,0,0
2020-11-01,PSE,Kelantan,0,0,0
2020-11-01,PSE,Melaka,0,0,0
2020-11-01,PSE,Perak,0,0,0
2020-11-01,PSE,Perlis,0,0,0
2020-11-01,PSE,Pulau Pinang,0,0,0
2020-11-01,PSE,Sabah,0,0,0
2020-11-01,PSE,Sarawak,0,0,0
2020-11-01,PSE,Selangor,3,1,2
2020-11-01,QAT,Johor,0,0,0
2020-11-01,QAT,Kedah,0,0,0
2020-11-01,QAT,Perlis,0,0,0
2020-11-01,QAT,Pulau Pinang,0,0,0
2020-11-01,QAT,Sabah,0,0,0
2020-11-01,QAT,Sarawak,0,0,0
2020-11-01,QAT,Selangor,2,2,0
2020-11-01,REU,Johor,0,0,0
2020-11-01,REU,Sarawak,0,0,0
2020-11-01,ROU,Johor,0,0,0
2020-11-01,ROU,Kedah,0,0,0
2020-11-01,ROU,Kelantan,0,0,0
2020-11-01,ROU,Negeri Sembilan,0,0,0
2020-11-01,ROU,Pahang,0,0,0
2020-11-01,ROU,Perak,0,0,0
2020-11-01,ROU,Perlis,0,0,0
2020-11-01,ROU,Pulau Pinang,0,0,0
2020-11-01,ROU,Sabah,0,0,0
2020-11-01,ROU,Sarawak,0,0,0
2020-11-01,ROU,Selangor,15,15,0
2020-11-01,ROU,W.P. Labuan,0,0,0
2020-11-01,RUS,Johor,1,1,0
2020-11-01,RUS,Kedah,0,0,0
2020-11-01,RUS,Kelantan,0,0,0
2020-11-01,RUS,Melaka,0,0,0
2020-11-01,RUS,Negeri Sembilan,0,0,0
2020-11-01,RUS,Pahang,0,0,0
2020-11-01,RUS,Perak,0,0,0
2020-11-01,RUS,Perlis,0,0,0
2020-11-01,RUS,Pulau Pinang,0,0,0
2020-11-01,RUS,Sabah,0,0,0
2020-11-01,RUS,Sarawak,0,0,0
2020-11-01,RUS,Selangor,53,47,6
2020-11-01,RUS,W.P. Labuan,0,0,0
2020-11-01,RWA,Johor,0,0,0
2020-11-01,RWA,Kedah,0,0,0
2020-11-01,RWA,Pulau Pinang,0,0,0
2020-11-01,RWA,Selangor,0,0,0
2020-11-01,SAU,Johor,0,0,0
2020-11-01,SAU,Kedah,0,0,0
2020-11-01,SAU,Kelantan,0,0,0
2020-11-01,SAU,Melaka,0,0,0
2020-11-01,SAU,Perak,0,0,0
2020-11-01,SAU,Perlis,0,0,0
2020-11-01,SAU,Pulau Pinang,0,0,0
2020-11-01,SAU,Sabah,0,0,0
2020-11-01,SAU,Sarawak,0,0,0
2020-11-01,SAU,Selangor,28,16,12
2020-11-01,SAU,W.P. Labuan,0,0,0
2020-11-01,SDN,Johor,0,0,0
2020-11-01,SDN,Kedah,0,0,0
2020-11-01,SDN,Kelantan,0,0,0
2020-11-01,SDN,Perlis,0,0,0
2020-11-01,SDN,Pulau Pinang,0,0,0
2020-11-01,SDN,Sabah,0,0,0
2020-11-01,SDN,Sarawak,0,0,0
2020-11-01,SDN,Selangor,5,4,1
2020-11-01,SDN,W.P. Labuan,0,0,0
2020-11-01,SEN,Johor,0,0,0
2020-11-01,SEN,Kedah,0,0,0
2020-11-01,SEN,Kelantan,0,0,0
2020-11-01,SEN,Perak,0,0,0
2020-11-01,SEN,Perlis,0,0,0
2020-11-01,SEN,Pulau Pinang,0,0,0
2020-11-01,SEN,Sabah,0,0,0
2020-11-01,SEN,Sarawak,0,0,0
2020-11-01,SEN,Selangor,2,1,1
2020-11-01,SGP,Johor,467,400,67
2020-11-01,SGP,Kedah,1,1,0
2020-11-01,SGP,Kelantan,3,2,1
2020-11-01,SGP,Melaka,0,0,0
2020-11-01,SGP,Negeri Sembilan,0,0,0
2020-11-01,SGP,Pahang,0,0,0
2020-11-01,SGP,Perak,6,3,3
2020-11-01,SGP,Perlis,0,0,0
2020-11-01,SGP,Pulau Pinang,37,28,9
2020-11-01,SGP,Sabah,0,0,0
2020-11-01,SGP,Sarawak,15,11,4
2020-11-01,SGP,Selangor,211,147,64
2020-11-01,SGP,Terengganu,0,0,0
2020-11-01,SGP,W.P. Labuan,0,0,0
2020-11-01,SGS,Johor,0,0,0
2020-11-01,SGS,Sabah,0,0,0
2020-11-01,SGS,Selangor,0,0,0
2020-11-01,SHN,Sarawak,0,0,0
2020-11-01,SLB,Johor,0,0,0
2020-11-01,SLB,Perlis,0,0,0
2020-11-01,SLB,Pulau Pinang,0,0,0
2020-11-01,SLB,Sabah,0,0,0
2020-11-01,SLB,Sarawak,0,0,0
2020-11-01,SLB,Selangor,0,0,0
2020-11-01,SLB,W.P. Labuan,0,0,0
2020-11-01,SLE,Johor,0,0,0
2020-11-01,SLE,Kedah,0,0,0
2020-11-01,SLE,Perak,0,0,0
2020-11-01,SLE,Pulau Pinang,0,0,0
2020-11-01,SLE,Sabah,0,0,0
2020-11-01,SLE,Selangor,0,0,0
2020-11-01,SLV,Johor,0,0,0
2020-11-01,SLV,Kedah,0,0,0
2020-11-01,SLV,Perak,0,0,0
2020-11-01,SLV,Perlis,0,0,0
2020-11-01,SLV,Pulau Pinang,0,0,0
2020-11-01,SLV,Sabah,0,0,0
2020-11-01,SLV,Selangor,0,0,0
2020-11-01,SLV,W.P. Labuan,0,0,0
2020-11-01,SMR,Johor,0,0,0
2020-11-01,SMR,Selangor,0,0,0
2020-11-01,SOM,Johor,0,0,0
2020-11-01,SOM,Kedah,0,0,0
2020-11-01,SOM,Kelantan,0,0,0
2020-11-01,SOM,Perlis,0,0,0
2020-11-01,SOM,Sabah,0,0,0
2020-11-01,SOM,Sarawak,0,0,0
2020-11-01,SOM,Selangor,1,0,1
2020-11-01,SRB,Johor,0,0,0
2020-11-01,SRB,Kedah,0,0,0
2020-11-01,SRB,Kelantan,0,0,0
2020-11-01,SRB,Pahang,0,0,0
2020-11-01,SRB,Perak,0,0,0
2020-11-01,SRB,Perlis,0,0,0
2020-11-01,SRB,Pulau Pinang,0,0,0
2020-11-01,SRB,Sabah,0,0,0
2020-11-01,SRB,Sarawak,0,0,0
2020-11-01,SRB,Selangor,1,1,0
2020-11-01,SSD,Johor,0,0,0
2020-11-01,SSD,Kedah,0,0,0
2020-11-01,SSD,Sarawak,0,0,0
2020-11-01,SSD,Selangor,0,0,0
2020-11-01,SSD,W.P. Labuan,0,0,0
2020-11-01,STP,Selangor,0,0,0
2020-11-01,SUR,Johor,0,0,0
2020-11-01,SUR,Kedah,0,0,0
2020-11-01,SUR,Kelantan,0,0,0
2020-11-01,SUR,Perak,0,0,0
2020-11-01,SUR,Perlis,0,0,0
2020-11-01,SUR,Pulau Pinang,0,0,0
2020-11-01,SUR,Sabah,0,0,0
2020-11-01,SUR,Sarawak,0,0,0
2020-11-01,SUR,Selangor,0,0,0
2020-11-01,SVK,Johor,0,0,0
2020-11-01,SVK,Kedah,0,0,0
2020-11-01,SVK,Kelantan,0,0,0
2020-11-01,SVK,Negeri Sembilan,0,0,0
2020-11-01,SVK,Pahang,0,0,0
2020-11-01,SVK,Perak,0,0,0
2020-11-01,SVK,Perlis,0,0,0
2020-11-01,SVK,Pulau Pinang,0,0,0
2020-11-01,SVK,Sabah,0,0,0
2020-11-01,SVK,Sarawak,0,0,0
2020-11-01,SVK,Selangor,4,4,0
2020-11-01,SVK,W.P. Labuan,0,0,0
2020-11-01,SVN,Johor,0,0,0
2020-11-01,SVN,Kedah,0,0,0
2020-11-01,SVN,Kelantan,0,0,0
2020-11-01,SVN,Perak,0,0,0
2020-11-01,SVN,Perlis,0,0,0
2020-11-01,SVN,Pulau Pinang,0,0,0
2020-11-01,SVN,Sabah,0,0,0
2020-11-01,SVN,Sarawak,0,0,0
2020-11-01,SVN,Selangor,4,4,0
2020-11-01,SVN,W.P. Labuan,0,0,0
2020-11-01,SWE,Johor,1,1,0
2020-11-01,SWE,Kedah,0,0,0
2020-11-01,SWE,Kelantan,0,0,0
2020-11-01,SWE,Melaka,0,0,0
2020-11-01,SWE,Negeri Sembilan,0,0,0
2020-11-01,SWE,Pahang,0,0,0
2020-11-01,SWE,Perak,0,0,0
2020-11-01,SWE,Perlis,0,0,0
2020-11-01,SWE,Pulau Pinang,0,0,0
2020-11-01,SWE,Sabah,0,0,0
2020-11-01,SWE,Sarawak,0,0,0
2020-11-01,SWE,Selangor,24,19,5
2020-11-01,SWE,W.P. Labuan,0,0,0
2020-11-01,SWZ,Johor,0,0,0
2020-11-01,SWZ,Kedah,0,0,0
2020-11-01,SWZ,Pulau Pinang,0,0,0
2020-11-01,SWZ,Sabah,0,0,0
2020-11-01,SWZ,Selangor,1,1,0
2020-11-01,SYC,Johor,0,0,0
2020-11-01,SYC,Kedah,0,0,0
2020-11-01,SYC,Pulau Pinang,0,0,0
2020-11-01,SYC,Sabah,0,0,0
2020-11-01,SYC,Sarawak,0,0,0
2020-11-01,SYC,Selangor,1,0,1
2020-11-01,SYR,Johor,0,0,0
2020-11-01,SYR,Kedah,0,0,0
2020-11-01,SYR,Kelantan,0,0,0
2020-11-01,SYR,Pahang,0,0,0
2020-11-01,SYR,Perlis,0,0,0
2020-11-01,SYR,Pulau Pinang,0,0,0
2020-11-01,SYR,Sabah,0,0,0
2020-11-01,SYR,Sarawak,0,0,0
2020-11-01,SYR,Selangor,8,6,2
2020-11-01,SYR,W.P. Labuan,0,0,0
2020-11-01,TCA,Perlis,0,0,0
2020-11-01,TCD,Johor,0,0,0
2020-11-01,TCD,Kedah,0,0,0
2020-11-01,TCD,Perlis,0,0,0
2020-11-01,TCD,Selangor,0,0,0
2020-11-01,TGO,Johor,0,0,0
2020-11-01,TGO,Perak,0,0,0
2020-11-01,TGO,Pulau Pinang,0,0,0
2020-11-01,TGO,Selangor,0,0,0
2020-11-01,THA,Johor,74,74,0
2020-11-01,THA,Kedah,10589,9805,784
2020-11-01,THA,Kelantan,2,0,2
2020-11-01,THA,Melaka,0,0,0
2020-11-01,THA,Negeri Sembilan,0,0,0
2020-11-01,THA,Pahang,0,0,0
2020-11-01,THA,Perak,5,2,3
2020-11-01,THA,Perlis,6790,6462,328
2020-11-01,THA,Pulau Pinang,0,0,0
2020-11-01,THA,Sabah,0,0,0
2020-11-01,THA,Sarawak,12,12,0
2020-11-01,THA,Selangor,161,75,86
2020-11-01,THA,Terengganu,0,0,0
2020-11-01,THA,W.P. Labuan,1,0,1
2020-11-01,TJK,Johor,0,0,0
2020-11-01,TJK,Kedah,0,0,0
2020-11-01,TJK,Perlis,0,0,0
2020-11-01,TJK,Pulau Pinang,0,0,0
2020-11-01,TJK,Sabah,0,0,0
2020-11-01,TJK,Selangor,2,2,0
2020-11-01,TKL,Selangor,0,0,0
2020-11-01,TKM,Johor,0,0,0
2020-11-01,TKM,Kedah,0,0,0
2020-11-01,TKM,Kelantan,0,0,0
2020-11-01,TKM,Perlis,0,0,0
2020-11-01,TKM,Pulau Pinang,0,0,0
2020-11-01,TKM,Sabah,0,0,0
2020-11-01,TKM,Sarawak,0,0,0
2020-11-01,TKM,Selangor,0,0,0
2020-11-01,TLS,Johor,0,0,0
2020-11-01,TLS,Kedah,0,0,0
2020-11-01,TLS,Perlis,0,0,0
2020-11-01,TLS,Pulau Pinang,0,0,0
2020-11-01,TLS,Sabah,0,0,0
2020-11-01,TLS,Sarawak,0,0,0
2020-11-01,TLS,Selangor,1,0,1
2020-11-01,TON,Johor,0,0,0
2020-11-01,TON,Pulau Pinang,0,0,0
2020-11-01,TON,Sarawak,0,0,0
2020-11-01,TON,Selangor,0,0,0
2020-11-01,TTO,Johor,0,0,0
2020-11-01,TTO,Kedah,0,0,0
2020-11-01,TTO,Pahang,0,0,0
2020-11-01,TTO,Pulau Pinang,0,0,0
2020-11-01,TTO,Sabah,0,0,0
2020-11-01,TTO,Sarawak,0,0,0
2020-11-01,TTO,Selangor,1,1,0
2020-11-01,TUN,Johor,0,0,0
2020-11-01,TUN,Kedah,0,0,0
2020-11-01,TUN,Kelantan,0,0,0
2020-11-01,TUN,Melaka,0,0,0
2020-11-01,TUN,Perak,0,0,0
2020-11-01,TUN,Perlis,0,0,0
2020-11-01,TUN,Pulau Pinang,0,0,0
2020-11-01,TUN,Sabah,0,0,0
2020-11-01,TUN,Sarawak,0,0,0
2020-11-01,TUN,Selangor,2,2,0
2020-11-01,TUN,W.P. Labuan,0,0,0
2020-11-01,TUR,Johor,0,0,0
2020-11-01,TUR,Kedah,0,0,0
2020-11-01,TUR,Kelantan,0,0,0
2020-11-01,TUR,Melaka,0,0,0
2020-11-01,TUR,Negeri Sembilan,0,0,0
2020-11-01,TUR,Pahang,0,0,0
2020-11-01,TUR,Perak,0,0,0
2020-11-01,TUR,Perlis,0,0,0
2020-11-01,TUR,Pulau Pinang,0,0,0
2020-11-01,TUR,Sabah,0,0,0
2020-11-01,TUR,Sarawak,0,0,0
2020-11-01,TUR,Selangor,16,14,2
2020-11-01,TUR,W.P. Labuan,0,0,0
2020-11-01,TUV,Selangor,0,0,0
2020-11-01,TWN,Johor,1,1,0
2020-11-01,TWN,Kedah,0,0,0
2020-11-01,TWN,Kelantan,0,0,0
2020-11-01,TWN,Melaka,0,0,0
2020-11-01,TWN,Negeri Sembilan,0,0,0
2020-11-01,TWN,Pahang,0,0,0
2020-11-01,TWN,Perak,0,0,0
2020-11-01,TWN,Perlis,0,0,0
2020-11-01,TWN,Pulau Pinang,12,7,5
2020-11-01,TWN,Sabah,0,0,0
2020-11-01,TWN,Sarawak,1,1,0
2020-11-01,TWN,Selangor,89,71,18
2020-11-01,TWN,W.P. Labuan,0,0,0
2020-11-01,TZA,Johor,0,0,0
2020-11-01,TZA,Kedah,0,0,0
2020-11-01,TZA,Perak,0,0,0
2020-11-01,TZA,Perlis,0,0,0
2020-11-01,TZA,Pulau Pinang,0,0,0
2020-11-01,TZA,Sabah,0,0,0
2020-11-01,TZA,Sarawak,0,0,0
2020-11-01,TZA,Selangor,3,2,1
2020-11-01,UGA,Johor,0,0,0
2020-11-01,UGA,Kedah,0,0,0
2020-11-01,UGA,Perak,0,0,0
2020-11-01,UGA,Perlis,0,0,0
2020-11-01,UGA,Pulau Pinang,0,0,0
2020-11-01,UGA,Sabah,0,0,0
2020-11-01,UGA,Sarawak,0,0,0
2020-11-01,UGA,Selangor,1,1,0
2020-11-01,UKR,Johor,0,0,0
2020-11-01,UKR,Kedah,0,0,0
2020-11-01,UKR,Kelantan,0,0,0
2020-11-01,UKR,Melaka,0,0,0
2020-11-01,UKR,Negeri Sembilan,0,0,0
2020-11-01,UKR,Pahang,0,0,0
2020-11-01,UKR,Perak,0,0,0
2020-11-01,UKR,Perlis,0,0,0
2020-11-01,UKR,Pulau Pinang,0,0,0
2020-11-01,UKR,Sabah,0,0,0
2020-11-01,UKR,Sarawak,0,0,0
2020-11-01,UKR,Selangor,47,47,0
2020-11-01,UKR,W.P. Labuan,0,0,0
2020-11-01,URY,Johor,0,0,0
2020-11-01,URY,Kedah,0,0,0
2020-11-01,URY,Kelantan,0,0,0
2020-11-01,URY,Perak,0,0,0
2020-11-01,URY,Perlis,0,0,0
2020-11-01,URY,Pulau Pinang,0,0,0
2020-11-01,URY,Sabah,0,0,0
2020-11-01,URY,Sarawak,0,0,0
2020-11-01,URY,Selangor,1,1,0
2020-11-01,URY,W.P. Labuan,0,0,0
2020-11-01,USA,Johor,0,0,0
2020-11-01,USA,Kedah,0,0,0
2020-11-01,USA,Kelantan,0,0,0
2020-11-01,USA,Melaka,0,0,0
2020-11-01,USA,Negeri Sembilan,0,0,0
2020-11-01,USA,Pahang,0,0,0
2020-11-01,USA,Perak,0,0,0
2020-11-01,USA,Perlis,0,0,0
2020-11-01,USA,Pulau Pinang,11,6,5
2020-11-01,USA,Sabah,0,0,0
2020-11-01,USA,Sarawak,0,0,0
2020-11-01,USA,Selangor,105,79,26
2020-11-01,USA,Terengganu,0,0,0
2020-11-01,USA,W.P. Labuan,0,0,0
2020-11-01,UZB,Johor,0,0,0
2020-11-01,UZB,Kedah,0,0,0
2020-11-01,UZB,Kelantan,0,0,0
2020-11-01,UZB,Perak,0,0,0
2020-11-01,UZB,Perlis,0,0,0
2020-11-01,UZB,Pulau Pinang,0,0,0
2020-11-01,UZB,Sabah,0,0,0
2020-11-01,UZB,Sarawak,0,0,0
2020-11-01,UZB,Selangor,1,0,1
2020-11-01,VAT,Johor,0,0,0
2020-11-01,VAT,Sarawak,0,0,0
2020-11-01,VAT,Selangor,0,0,0
2020-11-01,VCT,Johor,0,0,0
2020-11-01,VCT,Kedah,0,0,0
2020-11-01,VCT,Pulau Pinang,0,0,0
2020-11-01,VCT,Sarawak,0,0,0
2020-11-01,VCT,Selangor,0,0,0
2020-11-01,VEN,Johor,0,0,0
2020-11-01,VEN,Kedah,0,0,0
2020-11-01,VEN,Kelantan,0,0,0
2020-11-01,VEN,Melaka,0,0,0
2020-11-01,VEN,Perak,0,0,0
2020-11-01,VEN,Perlis,0,0,0
2020-11-01,VEN,Pulau Pinang,0,0,0
2020-11-01,VEN,Sabah,0,0,0
2020-11-01,VEN,Sarawak,0,0,0
2020-11-01,VEN,Selangor,0,0,0
2020-11-01,VEN,W.P. Labuan,0,0,0
2020-11-01,VNM,Johor,1,0,1
2020-11-01,VNM,Kedah,2,0,2
2020-11-01,VNM,Kelantan,0,0,0
2020-11-01,VNM,Melaka,0,0,0
2020-11-01,VNM,Negeri Sembilan,0,0,0
2020-11-01,VNM,Pahang,0,0,0
2020-11-01,VNM,Perak,0,0,0
2020-11-01,VNM,Perlis,0,0,0
2020-11-01,VNM,Pulau Pinang,0,0,0
2020-11-01,VNM,Sabah,0,0,0
2020-11-01,VNM,Sarawak,0,0,0
2020-11-01,VNM,Selangor,170,44,126
2020-11-01,VNM,Terengganu,0,0,0
2020-11-01,VNM,W.P. Labuan,0,0,0
2020-11-01,VUT,Johor,0,0,0
2020-11-01,VUT,Kedah,0,0,0
2020-11-01,VUT,Pulau Pinang,0,0,0
2020-11-01,VUT,Sabah,0,0,0
2020-11-01,VUT,Sarawak,0,0,0
2020-11-01,VUT,Selangor,0,0,0
2020-11-01,WSM,Johor,0,0,0
2020-11-01,WSM,Sarawak,0,0,0
2020-11-01,WSM,Selangor,0,0,0
2020-11-01,XXX,Johor,0,0,0
2020-11-01,XXX,Kedah,0,0,0
2020-11-01,XXX,Kelantan,0,0,0
2020-11-01,XXX,Melaka,0,0,0
2020-11-01,XXX,Pahang,0,0,0
2020-11-01,XXX,Perak,0,0,0
2020-11-01,XXX,Perlis,0,0,0
2020-11-01,XXX,Pulau Pinang,0,0,0
2020-11-01,XXX,Sabah,0,0,0
2020-11-01,XXX,Sarawak,0,0,0
2020-11-01,XXX,Selangor,9,7,2
2020-11-01,XXX,W.P. Labuan,0,0,0
2020-11-01,YEM,Johor,0,0,0
2020-11-01,YEM,Kedah,0,0,0
2020-11-01,YEM,Kelantan,0,0,0
2020-11-01,YEM,Melaka,0,0,0
2020-11-01,YEM,Pahang,0,0,0
2020-11-01,YEM,Perak,0,0,0
2020-11-01,YEM,Perlis,0,0,0
2020-11-01,YEM,Pulau Pinang,0,0,0
2020-11-01,YEM,Sabah,0,0,0
2020-11-01,YEM,Sarawak,0,0,0
2020-11-01,YEM,Selangor,14,12,2
2020-11-01,YEM,W.P. Labuan,0,0,0
2020-11-01,ZAF,Johor,1,1,0
2020-11-01,ZAF,Kedah,0,0,0
2020-11-01,ZAF,Kelantan,0,0,0
2020-11-01,ZAF,Melaka,0,0,0
2020-11-01,ZAF,Pahang,0,0,0
2020-11-01,ZAF,Perak,0,0,0
2020-11-01,ZAF,Perlis,0,0,0
2020-11-01,ZAF,Pulau Pinang,0,0,0
2020-11-01,ZAF,Sabah,0,0,0
2020-11-01,ZAF,Sarawak,1,0,1
2020-11-01,ZAF,Selangor,15,14,1
2020-11-01,ZAF,Terengganu,0,0,0
2020-11-01,ZAF,W.P. Labuan,0,0,0
2020-11-01,ZAR,Selangor,0,0,0
2020-11-01,ZMB,Johor,0,0,0
2020-11-01,ZMB,Kedah,0,0,0
2020-11-01,ZMB,Perak,0,0,0
2020-11-01,ZMB,Perlis,0,0,0
2020-11-01,ZMB,Pulau Pinang,0,0,0
2020-11-01,ZMB,Sabah,0,0,0
2020-11-01,ZMB,Sarawak,0,0,0
2020-11-01,ZMB,Selangor,2,2,0
2020-11-01,ZWE,Johor,0,0,0
2020-11-01,ZWE,Kedah,0,0,0
2020-11-01,ZWE,Kelantan,0,0,0
2020-11-01,ZWE,Perak,0,0,0
2020-11-01,ZWE,Perlis,0,0,0
2020-11-01,ZWE,Pulau Pinang,0,0,0
2020-11-01,ZWE,Sabah,0,0,0
2020-11-01,ZWE,Sarawak,0,0,0
2020-11-01,ZWE,Selangor,1,0,1
2020-12-01,ABW,Kedah,0,0,0
2020-12-01,ABW,Pulau Pinang,0,0,0
2020-12-01,AFG,Johor,0,0,0
2020-12-01,AFG,Kedah,0,0,0
2020-12-01,AFG,Perlis,0,0,0
2020-12-01,AFG,Pulau Pinang,0,0,0
2020-12-01,AFG,Sarawak,0,0,0
2020-12-01,AFG,Selangor,2,2,0
2020-12-01,AGO,Johor,0,0,0
2020-12-01,AGO,Kedah,0,0,0
2020-12-01,AGO,Sabah,0,0,0
2020-12-01,AGO,Selangor,0,0,0
2020-12-01,AIA,Selangor,0,0,0
2020-12-01,ALB,Johor,1,1,0
2020-12-01,ALB,Kedah,0,0,0
2020-12-01,ALB,Perak,0,0,0
2020-12-01,ALB,Perlis,0,0,0
2020-12-01,ALB,Pulau Pinang,0,0,0
2020-12-01,ALB,Sabah,0,0,0
2020-12-01,ALB,Sarawak,0,0,0
2020-12-01,ALB,Selangor,0,0,0
2020-12-01,AND,Johor,0,0,0
2020-12-01,AND,Kedah,0,0,0
2020-12-01,AND,Perlis,0,0,0
2020-12-01,AND,Pulau Pinang,0,0,0
2020-12-01,AND,Selangor,0,0,0
2020-12-01,ANT,Selangor,0,0,0
2020-12-01,ARE,Johor,0,0,0
2020-12-01,ARE,Kedah,0,0,0
2020-12-01,ARE,Kelantan,0,0,0
2020-12-01,ARE,Perak,0,0,0
2020-12-01,ARE,Perlis,0,0,0
2020-12-01,ARE,Pulau Pinang,0,0,0
2020-12-01,ARE,Sabah,0,0,0
2020-12-01,ARE,Sarawak,0,0,0
2020-12-01,ARE,Selangor,10,5,5
2020-12-01,ARG,Johor,0,0,0
2020-12-01,ARG,Kedah,0,0,0
2020-12-01,ARG,Kelantan,0,0,0
2020-12-01,ARG,Melaka,0,0,0
2020-12-01,ARG,Perak,0,0,0
2020-12-01,ARG,Perlis,0,0,0
2020-12-01,ARG,Pulau Pinang,0,0,0
2020-12-01,ARG,Sabah,0,0,0
2020-12-01,ARG,Sarawak,0,0,0
2020-12-01,ARG,Selangor,10,5,5
2020-12-01,ARG,W.P. Labuan,0,0,0
2020-12-01,ARM,Johor,0,0,0
2020-12-01,ARM,Kedah,0,0,0
2020-12-01,ARM,Kelantan,0,0,0
2020-12-01,ARM,Perak,0,0,0
2020-12-01,ARM,Perlis,0,0,0
2020-12-01,ARM,Pulau Pinang,0,0,0
2020-12-01,ARM,Sabah,0,0,0
2020-12-01,ARM,Sarawak,0,0,0
2020-12-01,ARM,Selangor,0,0,0
2020-12-01,ATA,Selangor,0,0,0
2020-12-01,ATG,Johor,0,0,0
2020-12-01,ATG,Kedah,0,0,0
2020-12-01,ATG,Pulau Pinang,0,0,0
2020-12-01,ATG,Sarawak,0,0,0
2020-12-01,ATG,Selangor,0,0,0
2020-12-01,AUS,Johor,11,8,3
2020-12-01,AUS,Kedah,0,0,0
2020-12-01,AUS,Kelantan,0,0,0
2020-12-01,AUS,Melaka,0,0,0
2020-12-01,AUS,Negeri Sembilan,0,0,0
2020-12-01,AUS,Pahang,0,0,0
2020-12-01,AUS,Perak,4,2,2
2020-12-01,AUS,Perlis,0,0,0
2020-12-01,AUS,Pulau Pinang,5,2,3
2020-12-01,AUS,Sabah,0,0,0
2020-12-01,AUS,Sarawak,1,1,0
2020-12-01,AUS,Selangor,102,68,34
2020-12-01,AUS,Terengganu,0,0,0
2020-12-01,AUS,W.P. Labuan,0,0,0
2020-12-01,AUT,Johor,0,0,0
2020-12-01,AUT,Kedah,0,0,0
2020-12-01,AUT,Kelantan,0,0,0
2020-12-01,AUT,Melaka,0,0,0
2020-12-01,AUT,Negeri Sembilan,0,0,0
2020-12-01,AUT,Pahang,0,0,0
2020-12-01,AUT,Perak,0,0,0
2020-12-01,AUT,Perlis,0,0,0
2020-12-01,AUT,Pulau Pinang,0,0,0
2020-12-01,AUT,Sabah,0,0,0
2020-12-01,AUT,Sarawak,0,0,0
2020-12-01,AUT,Selangor,5,5,0
2020-12-01,AUT,Terengganu,0,0,0
2020-12-01,AUT,W.P. Labuan,0,0,0
2020-12-01,AZE,Johor,0,0,0
2020-12-01,AZE,Kedah,0,0,0
2020-12-01,AZE,Kelantan,0,0,0
2020-12-01,AZE,Melaka,0,0,0
2020-12-01,AZE,Perlis,0,0,0
2020-12-01,AZE,Pulau Pinang,0,0,0
2020-12-01,AZE,Sabah,0,0,0
2020-12-01,AZE,Sarawak,0,0,0
2020-12-01,AZE,Selangor,1,1,0
2020-12-01,AZE,W.P. Labuan,0,0,0
2020-12-01,BDI,Pulau Pinang,0,0,0
2020-12-01,BDI,Sarawak,0,0,0
2020-12-01,BDI,Selangor,0,0,0
2020-12-01,BEL,Johor,1,1,0
2020-12-01,BEL,Kedah,0,0,0
2020-12-01,BEL,Kelantan,0,0,0
2020-12-01,BEL,Melaka,0,0,0
2020-12-01,BEL,Negeri Sembilan,0,0,0
2020-12-01,BEL,Pahang,0,0,0
2020-12-01,BEL,Perak,0,0,0
2020-12-01,BEL,Perlis,0,0,0
2020-12-01,BEL,Pulau Pinang,0,0,0
2020-12-01,BEL,Sabah,0,0,0
2020-12-01,BEL,Sarawak,0,0,0
2020-12-01,BEL,Selangor,13,8,5
2020-12-01,BEL,W.P. Labuan,0,0,0
2020-12-01,BEN,Johor,0,0,0
2020-12-01,BEN,Kedah,0,0,0
2020-12-01,BEN,Perak,0,0,0
2020-12-01,BEN,Pulau Pinang,0,0,0
2020-12-01,BEN,Sabah,0,0,0
2020-12-01,BEN,Sarawak,0,0,0
2020-12-01,BEN,Selangor,1,0,1
2020-12-01,BFA,Perak,0,0,0
2020-12-01,BFA,Pulau Pinang,0,0,0
2020-12-01,BFA,Selangor,0,0,0
2020-12-01,BGD,Johor,2,2,0
2020-12-01,BGD,Kedah,0,0,0
2020-12-01,BGD,Kelantan,0,0,0
2020-12-01,BGD,Melaka,0,0,0
2020-12-01,BGD,Negeri Sembilan,0,0,0
2020-12-01,BGD,Pahang,0,0,0
2020-12-01,BGD,Perak,0,0,0
2020-12-01,BGD,Perlis,0,0,0
2020-12-01,BGD,Pulau Pinang,0,0,0
2020-12-01,BGD,Sabah,0,0,0
2020-12-01,BGD,Sarawak,0,0,0
2020-12-01,BGD,Selangor,58,44,14
2020-12-01,BGD,W.P. Labuan,0,0,0
2020-12-01,BGR,Johor,0,0,0
2020-12-01,BGR,Kedah,0,0,0
2020-12-01,BGR,Kelantan,0,0,0
2020-12-01,BGR,Pahang,0,0,0
2020-12-01,BGR,Perak,0,0,0
2020-12-01,BGR,Perlis,0,0,0
2020-12-01,BGR,Pulau Pinang,0,0,0
2020-12-01,BGR,Sabah,0,0,0
2020-12-01,BGR,Sarawak,0,0,0
2020-12-01,BGR,Selangor,5,5,0
2020-12-01,BGR,W.P. Labuan,0,0,0
2020-12-01,BHR,Johor,0,0,0
2020-12-01,BHR,Kedah,0,0,0
2020-12-01,BHR,Kelantan,0,0,0
2020-12-01,BHR,Perlis,0,0,0
2020-12-01,BHR,Pulau Pinang,0,0,0
2020-12-01,BHR,Sabah,0,0,0
2020-12-01,BHR,Sarawak,0,0,0
2020-12-01,BHR,Selangor,2,1,1
2020-12-01,BHS,Johor,0,0,0
2020-12-01,BHS,Kedah,0,0,0
2020-12-01,BHS,Perak,0,0,0
2020-12-01,BHS,Sabah,0,0,0
2020-12-01,BHS,Sarawak,0,0,0
2020-12-01,BHS,Selangor,0,0,0
2020-12-01,BIH,Johor,0,0,0
2020-12-01,BIH,Kedah,0,0,0
2020-12-01,BIH,Perlis,0,0,0
2020-12-01,BIH,Pulau Pinang,0,0,0
2020-12-01,BIH,Sabah,0,0,0
2020-12-01,BIH,Sarawak,0,0,0
2020-12-01,BIH,Selangor,1,1,0
2020-12-01,BLR,Johor,0,0,0
2020-12-01,BLR,Kedah,0,0,0
2020-12-01,BLR,Kelantan,0,0,0
2020-12-01,BLR,Pahang,0,0,0
2020-12-01,BLR,Perak,0,0,0
2020-12-01,BLR,Perlis,0,0,0
2020-12-01,BLR,Pulau Pinang,0,0,0
2020-12-01,BLR,Sabah,0,0,0
2020-12-01,BLR,Sarawak,0,0,0
2020-12-01,BLR,Selangor,0,0,0
2020-12-01,BLR,W.P. Labuan,0,0,0
2020-12-01,BLZ,Johor,0,0,0
2020-12-01,BLZ,Pulau Pinang,0,0,0
2020-12-01,BLZ,Sarawak,0,0,0
2020-12-01,BLZ,Selangor,0,0,0
2020-12-01,BMU,Selangor,0,0,0
2020-12-01,BOL,Johor,0,0,0
2020-12-01,BOL,Kedah,0,0,0
2020-12-01,BOL,Melaka,0,0,0
2020-12-01,BOL,Perak,0,0,0
2020-12-01,BOL,Perlis,0,0,0
2020-12-01,BOL,Pulau Pinang,0,0,0
2020-12-01,BOL,Sabah,0,0,0
2020-12-01,BOL,Sarawak,0,0,0
2020-12-01,BOL,Selangor,0,0,0
2020-12-01,BRA,Johor,0,0,0
2020-12-01,BRA,Kedah,0,0,0
2020-12-01,BRA,Kelantan,0,0,0
2020-12-01,BRA,Melaka,0,0,0
2020-12-01,BRA,Pahang,0,0,0
2020-12-01,BRA,Perak,0,0,0
2020-12-01,BRA,Perlis,0,0,0
2020-12-01,BRA,Pulau Pinang,1,0,1
2020-12-01,BRA,Sabah,0,0,0
2020-12-01,BRA,Sarawak,0,0,0
2020-12-01,BRA,Selangor,12,9,3
2020-12-01,BRA,W.P. Labuan,0,0,0
2020-12-01,BRB,Johor,0,0,0
2020-12-01,BRB,Kedah,0,0,0
2020-12-01,BRB,Perlis,0,0,0
2020-12-01,BRB,Pulau Pinang,0,0,0
2020-12-01,BRB,Selangor,0,0,0
2020-12-01,BRN,Johor,0,0,0
2020-12-01,BRN,Kedah,0,0,0
2020-12-01,BRN,Kelantan,0,0,0
2020-12-01,BRN,Melaka,0,0,0
2020-12-01,BRN,Pahang,0,0,0
2020-12-01,BRN,Perak,0,0,0
2020-12-01,BRN,Perlis,0,0,0
2020-12-01,BRN,Pulau Pinang,0,0,0
2020-12-01,BRN,Sabah,0,0,0
2020-12-01,BRN,Sarawak,367,360,7
2020-12-01,BRN,Selangor,19,10,9
2020-12-01,BRN,W.P. Labuan,0,0,0
2020-12-01,BTN,Johor,0,0,0
2020-12-01,BTN,Kedah,0,0,0
2020-12-01,BTN,Perak,0,0,0
2020-12-01,BTN,Perlis,0,0,0
2020-12-01,BTN,Pulau Pinang,0,0,0
2020-12-01,BTN,Sabah,0,0,0
2020-12-01,BTN,Sarawak,0,0,0
2020-12-01,BTN,Selangor,0,0,0
2020-12-01,BWA,Johor,0,0,0
2020-12-01,BWA,Kedah,0,0,0
2020-12-01,BWA,Perlis,0,0,0
2020-12-01,BWA,Pulau Pinang,0,0,0
2020-12-01,BWA,Sabah,0,0,0
2020-12-01,BWA,Sarawak,0,0,0
2020-12-01,BWA,Selangor,0,0,0
2020-12-01,CAF,Kedah,0,0,0
2020-12-01,CAF,Selangor,0,0,0
2020-12-01,CAN,Johor,0,0,0
2020-12-01,CAN,Kedah,0,0,0
2020-12-01,CAN,Kelantan,0,0,0
2020-12-01,CAN,Melaka,0,0,0
2020-12-01,CAN,Negeri Sembilan,0,0,0
2020-12-01,CAN,Pahang,0,0,0
2020-12-01,CAN,Perak,0,0,0
2020-12-01,CAN,Perlis,0,0,0
2020-12-01,CAN,Pulau Pinang,1,1,0
2020-12-01,CAN,Sabah,0,0,0
2020-12-01,CAN,Sarawak,1,1,0
2020-12-01,CAN,Selangor,33,21,12
2020-12-01,CAN,Terengganu,0,0,0
2020-12-01,CAN,W.P. Labuan,0,0,0
2020-12-01,CCK,Selangor,0,0,0
2020-12-01,CHE,Johor,0,0,0
2020-12-01,CHE,Kedah,0,0,0
2020-12-01,CHE,Kelantan,0,0,0
2020-12-01,CHE,Melaka,0,0,0
2020-12-01,CHE,Negeri Sembilan,0,0,0
2020-12-01,CHE,Pahang,0,0,0
2020-12-01,CHE,Perak,0,0,0
2020-12-01,CHE,Perlis,0,0,0
2020-12-01,CHE,Pulau Pinang,0,0,0
2020-12-01,CHE,Sabah,0,0,0
2020-12-01,CHE,Sarawak,0,0,0
2020-12-01,CHE,Selangor,7,4,3
2020-12-01,CHE,W.P. Labuan,0,0,0
2020-12-01,CHL,Johor,0,0,0
2020-12-01,CHL,Kedah,0,0,0
2020-12-01,CHL,Kelantan,0,0,0
2020-12-01,CHL,Melaka,0,0,0
2020-12-01,CHL,Pahang,0,0,0
2020-12-01,CHL,Perak,0,0,0
2020-12-01,CHL,Perlis,0,0,0
2020-12-01,CHL,Pulau Pinang,0,0,0
2020-12-01,CHL,Sabah,0,0,0
2020-12-01,CHL,Sarawak,0,0,0
2020-12-01,CHL,Selangor,1,1,0
2020-12-01,CHN,Johor,46,40,6
2020-12-01,CHN,Kedah,0,0,0
2020-12-01,CHN,Kelantan,0,0,0
2020-12-01,CHN,Melaka,0,0,0
2020-12-01,CHN,Pahang,0,0,0
2020-12-01,CHN,Perak,0,0,0
2020-12-01,CHN,Perlis,0,0,0
2020-12-01,CHN,Pulau Pinang,2,2,0
2020-12-01,CHN,Sabah,5,5,0
2020-12-01,CHN,Sarawak,106,105,1
2020-12-01,CHN,Selangor,875,695,180
2020-12-01,CHN,Terengganu,0,0,0
2020-12-01,CHN,W.P. Labuan,0,0,0
2020-12-01,CIV,Johor,0,0,0
2020-12-01,CIV,Kedah,0,0,0
2020-12-01,CIV,Pulau Pinang,0,0,0
2020-12-01,CIV,Sabah,0,0,0
2020-12-01,CIV,Sarawak,0,0,0
2020-12-01,CIV,Selangor,2,2,0
2020-12-01,CMR,Johor,0,0,0
2020-12-01,CMR,Kedah,0,0,0
2020-12-01,CMR,Pulau Pinang,0,0,0
2020-12-01,CMR,Sabah,0,0,0
2020-12-01,CMR,Sarawak,0,0,0
2020-12-01,CMR,Selangor,0,0,0
2020-12-01,COD,Johor,0,0,0
2020-12-01,COD,Pulau Pinang,0,0,0
2020-12-01,COD,Sarawak,0,0,0
2020-12-01,COD,Selangor,0,0,0
2020-12-01,COG,Johor,0,0,0
2020-12-01,COG,Kedah,0,0,0
2020-12-01,COG,Selangor,0,0,0
2020-12-01,COK,Selangor,0,0,0
2020-12-01,COL,Johor,0,0,0
2020-12-01,COL,Kedah,0,0,0
2020-12-01,COL,Perak,0,0,0
2020-12-01,COL,Pulau Pinang,0,0,0
2020-12-01,COL,Sabah,0,0,0
2020-12-01,COL,Sarawak,0,0,0
2020-12-01,COL,Selangor,4,2,2
2020-12-01,COL,W.P. Labuan,0,0,0
2020-12-01,COM,Johor,0,0,0
2020-12-01,COM,Kedah,0,0,0
2020-12-01,COM,Selangor,0,0,0
2020-12-01,CPV,Johor,0,0,0
2020-12-01,CPV,Kedah,0,0,0
2020-12-01,CPV,Pulau Pinang,0,0,0
2020-12-01,CPV,Sabah,0,0,0
2020-12-01,CPV,Selangor,0,0,0
2020-12-01,CRI,Johor,0,0,0
2020-12-01,CRI,Kedah,0,0,0
2020-12-01,CRI,Perak,0,0,0
2020-12-01,CRI,Perlis,0,0,0
2020-12-01,CRI,Pulau Pinang,0,0,0
2020-12-01,CRI,Sabah,0,0,0
2020-12-01,CRI,Sarawak,0,0,0
2020-12-01,CRI,Selangor,1,1,0
2020-12-01,CUB,Johor,0,0,0
2020-12-01,CUB,Kedah,0,0,0
2020-12-01,CUB,Perlis,0,0,0
2020-12-01,CUB,Pulau Pinang,0,0,0
2020-12-01,CUB,Sabah,0,0,0
2020-12-01,CUB,Sarawak,0,0,0
2020-12-01,CUB,Selangor,0,0,0
2020-12-01,CYP,Johor,0,0,0
2020-12-01,CYP,Kedah,0,0,0
2020-12-01,CYP,Perak,0,0,0
2020-12-01,CYP,Perlis,0,0,0
2020-12-01,CYP,Pulau Pinang,0,0,0
2020-12-01,CYP,Sabah,0,0,0
2020-12-01,CYP,Sarawak,0,0,0
2020-12-01,CYP,Selangor,0,0,0
2020-12-01,CZE,Johor,0,0,0
2020-12-01,CZE,Kedah,0,0,0
2020-12-01,CZE,Kelantan,0,0,0
2020-12-01,CZE,Melaka,0,0,0
2020-12-01,CZE,Negeri Sembilan,0,0,0
2020-12-01,CZE,Perak,0,0,0
2020-12-01,CZE,Perlis,0,0,0
2020-12-01,CZE,Pulau Pinang,0,0,0
2020-12-01,CZE,Sabah,0,0,0
2020-12-01,CZE,Sarawak,0,0,0
2020-12-01,CZE,Selangor,4,3,1
2020-12-01,CZE,W.P. Labuan,0,0,0
2020-12-01,DEU,Johor,1,1,0
2020-12-01,DEU,Kedah,0,0,0
2020-12-01,DEU,Kelantan,0,0,0
2020-12-01,DEU,Melaka,0,0,0
2020-12-01,DEU,Negeri Sembilan,0,0,0
2020-12-01,DEU,Pahang,0,0,0
2020-12-01,DEU,Perak,0,0,0
2020-12-01,DEU,Perlis,0,0,0
2020-12-01,DEU,Pulau Pinang,0,0,0
2020-12-01,DEU,Sabah,0,0,0
2020-12-01,DEU,Sarawak,0,0,0
2020-12-01,DEU,Selangor,34,25,9
2020-12-01,DEU,Terengganu,0,0,0
2020-12-01,DEU,W.P. Labuan,0,0,0
2020-12-01,DJI,Johor,0,0,0
2020-12-01,DJI,Selangor,0,0,0
2020-12-01,DMA,Johor,0,0,0
2020-12-01,DMA,Kedah,0,0,0
2020-12-01,DMA,Pulau Pinang,0,0,0
2020-12-01,DMA,Sabah,0,0,0
2020-12-01,DMA,Sarawak,0,0,0
2020-12-01,DMA,Selangor,0,0,0
2020-12-01,DMA,W.P. Labuan,0,0,0
2020-12-01,DNK,Johor,1,1,0
2020-12-01,DNK,Kedah,0,0,0
2020-12-01,DNK,Kelantan,0,0,0
2020-12-01,DNK,Melaka,0,0,0
2020-12-01,DNK,Negeri Sembilan,0,0,0
2020-12-01,DNK,Pahang,0,0,0
2020-12-01,DNK,Perak,0,0,0
2020-12-01,DNK,Perlis,0,0,0
2020-12-01,DNK,Pulau Pinang,0,0,0
2020-12-01,DNK,Sabah,0,0,0
2020-12-01,DNK,Sarawak,0,0,0
2020-12-01,DNK,Selangor,11,5,6
2020-12-01,DNK,W.P. Labuan,0,0,0
2020-12-01,DOM,Johor,0,0,0
2020-12-01,DOM,Kedah,0,0,0
2020-12-01,DOM,Perak,0,0,0
2020-12-01,DOM,Perlis,0,0,0
2020-12-01,DOM,Pulau Pinang,0,0,0
2020-12-01,DOM,Sabah,0,0,0
2020-12-01,DOM,Sarawak,0,0,0
2020-12-01,DOM,Selangor,0,0,0
2020-12-01,DZA,Johor,0,0,0
2020-12-01,DZA,Kedah,0,0,0
2020-12-01,DZA,Kelantan,0,0,0
2020-12-01,DZA,Melaka,0,0,0
2020-12-01,DZA,Perak,0,0,0
2020-12-01,DZA,Perlis,0,0,0
2020-12-01,DZA,Pulau Pinang,0,0,0
2020-12-01,DZA,Sabah,0,0,0
2020-12-01,DZA,Sarawak,0,0,0
2020-12-01,DZA,Selangor,9,7,2
2020-12-01,DZA,W.P. Labuan,0,0,0
2020-12-01,ECU,Johor,0,0,0
2020-12-01,ECU,Kedah,0,0,0
2020-12-01,ECU,Perak,0,0,0
2020-12-01,ECU,Perlis,0,0,0
2020-12-01,ECU,Pulau Pinang,0,0,0
2020-12-01,ECU,Sabah,0,0,0
2020-12-01,ECU,Sarawak,0,0,0
2020-12-01,ECU,Selangor,1,1,0
2020-12-01,EGY,Johor,0,0,0
2020-12-01,EGY,Kedah,0,0,0
2020-12-01,EGY,Kelantan,0,0,0
2020-12-01,EGY,Melaka,0,0,0
2020-12-01,EGY,Pahang,0,0,0
2020-12-01,EGY,Perak,0,0,0
2020-12-01,EGY,Perlis,0,0,0
2020-12-01,EGY,Pulau Pinang,0,0,0
2020-12-01,EGY,Sabah,0,0,0
2020-12-01,EGY,Sarawak,0,0,0
2020-12-01,EGY,Selangor,50,39,11
2020-12-01,EGY,Terengganu,0,0,0
2020-12-01,EGY,W.P. Labuan,0,0,0
2020-12-01,ERI,Johor,0,0,0
2020-12-01,ERI,Pulau Pinang,0,0,0
2020-12-01,ERI,Sabah,0,0,0
2020-12-01,ERI,Selangor,0,0,0
2020-12-01,ESP,Johor,0,0,0
2020-12-01,ESP,Kedah,0,0,0
2020-12-01,ESP,Kelantan,0,0,0
2020-12-01,ESP,Melaka,0,0,0
2020-12-01,ESP,Negeri Sembilan,0,0,0
2020-12-01,ESP,Pahang,0,0,0
2020-12-01,ESP,Perak,0,0,0
2020-12-01,ESP,Perlis,0,0,0
2020-12-01,ESP,Pulau Pinang,0,0,0
2020-12-01,ESP,Sabah,0,0,0
2020-12-01,ESP,Sarawak,0,0,0
2020-12-01,ESP,Selangor,28,17,11
2020-12-01,ESP,W.P. Labuan,0,0,0
2020-12-01,EST,Johor,0,0,0
2020-12-01,EST,Kedah,0,0,0
2020-12-01,EST,Kelantan,0,0,0
2020-12-01,EST,Pahang,0,0,0
2020-12-01,EST,Perak,0,0,0
2020-12-01,EST,Perlis,0,0,0
2020-12-01,EST,Pulau Pinang,0,0,0
2020-12-01,EST,Sabah,0,0,0
2020-12-01,EST,Sarawak,0,0,0
2020-12-01,EST,Selangor,1,1,0
2020-12-01,EST,W.P. Labuan,0,0,0
2020-12-01,ETH,Johor,0,0,0
2020-12-01,ETH,Kedah,0,0,0
2020-12-01,ETH,Pulau Pinang,0,0,0
2020-12-01,ETH,Sarawak,0,0,0
2020-12-01,ETH,Selangor,3,3,0
2020-12-01,FIN,Johor,1,1,0
2020-12-01,FIN,Kedah,0,0,0
2020-12-01,FIN,Kelantan,0,0,0
2020-12-01,FIN,Melaka,0,0,0
2020-12-01,FIN,Negeri Sembilan,0,0,0
2020-12-01,FIN,Pahang,0,0,0
2020-12-01,FIN,Perak,0,0,0
2020-12-01,FIN,Perlis,0,0,0
2020-12-01,FIN,Pulau Pinang,0,0,0
2020-12-01,FIN,Sabah,0,0,0
2020-12-01,FIN,Sarawak,0,0,0
2020-12-01,FIN,Selangor,7,6,1
2020-12-01,FIN,W.P. Labuan,0,0,0
2020-12-01,FJI,Johor,0,0,0
2020-12-01,FJI,Kedah,0,0,0
2020-12-01,FJI,Kelantan,0,0,0
2020-12-01,FJI,Perak,0,0,0
2020-12-01,FJI,Perlis,0,0,0
2020-12-01,FJI,Pulau Pinang,0,0,0
2020-12-01,FJI,Sabah,0,0,0
2020-12-01,FJI,Sarawak,0,0,0
2020-12-01,FJI,Selangor,5,3,2
2020-12-01,FRA,Johor,1,0,1
2020-12-01,FRA,Kedah,0,0,0
2020-12-01,FRA,Kelantan,0,0,0
2020-12-01,FRA,Melaka,0,0,0
2020-12-01,FRA,Negeri Sembilan,0,0,0
2020-12-01,FRA,Pahang,0,0,0
2020-12-01,FRA,Perak,0,0,0
2020-12-01,FRA,Perlis,0,0,0
2020-12-01,FRA,Pulau Pinang,4,1,3
2020-12-01,FRA,Sabah,0,0,0
2020-12-01,FRA,Sarawak,0,0,0
2020-12-01,FRA,Selangor,53,37,16
2020-12-01,FRA,Terengganu,0,0,0
2020-12-01,FRA,W.P. Labuan,0,0,0
2020-12-01,FSM,Johor,0,0,0
2020-12-01,FSM,Pulau Pinang,0,0,0
2020-12-01,FSM,Selangor,0,0,0
2020-12-01,GAB,Johor,0,0,0
2020-12-01,GAB,Pulau Pinang,0,0,0
2020-12-01,GAB,Sarawak,0,0,0
2020-12-01,GAB,Selangor,0,0,0
2020-12-01,GBR,Johor,2,2,0
2020-12-01,GBR,Kedah,0,0,0
2020-12-01,GBR,Kelantan,0,0,0
2020-12-01,GBR,Melaka,0,0,0
2020-12-01,GBR,Negeri Sembilan,0,0,0
2020-12-01,GBR,Pahang,0,0,0
2020-12-01,GBR,Perak,0,0,0
2020-12-01,GBR,Perlis,0,0,0
2020-12-01,GBR,Pulau Pinang,1,1,0
2020-12-01,GBR,Sabah,1,1,0
2020-12-01,GBR,Sarawak,1,1,0
2020-12-01,GBR,Selangor,185,135,50
2020-12-01,GBR,Terengganu,0,0,0
2020-12-01,GBR,W.P. Labuan,0,0,0
2020-12-01,GEO,Johor,2,2,0
2020-12-01,GEO,Kedah,0,0,0
2020-12-01,GEO,Melaka,0,0,0
2020-12-01,GEO,Perak,0,0,0
2020-12-01,GEO,Perlis,0,0,0
2020-12-01,GEO,Pulau Pinang,0,0,0
2020-12-01,GEO,Sabah,0,0,0
2020-12-01,GEO,Sarawak,0,0,0
2020-12-01,GEO,Selangor,3,3,0
2020-12-01,GHA,Johor,0,0,0
2020-12-01,GHA,Kedah,0,0,0
2020-12-01,GHA,Kelantan,0,0,0
2020-12-01,GHA,Pulau Pinang,0,0,0
2020-12-01,GHA,Sabah,0,0,0
2020-12-01,GHA,Sarawak,0,0,0
2020-12-01,GHA,Selangor,6,5,1
2020-12-01,GIB,Johor,0,0,0
2020-12-01,GIB,Sarawak,0,0,0
2020-12-01,GIN,Johor,0,0,0
2020-12-01,GIN,Kedah,0,0,0
2020-12-01,GIN,Kelantan,0,0,0
2020-12-01,GIN,Perlis,0,0,0
2020-12-01,GIN,Pulau Pinang,0,0,0
2020-12-01,GIN,Sabah,0,0,0
2020-12-01,GIN,Sarawak,0,0,0
2020-12-01,GIN,Selangor,1,0,1
2020-12-01,GLP,Selangor,0,0,0
2020-12-01,GMB,Johor,0,0,0
2020-12-01,GMB,Kedah,0,0,0
2020-12-01,GMB,Kelantan,0,0,0
2020-12-01,GMB,Pulau Pinang,0,0,0
2020-12-01,GMB,Sabah,0,0,0
2020-12-01,GMB,Sarawak,0,0,0
2020-12-01,GMB,Selangor,1,0,1
2020-12-01,GNB,Johor,0,0,0
2020-12-01,GNB,Selangor,0,0,0
2020-12-01,GNQ,Johor,0,0,0
2020-12-01,GNQ,Selangor,1,0,1
2020-12-01,GRC,Johor,2,2,0
2020-12-01,GRC,Kedah,0,0,0
2020-12-01,GRC,Kelantan,0,0,0
2020-12-01,GRC,Melaka,0,0,0
2020-12-01,GRC,Negeri Sembilan,0,0,0
2020-12-01,GRC,Pahang,0,0,0
2020-12-01,GRC,Perak,0,0,0
2020-12-01,GRC,Perlis,0,0,0
2020-12-01,GRC,Pulau Pinang,0,0,0
2020-12-01,GRC,Sabah,0,0,0
2020-12-01,GRC,Sarawak,0,0,0
2020-12-01,GRC,Selangor,4,4,0
2020-12-01,GRD,Johor,0,0,0
2020-12-01,GRD,Kedah,0,0,0
2020-12-01,GRD,Pulau Pinang,0,0,0
2020-12-01,GRD,Sabah,0,0,0
2020-12-01,GRD,Sarawak,0,0,0
2020-12-01,GRD,Selangor,0,0,0
2020-12-01,GRL,Johor,0,0,0
2020-12-01,GRL,Selangor,0,0,0
2020-12-01,GTM,Johor,0,0,0
2020-12-01,GTM,Kedah,0,0,0
2020-12-01,GTM,Pahang,0,0,0
2020-12-01,GTM,Perak,0,0,0
2020-12-01,GTM,Pulau Pinang,0,0,0
2020-12-01,GTM,Sabah,0,0,0
2020-12-01,GTM,Sarawak,0,0,0
2020-12-01,GTM,Selangor,0,0,0
2020-12-01,GTM,W.P. Labuan,0,0,0
2020-12-01,GUY,Johor,0,0,0
2020-12-01,GUY,Kedah,0,0,0
2020-12-01,GUY,Pulau Pinang,0,0,0
2020-12-01,GUY,Sarawak,0,0,0
2020-12-01,GUY,Selangor,0,0,0
2020-12-01,HKG,Johor,0,0,0
2020-12-01,HKG,Kedah,0,0,0
2020-12-01,HKG,Kelantan,0,0,0
2020-12-01,HKG,Pahang,0,0,0
2020-12-01,HKG,Perak,0,0,0
2020-12-01,HKG,Perlis,0,0,0
2020-12-01,HKG,Pulau Pinang,3,1,2
2020-12-01,HKG,Sabah,0,0,0
2020-12-01,HKG,Sarawak,0,0,0
2020-12-01,HKG,Selangor,11,9,2
2020-12-01,HKG,Terengganu,0,0,0
2020-12-01,HMD,Johor,0,0,0
2020-12-01,HND,Johor,0,0,0
2020-12-01,HND,Kedah,0,0,0
2020-12-01,HND,Perak,0,0,0
2020-12-01,HND,Pulau Pinang,0,0,0
2020-12-01,HND,Sabah,0,0,0
2020-12-01,HND,Sarawak,0,0,0
2020-12-01,HND,Selangor,5,5,0
2020-12-01,HRV,Johor,3,3,0
2020-12-01,HRV,Kedah,0,0,0
2020-12-01,HRV,Kelantan,0,0,0
2020-12-01,HRV,Melaka,0,0,0
2020-12-01,HRV,Pahang,0,0,0
2020-12-01,HRV,Perak,0,0,0
2020-12-01,HRV,Perlis,0,0,0
2020-12-01,HRV,Pulau Pinang,0,0,0
2020-12-01,HRV,Sabah,0,0,0
2020-12-01,HRV,Sarawak,0,0,0
2020-12-01,HRV,Selangor,15,15,0
2020-12-01,HTI,Johor,0,0,0
2020-12-01,HTI,Kedah,0,0,0
2020-12-01,HTI,Kelantan,0,0,0
2020-12-01,HTI,Perak,0,0,0
2020-12-01,HTI,Pulau Pinang,0,0,0
2020-12-01,HTI,Sabah,0,0,0
2020-12-01,HTI,Selangor,0,0,0
2020-12-01,HUN,Johor,0,0,0
2020-12-01,HUN,Kedah,0,0,0
2020-12-01,HUN,Kelantan,0,0,0
2020-12-01,HUN,Pahang,0,0,0
2020-12-01,HUN,Perak,0,0,0
2020-12-01,HUN,Perlis,0,0,0
2020-12-01,HUN,Pulau Pinang,0,0,0
2020-12-01,HUN,Sabah,0,0,0
2020-12-01,HUN,Sarawak,0,0,0
2020-12-01,HUN,Selangor,1,1,0
2020-12-01,HUN,W.P. Labuan,0,0,0
2020-12-01,IDN,Johor,250,206,44
2020-12-01,IDN,Kedah,3,3,0
2020-12-01,IDN,Kelantan,0,0,0
2020-12-01,IDN,Melaka,0,0,0
2020-12-01,IDN,Negeri Sembilan,0,0,0
2020-12-01,IDN,Pahang,1,1,0
2020-12-01,IDN,Perak,0,0,0
2020-12-01,IDN,Perlis,8,6,2
2020-12-01,IDN,Pulau Pinang,4,1,3
2020-12-01,IDN,Sabah,2,0,2
2020-12-01,IDN,Sarawak,286,277,9
2020-12-01,IDN,Selangor,479,312,167
2020-12-01,IDN,Terengganu,0,0,0
2020-12-01,IDN,W.P. Labuan,3,3,0
2020-12-01,IND,Johor,16,16,0
2020-12-01,IND,Kedah,0,0,0
2020-12-01,IND,Kelantan,0,0,0
2020-12-01,IND,Melaka,0,0,0
2020-12-01,IND,Negeri Sembilan,0,0,0
2020-12-01,IND,Pahang,0,0,0
2020-12-01,IND,Perak,0,0,0
2020-12-01,IND,Perlis,0,0,0
2020-12-01,IND,Pulau Pinang,3,2,1
2020-12-01,IND,Sabah,0,0,0
2020-12-01,IND,Sarawak,0,0,0
2020-12-01,IND,Selangor,470,376,94
2020-12-01,IND,Terengganu,0,0,0
2020-12-01,IND,W.P. Labuan,1,1,0
2020-12-01,IOT,Pulau Pinang,0,0,0
2020-12-01,IOT,Selangor,0,0,0
2020-12-01,IRL,Johor,1,1,0
2020-12-01,IRL,Kedah,0,0,0
2020-12-01,IRL,Kelantan,0,0,0
2020-12-01,IRL,Negeri Sembilan,0,0,0
2020-12-01,IRL,Pahang,0,0,0
2020-12-01,IRL,Perak,0,0,0
2020-12-01,IRL,Perlis,0,0,0
2020-12-01,IRL,Pulau Pinang,0,0,0
2020-12-01,IRL,Sabah,0,0,0
2020-12-01,IRL,Sarawak,0,0,0
2020-12-01,IRL,Selangor,11,9,2
2020-12-01,IRL,Terengganu,0,0,0
2020-12-01,IRL,W.P. Labuan,0,0,0
2020-12-01,IRN,Johor,0,0,0
2020-12-01,IRN,Kedah,0,0,0
2020-12-01,IRN,Kelantan,0,0,0
2020-12-01,IRN,Perak,0,0,0
2020-12-01,IRN,Perlis,0,0,0
2020-12-01,IRN,Pulau Pinang,0,0,0
2020-12-01,IRN,Sabah,0,0,0
2020-12-01,IRN,Sarawak,0,0,0
2020-12-01,IRN,Selangor,12,6,6
2020-12-01,IRN,W.P. Labuan,0,0,0
2020-12-01,IRQ,Johor,0,0,0
2020-12-01,IRQ,Kedah,0,0,0
2020-12-01,IRQ,Kelantan,0,0,0
2020-12-01,IRQ,Melaka,0,0,0
2020-12-01,IRQ,Pahang,0,0,0
2020-12-01,IRQ,Perak,0,0,0
2020-12-01,IRQ,Perlis,0,0,0
2020-12-01,IRQ,Pulau Pinang,0,0,0
2020-12-01,IRQ,Sabah,0,0,0
2020-12-01,IRQ,Sarawak,0,0,0
2020-12-01,IRQ,Selangor,8,6,2
2020-12-01,ISL,Johor,0,0,0
2020-12-01,ISL,Kedah,0,0,0
2020-12-01,ISL,Kelantan,0,0,0
2020-12-01,ISL,Perak,0,0,0
2020-12-01,ISL,Perlis,0,0,0
2020-12-01,ISL,Pulau Pinang,0,0,0
2020-12-01,ISL,Sabah,0,0,0
2020-12-01,ISL,Sarawak,0,0,0
2020-12-01,ISL,Selangor,0,0,0
2020-12-01,ISL,W.P. Labuan,0,0,0
2020-12-01,ISR,Pulau Pinang,0,0,0
2020-12-01,ITA,Johor,0,0,0
2020-12-01,ITA,Kedah,0,0,0
2020-12-01,ITA,Kelantan,0,0,0
2020-12-01,ITA,Melaka,0,0,0
2020-12-01,ITA,Negeri Sembilan,0,0,0
2020-12-01,ITA,Pahang,0,0,0
2020-12-01,ITA,Perak,0,0,0
2020-12-01,ITA,Perlis,0,0,0
2020-12-01,ITA,Pulau Pinang,0,0,0
2020-12-01,ITA,Sabah,0,0,0
2020-12-01,ITA,Sarawak,1,1,0
2020-12-01,ITA,Selangor,15,13,2
2020-12-01,ITA,W.P. Labuan,0,0,0
2020-12-01,JAM,Johor,0,0,0
2020-12-01,JAM,Kedah,0,0,0
2020-12-01,JAM,Perak,0,0,0
2020-12-01,JAM,Pulau Pinang,0,0,0
2020-12-01,JAM,Sabah,0,0,0
2020-12-01,JAM,Sarawak,0,0,0
2020-12-01,JAM,Selangor,0,0,0
2020-12-01,JAM,W.P. Labuan,0,0,0
2020-12-01,JOR,Johor,0,0,0
2020-12-01,JOR,Kedah,0,0,0
2020-12-01,JOR,Kelantan,0,0,0
2020-12-01,JOR,Melaka,0,0,0
2020-12-01,JOR,Perlis,0,0,0
2020-12-01,JOR,Pulau Pinang,0,0,0
2020-12-01,JOR,Sabah,0,0,0
2020-12-01,JOR,Sarawak,0,0,0
2020-12-01,JOR,Selangor,7,5,2
2020-12-01,JOR,W.P. Labuan,0,0,0
2020-12-01,JPN,Johor,3,3,0
2020-12-01,JPN,Kedah,0,0,0
2020-12-01,JPN,Kelantan,0,0,0
2020-12-01,JPN,Melaka,0,0,0
2020-12-01,JPN,Negeri Sembilan,0,0,0
2020-12-01,JPN,Pahang,0,0,0
2020-12-01,JPN,Perak,0,0,0
2020-12-01,JPN,Perlis,0,0,0
2020-12-01,JPN,Pulau Pinang,25,20,5
2020-12-01,JPN,Sabah,0,0,0
2020-12-01,JPN,Sarawak,2,2,0
2020-12-01,JPN,Selangor,387,252,135
2020-12-01,JPN,W.P. Labuan,0,0,0
2020-12-01,KAZ,Johor,0,0,0
2020-12-01,KAZ,Kedah,0,0,0
2020-12-01,KAZ,Kelantan,0,0,0
2020-12-01,KAZ,Melaka,0,0,0
2020-12-01,KAZ,Perak,0,0,0
2020-12-01,KAZ,Perlis,0,0,0
2020-12-01,KAZ,Pulau Pinang,0,0,0
2020-12-01,KAZ,Sabah,0,0,0
2020-12-01,KAZ,Sarawak,0,0,0
2020-12-01,KAZ,Selangor,3,2,1
2020-12-01,KAZ,W.P. Labuan,0,0,0
2020-12-01,KEN,Johor,0,0,0
2020-12-01,KEN,Kedah,0,0,0
2020-12-01,KEN,Kelantan,0,0,0
2020-12-01,KEN,Perak,0,0,0
2020-12-01,KEN,Perlis,0,0,0
2020-12-01,KEN,Pulau Pinang,0,0,0
2020-12-01,KEN,Sabah,0,0,0
2020-12-01,KEN,Sarawak,0,0,0
2020-12-01,KEN,Selangor,4,4,0
2020-12-01,KGZ,Johor,0,0,0
2020-12-01,KGZ,Kedah,0,0,0
2020-12-01,KGZ,Kelantan,0,0,0
2020-12-01,KGZ,Perak,0,0,0
2020-12-01,KGZ,Perlis,0,0,0
2020-12-01,KGZ,Pulau Pinang,0,0,0
2020-12-01,KGZ,Sabah,0,0,0
2020-12-01,KGZ,Sarawak,0,0,0
2020-12-01,KGZ,Selangor,3,3,0
2020-12-01,KHM,Johor,0,0,0
2020-12-01,KHM,Kedah,0,0,0
2020-12-01,KHM,Kelantan,0,0,0
2020-12-01,KHM,Melaka,0,0,0
2020-12-01,KHM,Negeri Sembilan,0,0,0
2020-12-01,KHM,Pahang,0,0,0
2020-12-01,KHM,Perak,0,0,0
2020-12-01,KHM,Perlis,0,0,0
2020-12-01,KHM,Pulau Pinang,0,0,0
2020-12-01,KHM,Sabah,1,1,0
2020-12-01,KHM,Sarawak,0,0,0
2020-12-01,KHM,Selangor,8,2,6
2020-12-01,KHM,W.P. Labuan,0,0,0
2020-12-01,KIR,Johor,0,0,0
2020-12-01,KIR,Sabah,0,0,0
2020-12-01,KIR,Selangor,8,8,0
2020-12-01,KNA,Johor,0,0,0
2020-12-01,KNA,Kedah,0,0,0
2020-12-01,KNA,Perlis,0,0,0
2020-12-01,KNA,Pulau Pinang,0,0,0
2020-12-01,KNA,Sabah,0,0,0
2020-12-01,KNA,Selangor,1,0,1
2020-12-01,KNA,W.P. Labuan,0,0,0
2020-12-01,KOR,Johor,1,1,0
2020-12-01,KOR,Kedah,0,0,0
2020-12-01,KOR,Kelantan,0,0,0
2020-12-01,KOR,Melaka,0,0,0
2020-12-01,KOR,Negeri Sembilan,0,0,0
2020-12-01,KOR,Pahang,0,0,0
2020-12-01,KOR,Perak,0,0,0
2020-12-01,KOR,Perlis,0,0,0
2020-12-01,KOR,Pulau Pinang,3,3,0
2020-12-01,KOR,Sabah,0,0,0
2020-12-01,KOR,Sarawak,2,2,0
2020-12-01,KOR,Selangor,268,191,77
2020-12-01,KOR,Terengganu,0,0,0
2020-12-01,KOR,W.P. Labuan,0,0,0
2020-12-01,KWT,Johor,0,0,0
2020-12-01,KWT,Kedah,0,0,0
2020-12-01,KWT,Kelantan,0,0,0
2020-12-01,KWT,Perak,0,0,0
2020-12-01,KWT,Perlis,0,0,0
2020-12-01,KWT,Pulau Pinang,0,0,0
2020-12-01,KWT,Sabah,0,0,0
2020-12-01,KWT,Sarawak,0,0,0
2020-12-01,KWT,Selangor,3,2,1
2020-12-01,KWT,W.P. Labuan,0,0,0
2020-12-01,LAO,Johor,0,0,0
2020-12-01,LAO,Kedah,0,0,0
2020-12-01,LAO,Kelantan,0,0,0
2020-12-01,LAO,Melaka,0,0,0
2020-12-01,LAO,Perak,0,0,0
2020-12-01,LAO,Perlis,0,0,0
2020-12-01,LAO,Pulau Pinang,0,0,0
2020-12-01,LAO,Sabah,0,0,0
2020-12-01,LAO,Sarawak,0,0,0
2020-12-01,LAO,Selangor,3,1,2
2020-12-01,LAO,W.P. Labuan,0,0,0
2020-12-01,LBN,Johor,0,0,0
2020-12-01,LBN,Kedah,0,0,0
2020-12-01,LBN,Kelantan,0,0,0
2020-12-01,LBN,Pahang,0,0,0
2020-12-01,LBN,Perak,0,0,0
2020-12-01,LBN,Perlis,0,0,0
2020-12-01,LBN,Pulau Pinang,0,0,0
2020-12-01,LBN,Sabah,0,0,0
2020-12-01,LBN,Sarawak,0,0,0
2020-12-01,LBN,Selangor,6,4,2
2020-12-01,LBN,W.P. Labuan,0,0,0
2020-12-01,LBR,Johor,0,0,0
2020-12-01,LBR,Kedah,0,0,0
2020-12-01,LBR,Sabah,0,0,0
2020-12-01,LBR,Sarawak,0,0,0
2020-12-01,LBR,Selangor,1,1,0
2020-12-01,LBY,Johor,0,0,0
2020-12-01,LBY,Kedah,0,0,0
2020-12-01,LBY,Perlis,0,0,0
2020-12-01,LBY,Pulau Pinang,0,0,0
2020-12-01,LBY,Sabah,0,0,0
2020-12-01,LBY,Sarawak,0,0,0
2020-12-01,LBY,Selangor,3,3,0
2020-12-01,LCA,Johor,0,0,0
2020-12-01,LCA,Kedah,0,0,0
2020-12-01,LCA,Pulau Pinang,0,0,0
2020-12-01,LCA,Sarawak,0,0,0
2020-12-01,LCA,Selangor,0,0,0
2020-12-01,LIE,Johor,0,0,0
2020-12-01,LIE,Kedah,0,0,0
2020-12-01,LIE,Perlis,0,0,0
2020-12-01,LIE,Pulau Pinang,0,0,0
2020-12-01,LIE,Sabah,0,0,0
2020-12-01,LIE,Sarawak,0,0,0
2020-12-01,LIE,Selangor,0,0,0
2020-12-01,LKA,Johor,0,0,0
2020-12-01,LKA,Kedah,0,0,0
2020-12-01,LKA,Kelantan,0,0,0
2020-12-01,LKA,Melaka,0,0,0
2020-12-01,LKA,Pahang,0,0,0
2020-12-01,LKA,Perak,0,0,0
2020-12-01,LKA,Perlis,0,0,0
2020-12-01,LKA,Pulau Pinang,0,0,0
2020-12-01,LKA,Sabah,0,0,0
2020-12-01,LKA,Sarawak,0,0,0
2020-12-01,LKA,Selangor,37,32,5
2020-12-01,LKA,W.P. Labuan,0,0,0
2020-12-01,LSO,Johor,0,0,0
2020-12-01,LSO,Kedah,0,0,0
2020-12-01,LSO,Pulau Pinang,0,0,0
2020-12-01,LSO,Sarawak,0,0,0
2020-12-01,LSO,Selangor,1,1,0
2020-12-01,LTU,Johor,0,0,0
2020-12-01,LTU,Kedah,0,0,0
2020-12-01,LTU,Kelantan,0,0,0
2020-12-01,LTU,Pahang,0,0,0
2020-12-01,LTU,Perak,0,0,0
2020-12-01,LTU,Perlis,0,0,0
2020-12-01,LTU,Pulau Pinang,0,0,0
2020-12-01,LTU,Sabah,0,0,0
2020-12-01,LTU,Sarawak,0,0,0
2020-12-01,LTU,Selangor,3,3,0
2020-12-01,LTU,W.P. Labuan,0,0,0
2020-12-01,LUX,Johor,0,0,0
2020-12-01,LUX,Kedah,0,0,0
2020-12-01,LUX,Kelantan,0,0,0
2020-12-01,LUX,Perak,0,0,0
2020-12-01,LUX,Perlis,0,0,0
2020-12-01,LUX,Pulau Pinang,0,0,0
2020-12-01,LUX,Sabah,0,0,0
2020-12-01,LUX,Sarawak,0,0,0
2020-12-01,LUX,Selangor,0,0,0
2020-12-01,LVA,Johor,0,0,0
2020-12-01,LVA,Kedah,0,0,0
2020-12-01,LVA,Kelantan,0,0,0
2020-12-01,LVA,Pahang,0,0,0
2020-12-01,LVA,Perak,0,0,0
2020-12-01,LVA,Perlis,0,0,0
2020-12-01,LVA,Pulau Pinang,0,0,0
2020-12-01,LVA,Sabah,0,0,0
2020-12-01,LVA,Sarawak,0,0,0
2020-12-01,LVA,Selangor,1,1,0
2020-12-01,LVA,W.P. Labuan,0,0,0
2020-12-01,MAC,Johor,0,0,0
2020-12-01,MAC,Pahang,0,0,0
2020-12-01,MAC,Perak,0,0,0
2020-12-01,MAC,Selangor,0,0,0
2020-12-01,MAC,W.P. Labuan,0,0,0
2020-12-01,MAR,Johor,0,0,0
2020-12-01,MAR,Kedah,0,0,0
2020-12-01,MAR,Kelantan,0,0,0
2020-12-01,MAR,Melaka,0,0,0
2020-12-01,MAR,Pahang,0,0,0
2020-12-01,MAR,Perak,0,0,0
2020-12-01,MAR,Perlis,0,0,0
2020-12-01,MAR,Pulau Pinang,0,0,0
2020-12-01,MAR,Sabah,0,0,0
2020-12-01,MAR,Sarawak,0,0,0
2020-12-01,MAR,Selangor,4,2,2
2020-12-01,MAR,W.P. Labuan,0,0,0
2020-12-01,MCO,Johor,0,0,0
2020-12-01,MCO,Kedah,0,0,0
2020-12-01,MCO,Sabah,0,0,0
2020-12-01,MCO,Selangor,0,0,0
2020-12-01,MDA,Johor,0,0,0
2020-12-01,MDA,Kedah,0,0,0
2020-12-01,MDA,Kelantan,0,0,0
2020-12-01,MDA,Negeri Sembilan,0,0,0
2020-12-01,MDA,Perlis,0,0,0
2020-12-01,MDA,Pulau Pinang,0,0,0
2020-12-01,MDA,Sabah,0,0,0
2020-12-01,MDA,Sarawak,0,0,0
2020-12-01,MDA,Selangor,0,0,0
2020-12-01,MDG,Johor,0,0,0
2020-12-01,MDG,Kedah,0,0,0
2020-12-01,MDG,Perak,0,0,0
2020-12-01,MDG,Perlis,0,0,0
2020-12-01,MDG,Pulau Pinang,0,0,0
2020-12-01,MDG,Sabah,0,0,0
2020-12-01,MDG,Sarawak,0,0,0
2020-12-01,MDG,Selangor,0,0,0
2020-12-01,MDV,Johor,0,0,0
2020-12-01,MDV,Kedah,0,0,0
2020-12-01,MDV,Kelantan,0,0,0
2020-12-01,MDV,Perak,0,0,0
2020-12-01,MDV,Perlis,0,0,0
2020-12-01,MDV,Pulau Pinang,0,0,0
2020-12-01,MDV,Sabah,0,0,0
2020-12-01,MDV,Sarawak,0,0,0
2020-12-01,MDV,Selangor,17,11,6
2020-12-01,MEX,Johor,0,0,0
2020-12-01,MEX,Kedah,0,0,0
2020-12-01,MEX,Kelantan,0,0,0
2020-12-01,MEX,Pahang,0,0,0
2020-12-01,MEX,Perak,0,0,0
2020-12-01,MEX,Perlis,0,0,0
2020-12-01,MEX,Pulau Pinang,0,0,0
2020-12-01,MEX,Sabah,0,0,0
2020-12-01,MEX,Sarawak,0,0,0
2020-12-01,MEX,Selangor,1,1,0
2020-12-01,MEX,W.P. Labuan,0,0,0
2020-12-01,MHL,Johor,0,0,0
2020-12-01,MHL,Kedah,0,0,0
2020-12-01,MHL,Perak,0,0,0
2020-12-01,MHL,Pulau Pinang,0,0,0
2020-12-01,MHL,Sabah,0,0,0
2020-12-01,MHL,Selangor,0,0,0
2020-12-01,MKD,Johor,0,0,0
2020-12-01,MKD,Kedah,0,0,0
2020-12-01,MKD,Perak,0,0,0
2020-12-01,MKD,Pulau Pinang,0,0,0
2020-12-01,MKD,Sabah,0,0,0
2020-12-01,MKD,Sarawak,0,0,0
2020-12-01,MKD,Selangor,0,0,0
2020-12-01,MLI,Johor,0,0,0
2020-12-01,MLI,Sabah,0,0,0
2020-12-01,MLI,Selangor,0,0,0
2020-12-01,MLT,Johor,0,0,0
2020-12-01,MLT,Kedah,0,0,0
2020-12-01,MLT,Kelantan,0,0,0
2020-12-01,MLT,Perak,0,0,0
2020-12-01,MLT,Perlis,0,0,0
2020-12-01,MLT,Pulau Pinang,0,0,0
2020-12-01,MLT,Sabah,0,0,0
2020-12-01,MLT,Sarawak,0,0,0
2020-12-01,MLT,Selangor,0,0,0
2020-12-01,MLT,W.P. Labuan,0,0,0
2020-12-01,MMR,Johor,33,33,0
2020-12-01,MMR,Kedah,0,0,0
2020-12-01,MMR,Kelantan,0,0,0
2020-12-01,MMR,Negeri Sembilan,0,0,0
2020-12-01,MMR,Pahang,0,0,0
2020-12-01,MMR,Perak,0,0,0
2020-12-01,MMR,Perlis,0,0,0
2020-12-01,MMR,Pulau Pinang,1,1,0
2020-12-01,MMR,Sabah,0,0,0
2020-12-01,MMR,Sarawak,0,0,0
2020-12-01,MMR,Selangor,105,96,9
2020-12-01,MMR,Terengganu,0,0,0
2020-12-01,MMR,W.P. Labuan,0,0,0
2020-12-01,MNE,Johor,0,0,0
2020-12-01,MNE,Kedah,0,0,0
2020-12-01,MNE,Pulau Pinang,0,0,0
2020-12-01,MNE,Sabah,0,0,0
2020-12-01,MNE,Sarawak,0,0,0
2020-12-01,MNE,Selangor,5,5,0
2020-12-01,MNG,Johor,0,0,0
2020-12-01,MNG,Kedah,0,0,0
2020-12-01,MNG,Kelantan,0,0,0
2020-12-01,MNG,Perak,0,0,0
2020-12-01,MNG,Perlis,0,0,0
2020-12-01,MNG,Pulau Pinang,0,0,0
2020-12-01,MNG,Sabah,0,0,0
2020-12-01,MNG,Sarawak,0,0,0
2020-12-01,MNG,Selangor,0,0,0
2020-12-01,MNP,Selangor,0,0,0
2020-12-01,MOZ,Johor,0,0,0
2020-12-01,MOZ,Kedah,0,0,0
2020-12-01,MOZ,Perak,0,0,0
2020-12-01,MOZ,Pulau Pinang,0,0,0
2020-12-01,MOZ,Sabah,0,0,0
2020-12-01,MOZ,Sarawak,0,0,0
2020-12-01,MOZ,Selangor,3,3,0
2020-12-01,MRT,Johor,0,0,0
2020-12-01,MRT,Kedah,0,0,0
2020-12-01,MRT,Pulau Pinang,0,0,0
2020-12-01,MRT,Sabah,0,0,0
2020-12-01,MRT,Sarawak,0,0,0
2020-12-01,MRT,Selangor,0,0,0
2020-12-01,MUS,Johor,0,0,0
2020-12-01,MUS,Kedah,0,0,0
2020-12-01,MUS,Kelantan,0,0,0
2020-12-01,MUS,Pahang,0,0,0
2020-12-01,MUS,Perak,0,0,0
2020-12-01,MUS,Perlis,0,0,0
2020-12-01,MUS,Pulau Pinang,0,0,0
2020-12-01,MUS,Sabah,0,0,0
2020-12-01,MUS,Sarawak,0,0,0
2020-12-01,MUS,Selangor,5,0,5
2020-12-01,MWI,Johor,0,0,0
2020-12-01,MWI,Pulau Pinang,0,0,0
2020-12-01,MWI,Sabah,0,0,0
2020-12-01,MWI,Sarawak,0,0,0
2020-12-01,MWI,Selangor,1,1,0
2020-12-01,MYT,Selangor,0,0,0
2020-12-01,NAM,Johor,0,0,0
2020-12-01,NAM,Kedah,0,0,0
2020-12-01,NAM,Perak,0,0,0
2020-12-01,NAM,Perlis,0,0,0
2020-12-01,NAM,Pulau Pinang,0,0,0
2020-12-01,NAM,Sabah,0,0,0
2020-12-01,NAM,Sarawak,0,0,0
2020-12-01,NAM,Selangor,2,2,0
2020-12-01,NCL,Selangor,0,0,0
2020-12-01,NER,Johor,0,0,0
2020-12-01,NER,Sabah,0,0,0
2020-12-01,NER,Selangor,0,0,0
2020-12-01,NGA,Johor,0,0,0
2020-12-01,NGA,Kedah,0,0,0
2020-12-01,NGA,Perlis,0,0,0
2020-12-01,NGA,Pulau Pinang,0,0,0
2020-12-01,NGA,Sabah,0,0,0
2020-12-01,NGA,Sarawak,0,0,0
2020-12-01,NGA,Selangor,36,30,6
2020-12-01,NIC,Johor,0,0,0
2020-12-01,NIC,Kedah,0,0,0
2020-12-01,NIC,Pulau Pinang,0,0,0
2020-12-01,NIC,Sabah,0,0,0
2020-12-01,NIC,Selangor,0,0,0
2020-12-01,NLD,Johor,1,1,0
2020-12-01,NLD,Kedah,0,0,0
2020-12-01,NLD,Kelantan,0,0,0
2020-12-01,NLD,Melaka,0,0,0
2020-12-01,NLD,Negeri Sembilan,0,0,0
2020-12-01,NLD,Pahang,0,0,0
2020-12-01,NLD,Perak,0,0,0
2020-12-01,NLD,Perlis,0,0,0
2020-12-01,NLD,Pulau Pinang,1,1,0
2020-12-01,NLD,Sabah,0,0,0
2020-12-01,NLD,Sarawak,1,1,0
2020-12-01,NLD,Selangor,22,19,3
2020-12-01,NLD,Terengganu,0,0,0
2020-12-01,NLD,W.P. Labuan,0,0,0
2020-12-01,NOR,Johor,0,0,0
2020-12-01,NOR,Kedah,0,0,0
2020-12-01,NOR,Kelantan,0,0,0
2020-12-01,NOR,Melaka,0,0,0
2020-12-01,NOR,Pahang,0,0,0
2020-12-01,NOR,Perak,0,0,0
2020-12-01,NOR,Perlis,0,0,0
2020-12-01,NOR,Pulau Pinang,0,0,0
2020-12-01,NOR,Sabah,0,0,0
2020-12-01,NOR,Sarawak,0,0,0
2020-12-01,NOR,Selangor,6,5,1
2020-12-01,NOR,W.P. Labuan,0,0,0
2020-12-01,NPL,Johor,0,0,0
2020-12-01,NPL,Kedah,0,0,0
2020-12-01,NPL,Pahang,0,0,0
2020-12-01,NPL,Perak,0,0,0
2020-12-01,NPL,Perlis,0,0,0
2020-12-01,NPL,Pulau Pinang,0,0,0
2020-12-01,NPL,Sabah,0,0,0
2020-12-01,NPL,Sarawak,0,0,0
2020-12-01,NPL,Selangor,189,185,4
2020-12-01,NPL,W.P. Labuan,0,0,0
2020-12-01,NRU,Johor,0,0,0
2020-12-01,NRU,Pulau Pinang,0,0,0
2020-12-01,NRU,Selangor,0,0,0
2020-12-01,NZL,Johor,1,1,0
2020-12-01,NZL,Kedah,0,0,0
2020-12-01,NZL,Kelantan,0,0,0
2020-12-01,NZL,Melaka,0,0,0
2020-12-01,NZL,Negeri Sembilan,0,0,0
2020-12-01,NZL,Pahang,0,0,0
2020-12-01,NZL,Perak,2,1,1
2020-12-01,NZL,Perlis,0,0,0
2020-12-01,NZL,Pulau Pinang,0,0,0
2020-12-01,NZL,Sabah,0,0,0
2020-12-01,NZL,Sarawak,0,0,0
2020-12-01,NZL,Selangor,19,15,4
2020-12-01,NZL,Terengganu,0,0,0
2020-12-01,NZL,W.P. Labuan,0,0,0
2020-12-01,OMN,Johor,0,0,0
2020-12-01,OMN,Kedah,0,0,0
2020-12-01,OMN,Kelantan,0,0,0
2020-12-01,OMN,Melaka,0,0,0
2020-12-01,OMN,Perak,0,0,0
2020-12-01,OMN,Perlis,0,0,0
2020-12-01,OMN,Pulau Pinang,0,0,0
2020-12-01,OMN,Sabah,0,0,0
2020-12-01,OMN,Sarawak,0,0,0
2020-12-01,OMN,Selangor,5,0,5
2020-12-01,PAK,Johor,3,3,0
2020-12-01,PAK,Kedah,0,0,0
2020-12-01,PAK,Kelantan,0,0,0
2020-12-01,PAK,Melaka,0,0,0
2020-12-01,PAK,Negeri Sembilan,0,0,0
2020-12-01,PAK,Pahang,0,0,0
2020-12-01,PAK,Perak,0,0,0
2020-12-01,PAK,Perlis,0,0,0
2020-12-01,PAK,Pulau Pinang,0,0,0
2020-12-01,PAK,Sabah,0,0,0
2020-12-01,PAK,Sarawak,0,0,0
2020-12-01,PAK,Selangor,115,99,16
2020-12-01,PAK,W.P. Labuan,0,0,0
2020-12-01,PAN,Johor,0,0,0
2020-12-01,PAN,Kedah,0,0,0
2020-12-01,PAN,Perak,0,0,0
2020-12-01,PAN,Perlis,0,0,0
2020-12-01,PAN,Pulau Pinang,0,0,0
2020-12-01,PAN,Sabah,0,0,0
2020-12-01,PAN,Sarawak,0,0,0
2020-12-01,PAN,Selangor,0,0,0
2020-12-01,PER,Johor,0,0,0
2020-12-01,PER,Kedah,0,0,0
2020-12-01,PER,Kelantan,0,0,0
2020-12-01,PER,Pahang,0,0,0
2020-12-01,PER,Perak,0,0,0
2020-12-01,PER,Perlis,0,0,0
2020-12-01,PER,Pulau Pinang,0,0,0
2020-12-01,PER,Sabah,0,0,0
2020-12-01,PER,Sarawak,0,0,0
2020-12-01,PER,Selangor,13,8,5
2020-12-01,PER,W.P. Labuan,0,0,0
2020-12-01,PHL,Johor,85,80,5
2020-12-01,PHL,Kedah,0,0,0
2020-12-01,PHL,Kelantan,0,0,0
2020-12-01,PHL,Melaka,0,0,0
2020-12-01,PHL,Negeri Sembilan,0,0,0
2020-12-01,PHL,Pahang,0,0,0
2020-12-01,PHL,Perak,0,0,0
2020-12-01,PHL,Perlis,0,0,0
2020-12-01,PHL,Pulau Pinang,0,0,0
2020-12-01,PHL,Sabah,2,1,1
2020-12-01,PHL,Sarawak,61,58,3
2020-12-01,PHL,Selangor,255,209,46
2020-12-01,PHL,Terengganu,0,0,0
2020-12-01,PHL,W.P. Labuan,4,4,0
2020-12-01,PLW,Johor,0,0,0
2020-12-01,PLW,Pulau Pinang,0,0,0
2020-12-01,PLW,Selangor,0,0,0
2020-12-01,PNG,Johor,0,0,0
2020-12-01,PNG,Kedah,0,0,0
2020-12-01,PNG,Kelantan,0,0,0
2020-12-01,PNG,Perak,0,0,0
2020-12-01,PNG,Pulau Pinang,0,0,0
2020-12-01,PNG,Sabah,0,0,0
2020-12-01,PNG,Sarawak,1,1,0
2020-12-01,PNG,Selangor,0,0,0
2020-12-01,POL,Johor,4,4,0
2020-12-01,POL,Kedah,0,0,0
2020-12-01,POL,Kelantan,0,0,0
2020-12-01,POL,Melaka,0,0,0
2020-12-01,POL,Negeri Sembilan,0,0,0
2020-12-01,POL,Pahang,0,0,0
2020-12-01,POL,Perak,0,0,0
2020-12-01,POL,Perlis,0,0,0
2020-12-01,POL,Pulau Pinang,0,0,0
2020-12-01,POL,Sabah,0,0,0
2020-12-01,POL,Sarawak,0,0,0
2020-12-01,POL,Selangor,8,7,1
2020-12-01,POL,Terengganu,0,0,0
2020-12-01,POL,W.P. Labuan,0,0,0
2020-12-01,PRK,Selangor,0,0,0
2020-12-01,PRT,Johor,0,0,0
2020-12-01,PRT,Kedah,0,0,0
2020-12-01,PRT,Kelantan,0,0,0
2020-12-01,PRT,Melaka,0,0,0
2020-12-01,PRT,Pahang,0,0,0
2020-12-01,PRT,Perak,0,0,0
2020-12-01,PRT,Perlis,0,0,0
2020-12-01,PRT,Pulau Pinang,0,0,0
2020-12-01,PRT,Sabah,0,0,0
2020-12-01,PRT,Sarawak,0,0,0
2020-12-01,PRT,Selangor,1,0,1
2020-12-01,PRT,W.P. Labuan,0,0,0
2020-12-01,PRY,Johor,0,0,0
2020-12-01,PRY,Kedah,0,0,0
2020-12-01,PRY,Perak,0,0,0
2020-12-01,PRY,Perlis,0,0,0
2020-12-01,PRY,Pulau Pinang,0,0,0
2020-12-01,PRY,Sabah,0,0,0
2020-12-01,PRY,Sarawak,0,0,0
2020-12-01,PRY,Selangor,0,0,0
2020-12-01,PSE,Johor,0,0,0
2020-12-01,PSE,Kedah,0,0,0
2020-12-01,PSE,Kelantan,0,0,0
2020-12-01,PSE,Melaka,0,0,0
2020-12-01,PSE,Perak,0,0,0
2020-12-01,PSE,Perlis,0,0,0
2020-12-01,PSE,Pulau Pinang,0,0,0
2020-12-01,PSE,Sabah,0,0,0
2020-12-01,PSE,Sarawak,0,0,0
2020-12-01,PSE,Selangor,4,3,1
2020-12-01,QAT,Johor,0,0,0
2020-12-01,QAT,Kedah,0,0,0
2020-12-01,QAT,Perlis,0,0,0
2020-12-01,QAT,Pulau Pinang,0,0,0
2020-12-01,QAT,Sabah,0,0,0
2020-12-01,QAT,Sarawak,0,0,0
2020-12-01,QAT,Selangor,2,2,0
2020-12-01,REU,Johor,0,0,0
2020-12-01,REU,Sarawak,0,0,0
2020-12-01,ROU,Johor,0,0,0
2020-12-01,ROU,Kedah,0,0,0
2020-12-01,ROU,Kelantan,0,0,0
2020-12-01,ROU,Negeri Sembilan,0,0,0
2020-12-01,ROU,Pahang,0,0,0
2020-12-01,ROU,Perak,0,0,0
2020-12-01,ROU,Perlis,0,0,0
2020-12-01,ROU,Pulau Pinang,0,0,0
2020-12-01,ROU,Sabah,0,0,0
2020-12-01,ROU,Sarawak,0,0,0
2020-12-01,ROU,Selangor,10,8,2
2020-12-01,ROU,W.P. Labuan,0,0,0
2020-12-01,RUS,Johor,7,7,0
2020-12-01,RUS,Kedah,0,0,0
2020-12-01,RUS,Kelantan,0,0,0
2020-12-01,RUS,Melaka,0,0,0
2020-12-01,RUS,Negeri Sembilan,0,0,0
2020-12-01,RUS,Pahang,0,0,0
2020-12-01,RUS,Perak,0,0,0
2020-12-01,RUS,Perlis,0,0,0
2020-12-01,RUS,Pulau Pinang,0,0,0
2020-12-01,RUS,Sabah,0,0,0
2020-12-01,RUS,Sarawak,0,0,0
2020-12-01,RUS,Selangor,28,24,4
2020-12-01,RUS,W.P. Labuan,0,0,0
2020-12-01,RWA,Johor,0,0,0
2020-12-01,RWA,Kedah,0,0,0
2020-12-01,RWA,Pulau Pinang,0,0,0
2020-12-01,RWA,Selangor,0,0,0
2020-12-01,SAU,Johor,0,0,0
2020-12-01,SAU,Kedah,0,0,0
2020-12-01,SAU,Kelantan,0,0,0
2020-12-01,SAU,Melaka,0,0,0
2020-12-01,SAU,Perak,0,0,0
2020-12-01,SAU,Perlis,0,0,0
2020-12-01,SAU,Pulau Pinang,0,0,0
2020-12-01,SAU,Sabah,0,0,0
2020-12-01,SAU,Sarawak,0,0,0
2020-12-01,SAU,Selangor,14,6,8
2020-12-01,SAU,W.P. Labuan,0,0,0
2020-12-01,SDN,Johor,0,0,0
2020-12-01,SDN,Kedah,0,0,0
2020-12-01,SDN,Kelantan,0,0,0
2020-12-01,SDN,Perlis,0,0,0
2020-12-01,SDN,Pulau Pinang,0,0,0
2020-12-01,SDN,Sabah,0,0,0
2020-12-01,SDN,Sarawak,0,0,0
2020-12-01,SDN,Selangor,7,6,1
2020-12-01,SDN,W.P. Labuan,0,0,0
2020-12-01,SEN,Johor,0,0,0
2020-12-01,SEN,Kedah,0,0,0
2020-12-01,SEN,Kelantan,0,0,0
2020-12-01,SEN,Perak,0,0,0
2020-12-01,SEN,Perlis,0,0,0
2020-12-01,SEN,Pulau Pinang,0,0,0
2020-12-01,SEN,Sabah,0,0,0
2020-12-01,SEN,Sarawak,0,0,0
2020-12-01,SEN,Selangor,1,0,1
2020-12-01,SGP,Johor,304,244,60
2020-12-01,SGP,Kedah,1,1,0
2020-12-01,SGP,Kelantan,0,0,0
2020-12-01,SGP,Melaka,0,0,0
2020-12-01,SGP,Negeri Sembilan,0,0,0
2020-12-01,SGP,Pahang,0,0,0
2020-12-01,SGP,Perak,0,0,0
2020-12-01,SGP,Perlis,0,0,0
2020-12-01,SGP,Pulau Pinang,24,17,7
2020-12-01,SGP,Sabah,0,0,0
2020-12-01,SGP,Sarawak,5,2,3
2020-12-01,SGP,Selangor,112,71,41
2020-12-01,SGP,Terengganu,0,0,0
2020-12-01,SGP,W.P. Labuan,0,0,0
2020-12-01,SGS,Johor,0,0,0
2020-12-01,SGS,Sabah,0,0,0
2020-12-01,SGS,Selangor,0,0,0
2020-12-01,SHN,Sarawak,0,0,0
2020-12-01,SLB,Johor,0,0,0
2020-12-01,SLB,Perlis,0,0,0
2020-12-01,SLB,Pulau Pinang,0,0,0
2020-12-01,SLB,Sabah,0,0,0
2020-12-01,SLB,Sarawak,0,0,0
2020-12-01,SLB,Selangor,0,0,0
2020-12-01,SLB,W.P. Labuan,0,0,0
2020-12-01,SLE,Johor,0,0,0
2020-12-01,SLE,Kedah,0,0,0
2020-12-01,SLE,Perak,0,0,0
2020-12-01,SLE,Pulau Pinang,0,0,0
2020-12-01,SLE,Sabah,0,0,0
2020-12-01,SLE,Selangor,0,0,0
2020-12-01,SLV,Johor,0,0,0
2020-12-01,SLV,Kedah,0,0,0
2020-12-01,SLV,Perak,0,0,0
2020-12-01,SLV,Perlis,0,0,0
2020-12-01,SLV,Pulau Pinang,0,0,0
2020-12-01,SLV,Sabah,0,0,0
2020-12-01,SLV,Selangor,0,0,0
2020-12-01,SLV,W.P. Labuan,0,0,0
2020-12-01,SMR,Johor,0,0,0
2020-12-01,SMR,Selangor,0,0,0
2020-12-01,SOM,Johor,0,0,0
2020-12-01,SOM,Kedah,0,0,0
2020-12-01,SOM,Kelantan,0,0,0
2020-12-01,SOM,Perlis,0,0,0
2020-12-01,SOM,Sabah,0,0,0
2020-12-01,SOM,Sarawak,0,0,0
2020-12-01,SOM,Selangor,3,2,1
2020-12-01,SRB,Johor,0,0,0
2020-12-01,SRB,Kedah,0,0,0
2020-12-01,SRB,Kelantan,0,0,0
2020-12-01,SRB,Pahang,0,0,0
2020-12-01,SRB,Perak,0,0,0
2020-12-01,SRB,Perlis,0,0,0
2020-12-01,SRB,Pulau Pinang,0,0,0
2020-12-01,SRB,Sabah,0,0,0
2020-12-01,SRB,Sarawak,0,0,0
2020-12-01,SRB,Selangor,0,0,0
2020-12-01,SSD,Johor,0,0,0
2020-12-01,SSD,Kedah,0,0,0
2020-12-01,SSD,Sarawak,0,0,0
2020-12-01,SSD,Selangor,0,0,0
2020-12-01,SSD,W.P. Labuan,0,0,0
2020-12-01,STP,Selangor,0,0,0
2020-12-01,SUR,Johor,0,0,0
2020-12-01,SUR,Kedah,0,0,0
2020-12-01,SUR,Kelantan,0,0,0
2020-12-01,SUR,Perak,0,0,0
2020-12-01,SUR,Perlis,0,0,0
2020-12-01,SUR,Pulau Pinang,0,0,0
2020-12-01,SUR,Sabah,0,0,0
2020-12-01,SUR,Sarawak,0,0,0
2020-12-01,SUR,Selangor,0,0,0
2020-12-01,SVK,Johor,0,0,0
2020-12-01,SVK,Kedah,0,0,0
2020-12-01,SVK,Kelantan,0,0,0
2020-12-01,SVK,Negeri Sembilan,0,0,0
2020-12-01,SVK,Pahang,0,0,0
2020-12-01,SVK,Perak,0,0,0
2020-12-01,SVK,Perlis,0,0,0
2020-12-01,SVK,Pulau Pinang,0,0,0
2020-12-01,SVK,Sabah,0,0,0
2020-12-01,SVK,Sarawak,0,0,0
2020-12-01,SVK,Selangor,0,0,0
2020-12-01,SVK,W.P. Labuan,0,0,0
2020-12-01,SVN,Johor,0,0,0
2020-12-01,SVN,Kedah,0,0,0
2020-12-01,SVN,Kelantan,0,0,0
2020-12-01,SVN,Perak,0,0,0
2020-12-01,SVN,Perlis,0,0,0
2020-12-01,SVN,Pulau Pinang,0,0,0
2020-12-01,SVN,Sabah,0,0,0
2020-12-01,SVN,Sarawak,0,0,0
2020-12-01,SVN,Selangor,0,0,0
2020-12-01,SVN,W.P. Labuan,0,0,0
2020-12-01,SWE,Johor,2,2,0
2020-12-01,SWE,Kedah,0,0,0
2020-12-01,SWE,Kelantan,0,0,0
2020-12-01,SWE,Melaka,0,0,0
2020-12-01,SWE,Negeri Sembilan,0,0,0
2020-12-01,SWE,Pahang,0,0,0
2020-12-01,SWE,Perak,0,0,0
2020-12-01,SWE,Perlis,0,0,0
2020-12-01,SWE,Pulau Pinang,0,0,0
2020-12-01,SWE,Sabah,0,0,0
2020-12-01,SWE,Sarawak,0,0,0
2020-12-01,SWE,Selangor,20,15,5
2020-12-01,SWE,W.P. Labuan,0,0,0
2020-12-01,SWZ,Johor,0,0,0
2020-12-01,SWZ,Kedah,0,0,0
2020-12-01,SWZ,Pulau Pinang,0,0,0
2020-12-01,SWZ,Sabah,0,0,0
2020-12-01,SWZ,Selangor,1,1,0
2020-12-01,SYC,Johor,0,0,0
2020-12-01,SYC,Kedah,0,0,0
2020-12-01,SYC,Pulau Pinang,0,0,0
2020-12-01,SYC,Sabah,0,0,0
2020-12-01,SYC,Sarawak,0,0,0
2020-12-01,SYC,Selangor,0,0,0
2020-12-01,SYR,Johor,0,0,0
2020-12-01,SYR,Kedah,0,0,0
2020-12-01,SYR,Kelantan,0,0,0
2020-12-01,SYR,Pahang,0,0,0
2020-12-01,SYR,Perlis,0,0,0
2020-12-01,SYR,Pulau Pinang,0,0,0
2020-12-01,SYR,Sabah,0,0,0
2020-12-01,SYR,Sarawak,0,0,0
2020-12-01,SYR,Selangor,6,6,0
2020-12-01,SYR,W.P. Labuan,0,0,0
2020-12-01,TCA,Perlis,0,0,0
2020-12-01,TCD,Johor,0,0,0
2020-12-01,TCD,Kedah,0,0,0
2020-12-01,TCD,Perlis,0,0,0
2020-12-01,TCD,Selangor,0,0,0
2020-12-01,TGO,Johor,0,0,0
2020-12-01,TGO,Perak,0,0,0
2020-12-01,TGO,Pulau Pinang,0,0,0
2020-12-01,TGO,Selangor,0,0,0
2020-12-01,THA,Johor,115,115,0
2020-12-01,THA,Kedah,14203,13891,312
2020-12-01,THA,Kelantan,2,1,1
2020-12-01,THA,Melaka,0,0,0
2020-12-01,THA,Negeri Sembilan,0,0,0
2020-12-01,THA,Pahang,0,0,0
2020-12-01,THA,Perak,0,0,0
2020-12-01,THA,Perlis,8789,8405,384
2020-12-01,THA,Pulau Pinang,0,0,0
2020-12-01,THA,Sabah,0,0,0
2020-12-01,THA,Sarawak,12,12,0
2020-12-01,THA,Selangor,203,110,93
2020-12-01,THA,Terengganu,0,0,0
2020-12-01,THA,W.P. Labuan,0,0,0
2020-12-01,TJK,Johor,0,0,0
2020-12-01,TJK,Kedah,0,0,0
2020-12-01,TJK,Perlis,0,0,0
2020-12-01,TJK,Pulau Pinang,0,0,0
2020-12-01,TJK,Sabah,0,0,0
2020-12-01,TJK,Selangor,2,2,0
2020-12-01,TKL,Selangor,0,0,0
2020-12-01,TKM,Johor,0,0,0
2020-12-01,TKM,Kedah,0,0,0
2020-12-01,TKM,Kelantan,0,0,0
2020-12-01,TKM,Perlis,0,0,0
2020-12-01,TKM,Pulau Pinang,0,0,0
2020-12-01,TKM,Sabah,0,0,0
2020-12-01,TKM,Sarawak,0,0,0
2020-12-01,TKM,Selangor,0,0,0
2020-12-01,TLS,Johor,0,0,0
2020-12-01,TLS,Kedah,0,0,0
2020-12-01,TLS,Perlis,0,0,0
2020-12-01,TLS,Pulau Pinang,0,0,0
2020-12-01,TLS,Sabah,0,0,0
2020-12-01,TLS,Sarawak,0,0,0
2020-12-01,TLS,Selangor,3,2,1
2020-12-01,TON,Johor,0,0,0
2020-12-01,TON,Pulau Pinang,0,0,0
2020-12-01,TON,Sarawak,0,0,0
2020-12-01,TON,Selangor,0,0,0
2020-12-01,TTO,Johor,0,0,0
2020-12-01,TTO,Kedah,0,0,0
2020-12-01,TTO,Pahang,0,0,0
2020-12-01,TTO,Pulau Pinang,0,0,0
2020-12-01,TTO,Sabah,0,0,0
2020-12-01,TTO,Sarawak,0,0,0
2020-12-01,TTO,Selangor,0,0,0
2020-12-01,TUN,Johor,0,0,0
2020-12-01,TUN,Kedah,0,0,0
2020-12-01,TUN,Kelantan,0,0,0
2020-12-01,TUN,Melaka,0,0,0
2020-12-01,TUN,Perak,0,0,0
2020-12-01,TUN,Perlis,0,0,0
2020-12-01,TUN,Pulau Pinang,0,0,0
2020-12-01,TUN,Sabah,0,0,0
2020-12-01,TUN,Sarawak,0,0,0
2020-12-01,TUN,Selangor,1,1,0
2020-12-01,TUN,W.P. Labuan,0,0,0
2020-12-01,TUR,Johor,0,0,0
2020-12-01,TUR,Kedah,0,0,0
2020-12-01,TUR,Kelantan,0,0,0
2020-12-01,TUR,Melaka,0,0,0
2020-12-01,TUR,Negeri Sembilan,0,0,0
2020-12-01,TUR,Pahang,0,0,0
2020-12-01,TUR,Perak,0,0,0
2020-12-01,TUR,Perlis,0,0,0
2020-12-01,TUR,Pulau Pinang,0,0,0
2020-12-01,TUR,Sabah,0,0,0
2020-12-01,TUR,Sarawak,0,0,0
2020-12-01,TUR,Selangor,5,4,1
2020-12-01,TUR,W.P. Labuan,0,0,0
2020-12-01,TUV,Selangor,0,0,0
2020-12-01,TWN,Johor,0,0,0
2020-12-01,TWN,Kedah,0,0,0
2020-12-01,TWN,Kelantan,0,0,0
2020-12-01,TWN,Melaka,0,0,0
2020-12-01,TWN,Negeri Sembilan,0,0,0
2020-12-01,TWN,Pahang,0,0,0
2020-12-01,TWN,Perak,0,0,0
2020-12-01,TWN,Perlis,0,0,0
2020-12-01,TWN,Pulau Pinang,10,5,5
2020-12-01,TWN,Sabah,0,0,0
2020-12-01,TWN,Sarawak,4,4,0
2020-12-01,TWN,Selangor,71,51,20
2020-12-01,TWN,W.P. Labuan,0,0,0
2020-12-01,TZA,Johor,0,0,0
2020-12-01,TZA,Kedah,0,0,0
2020-12-01,TZA,Perak,0,0,0
2020-12-01,TZA,Perlis,0,0,0
2020-12-01,TZA,Pulau Pinang,0,0,0
2020-12-01,TZA,Sabah,0,0,0
2020-12-01,TZA,Sarawak,0,0,0
2020-12-01,TZA,Selangor,4,1,3
2020-12-01,UGA,Johor,0,0,0
2020-12-01,UGA,Kedah,0,0,0
2020-12-01,UGA,Perak,0,0,0
2020-12-01,UGA,Perlis,0,0,0
2020-12-01,UGA,Pulau Pinang,0,0,0
2020-12-01,UGA,Sabah,0,0,0
2020-12-01,UGA,Sarawak,0,0,0
2020-12-01,UGA,Selangor,1,1,0
2020-12-01,UKR,Johor,34,34,0
2020-12-01,UKR,Kedah,0,0,0
2020-12-01,UKR,Kelantan,0,0,0
2020-12-01,UKR,Melaka,10,10,0
2020-12-01,UKR,Negeri Sembilan,0,0,0
2020-12-01,UKR,Pahang,0,0,0
2020-12-01,UKR,Perak,0,0,0
2020-12-01,UKR,Perlis,0,0,0
2020-12-01,UKR,Pulau Pinang,0,0,0
2020-12-01,UKR,Sabah,0,0,0
2020-12-01,UKR,Sarawak,0,0,0
2020-12-01,UKR,Selangor,31,30,1
2020-12-01,UKR,W.P. Labuan,0,0,0
2020-12-01,URY,Johor,0,0,0
2020-12-01,URY,Kedah,0,0,0
2020-12-01,URY,Kelantan,0,0,0
2020-12-01,URY,Perak,0,0,0
2020-12-01,URY,Perlis,0,0,0
2020-12-01,URY,Pulau Pinang,0,0,0
2020-12-01,URY,Sabah,0,0,0
2020-12-01,URY,Sarawak,0,0,0
2020-12-01,URY,Selangor,0,0,0
2020-12-01,URY,W.P. Labuan,0,0,0
2020-12-01,USA,Johor,1,1,0
2020-12-01,USA,Kedah,0,0,0
2020-12-01,USA,Kelantan,0,0,0
2020-12-01,USA,Melaka,0,0,0
2020-12-01,USA,Negeri Sembilan,0,0,0
2020-12-01,USA,Pahang,0,0,0
2020-12-01,USA,Perak,0,0,0
2020-12-01,USA,Perlis,0,0,0
2020-12-01,USA,Pulau Pinang,8,5,3
2020-12-01,USA,Sabah,0,0,0
2020-12-01,USA,Sarawak,0,0,0
2020-12-01,USA,Selangor,113,74,39
2020-12-01,USA,Terengganu,0,0,0
2020-12-01,USA,W.P. Labuan,0,0,0
2020-12-01,UZB,Johor,1,0,1
2020-12-01,UZB,Kedah,0,0,0
2020-12-01,UZB,Kelantan,0,0,0
2020-12-01,UZB,Perak,0,0,0
2020-12-01,UZB,Perlis,0,0,0
2020-12-01,UZB,Pulau Pinang,0,0,0
2020-12-01,UZB,Sabah,0,0,0
2020-12-01,UZB,Sarawak,0,0,0
2020-12-01,UZB,Selangor,3,2,1
2020-12-01,VAT,Johor,0,0,0
2020-12-01,VAT,Sarawak,0,0,0
2020-12-01,VAT,Selangor,0,0,0
2020-12-01,VCT,Johor,0,0,0
2020-12-01,VCT,Kedah,0,0,0
2020-12-01,VCT,Pulau Pinang,0,0,0
2020-12-01,VCT,Sarawak,0,0,0
2020-12-01,VCT,Selangor,0,0,0
2020-12-01,VEN,Johor,0,0,0
2020-12-01,VEN,Kedah,0,0,0
2020-12-01,VEN,Kelantan,0,0,0
2020-12-01,VEN,Melaka,0,0,0
2020-12-01,VEN,Perak,0,0,0
2020-12-01,VEN,Perlis,0,0,0
2020-12-01,VEN,Pulau Pinang,0,0,0
2020-12-01,VEN,Sabah,0,0,0
2020-12-01,VEN,Sarawak,0,0,0
2020-12-01,VEN,Selangor,1,1,0
2020-12-01,VEN,W.P. Labuan,0,0,0
2020-12-01,VNM,Johor,2,0,2
2020-12-01,VNM,Kedah,0,0,0
2020-12-01,VNM,Kelantan,0,0,0
2020-12-01,VNM,Melaka,0,0,0
2020-12-01,VNM,Negeri Sembilan,0,0,0
2020-12-01,VNM,Pahang,0,0,0
2020-12-01,VNM,Perak,0,0,0
2020-12-01,VNM,Perlis,0,0,0
2020-12-01,VNM,Pulau Pinang,0,0,0
2020-12-01,VNM,Sabah,0,0,0
2020-12-01,VNM,Sarawak,1,1,0
2020-12-01,VNM,Selangor,73,32,41
2020-12-01,VNM,Terengganu,20,20,0
2020-12-01,VNM,W.P. Labuan,0,0,0
2020-12-01,VUT,Johor,0,0,0
2020-12-01,VUT,Kedah,0,0,0
2020-12-01,VUT,Pulau Pinang,0,0,0
2020-12-01,VUT,Sabah,0,0,0
2020-12-01,VUT,Sarawak,0,0,0
2020-12-01,VUT,Selangor,0,0,0
2020-12-01,WSM,Johor,0,0,0
2020-12-01,WSM,Sarawak,0,0,0
2020-12-01,WSM,Selangor,0,0,0
2020-12-01,XXX,Johor,0,0,0
2020-12-01,XXX,Kedah,0,0,0
2020-12-01,XXX,Kelantan,0,0,0
2020-12-01,XXX,Melaka,0,0,0
2020-12-01,XXX,Pahang,0,0,0
2020-12-01,XXX,Perak,0,0,0
2020-12-01,XXX,Perlis,0,0,0
2020-12-01,XXX,Pulau Pinang,0,0,0
2020-12-01,XXX,Sabah,0,0,0
2020-12-01,XXX,Sarawak,0,0,0
2020-12-01,XXX,Selangor,13,8,5
2020-12-01,XXX,W.P. Labuan,0,0,0
2020-12-01,YEM,Johor,4,4,0
2020-12-01,YEM,Kedah,0,0,0
2020-12-01,YEM,Kelantan,0,0,0
2020-12-01,YEM,Melaka,0,0,0
2020-12-01,YEM,Pahang,0,0,0
2020-12-01,YEM,Perak,0,0,0
2020-12-01,YEM,Perlis,0,0,0
2020-12-01,YEM,Pulau Pinang,0,0,0
2020-12-01,YEM,Sabah,0,0,0
2020-12-01,YEM,Sarawak,0,0,0
2020-12-01,YEM,Selangor,24,19,5
2020-12-01,YEM,W.P. Labuan,0,0,0
2020-12-01,ZAF,Johor,5,5,0
2020-12-01,ZAF,Kedah,0,0,0
2020-12-01,ZAF,Kelantan,0,0,0
2020-12-01,ZAF,Melaka,0,0,0
2020-12-01,ZAF,Pahang,0,0,0
2020-12-01,ZAF,Perak,0,0,0
2020-12-01,ZAF,Perlis,0,0,0
2020-12-01,ZAF,Pulau Pinang,0,0,0
2020-12-01,ZAF,Sabah,0,0,0
2020-12-01,ZAF,Sarawak,1,0,1
2020-12-01,ZAF,Selangor,20,12,8
2020-12-01,ZAF,Terengganu,0,0,0
2020-12-01,ZAF,W.P. Labuan,0,0,0
2020-12-01,ZAR,Selangor,0,0,0
2020-12-01,ZMB,Johor,0,0,0
2020-12-01,ZMB,Kedah,0,0,0
2020-12-01,ZMB,Perak,0,0,0
2020-12-01,ZMB,Perlis,0,0,0
2020-12-01,ZMB,Pulau Pinang,0,0,0
2020-12-01,ZMB,Sabah,0,0,0
2020-12-01,ZMB,Sarawak,0,0,0
2020-12-01,ZMB,Selangor,4,3,1
2020-12-01,ZWE,Johor,0,0,0
2020-12-01,ZWE,Kedah,0,0,0
2020-12-01,ZWE,Kelantan,0,0,0
2020-12-01,ZWE,Perak,0,0,0
2020-12-01,ZWE,Perlis,0,0,0
2020-12-01,ZWE,Pulau Pinang,0,0,0
2020-12-01,ZWE,Sabah,0,0,0
2020-12-01,ZWE,Sarawak,0,0,0
2020-12-01,ZWE,Selangor,2,1,1
2021-01-01,ABW,Kedah,0,0,0
2021-01-01,ABW,Pulau Pinang,0,0,0
2021-01-01,AFG,Johor,0,0,0
2021-01-01,AFG,Kedah,0,0,0
2021-01-01,AFG,Perlis,0,0,0
2021-01-01,AFG,Pulau Pinang,0,0,0
2021-01-01,AFG,Sarawak,0,0,0
2021-01-01,AFG,Selangor,15,10,5
2021-01-01,AGO,Johor,0,0,0
2021-01-01,AGO,Kedah,0,0,0
2021-01-01,AGO,Sabah,0,0,0
2021-01-01,AGO,Selangor,0,0,0
2021-01-01,AIA,Selangor,0,0,0
2021-01-01,ALB,Johor,0,0,0
2021-01-01,ALB,Kedah,0,0,0
2021-01-01,ALB,Perak,0,0,0
2021-01-01,ALB,Perlis,0,0,0
2021-01-01,ALB,Pulau Pinang,0,0,0
2021-01-01,ALB,Sabah,0,0,0
2021-01-01,ALB,Sarawak,0,0,0
2021-01-01,ALB,Selangor,1,1,0
2021-01-01,AND,Johor,0,0,0
2021-01-01,AND,Kedah,0,0,0
2021-01-01,AND,Perlis,0,0,0
2021-01-01,AND,Pulau Pinang,0,0,0
2021-01-01,AND,Selangor,0,0,0
2021-01-01,ANT,Selangor,0,0,0
2021-01-01,ARE,Johor,0,0,0
2021-01-01,ARE,Kedah,0,0,0
2021-01-01,ARE,Kelantan,0,0,0
2021-01-01,ARE,Perak,0,0,0
2021-01-01,ARE,Perlis,0,0,0
2021-01-01,ARE,Pulau Pinang,0,0,0
2021-01-01,ARE,Sabah,0,0,0
2021-01-01,ARE,Sarawak,0,0,0
2021-01-01,ARE,Selangor,8,7,1
2021-01-01,ARG,Johor,0,0,0
2021-01-01,ARG,Kedah,0,0,0
2021-01-01,ARG,Kelantan,0,0,0
2021-01-01,ARG,Melaka,0,0,0
2021-01-01,ARG,Perak,0,0,0
2021-01-01,ARG,Perlis,0,0,0
2021-01-01,ARG,Pulau Pinang,0,0,0
2021-01-01,ARG,Sabah,0,0,0
2021-01-01,ARG,Sarawak,0,0,0
2021-01-01,ARG,Selangor,13,4,9
2021-01-01,ARG,W.P. Labuan,0,0,0
2021-01-01,ARM,Johor,0,0,0
2021-01-01,ARM,Kedah,0,0,0
2021-01-01,ARM,Kelantan,0,0,0
2021-01-01,ARM,Perak,0,0,0
2021-01-01,ARM,Perlis,0,0,0
2021-01-01,ARM,Pulau Pinang,0,0,0
2021-01-01,ARM,Sabah,0,0,0
2021-01-01,ARM,Sarawak,0,0,0
2021-01-01,ARM,Selangor,0,0,0
2021-01-01,ATA,Selangor,0,0,0
2021-01-01,ATG,Johor,0,0,0
2021-01-01,ATG,Kedah,0,0,0
2021-01-01,ATG,Pulau Pinang,0,0,0
2021-01-01,ATG,Sarawak,0,0,0
2021-01-01,ATG,Selangor,0,0,0
2021-01-01,AUS,Johor,9,5,4
2021-01-01,AUS,Kedah,0,0,0
2021-01-01,AUS,Kelantan,0,0,0
2021-01-01,AUS,Melaka,0,0,0
2021-01-01,AUS,Negeri Sembilan,0,0,0
2021-01-01,AUS,Pahang,0,0,0
2021-01-01,AUS,Perak,1,1,0
2021-01-01,AUS,Perlis,0,0,0
2021-01-01,AUS,Pulau Pinang,5,2,3
2021-01-01,AUS,Sabah,0,0,0
2021-01-01,AUS,Sarawak,2,2,0
2021-01-01,AUS,Selangor,135,89,46
2021-01-01,AUS,Terengganu,0,0,0
2021-01-01,AUS,W.P. Labuan,0,0,0
2021-01-01,AUT,Johor,0,0,0
2021-01-01,AUT,Kedah,0,0,0
2021-01-01,AUT,Kelantan,0,0,0
2021-01-01,AUT,Melaka,0,0,0
2021-01-01,AUT,Negeri Sembilan,0,0,0
2021-01-01,AUT,Pahang,0,0,0
2021-01-01,AUT,Perak,0,0,0
2021-01-01,AUT,Perlis,0,0,0
2021-01-01,AUT,Pulau Pinang,0,0,0
2021-01-01,AUT,Sabah,0,0,0
2021-01-01,AUT,Sarawak,0,0,0
2021-01-01,AUT,Selangor,19,14,5
2021-01-01,AUT,Terengganu,0,0,0
2021-01-01,AUT,W.P. Labuan,0,0,0
2021-01-01,AZE,Johor,0,0,0
2021-01-01,AZE,Kedah,0,0,0
2021-01-01,AZE,Kelantan,0,0,0
2021-01-01,AZE,Melaka,0,0,0
2021-01-01,AZE,Perlis,0,0,0
2021-01-01,AZE,Pulau Pinang,0,0,0
2021-01-01,AZE,Sabah,0,0,0
2021-01-01,AZE,Sarawak,0,0,0
2021-01-01,AZE,Selangor,1,1,0
2021-01-01,AZE,W.P. Labuan,0,0,0
2021-01-01,BDI,Pulau Pinang,0,0,0
2021-01-01,BDI,Sarawak,0,0,0
2021-01-01,BDI,Selangor,0,0,0
2021-01-01,BEL,Johor,0,0,0
2021-01-01,BEL,Kedah,0,0,0
2021-01-01,BEL,Kelantan,0,0,0
2021-01-01,BEL,Melaka,0,0,0
2021-01-01,BEL,Negeri Sembilan,0,0,0
2021-01-01,BEL,Pahang,0,0,0
2021-01-01,BEL,Perak,0,0,0
2021-01-01,BEL,Perlis,0,0,0
2021-01-01,BEL,Pulau Pinang,0,0,0
2021-01-01,BEL,Sabah,0,0,0
2021-01-01,BEL,Sarawak,0,0,0
2021-01-01,BEL,Selangor,21,14,7
2021-01-01,BEL,W.P. Labuan,0,0,0
2021-01-01,BEN,Johor,0,0,0
2021-01-01,BEN,Kedah,0,0,0
2021-01-01,BEN,Perak,0,0,0
2021-01-01,BEN,Pulau Pinang,0,0,0
2021-01-01,BEN,Sabah,0,0,0
2021-01-01,BEN,Sarawak,0,0,0
2021-01-01,BEN,Selangor,0,0,0
2021-01-01,BFA,Perak,0,0,0
2021-01-01,BFA,Pulau Pinang,0,0,0
2021-01-01,BFA,Selangor,0,0,0
2021-01-01,BGD,Johor,7,7,0
2021-01-01,BGD,Kedah,0,0,0
2021-01-01,BGD,Kelantan,0,0,0
2021-01-01,BGD,Melaka,0,0,0
2021-01-01,BGD,Negeri Sembilan,0,0,0
2021-01-01,BGD,Pahang,0,0,0
2021-01-01,BGD,Perak,0,0,0
2021-01-01,BGD,Perlis,0,0,0
2021-01-01,BGD,Pulau Pinang,0,0,0
2021-01-01,BGD,Sabah,0,0,0
2021-01-01,BGD,Sarawak,0,0,0
2021-01-01,BGD,Selangor,99,94,5
2021-01-01,BGD,W.P. Labuan,0,0,0
2021-01-01,BGR,Johor,0,0,0
2021-01-01,BGR,Kedah,0,0,0
2021-01-01,BGR,Kelantan,0,0,0
2021-01-01,BGR,Pahang,0,0,0
2021-01-01,BGR,Perak,0,0,0
2021-01-01,BGR,Perlis,0,0,0
2021-01-01,BGR,Pulau Pinang,0,0,0
2021-01-01,BGR,Sabah,0,0,0
2021-01-01,BGR,Sarawak,0,0,0
2021-01-01,BGR,Selangor,17,15,2
2021-01-01,BGR,W.P. Labuan,0,0,0
2021-01-01,BHR,Johor,0,0,0
2021-01-01,BHR,Kedah,0,0,0
2021-01-01,BHR,Kelantan,0,0,0
2021-01-01,BHR,Perlis,0,0,0
2021-01-01,BHR,Pulau Pinang,0,0,0
2021-01-01,BHR,Sabah,0,0,0
2021-01-01,BHR,Sarawak,0,0,0
2021-01-01,BHR,Selangor,0,0,0
2021-01-01,BHS,Johor,0,0,0
2021-01-01,BHS,Kedah,0,0,0
2021-01-01,BHS,Perak,0,0,0
2021-01-01,BHS,Sabah,0,0,0
2021-01-01,BHS,Sarawak,0,0,0
2021-01-01,BHS,Selangor,0,0,0
2021-01-01,BIH,Johor,0,0,0
2021-01-01,BIH,Kedah,0,0,0
2021-01-01,BIH,Perlis,0,0,0
2021-01-01,BIH,Pulau Pinang,0,0,0
2021-01-01,BIH,Sabah,0,0,0
2021-01-01,BIH,Sarawak,0,0,0
2021-01-01,BIH,Selangor,10,7,3
2021-01-01,BLR,Johor,0,0,0
2021-01-01,BLR,Kedah,0,0,0
2021-01-01,BLR,Kelantan,0,0,0
2021-01-01,BLR,Pahang,0,0,0
2021-01-01,BLR,Perak,0,0,0
2021-01-01,BLR,Perlis,0,0,0
2021-01-01,BLR,Pulau Pinang,0,0,0
2021-01-01,BLR,Sabah,0,0,0
2021-01-01,BLR,Sarawak,0,0,0
2021-01-01,BLR,Selangor,2,1,1
2021-01-01,BLR,W.P. Labuan,0,0,0
2021-01-01,BLZ,Johor,0,0,0
2021-01-01,BLZ,Pulau Pinang,0,0,0
2021-01-01,BLZ,Sarawak,0,0,0
2021-01-01,BLZ,Selangor,1,1,0
2021-01-01,BMU,Selangor,0,0,0
2021-01-01,BOL,Johor,0,0,0
2021-01-01,BOL,Kedah,0,0,0
2021-01-01,BOL,Melaka,0,0,0
2021-01-01,BOL,Perak,0,0,0
2021-01-01,BOL,Perlis,0,0,0
2021-01-01,BOL,Pulau Pinang,0,0,0
2021-01-01,BOL,Sabah,0,0,0
2021-01-01,BOL,Sarawak,0,0,0
2021-01-01,BOL,Selangor,0,0,0
2021-01-01,BRA,Johor,0,0,0
2021-01-01,BRA,Kedah,0,0,0
2021-01-01,BRA,Kelantan,0,0,0
2021-01-01,BRA,Melaka,0,0,0
2021-01-01,BRA,Pahang,0,0,0
2021-01-01,BRA,Perak,0,0,0
2021-01-01,BRA,Perlis,0,0,0
2021-01-01,BRA,Pulau Pinang,0,0,0
2021-01-01,BRA,Sabah,0,0,0
2021-01-01,BRA,Sarawak,0,0,0
2021-01-01,BRA,Selangor,35,25,10
2021-01-01,BRA,W.P. Labuan,0,0,0
2021-01-01,BRB,Johor,0,0,0
2021-01-01,BRB,Kedah,0,0,0
2021-01-01,BRB,Perlis,0,0,0
2021-01-01,BRB,Pulau Pinang,0,0,0
2021-01-01,BRB,Selangor,1,1,0
2021-01-01,BRN,Johor,1,1,0
2021-01-01,BRN,Kedah,0,0,0
2021-01-01,BRN,Kelantan,0,0,0
2021-01-01,BRN,Melaka,0,0,0
2021-01-01,BRN,Pahang,0,0,0
2021-01-01,BRN,Perak,0,0,0
2021-01-01,BRN,Perlis,0,0,0
2021-01-01,BRN,Pulau Pinang,0,0,0
2021-01-01,BRN,Sabah,0,0,0
2021-01-01,BRN,Sarawak,326,322,4
2021-01-01,BRN,Selangor,8,7,1
2021-01-01,BRN,W.P. Labuan,2,2,0
2021-01-01,BTN,Johor,0,0,0
2021-01-01,BTN,Kedah,0,0,0
2021-01-01,BTN,Perak,0,0,0
2021-01-01,BTN,Perlis,0,0,0
2021-01-01,BTN,Pulau Pinang,0,0,0
2021-01-01,BTN,Sabah,0,0,0
2021-01-01,BTN,Sarawak,0,0,0
2021-01-01,BTN,Selangor,0,0,0
2021-01-01,BWA,Johor,0,0,0
2021-01-01,BWA,Kedah,0,0,0
2021-01-01,BWA,Perlis,0,0,0
2021-01-01,BWA,Pulau Pinang,0,0,0
2021-01-01,BWA,Sabah,0,0,0
2021-01-01,BWA,Sarawak,0,0,0
2021-01-01,BWA,Selangor,0,0,0
2021-01-01,CAF,Kedah,0,0,0
2021-01-01,CAF,Selangor,0,0,0
2021-01-01,CAN,Johor,2,2,0
2021-01-01,CAN,Kedah,0,0,0
2021-01-01,CAN,Kelantan,0,0,0
2021-01-01,CAN,Melaka,0,0,0
2021-01-01,CAN,Negeri Sembilan,0,0,0
2021-01-01,CAN,Pahang,0,0,0
2021-01-01,CAN,Perak,0,0,0
2021-01-01,CAN,Perlis,0,0,0
2021-01-01,CAN,Pulau Pinang,0,0,0
2021-01-01,CAN,Sabah,0,0,0
2021-01-01,CAN,Sarawak,0,0,0
2021-01-01,CAN,Selangor,81,53,28
2021-01-01,CAN,Terengganu,0,0,0
2021-01-01,CAN,W.P. Labuan,0,0,0
2021-01-01,CCK,Selangor,0,0,0
2021-01-01,CHE,Johor,1,0,1
2021-01-01,CHE,Kedah,0,0,0
2021-01-01,CHE,Kelantan,0,0,0
2021-01-01,CHE,Melaka,0,0,0
2021-01-01,CHE,Negeri Sembilan,0,0,0
2021-01-01,CHE,Pahang,0,0,0
2021-01-01,CHE,Perak,0,0,0
2021-01-01,CHE,Perlis,0,0,0
2021-01-01,CHE,Pulau Pinang,1,1,0
2021-01-01,CHE,Sabah,0,0,0
2021-01-01,CHE,Sarawak,0,0,0
2021-01-01,CHE,Selangor,14,6,8
2021-01-01,CHE,W.P. Labuan,0,0,0
2021-01-01,CHL,Johor,0,0,0
2021-01-01,CHL,Kedah,0,0,0
2021-01-01,CHL,Kelantan,0,0,0
2021-01-01,CHL,Melaka,0,0,0
2021-01-01,CHL,Pahang,0,0,0
2021-01-01,CHL,Perak,0,0,0
2021-01-01,CHL,Perlis,0,0,0
2021-01-01,CHL,Pulau Pinang,0,0,0
2021-01-01,CHL,Sabah,0,0,0
2021-01-01,CHL,Sarawak,0,0,0
2021-01-01,CHL,Selangor,1,1,0
2021-01-01,CHN,Johor,24,22,2
2021-01-01,CHN,Kedah,0,0,0
2021-01-01,CHN,Kelantan,0,0,0
2021-01-01,CHN,Melaka,0,0,0
2021-01-01,CHN,Pahang,0,0,0
2021-01-01,CHN,Perak,0,0,0
2021-01-01,CHN,Perlis,0,0,0
2021-01-01,CHN,Pulau Pinang,3,3,0
2021-01-01,CHN,Sabah,0,0,0
2021-01-01,CHN,Sarawak,209,200,9
2021-01-01,CHN,Selangor,870,717,153
2021-01-01,CHN,Terengganu,0,0,0
2021-01-01,CHN,W.P. Labuan,0,0,0
2021-01-01,CIV,Johor,0,0,0
2021-01-01,CIV,Kedah,0,0,0
2021-01-01,CIV,Pulau Pinang,0,0,0
2021-01-01,CIV,Sabah,0,0,0
2021-01-01,CIV,Sarawak,0,0,0
2021-01-01,CIV,Selangor,1,1,0
2021-01-01,CMR,Johor,0,0,0
2021-01-01,CMR,Kedah,0,0,0
2021-01-01,CMR,Pulau Pinang,0,0,0
2021-01-01,CMR,Sabah,0,0,0
2021-01-01,CMR,Sarawak,0,0,0
2021-01-01,CMR,Selangor,2,1,1
2021-01-01,COD,Johor,0,0,0
2021-01-01,COD,Pulau Pinang,0,0,0
2021-01-01,COD,Sarawak,0,0,0
2021-01-01,COD,Selangor,0,0,0
2021-01-01,COG,Johor,0,0,0
2021-01-01,COG,Kedah,0,0,0
2021-01-01,COG,Selangor,0,0,0
2021-01-01,COK,Selangor,0,0,0
2021-01-01,COL,Johor,0,0,0
2021-01-01,COL,Kedah,0,0,0
2021-01-01,COL,Perak,0,0,0
2021-01-01,COL,Pulau Pinang,0,0,0
2021-01-01,COL,Sabah,0,0,0
2021-01-01,COL,Sarawak,0,0,0
2021-01-01,COL,Selangor,6,1,5
2021-01-01,COL,W.P. Labuan,0,0,0
2021-01-01,COM,Johor,0,0,0
2021-01-01,COM,Kedah,0,0,0
2021-01-01,COM,Selangor,0,0,0
2021-01-01,CPV,Johor,0,0,0
2021-01-01,CPV,Kedah,0,0,0
2021-01-01,CPV,Pulau Pinang,0,0,0
2021-01-01,CPV,Sabah,0,0,0
2021-01-01,CPV,Selangor,0,0,0
2021-01-01,CRI,Johor,0,0,0
2021-01-01,CRI,Kedah,0,0,0
2021-01-01,CRI,Perak,0,0,0
2021-01-01,CRI,Perlis,0,0,0
2021-01-01,CRI,Pulau Pinang,0,0,0
2021-01-01,CRI,Sabah,0,0,0
2021-01-01,CRI,Sarawak,0,0,0
2021-01-01,CRI,Selangor,21,11,10
2021-01-01,CUB,Johor,0,0,0
2021-01-01,CUB,Kedah,0,0,0
2021-01-01,CUB,Perlis,0,0,0
2021-01-01,CUB,Pulau Pinang,0,0,0
2021-01-01,CUB,Sabah,0,0,0
2021-01-01,CUB,Sarawak,0,0,0
2021-01-01,CUB,Selangor,0,0,0
2021-01-01,CYP,Johor,0,0,0
2021-01-01,CYP,Kedah,0,0,0
2021-01-01,CYP,Perak,0,0,0
2021-01-01,CYP,Perlis,0,0,0
2021-01-01,CYP,Pulau Pinang,0,0,0
2021-01-01,CYP,Sabah,0,0,0
2021-01-01,CYP,Sarawak,0,0,0
2021-01-01,CYP,Selangor,0,0,0
2021-01-01,CZE,Johor,0,0,0
2021-01-01,CZE,Kedah,0,0,0
2021-01-01,CZE,Kelantan,0,0,0
2021-01-01,CZE,Melaka,0,0,0
2021-01-01,CZE,Negeri Sembilan,0,0,0
2021-01-01,CZE,Perak,0,0,0
2021-01-01,CZE,Perlis,0,0,0
2021-01-01,CZE,Pulau Pinang,0,0,0
2021-01-01,CZE,Sabah,0,0,0
2021-01-01,CZE,Sarawak,0,0,0
2021-01-01,CZE,Selangor,11,11,0
2021-01-01,CZE,W.P. Labuan,0,0,0
2021-01-01,DEU,Johor,1,1,0
2021-01-01,DEU,Kedah,0,0,0
2021-01-01,DEU,Kelantan,0,0,0
2021-01-01,DEU,Melaka,0,0,0
2021-01-01,DEU,Negeri Sembilan,0,0,0
2021-01-01,DEU,Pahang,0,0,0
2021-01-01,DEU,Perak,0,0,0
2021-01-01,DEU,Perlis,0,0,0
2021-01-01,DEU,Pulau Pinang,0,0,0
2021-01-01,DEU,Sabah,0,0,0
2021-01-01,DEU,Sarawak,0,0,0
2021-01-01,DEU,Selangor,96,79,17
2021-01-01,DEU,Terengganu,0,0,0
2021-01-01,DEU,W.P. Labuan,0,0,0
2021-01-01,DJI,Johor,0,0,0
2021-01-01,DJI,Selangor,0,0,0
2021-01-01,DMA,Johor,0,0,0
2021-01-01,DMA,Kedah,0,0,0
2021-01-01,DMA,Pulau Pinang,0,0,0
2021-01-01,DMA,Sabah,0,0,0
2021-01-01,DMA,Sarawak,0,0,0
2021-01-01,DMA,Selangor,1,1,0
2021-01-01,DMA,W.P. Labuan,0,0,0
2021-01-01,DNK,Johor,0,0,0
2021-01-01,DNK,Kedah,0,0,0
2021-01-01,DNK,Kelantan,0,0,0
2021-01-01,DNK,Melaka,0,0,0
2021-01-01,DNK,Negeri Sembilan,0,0,0
2021-01-01,DNK,Pahang,0,0,0
2021-01-01,DNK,Perak,0,0,0
2021-01-01,DNK,Perlis,0,0,0
2021-01-01,DNK,Pulau Pinang,0,0,0
2021-01-01,DNK,Sabah,0,0,0
2021-01-01,DNK,Sarawak,0,0,0
2021-01-01,DNK,Selangor,26,18,8
2021-01-01,DNK,W.P. Labuan,0,0,0
2021-01-01,DOM,Johor,0,0,0
2021-01-01,DOM,Kedah,0,0,0
2021-01-01,DOM,Perak,0,0,0
2021-01-01,DOM,Perlis,0,0,0
2021-01-01,DOM,Pulau Pinang,0,0,0
2021-01-01,DOM,Sabah,0,0,0
2021-01-01,DOM,Sarawak,0,0,0
2021-01-01,DOM,Selangor,0,0,0
2021-01-01,DZA,Johor,0,0,0
2021-01-01,DZA,Kedah,0,0,0
2021-01-01,DZA,Kelantan,0,0,0
2021-01-01,DZA,Melaka,0,0,0
2021-01-01,DZA,Perak,0,0,0
2021-01-01,DZA,Perlis,0,0,0
2021-01-01,DZA,Pulau Pinang,0,0,0
2021-01-01,DZA,Sabah,0,0,0
2021-01-01,DZA,Sarawak,0,0,0
2021-01-01,DZA,Selangor,9,5,4
2021-01-01,DZA,W.P. Labuan,0,0,0
2021-01-01,ECU,Johor,0,0,0
2021-01-01,ECU,Kedah,0,0,0
2021-01-01,ECU,Perak,0,0,0
2021-01-01,ECU,Perlis,0,0,0
2021-01-01,ECU,Pulau Pinang,0,0,0
2021-01-01,ECU,Sabah,0,0,0
2021-01-01,ECU,Sarawak,0,0,0
2021-01-01,ECU,Selangor,0,0,0
2021-01-01,EGY,Johor,0,0,0
2021-01-01,EGY,Kedah,0,0,0
2021-01-01,EGY,Kelantan,0,0,0
2021-01-01,EGY,Melaka,0,0,0
2021-01-01,EGY,Pahang,0,0,0
2021-01-01,EGY,Perak,0,0,0
2021-01-01,EGY,Perlis,0,0,0
2021-01-01,EGY,Pulau Pinang,0,0,0
2021-01-01,EGY,Sabah,0,0,0
2021-01-01,EGY,Sarawak,0,0,0
2021-01-01,EGY,Selangor,40,30,10
2021-01-01,EGY,Terengganu,0,0,0
2021-01-01,EGY,W.P. Labuan,0,0,0
2021-01-01,ERI,Johor,0,0,0
2021-01-01,ERI,Pulau Pinang,0,0,0
2021-01-01,ERI,Sabah,0,0,0
2021-01-01,ERI,Selangor,0,0,0
2021-01-01,ESP,Johor,0,0,0
2021-01-01,ESP,Kedah,0,0,0
2021-01-01,ESP,Kelantan,0,0,0
2021-01-01,ESP,Melaka,0,0,0
2021-01-01,ESP,Negeri Sembilan,0,0,0
2021-01-01,ESP,Pahang,0,0,0
2021-01-01,ESP,Perak,0,0,0
2021-01-01,ESP,Perlis,0,0,0
2021-01-01,ESP,Pulau Pinang,1,1,0
2021-01-01,ESP,Sabah,0,0,0
2021-01-01,ESP,Sarawak,0,0,0
2021-01-01,ESP,Selangor,19,12,7
2021-01-01,ESP,W.P. Labuan,0,0,0
2021-01-01,EST,Johor,0,0,0
2021-01-01,EST,Kedah,0,0,0
2021-01-01,EST,Kelantan,0,0,0
2021-01-01,EST,Pahang,0,0,0
2021-01-01,EST,Perak,0,0,0
2021-01-01,EST,Perlis,0,0,0
2021-01-01,EST,Pulau Pinang,0,0,0
2021-01-01,EST,Sabah,0,0,0
2021-01-01,EST,Sarawak,0,0,0
2021-01-01,EST,Selangor,1,1,0
2021-01-01,EST,W.P. Labuan,0,0,0
2021-01-01,ETH,Johor,0,0,0
2021-01-01,ETH,Kedah,0,0,0
2021-01-01,ETH,Pulau Pinang,0,0,0
2021-01-01,ETH,Sarawak,0,0,0
2021-01-01,ETH,Selangor,0,0,0
2021-01-01,FIN,Johor,0,0,0
2021-01-01,FIN,Kedah,0,0,0
2021-01-01,FIN,Kelantan,0,0,0
2021-01-01,FIN,Melaka,0,0,0
2021-01-01,FIN,Negeri Sembilan,0,0,0
2021-01-01,FIN,Pahang,0,0,0
2021-01-01,FIN,Perak,0,0,0
2021-01-01,FIN,Perlis,0,0,0
2021-01-01,FIN,Pulau Pinang,0,0,0
2021-01-01,FIN,Sabah,0,0,0
2021-01-01,FIN,Sarawak,0,0,0
2021-01-01,FIN,Selangor,9,6,3
2021-01-01,FIN,W.P. Labuan,0,0,0
2021-01-01,FJI,Johor,0,0,0
2021-01-01,FJI,Kedah,0,0,0
2021-01-01,FJI,Kelantan,0,0,0
2021-01-01,FJI,Perak,0,0,0
2021-01-01,FJI,Perlis,0,0,0
2021-01-01,FJI,Pulau Pinang,0,0,0
2021-01-01,FJI,Sabah,0,0,0
2021-01-01,FJI,Sarawak,0,0,0
2021-01-01,FJI,Selangor,0,0,0
2021-01-01,FRA,Johor,2,2,0
2021-01-01,FRA,Kedah,0,0,0
2021-01-01,FRA,Kelantan,0,0,0
2021-01-01,FRA,Melaka,0,0,0
2021-01-01,FRA,Negeri Sembilan,0,0,0
2021-01-01,FRA,Pahang,0,0,0
2021-01-01,FRA,Perak,0,0,0
2021-01-01,FRA,Perlis,0,0,0
2021-01-01,FRA,Pulau Pinang,0,0,0
2021-01-01,FRA,Sabah,0,0,0
2021-01-01,FRA,Sarawak,0,0,0
2021-01-01,FRA,Selangor,117,86,31
2021-01-01,FRA,Terengganu,0,0,0
2021-01-01,FRA,W.P. Labuan,0,0,0
2021-01-01,FSM,Johor,0,0,0
2021-01-01,FSM,Pulau Pinang,0,0,0
2021-01-01,FSM,Selangor,0,0,0
2021-01-01,GAB,Johor,0,0,0
2021-01-01,GAB,Pulau Pinang,0,0,0
2021-01-01,GAB,Sarawak,0,0,0
2021-01-01,GAB,Selangor,1,1,0
2021-01-01,GBR,Johor,10,9,1
2021-01-01,GBR,Kedah,0,0,0
2021-01-01,GBR,Kelantan,0,0,0
2021-01-01,GBR,Melaka,0,0,0
2021-01-01,GBR,Negeri Sembilan,0,0,0
2021-01-01,GBR,Pahang,0,0,0
2021-01-01,GBR,Perak,1,0,1
2021-01-01,GBR,Perlis,0,0,0
2021-01-01,GBR,Pulau Pinang,3,3,0
2021-01-01,GBR,Sabah,0,0,0
2021-01-01,GBR,Sarawak,1,1,0
2021-01-01,GBR,Selangor,228,179,49
2021-01-01,GBR,Terengganu,0,0,0
2021-01-01,GBR,W.P. Labuan,0,0,0
2021-01-01,GEO,Johor,0,0,0
2021-01-01,GEO,Kedah,0,0,0
2021-01-01,GEO,Melaka,0,0,0
2021-01-01,GEO,Perak,0,0,0
2021-01-01,GEO,Perlis,0,0,0
2021-01-01,GEO,Pulau Pinang,0,0,0
2021-01-01,GEO,Sabah,0,0,0
2021-01-01,GEO,Sarawak,0,0,0
2021-01-01,GEO,Selangor,2,2,0
2021-01-01,GHA,Johor,0,0,0
2021-01-01,GHA,Kedah,0,0,0
2021-01-01,GHA,Kelantan,0,0,0
2021-01-01,GHA,Pulau Pinang,0,0,0
2021-01-01,GHA,Sabah,0,0,0
2021-01-01,GHA,Sarawak,0,0,0
2021-01-01,GHA,Selangor,7,7,0
2021-01-01,GIB,Johor,0,0,0
2021-01-01,GIB,Sarawak,0,0,0
2021-01-01,GIN,Johor,0,0,0
2021-01-01,GIN,Kedah,0,0,0
2021-01-01,GIN,Kelantan,0,0,0
2021-01-01,GIN,Perlis,0,0,0
2021-01-01,GIN,Pulau Pinang,0,0,0
2021-01-01,GIN,Sabah,0,0,0
2021-01-01,GIN,Sarawak,0,0,0
2021-01-01,GIN,Selangor,0,0,0
2021-01-01,GLP,Selangor,0,0,0
2021-01-01,GMB,Johor,0,0,0
2021-01-01,GMB,Kedah,0,0,0
2021-01-01,GMB,Kelantan,0,0,0
2021-01-01,GMB,Pulau Pinang,0,0,0
2021-01-01,GMB,Sabah,0,0,0
2021-01-01,GMB,Sarawak,0,0,0
2021-01-01,GMB,Selangor,1,0,1
2021-01-01,GNB,Johor,0,0,0
2021-01-01,GNB,Selangor,0,0,0
2021-01-01,GNQ,Johor,0,0,0
2021-01-01,GNQ,Selangor,0,0,0
2021-01-01,GRC,Johor,0,0,0
2021-01-01,GRC,Kedah,0,0,0
2021-01-01,GRC,Kelantan,0,0,0
2021-01-01,GRC,Melaka,0,0,0
2021-01-01,GRC,Negeri Sembilan,0,0,0
2021-01-01,GRC,Pahang,0,0,0
2021-01-01,GRC,Perak,0,0,0
2021-01-01,GRC,Perlis,0,0,0
2021-01-01,GRC,Pulau Pinang,0,0,0
2021-01-01,GRC,Sabah,0,0,0
2021-01-01,GRC,Sarawak,0,0,0
2021-01-01,GRC,Selangor,1,1,0
2021-01-01,GRD,Johor,0,0,0
2021-01-01,GRD,Kedah,0,0,0
2021-01-01,GRD,Pulau Pinang,0,0,0
2021-01-01,GRD,Sabah,0,0,0
2021-01-01,GRD,Sarawak,0,0,0
2021-01-01,GRD,Selangor,0,0,0
2021-01-01,GRL,Johor,0,0,0
2021-01-01,GRL,Selangor,0,0,0
2021-01-01,GTM,Johor,0,0,0
2021-01-01,GTM,Kedah,0,0,0
2021-01-01,GTM,Pahang,0,0,0
2021-01-01,GTM,Perak,0,0,0
2021-01-01,GTM,Pulau Pinang,0,0,0
2021-01-01,GTM,Sabah,0,0,0
2021-01-01,GTM,Sarawak,0,0,0
2021-01-01,GTM,Selangor,0,0,0
2021-01-01,GTM,W.P. Labuan,0,0,0
2021-01-01,GUY,Johor,0,0,0
2021-01-01,GUY,Kedah,0,0,0
2021-01-01,GUY,Pulau Pinang,0,0,0
2021-01-01,GUY,Sarawak,0,0,0
2021-01-01,GUY,Selangor,0,0,0
2021-01-01,HKG,Johor,0,0,0
2021-01-01,HKG,Kedah,0,0,0
2021-01-01,HKG,Kelantan,0,0,0
2021-01-01,HKG,Pahang,0,0,0
2021-01-01,HKG,Perak,0,0,0
2021-01-01,HKG,Perlis,0,0,0
2021-01-01,HKG,Pulau Pinang,5,3,2
2021-01-01,HKG,Sabah,0,0,0
2021-01-01,HKG,Sarawak,0,0,0
2021-01-01,HKG,Selangor,2,2,0
2021-01-01,HKG,Terengganu,0,0,0
2021-01-01,HMD,Johor,0,0,0
2021-01-01,HND,Johor,0,0,0
2021-01-01,HND,Kedah,0,0,0
2021-01-01,HND,Perak,0,0,0
2021-01-01,HND,Pulau Pinang,0,0,0
2021-01-01,HND,Sabah,0,0,0
2021-01-01,HND,Sarawak,0,0,0
2021-01-01,HND,Selangor,1,0,1
2021-01-01,HRV,Johor,12,12,0
2021-01-01,HRV,Kedah,0,0,0
2021-01-01,HRV,Kelantan,0,0,0
2021-01-01,HRV,Melaka,0,0,0
2021-01-01,HRV,Pahang,0,0,0
2021-01-01,HRV,Perak,0,0,0
2021-01-01,HRV,Perlis,0,0,0
2021-01-01,HRV,Pulau Pinang,0,0,0
2021-01-01,HRV,Sabah,0,0,0
2021-01-01,HRV,Sarawak,0,0,0
2021-01-01,HRV,Selangor,36,36,0
2021-01-01,HTI,Johor,0,0,0
2021-01-01,HTI,Kedah,0,0,0
2021-01-01,HTI,Kelantan,0,0,0
2021-01-01,HTI,Perak,0,0,0
2021-01-01,HTI,Pulau Pinang,0,0,0
2021-01-01,HTI,Sabah,0,0,0
2021-01-01,HTI,Selangor,0,0,0
2021-01-01,HUN,Johor,0,0,0
2021-01-01,HUN,Kedah,0,0,0
2021-01-01,HUN,Kelantan,0,0,0
2021-01-01,HUN,Pahang,0,0,0
2021-01-01,HUN,Perak,0,0,0
2021-01-01,HUN,Perlis,0,0,0
2021-01-01,HUN,Pulau Pinang,0,0,0
2021-01-01,HUN,Sabah,0,0,0
2021-01-01,HUN,Sarawak,0,0,0
2021-01-01,HUN,Selangor,12,9,3
2021-01-01,HUN,W.P. Labuan,0,0,0
2021-01-01,IDN,Johor,236,200,36
2021-01-01,IDN,Kedah,5,5,0
2021-01-01,IDN,Kelantan,0,0,0
2021-01-01,IDN,Melaka,0,0,0
2021-01-01,IDN,Negeri Sembilan,0,0,0
2021-01-01,IDN,Pahang,0,0,0
2021-01-01,IDN,Perak,0,0,0
2021-01-01,IDN,Perlis,4,3,1
2021-01-01,IDN,Pulau Pinang,16,5,11
2021-01-01,IDN,Sabah,4,0,4
2021-01-01,IDN,Sarawak,313,309,4
2021-01-01,IDN,Selangor,543,378,165
2021-01-01,IDN,Terengganu,0,0,0
2021-01-01,IDN,W.P. Labuan,2,2,0
2021-01-01,IND,Johor,49,48,1
2021-01-01,IND,Kedah,0,0,0
2021-01-01,IND,Kelantan,0,0,0
2021-01-01,IND,Melaka,0,0,0
2021-01-01,IND,Negeri Sembilan,0,0,0
2021-01-01,IND,Pahang,0,0,0
2021-01-01,IND,Perak,0,0,0
2021-01-01,IND,Perlis,0,0,0
2021-01-01,IND,Pulau Pinang,1,1,0
2021-01-01,IND,Sabah,0,0,0
2021-01-01,IND,Sarawak,0,0,0
2021-01-01,IND,Selangor,707,581,126
2021-01-01,IND,Terengganu,0,0,0
2021-01-01,IND,W.P. Labuan,0,0,0
2021-01-01,IOT,Pulau Pinang,0,0,0
2021-01-01,IOT,Selangor,0,0,0
2021-01-01,IRL,Johor,0,0,0
2021-01-01,IRL,Kedah,0,0,0
2021-01-01,IRL,Kelantan,0,0,0
2021-01-01,IRL,Negeri Sembilan,0,0,0
2021-01-01,IRL,Pahang,0,0,0
2021-01-01,IRL,Perak,0,0,0
2021-01-01,IRL,Perlis,0,0,0
2021-01-01,IRL,Pulau Pinang,0,0,0
2021-01-01,IRL,Sabah,0,0,0
2021-01-01,IRL,Sarawak,0,0,0
2021-01-01,IRL,Selangor,15,12,3
2021-01-01,IRL,Terengganu,0,0,0
2021-01-01,IRL,W.P. Labuan,0,0,0
2021-01-01,IRN,Johor,0,0,0
2021-01-01,IRN,Kedah,0,0,0
2021-01-01,IRN,Kelantan,0,0,0
2021-01-01,IRN,Perak,0,0,0
2021-01-01,IRN,Perlis,0,0,0
2021-01-01,IRN,Pulau Pinang,0,0,0
2021-01-01,IRN,Sabah,0,0,0
2021-01-01,IRN,Sarawak,0,0,0
2021-01-01,IRN,Selangor,49,41,8
2021-01-01,IRN,W.P. Labuan,0,0,0
2021-01-01,IRQ,Johor,0,0,0
2021-01-01,IRQ,Kedah,0,0,0
2021-01-01,IRQ,Kelantan,0,0,0
2021-01-01,IRQ,Melaka,0,0,0
2021-01-01,IRQ,Pahang,0,0,0
2021-01-01,IRQ,Perak,0,0,0
2021-01-01,IRQ,Perlis,0,0,0
2021-01-01,IRQ,Pulau Pinang,0,0,0
2021-01-01,IRQ,Sabah,0,0,0
2021-01-01,IRQ,Sarawak,0,0,0
2021-01-01,IRQ,Selangor,11,9,2
2021-01-01,ISL,Johor,0,0,0
2021-01-01,ISL,Kedah,0,0,0
2021-01-01,ISL,Kelantan,0,0,0
2021-01-01,ISL,Perak,0,0,0
2021-01-01,ISL,Perlis,0,0,0
2021-01-01,ISL,Pulau Pinang,0,0,0
2021-01-01,ISL,Sabah,0,0,0
2021-01-01,ISL,Sarawak,0,0,0
2021-01-01,ISL,Selangor,2,1,1
2021-01-01,ISL,W.P. Labuan,0,0,0
2021-01-01,ISR,Pulau Pinang,0,0,0
2021-01-01,ITA,Johor,0,0,0
2021-01-01,ITA,Kedah,0,0,0
2021-01-01,ITA,Kelantan,0,0,0
2021-01-01,ITA,Melaka,0,0,0
2021-01-01,ITA,Negeri Sembilan,0,0,0
2021-01-01,ITA,Pahang,0,0,0
2021-01-01,ITA,Perak,0,0,0
2021-01-01,ITA,Perlis,0,0,0
2021-01-01,ITA,Pulau Pinang,0,0,0
2021-01-01,ITA,Sabah,0,0,0
2021-01-01,ITA,Sarawak,0,0,0
2021-01-01,ITA,Selangor,47,39,8
2021-01-01,ITA,W.P. Labuan,0,0,0
2021-01-01,JAM,Johor,0,0,0
2021-01-01,JAM,Kedah,0,0,0
2021-01-01,JAM,Perak,0,0,0
2021-01-01,JAM,Pulau Pinang,0,0,0
2021-01-01,JAM,Sabah,0,0,0
2021-01-01,JAM,Sarawak,0,0,0
2021-01-01,JAM,Selangor,0,0,0
2021-01-01,JAM,W.P. Labuan,0,0,0
2021-01-01,JOR,Johor,0,0,0
2021-01-01,JOR,Kedah,0,0,0
2021-01-01,JOR,Kelantan,0,0,0
2021-01-01,JOR,Melaka,0,0,0
2021-01-01,JOR,Perlis,0,0,0
2021-01-01,JOR,Pulau Pinang,0,0,0
2021-01-01,JOR,Sabah,0,0,0
2021-01-01,JOR,Sarawak,0,0,0
2021-01-01,JOR,Selangor,8,6,2
2021-01-01,JOR,W.P. Labuan,0,0,0
2021-01-01,JPN,Johor,3,3,0
2021-01-01,JPN,Kedah,0,0,0
2021-01-01,JPN,Kelantan,0,0,0
2021-01-01,JPN,Melaka,0,0,0
2021-01-01,JPN,Negeri Sembilan,0,0,0
2021-01-01,JPN,Pahang,0,0,0
2021-01-01,JPN,Perak,0,0,0
2021-01-01,JPN,Perlis,0,0,0
2021-01-01,JPN,Pulau Pinang,18,15,3
2021-01-01,JPN,Sabah,0,0,0
2021-01-01,JPN,Sarawak,6,6,0
2021-01-01,JPN,Selangor,369,256,113
2021-01-01,JPN,W.P. Labuan,0,0,0
2021-01-01,KAZ,Johor,0,0,0
2021-01-01,KAZ,Kedah,0,0,0
2021-01-01,KAZ,Kelantan,0,0,0
2021-01-01,KAZ,Melaka,0,0,0
2021-01-01,KAZ,Perak,0,0,0
2021-01-01,KAZ,Perlis,0,0,0
2021-01-01,KAZ,Pulau Pinang,0,0,0
2021-01-01,KAZ,Sabah,0,0,0
2021-01-01,KAZ,Sarawak,0,0,0
2021-01-01,KAZ,Selangor,5,1,4
2021-01-01,KAZ,W.P. Labuan,0,0,0
2021-01-01,KEN,Johor,0,0,0
2021-01-01,KEN,Kedah,0,0,0
2021-01-01,KEN,Kelantan,0,0,0
2021-01-01,KEN,Perak,0,0,0
2021-01-01,KEN,Perlis,0,0,0
2021-01-01,KEN,Pulau Pinang,0,0,0
2021-01-01,KEN,Sabah,0,0,0
2021-01-01,KEN,Sarawak,0,0,0
2021-01-01,KEN,Selangor,9,7,2
2021-01-01,KGZ,Johor,0,0,0
2021-01-01,KGZ,Kedah,0,0,0
2021-01-01,KGZ,Kelantan,0,0,0
2021-01-01,KGZ,Perak,0,0,0
2021-01-01,KGZ,Perlis,0,0,0
2021-01-01,KGZ,Pulau Pinang,0,0,0
2021-01-01,KGZ,Sabah,0,0,0
2021-01-01,KGZ,Sarawak,0,0,0
2021-01-01,KGZ,Selangor,4,1,3
2021-01-01,KHM,Johor,0,0,0
2021-01-01,KHM,Kedah,0,0,0
2021-01-01,KHM,Kelantan,0,0,0
2021-01-01,KHM,Melaka,0,0,0
2021-01-01,KHM,Negeri Sembilan,0,0,0
2021-01-01,KHM,Pahang,0,0,0
2021-01-01,KHM,Perak,0,0,0
2021-01-01,KHM,Perlis,0,0,0
2021-01-01,KHM,Pulau Pinang,0,0,0
2021-01-01,KHM,Sabah,0,0,0
2021-01-01,KHM,Sarawak,0,0,0
2021-01-01,KHM,Selangor,9,4,5
2021-01-01,KHM,W.P. Labuan,0,0,0
2021-01-01,KIR,Johor,0,0,0
2021-01-01,KIR,Sabah,0,0,0
2021-01-01,KIR,Selangor,6,6,0
2021-01-01,KNA,Johor,0,0,0
2021-01-01,KNA,Kedah,0,0,0
2021-01-01,KNA,Perlis,0,0,0
2021-01-01,KNA,Pulau Pinang,0,0,0
2021-01-01,KNA,Sabah,0,0,0
2021-01-01,KNA,Selangor,0,0,0
2021-01-01,KNA,W.P. Labuan,0,0,0
2021-01-01,KOR,Johor,6,6,0
2021-01-01,KOR,Kedah,0,0,0
2021-01-01,KOR,Kelantan,0,0,0
2021-01-01,KOR,Melaka,0,0,0
2021-01-01,KOR,Negeri Sembilan,0,0,0
2021-01-01,KOR,Pahang,0,0,0
2021-01-01,KOR,Perak,0,0,0
2021-01-01,KOR,Perlis,0,0,0
2021-01-01,KOR,Pulau Pinang,2,1,1
2021-01-01,KOR,Sabah,0,0,0
2021-01-01,KOR,Sarawak,3,3,0
2021-01-01,KOR,Selangor,226,145,81
2021-01-01,KOR,Terengganu,0,0,0
2021-01-01,KOR,W.P. Labuan,0,0,0
2021-01-01,KWT,Johor,0,0,0
2021-01-01,KWT,Kedah,0,0,0
2021-01-01,KWT,Kelantan,0,0,0
2021-01-01,KWT,Perak,0,0,0
2021-01-01,KWT,Perlis,0,0,0
2021-01-01,KWT,Pulau Pinang,0,0,0
2021-01-01,KWT,Sabah,0,0,0
2021-01-01,KWT,Sarawak,0,0,0
2021-01-01,KWT,Selangor,9,6,3
2021-01-01,KWT,W.P. Labuan,0,0,0
2021-01-01,LAO,Johor,0,0,0
2021-01-01,LAO,Kedah,0,0,0
2021-01-01,LAO,Kelantan,0,0,0
2021-01-01,LAO,Melaka,0,0,0
2021-01-01,LAO,Perak,0,0,0
2021-01-01,LAO,Perlis,0,0,0
2021-01-01,LAO,Pulau Pinang,0,0,0
2021-01-01,LAO,Sabah,0,0,0
2021-01-01,LAO,Sarawak,0,0,0
2021-01-01,LAO,Selangor,3,1,2
2021-01-01,LAO,W.P. Labuan,0,0,0
2021-01-01,LBN,Johor,0,0,0
2021-01-01,LBN,Kedah,0,0,0
2021-01-01,LBN,Kelantan,0,0,0
2021-01-01,LBN,Pahang,0,0,0
2021-01-01,LBN,Perak,0,0,0
2021-01-01,LBN,Perlis,0,0,0
2021-01-01,LBN,Pulau Pinang,0,0,0
2021-01-01,LBN,Sabah,0,0,0
2021-01-01,LBN,Sarawak,0,0,0
2021-01-01,LBN,Selangor,2,2,0
2021-01-01,LBN,W.P. Labuan,0,0,0
2021-01-01,LBR,Johor,0,0,0
2021-01-01,LBR,Kedah,0,0,0
2021-01-01,LBR,Sabah,0,0,0
2021-01-01,LBR,Sarawak,0,0,0
2021-01-01,LBR,Selangor,0,0,0
2021-01-01,LBY,Johor,0,0,0
2021-01-01,LBY,Kedah,0,0,0
2021-01-01,LBY,Perlis,0,0,0
2021-01-01,LBY,Pulau Pinang,0,0,0
2021-01-01,LBY,Sabah,0,0,0
2021-01-01,LBY,Sarawak,0,0,0
2021-01-01,LBY,Selangor,13,11,2
2021-01-01,LCA,Johor,0,0,0
2021-01-01,LCA,Kedah,0,0,0
2021-01-01,LCA,Pulau Pinang,0,0,0
2021-01-01,LCA,Sarawak,0,0,0
2021-01-01,LCA,Selangor,1,1,0
2021-01-01,LIE,Johor,0,0,0
2021-01-01,LIE,Kedah,0,0,0
2021-01-01,LIE,Perlis,0,0,0
2021-01-01,LIE,Pulau Pinang,0,0,0
2021-01-01,LIE,Sabah,0,0,0
2021-01-01,LIE,Sarawak,0,0,0
2021-01-01,LIE,Selangor,0,0,0
2021-01-01,LKA,Johor,9,9,0
2021-01-01,LKA,Kedah,0,0,0
2021-01-01,LKA,Kelantan,0,0,0
2021-01-01,LKA,Melaka,0,0,0
2021-01-01,LKA,Pahang,0,0,0
2021-01-01,LKA,Perak,0,0,0
2021-01-01,LKA,Perlis,0,0,0
2021-01-01,LKA,Pulau Pinang,0,0,0
2021-01-01,LKA,Sabah,0,0,0
2021-01-01,LKA,Sarawak,0,0,0
2021-01-01,LKA,Selangor,39,32,7
2021-01-01,LKA,W.P. Labuan,0,0,0
2021-01-01,LSO,Johor,0,0,0
2021-01-01,LSO,Kedah,0,0,0
2021-01-01,LSO,Pulau Pinang,0,0,0
2021-01-01,LSO,Sarawak,0,0,0
2021-01-01,LSO,Selangor,0,0,0
2021-01-01,LTU,Johor,2,2,0
2021-01-01,LTU,Kedah,0,0,0
2021-01-01,LTU,Kelantan,0,0,0
2021-01-01,LTU,Pahang,0,0,0
2021-01-01,LTU,Perak,0,0,0
2021-01-01,LTU,Perlis,0,0,0
2021-01-01,LTU,Pulau Pinang,0,0,0
2021-01-01,LTU,Sabah,0,0,0
2021-01-01,LTU,Sarawak,0,0,0
2021-01-01,LTU,Selangor,6,5,1
2021-01-01,LTU,W.P. Labuan,0,0,0
2021-01-01,LUX,Johor,0,0,0
2021-01-01,LUX,Kedah,0,0,0
2021-01-01,LUX,Kelantan,0,0,0
2021-01-01,LUX,Perak,0,0,0
2021-01-01,LUX,Perlis,0,0,0
2021-01-01,LUX,Pulau Pinang,0,0,0
2021-01-01,LUX,Sabah,0,0,0
2021-01-01,LUX,Sarawak,0,0,0
2021-01-01,LUX,Selangor,0,0,0
2021-01-01,LVA,Johor,0,0,0
2021-01-01,LVA,Kedah,0,0,0
2021-01-01,LVA,Kelantan,0,0,0
2021-01-01,LVA,Pahang,0,0,0
2021-01-01,LVA,Perak,0,0,0
2021-01-01,LVA,Perlis,0,0,0
2021-01-01,LVA,Pulau Pinang,0,0,0
2021-01-01,LVA,Sabah,0,0,0
2021-01-01,LVA,Sarawak,0,0,0
2021-01-01,LVA,Selangor,1,0,1
2021-01-01,LVA,W.P. Labuan,0,0,0
2021-01-01,MAC,Johor,0,0,0
2021-01-01,MAC,Pahang,0,0,0
2021-01-01,MAC,Perak,0,0,0
2021-01-01,MAC,Selangor,0,0,0
2021-01-01,MAC,W.P. Labuan,0,0,0
2021-01-01,MAR,Johor,0,0,0
2021-01-01,MAR,Kedah,0,0,0
2021-01-01,MAR,Kelantan,0,0,0
2021-01-01,MAR,Melaka,0,0,0
2021-01-01,MAR,Pahang,0,0,0
2021-01-01,MAR,Perak,0,0,0
2021-01-01,MAR,Perlis,0,0,0
2021-01-01,MAR,Pulau Pinang,0,0,0
2021-01-01,MAR,Sabah,0,0,0
2021-01-01,MAR,Sarawak,0,0,0
2021-01-01,MAR,Selangor,8,4,4
2021-01-01,MAR,W.P. Labuan,0,0,0
2021-01-01,MCO,Johor,0,0,0
2021-01-01,MCO,Kedah,0,0,0
2021-01-01,MCO,Sabah,0,0,0
2021-01-01,MCO,Selangor,0,0,0
2021-01-01,MDA,Johor,0,0,0
2021-01-01,MDA,Kedah,0,0,0
2021-01-01,MDA,Kelantan,0,0,0
2021-01-01,MDA,Negeri Sembilan,0,0,0
2021-01-01,MDA,Perlis,0,0,0
2021-01-01,MDA,Pulau Pinang,0,0,0
2021-01-01,MDA,Sabah,0,0,0
2021-01-01,MDA,Sarawak,0,0,0
2021-01-01,MDA,Selangor,0,0,0
2021-01-01,MDG,Johor,0,0,0
2021-01-01,MDG,Kedah,0,0,0
2021-01-01,MDG,Perak,0,0,0
2021-01-01,MDG,Perlis,0,0,0
2021-01-01,MDG,Pulau Pinang,0,0,0
2021-01-01,MDG,Sabah,0,0,0
2021-01-01,MDG,Sarawak,0,0,0
2021-01-01,MDG,Selangor,0,0,0
2021-01-01,MDV,Johor,0,0,0
2021-01-01,MDV,Kedah,0,0,0
2021-01-01,MDV,Kelantan,0,0,0
2021-01-01,MDV,Perak,0,0,0
2021-01-01,MDV,Perlis,0,0,0
2021-01-01,MDV,Pulau Pinang,0,0,0
2021-01-01,MDV,Sabah,0,0,0
2021-01-01,MDV,Sarawak,0,0,0
2021-01-01,MDV,Selangor,40,19,21
2021-01-01,MEX,Johor,0,0,0
2021-01-01,MEX,Kedah,0,0,0
2021-01-01,MEX,Kelantan,0,0,0
2021-01-01,MEX,Pahang,0,0,0
2021-01-01,MEX,Perak,0,0,0
2021-01-01,MEX,Perlis,0,0,0
2021-01-01,MEX,Pulau Pinang,0,0,0
2021-01-01,MEX,Sabah,0,0,0
2021-01-01,MEX,Sarawak,0,0,0
2021-01-01,MEX,Selangor,7,7,0
2021-01-01,MEX,W.P. Labuan,0,0,0
2021-01-01,MHL,Johor,0,0,0
2021-01-01,MHL,Kedah,0,0,0
2021-01-01,MHL,Perak,0,0,0
2021-01-01,MHL,Pulau Pinang,0,0,0
2021-01-01,MHL,Sabah,0,0,0
2021-01-01,MHL,Selangor,0,0,0
2021-01-01,MKD,Johor,0,0,0
2021-01-01,MKD,Kedah,0,0,0
2021-01-01,MKD,Perak,0,0,0
2021-01-01,MKD,Pulau Pinang,0,0,0
2021-01-01,MKD,Sabah,0,0,0
2021-01-01,MKD,Sarawak,0,0,0
2021-01-01,MKD,Selangor,0,0,0
2021-01-01,MLI,Johor,0,0,0
2021-01-01,MLI,Sabah,0,0,0
2021-01-01,MLI,Selangor,1,1,0
2021-01-01,MLT,Johor,0,0,0
2021-01-01,MLT,Kedah,0,0,0
2021-01-01,MLT,Kelantan,0,0,0
2021-01-01,MLT,Perak,0,0,0
2021-01-01,MLT,Perlis,0,0,0
2021-01-01,MLT,Pulau Pinang,0,0,0
2021-01-01,MLT,Sabah,0,0,0
2021-01-01,MLT,Sarawak,0,0,0
2021-01-01,MLT,Selangor,1,1,0
2021-01-01,MLT,W.P. Labuan,0,0,0
2021-01-01,MMR,Johor,9,9,0
2021-01-01,MMR,Kedah,0,0,0
2021-01-01,MMR,Kelantan,0,0,0
2021-01-01,MMR,Negeri Sembilan,0,0,0
2021-01-01,MMR,Pahang,0,0,0
2021-01-01,MMR,Perak,0,0,0
2021-01-01,MMR,Perlis,0,0,0
2021-01-01,MMR,Pulau Pinang,0,0,0
2021-01-01,MMR,Sabah,0,0,0
2021-01-01,MMR,Sarawak,0,0,0
2021-01-01,MMR,Selangor,121,114,7
2021-01-01,MMR,Terengganu,0,0,0
2021-01-01,MMR,W.P. Labuan,0,0,0
2021-01-01,MNE,Johor,6,6,0
2021-01-01,MNE,Kedah,0,0,0
2021-01-01,MNE,Pulau Pinang,0,0,0
2021-01-01,MNE,Sabah,0,0,0
2021-01-01,MNE,Sarawak,0,0,0
2021-01-01,MNE,Selangor,1,1,0
2021-01-01,MNG,Johor,0,0,0
2021-01-01,MNG,Kedah,0,0,0
2021-01-01,MNG,Kelantan,0,0,0
2021-01-01,MNG,Perak,0,0,0
2021-01-01,MNG,Perlis,0,0,0
2021-01-01,MNG,Pulau Pinang,0,0,0
2021-01-01,MNG,Sabah,0,0,0
2021-01-01,MNG,Sarawak,0,0,0
2021-01-01,MNG,Selangor,0,0,0
2021-01-01,MNP,Selangor,0,0,0
2021-01-01,MOZ,Johor,0,0,0
2021-01-01,MOZ,Kedah,0,0,0
2021-01-01,MOZ,Perak,0,0,0
2021-01-01,MOZ,Pulau Pinang,0,0,0
2021-01-01,MOZ,Sabah,0,0,0
2021-01-01,MOZ,Sarawak,0,0,0
2021-01-01,MOZ,Selangor,2,1,1
2021-01-01,MRT,Johor,0,0,0
2021-01-01,MRT,Kedah,0,0,0
2021-01-01,MRT,Pulau Pinang,0,0,0
2021-01-01,MRT,Sabah,0,0,0
2021-01-01,MRT,Sarawak,0,0,0
2021-01-01,MRT,Selangor,5,4,1
2021-01-01,MUS,Johor,0,0,0
2021-01-01,MUS,Kedah,0,0,0
2021-01-01,MUS,Kelantan,0,0,0
2021-01-01,MUS,Pahang,0,0,0
2021-01-01,MUS,Perak,0,0,0
2021-01-01,MUS,Perlis,0,0,0
2021-01-01,MUS,Pulau Pinang,0,0,0
2021-01-01,MUS,Sabah,0,0,0
2021-01-01,MUS,Sarawak,0,0,0
2021-01-01,MUS,Selangor,8,5,3
2021-01-01,MWI,Johor,0,0,0
2021-01-01,MWI,Pulau Pinang,0,0,0
2021-01-01,MWI,Sabah,0,0,0
2021-01-01,MWI,Sarawak,0,0,0
2021-01-01,MWI,Selangor,0,0,0
2021-01-01,MYT,Selangor,0,0,0
2021-01-01,NAM,Johor,0,0,0
2021-01-01,NAM,Kedah,0,0,0
2021-01-01,NAM,Perak,0,0,0
2021-01-01,NAM,Perlis,0,0,0
2021-01-01,NAM,Pulau Pinang,0,0,0
2021-01-01,NAM,Sabah,0,0,0
2021-01-01,NAM,Sarawak,0,0,0
2021-01-01,NAM,Selangor,0,0,0
2021-01-01,NCL,Selangor,0,0,0
2021-01-01,NER,Johor,0,0,0
2021-01-01,NER,Sabah,0,0,0
2021-01-01,NER,Selangor,0,0,0
2021-01-01,NGA,Johor,0,0,0
2021-01-01,NGA,Kedah,0,0,0
2021-01-01,NGA,Perlis,0,0,0
2021-01-01,NGA,Pulau Pinang,0,0,0
2021-01-01,NGA,Sabah,0,0,0
2021-01-01,NGA,Sarawak,0,0,0
2021-01-01,NGA,Selangor,39,36,3
2021-01-01,NIC,Johor,0,0,0
2021-01-01,NIC,Kedah,0,0,0
2021-01-01,NIC,Pulau Pinang,0,0,0
2021-01-01,NIC,Sabah,0,0,0
2021-01-01,NIC,Selangor,0,0,0
2021-01-01,NLD,Johor,2,2,0
2021-01-01,NLD,Kedah,0,0,0
2021-01-01,NLD,Kelantan,0,0,0
2021-01-01,NLD,Melaka,0,0,0
2021-01-01,NLD,Negeri Sembilan,0,0,0
2021-01-01,NLD,Pahang,0,0,0
2021-01-01,NLD,Perak,0,0,0
2021-01-01,NLD,Perlis,0,0,0
2021-01-01,NLD,Pulau Pinang,0,0,0
2021-01-01,NLD,Sabah,0,0,0
2021-01-01,NLD,Sarawak,0,0,0
2021-01-01,NLD,Selangor,56,44,12
2021-01-01,NLD,Terengganu,0,0,0
2021-01-01,NLD,W.P. Labuan,0,0,0
2021-01-01,NOR,Johor,0,0,0
2021-01-01,NOR,Kedah,0,0,0
2021-01-01,NOR,Kelantan,0,0,0
2021-01-01,NOR,Melaka,0,0,0
2021-01-01,NOR,Pahang,0,0,0
2021-01-01,NOR,Perak,0,0,0
2021-01-01,NOR,Perlis,0,0,0
2021-01-01,NOR,Pulau Pinang,0,0,0
2021-01-01,NOR,Sabah,0,0,0
2021-01-01,NOR,Sarawak,0,0,0
2021-01-01,NOR,Selangor,24,21,3
2021-01-01,NOR,W.P. Labuan,0,0,0
2021-01-01,NPL,Johor,0,0,0
2021-01-01,NPL,Kedah,0,0,0
2021-01-01,NPL,Pahang,0,0,0
2021-01-01,NPL,Perak,0,0,0
2021-01-01,NPL,Perlis,0,0,0
2021-01-01,NPL,Pulau Pinang,0,0,0
2021-01-01,NPL,Sabah,0,0,0
2021-01-01,NPL,Sarawak,0,0,0
2021-01-01,NPL,Selangor,75,73,2
2021-01-01,NPL,W.P. Labuan,0,0,0
2021-01-01,NRU,Johor,0,0,0
2021-01-01,NRU,Pulau Pinang,0,0,0
2021-01-01,NRU,Selangor,0,0,0
2021-01-01,NZL,Johor,1,0,1
2021-01-01,NZL,Kedah,0,0,0
2021-01-01,NZL,Kelantan,0,0,0
2021-01-01,NZL,Melaka,0,0,0
2021-01-01,NZL,Negeri Sembilan,0,0,0
2021-01-01,NZL,Pahang,0,0,0
2021-01-01,NZL,Perak,0,0,0
2021-01-01,NZL,Perlis,0,0,0
2021-01-01,NZL,Pulau Pinang,4,2,2
2021-01-01,NZL,Sabah,0,0,0
2021-01-01,NZL,Sarawak,0,0,0
2021-01-01,NZL,Selangor,23,15,8
2021-01-01,NZL,Terengganu,0,0,0
2021-01-01,NZL,W.P. Labuan,0,0,0
2021-01-01,OMN,Johor,0,0,0
2021-01-01,OMN,Kedah,0,0,0
2021-01-01,OMN,Kelantan,0,0,0
2021-01-01,OMN,Melaka,0,0,0
2021-01-01,OMN,Perak,0,0,0
2021-01-01,OMN,Perlis,0,0,0
2021-01-01,OMN,Pulau Pinang,0,0,0
2021-01-01,OMN,Sabah,0,0,0
2021-01-01,OMN,Sarawak,0,0,0
2021-01-01,OMN,Selangor,6,3,3
2021-01-01,PAK,Johor,0,0,0
2021-01-01,PAK,Kedah,0,0,0
2021-01-01,PAK,Kelantan,0,0,0
2021-01-01,PAK,Melaka,0,0,0
2021-01-01,PAK,Negeri Sembilan,0,0,0
2021-01-01,PAK,Pahang,0,0,0
2021-01-01,PAK,Perak,0,0,0
2021-01-01,PAK,Perlis,0,0,0
2021-01-01,PAK,Pulau Pinang,0,0,0
2021-01-01,PAK,Sabah,2,2,0
2021-01-01,PAK,Sarawak,0,0,0
2021-01-01,PAK,Selangor,187,162,25
2021-01-01,PAK,W.P. Labuan,0,0,0
2021-01-01,PAN,Johor,0,0,0
2021-01-01,PAN,Kedah,0,0,0
2021-01-01,PAN,Perak,0,0,0
2021-01-01,PAN,Perlis,0,0,0
2021-01-01,PAN,Pulau Pinang,0,0,0
2021-01-01,PAN,Sabah,0,0,0
2021-01-01,PAN,Sarawak,0,0,0
2021-01-01,PAN,Selangor,3,1,2
2021-01-01,PER,Johor,0,0,0
2021-01-01,PER,Kedah,0,0,0
2021-01-01,PER,Kelantan,0,0,0
2021-01-01,PER,Pahang,0,0,0
2021-01-01,PER,Perak,0,0,0
2021-01-01,PER,Perlis,0,0,0
2021-01-01,PER,Pulau Pinang,0,0,0
2021-01-01,PER,Sabah,0,0,0
2021-01-01,PER,Sarawak,0,0,0
2021-01-01,PER,Selangor,1,1,0
2021-01-01,PER,W.P. Labuan,0,0,0
2021-01-01,PHL,Johor,57,56,1
2021-01-01,PHL,Kedah,0,0,0
2021-01-01,PHL,Kelantan,0,0,0
2021-01-01,PHL,Melaka,0,0,0
2021-01-01,PHL,Negeri Sembilan,0,0,0
2021-01-01,PHL,Pahang,0,0,0
2021-01-01,PHL,Perak,1,0,1
2021-01-01,PHL,Perlis,0,0,0
2021-01-01,PHL,Pulau Pinang,3,1,2
2021-01-01,PHL,Sabah,3,3,0
2021-01-01,PHL,Sarawak,56,55,1
2021-01-01,PHL,Selangor,436,357,79
2021-01-01,PHL,Terengganu,0,0,0
2021-01-01,PHL,W.P. Labuan,2,2,0
2021-01-01,PLW,Johor,0,0,0
2021-01-01,PLW,Pulau Pinang,0,0,0
2021-01-01,PLW,Selangor,0,0,0
2021-01-01,PNG,Johor,0,0,0
2021-01-01,PNG,Kedah,0,0,0
2021-01-01,PNG,Kelantan,0,0,0
2021-01-01,PNG,Perak,0,0,0
2021-01-01,PNG,Pulau Pinang,0,0,0
2021-01-01,PNG,Sabah,0,0,0
2021-01-01,PNG,Sarawak,0,0,0
2021-01-01,PNG,Selangor,2,2,0
2021-01-01,POL,Johor,1,1,0
2021-01-01,POL,Kedah,0,0,0
2021-01-01,POL,Kelantan,0,0,0
2021-01-01,POL,Melaka,0,0,0
2021-01-01,POL,Negeri Sembilan,0,0,0
2021-01-01,POL,Pahang,0,0,0
2021-01-01,POL,Perak,0,0,0
2021-01-01,POL,Perlis,0,0,0
2021-01-01,POL,Pulau Pinang,0,0,0
2021-01-01,POL,Sabah,0,0,0
2021-01-01,POL,Sarawak,0,0,0
2021-01-01,POL,Selangor,28,25,3
2021-01-01,POL,Terengganu,0,0,0
2021-01-01,POL,W.P. Labuan,0,0,0
2021-01-01,PRK,Selangor,0,0,0
2021-01-01,PRT,Johor,0,0,0
2021-01-01,PRT,Kedah,0,0,0
2021-01-01,PRT,Kelantan,0,0,0
2021-01-01,PRT,Melaka,0,0,0
2021-01-01,PRT,Pahang,0,0,0
2021-01-01,PRT,Perak,0,0,0
2021-01-01,PRT,Perlis,0,0,0
2021-01-01,PRT,Pulau Pinang,0,0,0
2021-01-01,PRT,Sabah,0,0,0
2021-01-01,PRT,Sarawak,0,0,0
2021-01-01,PRT,Selangor,13,7,6
2021-01-01,PRT,W.P. Labuan,0,0,0
2021-01-01,PRY,Johor,0,0,0
2021-01-01,PRY,Kedah,0,0,0
2021-01-01,PRY,Perak,0,0,0
2021-01-01,PRY,Perlis,0,0,0
2021-01-01,PRY,Pulau Pinang,0,0,0
2021-01-01,PRY,Sabah,0,0,0
2021-01-01,PRY,Sarawak,0,0,0
2021-01-01,PRY,Selangor,0,0,0
2021-01-01,PSE,Johor,0,0,0
2021-01-01,PSE,Kedah,0,0,0
2021-01-01,PSE,Kelantan,0,0,0
2021-01-01,PSE,Melaka,0,0,0
2021-01-01,PSE,Perak,0,0,0
2021-01-01,PSE,Perlis,0,0,0
2021-01-01,PSE,Pulau Pinang,0,0,0
2021-01-01,PSE,Sabah,0,0,0
2021-01-01,PSE,Sarawak,0,0,0
2021-01-01,PSE,Selangor,9,8,1
2021-01-01,QAT,Johor,0,0,0
2021-01-01,QAT,Kedah,0,0,0
2021-01-01,QAT,Perlis,0,0,0
2021-01-01,QAT,Pulau Pinang,0,0,0
2021-01-01,QAT,Sabah,0,0,0
2021-01-01,QAT,Sarawak,0,0,0
2021-01-01,QAT,Selangor,5,2,3
2021-01-01,REU,Johor,0,0,0
2021-01-01,REU,Sarawak,0,0,0
2021-01-01,ROU,Johor,3,3,0
2021-01-01,ROU,Kedah,0,0,0
2021-01-01,ROU,Kelantan,0,0,0
2021-01-01,ROU,Negeri Sembilan,0,0,0
2021-01-01,ROU,Pahang,0,0,0
2021-01-01,ROU,Perak,0,0,0
2021-01-01,ROU,Perlis,0,0,0
2021-01-01,ROU,Pulau Pinang,0,0,0
2021-01-01,ROU,Sabah,0,0,0
2021-01-01,ROU,Sarawak,0,0,0
2021-01-01,ROU,Selangor,20,18,2
2021-01-01,ROU,W.P. Labuan,0,0,0
2021-01-01,RUS,Johor,4,4,0
2021-01-01,RUS,Kedah,0,0,0
2021-01-01,RUS,Kelantan,0,0,0
2021-01-01,RUS,Melaka,0,0,0
2021-01-01,RUS,Negeri Sembilan,0,0,0
2021-01-01,RUS,Pahang,0,0,0
2021-01-01,RUS,Perak,0,0,0
2021-01-01,RUS,Perlis,0,0,0
2021-01-01,RUS,Pulau Pinang,0,0,0
2021-01-01,RUS,Sabah,0,0,0
2021-01-01,RUS,Sarawak,0,0,0
2021-01-01,RUS,Selangor,47,40,7
2021-01-01,RUS,W.P. Labuan,0,0,0
2021-01-01,RWA,Johor,0,0,0
2021-01-01,RWA,Kedah,0,0,0
2021-01-01,RWA,Pulau Pinang,0,0,0
2021-01-01,RWA,Selangor,0,0,0
2021-01-01,SAU,Johor,0,0,0
2021-01-01,SAU,Kedah,0,0,0
2021-01-01,SAU,Kelantan,0,0,0
2021-01-01,SAU,Melaka,0,0,0
2021-01-01,SAU,Perak,0,0,0
2021-01-01,SAU,Perlis,0,0,0
2021-01-01,SAU,Pulau Pinang,0,0,0
2021-01-01,SAU,Sabah,0,0,0
2021-01-01,SAU,Sarawak,0,0,0
2021-01-01,SAU,Selangor,52,28,24
2021-01-01,SAU,W.P. Labuan,0,0,0
2021-01-01,SDN,Johor,0,0,0
2021-01-01,SDN,Kedah,0,0,0
2021-01-01,SDN,Kelantan,0,0,0
2021-01-01,SDN,Perlis,0,0,0
2021-01-01,SDN,Pulau Pinang,0,0,0
2021-01-01,SDN,Sabah,0,0,0
2021-01-01,SDN,Sarawak,0,0,0
2021-01-01,SDN,Selangor,23,21,2
2021-01-01,SDN,W.P. Labuan,0,0,0
2021-01-01,SEN,Johor,0,0,0
2021-01-01,SEN,Kedah,0,0,0
2021-01-01,SEN,Kelantan,0,0,0
2021-01-01,SEN,Perak,0,0,0
2021-01-01,SEN,Perlis,0,0,0
2021-01-01,SEN,Pulau Pinang,0,0,0
2021-01-01,SEN,Sabah,0,0,0
2021-01-01,SEN,Sarawak,0,0,0
2021-01-01,SEN,Selangor,2,1,1
2021-01-01,SGP,Johor,271,232,39
2021-01-01,SGP,Kedah,3,3,0
2021-01-01,SGP,Kelantan,0,0,0
2021-01-01,SGP,Melaka,0,0,0
2021-01-01,SGP,Negeri Sembilan,0,0,0
2021-01-01,SGP,Pahang,0,0,0
2021-01-01,SGP,Perak,2,1,1
2021-01-01,SGP,Perlis,3,3,0
2021-01-01,SGP,Pulau Pinang,11,3,8
2021-01-01,SGP,Sabah,0,0,0
2021-01-01,SGP,Sarawak,18,5,13
2021-01-01,SGP,Selangor,131,81,50
2021-01-01,SGP,Terengganu,0,0,0
2021-01-01,SGP,W.P. Labuan,0,0,0
2021-01-01,SGS,Johor,0,0,0
2021-01-01,SGS,Sabah,0,0,0
2021-01-01,SGS,Selangor,0,0,0
2021-01-01,SHN,Sarawak,0,0,0
2021-01-01,SLB,Johor,0,0,0
2021-01-01,SLB,Perlis,0,0,0
2021-01-01,SLB,Pulau Pinang,0,0,0
2021-01-01,SLB,Sabah,0,0,0
2021-01-01,SLB,Sarawak,0,0,0
2021-01-01,SLB,Selangor,0,0,0
2021-01-01,SLB,W.P. Labuan,0,0,0
2021-01-01,SLE,Johor,0,0,0
2021-01-01,SLE,Kedah,0,0,0
2021-01-01,SLE,Perak,0,0,0
2021-01-01,SLE,Pulau Pinang,0,0,0
2021-01-01,SLE,Sabah,0,0,0
2021-01-01,SLE,Selangor,1,1,0
2021-01-01,SLV,Johor,0,0,0
2021-01-01,SLV,Kedah,0,0,0
2021-01-01,SLV,Perak,0,0,0
2021-01-01,SLV,Perlis,0,0,0
2021-01-01,SLV,Pulau Pinang,0,0,0
2021-01-01,SLV,Sabah,0,0,0
2021-01-01,SLV,Selangor,0,0,0
2021-01-01,SLV,W.P. Labuan,0,0,0
2021-01-01,SMR,Johor,0,0,0
2021-01-01,SMR,Selangor,1,1,0
2021-01-01,SOM,Johor,0,0,0
2021-01-01,SOM,Kedah,0,0,0
2021-01-01,SOM,Kelantan,0,0,0
2021-01-01,SOM,Perlis,0,0,0
2021-01-01,SOM,Sabah,0,0,0
2021-01-01,SOM,Sarawak,0,0,0
2021-01-01,SOM,Selangor,3,2,1
2021-01-01,SRB,Johor,0,0,0
2021-01-01,SRB,Kedah,0,0,0
2021-01-01,SRB,Kelantan,0,0,0
2021-01-01,SRB,Pahang,0,0,0
2021-01-01,SRB,Perak,0,0,0
2021-01-01,SRB,Perlis,0,0,0
2021-01-01,SRB,Pulau Pinang,0,0,0
2021-01-01,SRB,Sabah,0,0,0
2021-01-01,SRB,Sarawak,0,0,0
2021-01-01,SRB,Selangor,3,2,1
2021-01-01,SSD,Johor,0,0,0
2021-01-01,SSD,Kedah,0,0,0
2021-01-01,SSD,Sarawak,0,0,0
2021-01-01,SSD,Selangor,1,0,1
2021-01-01,SSD,W.P. Labuan,0,0,0
2021-01-01,STP,Selangor,2,2,0
2021-01-01,SUR,Johor,0,0,0
2021-01-01,SUR,Kedah,0,0,0
2021-01-01,SUR,Kelantan,0,0,0
2021-01-01,SUR,Perak,0,0,0
2021-01-01,SUR,Perlis,0,0,0
2021-01-01,SUR,Pulau Pinang,0,0,0
2021-01-01,SUR,Sabah,0,0,0
2021-01-01,SUR,Sarawak,0,0,0
2021-01-01,SUR,Selangor,0,0,0
2021-01-01,SVK,Johor,0,0,0
2021-01-01,SVK,Kedah,0,0,0
2021-01-01,SVK,Kelantan,0,0,0
2021-01-01,SVK,Negeri Sembilan,0,0,0
2021-01-01,SVK,Pahang,0,0,0
2021-01-01,SVK,Perak,0,0,0
2021-01-01,SVK,Perlis,0,0,0
2021-01-01,SVK,Pulau Pinang,0,0,0
2021-01-01,SVK,Sabah,0,0,0
2021-01-01,SVK,Sarawak,0,0,0
2021-01-01,SVK,Selangor,9,8,1
2021-01-01,SVK,W.P. Labuan,0,0,0
2021-01-01,SVN,Johor,0,0,0
2021-01-01,SVN,Kedah,0,0,0
2021-01-01,SVN,Kelantan,0,0,0
2021-01-01,SVN,Perak,0,0,0
2021-01-01,SVN,Perlis,0,0,0
2021-01-01,SVN,Pulau Pinang,0,0,0
2021-01-01,SVN,Sabah,0,0,0
2021-01-01,SVN,Sarawak,0,0,0
2021-01-01,SVN,Selangor,2,1,1
2021-01-01,SVN,W.P. Labuan,0,0,0
2021-01-01,SWE,Johor,0,0,0
2021-01-01,SWE,Kedah,0,0,0
2021-01-01,SWE,Kelantan,0,0,0
2021-01-01,SWE,Melaka,0,0,0
2021-01-01,SWE,Negeri Sembilan,0,0,0
2021-01-01,SWE,Pahang,0,0,0
2021-01-01,SWE,Perak,0,0,0
2021-01-01,SWE,Perlis,0,0,0
2021-01-01,SWE,Pulau Pinang,1,1,0
2021-01-01,SWE,Sabah,0,0,0
2021-01-01,SWE,Sarawak,0,0,0
2021-01-01,SWE,Selangor,29,25,4
2021-01-01,SWE,W.P. Labuan,0,0,0
2021-01-01,SWZ,Johor,0,0,0
2021-01-01,SWZ,Kedah,0,0,0
2021-01-01,SWZ,Pulau Pinang,0,0,0
2021-01-01,SWZ,Sabah,0,0,0
2021-01-01,SWZ,Selangor,5,2,3
2021-01-01,SYC,Johor,0,0,0
2021-01-01,SYC,Kedah,0,0,0
2021-01-01,SYC,Pulau Pinang,0,0,0
2021-01-01,SYC,Sabah,0,0,0
2021-01-01,SYC,Sarawak,0,0,0
2021-01-01,SYC,Selangor,2,0,2
2021-01-01,SYR,Johor,0,0,0
2021-01-01,SYR,Kedah,0,0,0
2021-01-01,SYR,Kelantan,0,0,0
2021-01-01,SYR,Pahang,0,0,0
2021-01-01,SYR,Perlis,0,0,0
2021-01-01,SYR,Pulau Pinang,0,0,0
2021-01-01,SYR,Sabah,0,0,0
2021-01-01,SYR,Sarawak,0,0,0
2021-01-01,SYR,Selangor,10,5,5
2021-01-01,SYR,W.P. Labuan,0,0,0
2021-01-01,TCA,Perlis,0,0,0
2021-01-01,TCD,Johor,0,0,0
2021-01-01,TCD,Kedah,0,0,0
2021-01-01,TCD,Perlis,0,0,0
2021-01-01,TCD,Selangor,0,0,0
2021-01-01,TGO,Johor,0,0,0
2021-01-01,TGO,Perak,0,0,0
2021-01-01,TGO,Pulau Pinang,0,0,0
2021-01-01,TGO,Selangor,0,0,0
2021-01-01,THA,Johor,0,0,0
2021-01-01,THA,Kedah,17920,17905,15
2021-01-01,THA,Kelantan,0,0,0
2021-01-01,THA,Melaka,0,0,0
2021-01-01,THA,Negeri Sembilan,0,0,0
2021-01-01,THA,Pahang,0,0,0
2021-01-01,THA,Perak,0,0,0
2021-01-01,THA,Perlis,9926,9477,449
2021-01-01,THA,Pulau Pinang,4,2,2
2021-01-01,THA,Sabah,0,0,0
2021-01-01,THA,Sarawak,11,11,0
2021-01-01,THA,Selangor,93,38,55
2021-01-01,THA,Terengganu,7,7,0
2021-01-01,THA,W.P. Labuan,0,0,0
2021-01-01,TJK,Johor,0,0,0
2021-01-01,TJK,Kedah,0,0,0
2021-01-01,TJK,Perlis,0,0,0
2021-01-01,TJK,Pulau Pinang,0,0,0
2021-01-01,TJK,Sabah,0,0,0
2021-01-01,TJK,Selangor,0,0,0
2021-01-01,TKL,Selangor,0,0,0
2021-01-01,TKM,Johor,0,0,0
2021-01-01,TKM,Kedah,0,0,0
2021-01-01,TKM,Kelantan,0,0,0
2021-01-01,TKM,Perlis,0,0,0
2021-01-01,TKM,Pulau Pinang,0,0,0
2021-01-01,TKM,Sabah,0,0,0
2021-01-01,TKM,Sarawak,0,0,0
2021-01-01,TKM,Selangor,0,0,0
2021-01-01,TLS,Johor,0,0,0
2021-01-01,TLS,Kedah,0,0,0
2021-01-01,TLS,Perlis,0,0,0
2021-01-01,TLS,Pulau Pinang,0,0,0
2021-01-01,TLS,Sabah,0,0,0
2021-01-01,TLS,Sarawak,0,0,0
2021-01-01,TLS,Selangor,0,0,0
2021-01-01,TON,Johor,0,0,0
2021-01-01,TON,Pulau Pinang,0,0,0
2021-01-01,TON,Sarawak,0,0,0
2021-01-01,TON,Selangor,0,0,0
2021-01-01,TTO,Johor,0,0,0
2021-01-01,TTO,Kedah,0,0,0
2021-01-01,TTO,Pahang,0,0,0
2021-01-01,TTO,Pulau Pinang,0,0,0
2021-01-01,TTO,Sabah,0,0,0
2021-01-01,TTO,Sarawak,0,0,0
2021-01-01,TTO,Selangor,3,1,2
2021-01-01,TUN,Johor,0,0,0
2021-01-01,TUN,Kedah,0,0,0
2021-01-01,TUN,Kelantan,0,0,0
2021-01-01,TUN,Melaka,0,0,0
2021-01-01,TUN,Perak,0,0,0
2021-01-01,TUN,Perlis,0,0,0
2021-01-01,TUN,Pulau Pinang,0,0,0
2021-01-01,TUN,Sabah,0,0,0
2021-01-01,TUN,Sarawak,0,0,0
2021-01-01,TUN,Selangor,4,2,2
2021-01-01,TUN,W.P. Labuan,0,0,0
2021-01-01,TUR,Johor,0,0,0
2021-01-01,TUR,Kedah,0,0,0
2021-01-01,TUR,Kelantan,0,0,0
2021-01-01,TUR,Melaka,0,0,0
2021-01-01,TUR,Negeri Sembilan,0,0,0
2021-01-01,TUR,Pahang,0,0,0
2021-01-01,TUR,Perak,0,0,0
2021-01-01,TUR,Perlis,0,0,0
2021-01-01,TUR,Pulau Pinang,0,0,0
2021-01-01,TUR,Sabah,0,0,0
2021-01-01,TUR,Sarawak,0,0,0
2021-01-01,TUR,Selangor,18,15,3
2021-01-01,TUR,W.P. Labuan,0,0,0
2021-01-01,TUV,Selangor,0,0,0
2021-01-01,TWN,Johor,1,1,0
2021-01-01,TWN,Kedah,0,0,0
2021-01-01,TWN,Kelantan,0,0,0
2021-01-01,TWN,Melaka,0,0,0
2021-01-01,TWN,Negeri Sembilan,0,0,0
2021-01-01,TWN,Pahang,0,0,0
2021-01-01,TWN,Perak,0,0,0
2021-01-01,TWN,Perlis,0,0,0
2021-01-01,TWN,Pulau Pinang,8,3,5
2021-01-01,TWN,Sabah,0,0,0
2021-01-01,TWN,Sarawak,1,1,0
2021-01-01,TWN,Selangor,80,47,33
2021-01-01,TWN,W.P. Labuan,0,0,0
2021-01-01,TZA,Johor,0,0,0
2021-01-01,TZA,Kedah,0,0,0
2021-01-01,TZA,Perak,0,0,0
2021-01-01,TZA,Perlis,0,0,0
2021-01-01,TZA,Pulau Pinang,0,0,0
2021-01-01,TZA,Sabah,0,0,0
2021-01-01,TZA,Sarawak,0,0,0
2021-01-01,TZA,Selangor,7,2,5
2021-01-01,UGA,Johor,0,0,0
2021-01-01,UGA,Kedah,0,0,0
2021-01-01,UGA,Perak,0,0,0
2021-01-01,UGA,Perlis,0,0,0
2021-01-01,UGA,Pulau Pinang,0,0,0
2021-01-01,UGA,Sabah,0,0,0
2021-01-01,UGA,Sarawak,0,0,0
2021-01-01,UGA,Selangor,3,3,0
2021-01-01,UKR,Johor,13,13,0
2021-01-01,UKR,Kedah,0,0,0
2021-01-01,UKR,Kelantan,0,0,0
2021-01-01,UKR,Melaka,0,0,0
2021-01-01,UKR,Negeri Sembilan,0,0,0
2021-01-01,UKR,Pahang,0,0,0
2021-01-01,UKR,Perak,0,0,0
2021-01-01,UKR,Perlis,0,0,0
2021-01-01,UKR,Pulau Pinang,0,0,0
2021-01-01,UKR,Sabah,0,0,0
2021-01-01,UKR,Sarawak,0,0,0
2021-01-01,UKR,Selangor,80,71,9
2021-01-01,UKR,W.P. Labuan,0,0,0
2021-01-01,URY,Johor,0,0,0
2021-01-01,URY,Kedah,0,0,0
2021-01-01,URY,Kelantan,0,0,0
2021-01-01,URY,Perak,0,0,0
2021-01-01,URY,Perlis,0,0,0
2021-01-01,URY,Pulau Pinang,0,0,0
2021-01-01,URY,Sabah,0,0,0
2021-01-01,URY,Sarawak,0,0,0
2021-01-01,URY,Selangor,0,0,0
2021-01-01,URY,W.P. Labuan,0,0,0
2021-01-01,USA,Johor,5,5,0
2021-01-01,USA,Kedah,0,0,0
2021-01-01,USA,Kelantan,0,0,0
2021-01-01,USA,Melaka,0,0,0
2021-01-01,USA,Negeri Sembilan,0,0,0
2021-01-01,USA,Pahang,0,0,0
2021-01-01,USA,Perak,4,2,2
2021-01-01,USA,Perlis,0,0,0
2021-01-01,USA,Pulau Pinang,2,1,1
2021-01-01,USA,Sabah,1,1,0
2021-01-01,USA,Sarawak,0,0,0
2021-01-01,USA,Selangor,176,131,45
2021-01-01,USA,Terengganu,0,0,0
2021-01-01,USA,W.P. Labuan,0,0,0
2021-01-01,UZB,Johor,0,0,0
2021-01-01,UZB,Kedah,0,0,0
2021-01-01,UZB,Kelantan,0,0,0
2021-01-01,UZB,Perak,0,0,0
2021-01-01,UZB,Perlis,0,0,0
2021-01-01,UZB,Pulau Pinang,0,0,0
2021-01-01,UZB,Sabah,0,0,0
2021-01-01,UZB,Sarawak,0,0,0
2021-01-01,UZB,Selangor,14,7,7
2021-01-01,VAT,Johor,0,0,0
2021-01-01,VAT,Sarawak,0,0,0
2021-01-01,VAT,Selangor,1,1,0
2021-01-01,VCT,Johor,0,0,0
2021-01-01,VCT,Kedah,0,0,0
2021-01-01,VCT,Pulau Pinang,0,0,0
2021-01-01,VCT,Sarawak,0,0,0
2021-01-01,VCT,Selangor,0,0,0
2021-01-01,VEN,Johor,0,0,0
2021-01-01,VEN,Kedah,0,0,0
2021-01-01,VEN,Kelantan,0,0,0
2021-01-01,VEN,Melaka,0,0,0
2021-01-01,VEN,Perak,0,0,0
2021-01-01,VEN,Perlis,0,0,0
2021-01-01,VEN,Pulau Pinang,0,0,0
2021-01-01,VEN,Sabah,0,0,0
2021-01-01,VEN,Sarawak,0,0,0
2021-01-01,VEN,Selangor,4,4,0
2021-01-01,VEN,W.P. Labuan,0,0,0
2021-01-01,VNM,Johor,3,0,3
2021-01-01,VNM,Kedah,0,0,0
2021-01-01,VNM,Kelantan,0,0,0
2021-01-01,VNM,Melaka,0,0,0
2021-01-01,VNM,Negeri Sembilan,0,0,0
2021-01-01,VNM,Pahang,0,0,0
2021-01-01,VNM,Perak,0,0,0
2021-01-01,VNM,Perlis,0,0,0
2021-01-01,VNM,Pulau Pinang,1,0,1
2021-01-01,VNM,Sabah,0,0,0
2021-01-01,VNM,Sarawak,0,0,0
2021-01-01,VNM,Selangor,93,23,70
2021-01-01,VNM,Terengganu,6,6,0
2021-01-01,VNM,W.P. Labuan,0,0,0
2021-01-01,VUT,Johor,0,0,0
2021-01-01,VUT,Kedah,0,0,0
2021-01-01,VUT,Pulau Pinang,0,0,0
2021-01-01,VUT,Sabah,0,0,0
2021-01-01,VUT,Sarawak,0,0,0
2021-01-01,VUT,Selangor,0,0,0
2021-01-01,WSM,Johor,0,0,0
2021-01-01,WSM,Sarawak,0,0,0
2021-01-01,WSM,Selangor,0,0,0
2021-01-01,XXX,Johor,0,0,0
2021-01-01,XXX,Kedah,0,0,0
2021-01-01,XXX,Kelantan,0,0,0
2021-01-01,XXX,Melaka,0,0,0
2021-01-01,XXX,Pahang,0,0,0
2021-01-01,XXX,Perak,0,0,0
2021-01-01,XXX,Perlis,0,0,0
2021-01-01,XXX,Pulau Pinang,2,1,1
2021-01-01,XXX,Sabah,0,0,0
2021-01-01,XXX,Sarawak,0,0,0
2021-01-01,XXX,Selangor,18,10,8
2021-01-01,XXX,W.P. Labuan,0,0,0
2021-01-01,YEM,Johor,0,0,0
2021-01-01,YEM,Kedah,0,0,0
2021-01-01,YEM,Kelantan,0,0,0
2021-01-01,YEM,Melaka,0,0,0
2021-01-01,YEM,Pahang,0,0,0
2021-01-01,YEM,Perak,0,0,0
2021-01-01,YEM,Perlis,0,0,0
2021-01-01,YEM,Pulau Pinang,0,0,0
2021-01-01,YEM,Sabah,0,0,0
2021-01-01,YEM,Sarawak,0,0,0
2021-01-01,YEM,Selangor,23,19,4
2021-01-01,YEM,W.P. Labuan,0,0,0
2021-01-01,ZAF,Johor,2,2,0
2021-01-01,ZAF,Kedah,0,0,0
2021-01-01,ZAF,Kelantan,0,0,0
2021-01-01,ZAF,Melaka,0,0,0
2021-01-01,ZAF,Pahang,0,0,0
2021-01-01,ZAF,Perak,0,0,0
2021-01-01,ZAF,Perlis,0,0,0
2021-01-01,ZAF,Pulau Pinang,0,0,0
2021-01-01,ZAF,Sabah,0,0,0
2021-01-01,ZAF,Sarawak,0,0,0
2021-01-01,ZAF,Selangor,26,19,7
2021-01-01,ZAF,Terengganu,0,0,0
2021-01-01,ZAF,W.P. Labuan,0,0,0
2021-01-01,ZAR,Selangor,0,0,0
2021-01-01,ZMB,Johor,0,0,0
2021-01-01,ZMB,Kedah,0,0,0
2021-01-01,ZMB,Perak,0,0,0
2021-01-01,ZMB,Perlis,0,0,0
2021-01-01,ZMB,Pulau Pinang,0,0,0
2021-01-01,ZMB,Sabah,0,0,0
2021-01-01,ZMB,Sarawak,0,0,0
2021-01-01,ZMB,Selangor,5,4,1
2021-01-01,ZWE,Johor,0,0,0
2021-01-01,ZWE,Kedah,0,0,0
2021-01-01,ZWE,Kelantan,0,0,0
2021-01-01,ZWE,Perak,0,0,0
2021-01-01,ZWE,Perlis,0,0,0
2021-01-01,ZWE,Pulau Pinang,0,0,0
2021-01-01,ZWE,Sabah,0,0,0
2021-01-01,ZWE,Sarawak,0,0,0
2021-01-01,ZWE,Selangor,1,1,0
2021-02-01,ABW,Kedah,0,0,0
2021-02-01,ABW,Pulau Pinang,0,0,0
2021-02-01,AFG,Johor,0,0,0
2021-02-01,AFG,Kedah,0,0,0
2021-02-01,AFG,Perlis,0,0,0
2021-02-01,AFG,Pulau Pinang,0,0,0
2021-02-01,AFG,Sarawak,0,0,0
2021-02-01,AFG,Selangor,17,15,2
2021-02-01,AGO,Johor,0,0,0
2021-02-01,AGO,Kedah,0,0,0
2021-02-01,AGO,Sabah,0,0,0
2021-02-01,AGO,Selangor,0,0,0
2021-02-01,AIA,Selangor,0,0,0
2021-02-01,ALB,Johor,0,0,0
2021-02-01,ALB,Kedah,0,0,0
2021-02-01,ALB,Perak,0,0,0
2021-02-01,ALB,Perlis,0,0,0
2021-02-01,ALB,Pulau Pinang,0,0,0
2021-02-01,ALB,Sabah,0,0,0
2021-02-01,ALB,Sarawak,0,0,0
2021-02-01,ALB,Selangor,0,0,0
2021-02-01,AND,Johor,0,0,0
2021-02-01,AND,Kedah,0,0,0
2021-02-01,AND,Perlis,0,0,0
2021-02-01,AND,Pulau Pinang,0,0,0
2021-02-01,AND,Selangor,0,0,0
2021-02-01,ANT,Selangor,0,0,0
2021-02-01,ARE,Johor,0,0,0
2021-02-01,ARE,Kedah,0,0,0
2021-02-01,ARE,Kelantan,0,0,0
2021-02-01,ARE,Perak,0,0,0
2021-02-01,ARE,Perlis,0,0,0
2021-02-01,ARE,Pulau Pinang,0,0,0
2021-02-01,ARE,Sabah,0,0,0
2021-02-01,ARE,Sarawak,0,0,0
2021-02-01,ARE,Selangor,2,1,1
2021-02-01,ARG,Johor,0,0,0
2021-02-01,ARG,Kedah,0,0,0
2021-02-01,ARG,Kelantan,0,0,0
2021-02-01,ARG,Melaka,0,0,0
2021-02-01,ARG,Perak,0,0,0
2021-02-01,ARG,Perlis,0,0,0
2021-02-01,ARG,Pulau Pinang,0,0,0
2021-02-01,ARG,Sabah,0,0,0
2021-02-01,ARG,Sarawak,0,0,0
2021-02-01,ARG,Selangor,4,4,0
2021-02-01,ARG,W.P. Labuan,0,0,0
2021-02-01,ARM,Johor,0,0,0
2021-02-01,ARM,Kedah,0,0,0
2021-02-01,ARM,Kelantan,0,0,0
2021-02-01,ARM,Perak,0,0,0
2021-02-01,ARM,Perlis,0,0,0
2021-02-01,ARM,Pulau Pinang,1,0,1
2021-02-01,ARM,Sabah,0,0,0
2021-02-01,ARM,Sarawak,0,0,0
2021-02-01,ARM,Selangor,0,0,0
2021-02-01,ATA,Selangor,0,0,0
2021-02-01,ATG,Johor,0,0,0
2021-02-01,ATG,Kedah,0,0,0
2021-02-01,ATG,Pulau Pinang,0,0,0
2021-02-01,ATG,Sarawak,0,0,0
2021-02-01,ATG,Selangor,0,0,0
2021-02-01,AUS,Johor,1,1,0
2021-02-01,AUS,Kedah,0,0,0
2021-02-01,AUS,Kelantan,0,0,0
2021-02-01,AUS,Melaka,0,0,0
2021-02-01,AUS,Negeri Sembilan,0,0,0
2021-02-01,AUS,Pahang,0,0,0
2021-02-01,AUS,Perak,2,1,1
2021-02-01,AUS,Perlis,0,0,0
2021-02-01,AUS,Pulau Pinang,4,3,1
2021-02-01,AUS,Sabah,0,0,0
2021-02-01,AUS,Sarawak,0,0,0
2021-02-01,AUS,Selangor,80,50,30
2021-02-01,AUS,Terengganu,0,0,0
2021-02-01,AUS,W.P. Labuan,0,0,0
2021-02-01,AUT,Johor,0,0,0
2021-02-01,AUT,Kedah,0,0,0
2021-02-01,AUT,Kelantan,0,0,0
2021-02-01,AUT,Melaka,0,0,0
2021-02-01,AUT,Negeri Sembilan,0,0,0
2021-02-01,AUT,Pahang,0,0,0
2021-02-01,AUT,Perak,0,0,0
2021-02-01,AUT,Perlis,0,0,0
2021-02-01,AUT,Pulau Pinang,0,0,0
2021-02-01,AUT,Sabah,0,0,0
2021-02-01,AUT,Sarawak,0,0,0
2021-02-01,AUT,Selangor,13,13,0
2021-02-01,AUT,Terengganu,0,0,0
2021-02-01,AUT,W.P. Labuan,0,0,0
2021-02-01,AZE,Johor,0,0,0
2021-02-01,AZE,Kedah,0,0,0
2021-02-01,AZE,Kelantan,0,0,0
2021-02-01,AZE,Melaka,0,0,0
2021-02-01,AZE,Perlis,0,0,0
2021-02-01,AZE,Pulau Pinang,0,0,0
2021-02-01,AZE,Sabah,0,0,0
2021-02-01,AZE,Sarawak,0,0,0
2021-02-01,AZE,Selangor,0,0,0
2021-02-01,AZE,W.P. Labuan,0,0,0
2021-02-01,BDI,Pulau Pinang,0,0,0
2021-02-01,BDI,Sarawak,0,0,0
2021-02-01,BDI,Selangor,0,0,0
2021-02-01,BEL,Johor,0,0,0
2021-02-01,BEL,Kedah,0,0,0
2021-02-01,BEL,Kelantan,0,0,0
2021-02-01,BEL,Melaka,0,0,0
2021-02-01,BEL,Negeri Sembilan,0,0,0
2021-02-01,BEL,Pahang,0,0,0
2021-02-01,BEL,Perak,0,0,0
2021-02-01,BEL,Perlis,0,0,0
2021-02-01,BEL,Pulau Pinang,0,0,0
2021-02-01,BEL,Sabah,0,0,0
2021-02-01,BEL,Sarawak,0,0,0
2021-02-01,BEL,Selangor,13,9,4
2021-02-01,BEL,W.P. Labuan,0,0,0
2021-02-01,BEN,Johor,0,0,0
2021-02-01,BEN,Kedah,0,0,0
2021-02-01,BEN,Perak,0,0,0
2021-02-01,BEN,Pulau Pinang,0,0,0
2021-02-01,BEN,Sabah,0,0,0
2021-02-01,BEN,Sarawak,0,0,0
2021-02-01,BEN,Selangor,0,0,0
2021-02-01,BFA,Perak,0,0,0
2021-02-01,BFA,Pulau Pinang,0,0,0
2021-02-01,BFA,Selangor,0,0,0
2021-02-01,BGD,Johor,4,4,0
2021-02-01,BGD,Kedah,0,0,0
2021-02-01,BGD,Kelantan,0,0,0
2021-02-01,BGD,Melaka,0,0,0
2021-02-01,BGD,Negeri Sembilan,0,0,0
2021-02-01,BGD,Pahang,0,0,0
2021-02-01,BGD,Perak,0,0,0
2021-02-01,BGD,Perlis,0,0,0
2021-02-01,BGD,Pulau Pinang,0,0,0
2021-02-01,BGD,Sabah,0,0,0
2021-02-01,BGD,Sarawak,0,0,0
2021-02-01,BGD,Selangor,143,101,42
2021-02-01,BGD,W.P. Labuan,0,0,0
2021-02-01,BGR,Johor,0,0,0
2021-02-01,BGR,Kedah,0,0,0
2021-02-01,BGR,Kelantan,0,0,0
2021-02-01,BGR,Pahang,0,0,0
2021-02-01,BGR,Perak,0,0,0
2021-02-01,BGR,Perlis,0,0,0
2021-02-01,BGR,Pulau Pinang,0,0,0
2021-02-01,BGR,Sabah,0,0,0
2021-02-01,BGR,Sarawak,0,0,0
2021-02-01,BGR,Selangor,18,18,0
2021-02-01,BGR,W.P. Labuan,0,0,0
2021-02-01,BHR,Johor,0,0,0
2021-02-01,BHR,Kedah,0,0,0
2021-02-01,BHR,Kelantan,0,0,0
2021-02-01,BHR,Perlis,0,0,0
2021-02-01,BHR,Pulau Pinang,0,0,0
2021-02-01,BHR,Sabah,0,0,0
2021-02-01,BHR,Sarawak,0,0,0
2021-02-01,BHR,Selangor,1,1,0
2021-02-01,BHS,Johor,0,0,0
2021-02-01,BHS,Kedah,0,0,0
2021-02-01,BHS,Perak,0,0,0
2021-02-01,BHS,Sabah,0,0,0
2021-02-01,BHS,Sarawak,0,0,0
2021-02-01,BHS,Selangor,0,0,0
2021-02-01,BIH,Johor,0,0,0
2021-02-01,BIH,Kedah,0,0,0
2021-02-01,BIH,Perlis,0,0,0
2021-02-01,BIH,Pulau Pinang,0,0,0
2021-02-01,BIH,Sabah,0,0,0
2021-02-01,BIH,Sarawak,0,0,0
2021-02-01,BIH,Selangor,1,0,1
2021-02-01,BLR,Johor,0,0,0
2021-02-01,BLR,Kedah,0,0,0
2021-02-01,BLR,Kelantan,0,0,0
2021-02-01,BLR,Pahang,0,0,0
2021-02-01,BLR,Perak,0,0,0
2021-02-01,BLR,Perlis,0,0,0
2021-02-01,BLR,Pulau Pinang,0,0,0
2021-02-01,BLR,Sabah,0,0,0
2021-02-01,BLR,Sarawak,0,0,0
2021-02-01,BLR,Selangor,0,0,0
2021-02-01,BLR,W.P. Labuan,0,0,0
2021-02-01,BLZ,Johor,0,0,0
2021-02-01,BLZ,Pulau Pinang,0,0,0
2021-02-01,BLZ,Sarawak,0,0,0
2021-02-01,BLZ,Selangor,0,0,0
2021-02-01,BMU,Selangor,0,0,0
2021-02-01,BOL,Johor,0,0,0
2021-02-01,BOL,Kedah,0,0,0
2021-02-01,BOL,Melaka,0,0,0
2021-02-01,BOL,Perak,0,0,0
2021-02-01,BOL,Perlis,0,0,0
2021-02-01,BOL,Pulau Pinang,0,0,0
2021-02-01,BOL,Sabah,0,0,0
2021-02-01,BOL,Sarawak,0,0,0
2021-02-01,BOL,Selangor,0,0,0
2021-02-01,BRA,Johor,12,12,0
2021-02-01,BRA,Kedah,0,0,0
2021-02-01,BRA,Kelantan,0,0,0
2021-02-01,BRA,Melaka,0,0,0
2021-02-01,BRA,Pahang,0,0,0
2021-02-01,BRA,Perak,0,0,0
2021-02-01,BRA,Perlis,0,0,0
2021-02-01,BRA,Pulau Pinang,0,0,0
2021-02-01,BRA,Sabah,0,0,0
2021-02-01,BRA,Sarawak,0,0,0
2021-02-01,BRA,Selangor,30,20,10
2021-02-01,BRA,W.P. Labuan,0,0,0
2021-02-01,BRB,Johor,0,0,0
2021-02-01,BRB,Kedah,0,0,0
2021-02-01,BRB,Perlis,0,0,0
2021-02-01,BRB,Pulau Pinang,0,0,0
2021-02-01,BRB,Selangor,0,0,0
2021-02-01,BRN,Johor,0,0,0
2021-02-01,BRN,Kedah,0,0,0
2021-02-01,BRN,Kelantan,0,0,0
2021-02-01,BRN,Melaka,0,0,0
2021-02-01,BRN,Pahang,0,0,0
2021-02-01,BRN,Perak,0,0,0
2021-02-01,BRN,Perlis,0,0,0
2021-02-01,BRN,Pulau Pinang,0,0,0
2021-02-01,BRN,Sabah,0,0,0
2021-02-01,BRN,Sarawak,355,347,8
2021-02-01,BRN,Selangor,6,4,2
2021-02-01,BRN,W.P. Labuan,1,1,0
2021-02-01,BTN,Johor,0,0,0
2021-02-01,BTN,Kedah,0,0,0
2021-02-01,BTN,Perak,0,0,0
2021-02-01,BTN,Perlis,0,0,0
2021-02-01,BTN,Pulau Pinang,0,0,0
2021-02-01,BTN,Sabah,0,0,0
2021-02-01,BTN,Sarawak,0,0,0
2021-02-01,BTN,Selangor,2,0,2
2021-02-01,BWA,Johor,0,0,0
2021-02-01,BWA,Kedah,0,0,0
2021-02-01,BWA,Perlis,0,0,0
2021-02-01,BWA,Pulau Pinang,0,0,0
2021-02-01,BWA,Sabah,0,0,0
2021-02-01,BWA,Sarawak,0,0,0
2021-02-01,BWA,Selangor,0,0,0
2021-02-01,CAF,Kedah,0,0,0
2021-02-01,CAF,Selangor,0,0,0
2021-02-01,CAN,Johor,0,0,0
2021-02-01,CAN,Kedah,0,0,0
2021-02-01,CAN,Kelantan,0,0,0
2021-02-01,CAN,Melaka,0,0,0
2021-02-01,CAN,Negeri Sembilan,0,0,0
2021-02-01,CAN,Pahang,0,0,0
2021-02-01,CAN,Perak,0,0,0
2021-02-01,CAN,Perlis,0,0,0
2021-02-01,CAN,Pulau Pinang,1,1,0
2021-02-01,CAN,Sabah,0,0,0
2021-02-01,CAN,Sarawak,0,0,0
2021-02-01,CAN,Selangor,31,24,7
2021-02-01,CAN,Terengganu,0,0,0
2021-02-01,CAN,W.P. Labuan,0,0,0
2021-02-01,CCK,Selangor,0,0,0
2021-02-01,CHE,Johor,0,0,0
2021-02-01,CHE,Kedah,0,0,0
2021-02-01,CHE,Kelantan,0,0,0
2021-02-01,CHE,Melaka,0,0,0
2021-02-01,CHE,Negeri Sembilan,0,0,0
2021-02-01,CHE,Pahang,0,0,0
2021-02-01,CHE,Perak,0,0,0
2021-02-01,CHE,Perlis,0,0,0
2021-02-01,CHE,Pulau Pinang,0,0,0
2021-02-01,CHE,Sabah,0,0,0
2021-02-01,CHE,Sarawak,0,0,0
2021-02-01,CHE,Selangor,9,5,4
2021-02-01,CHE,W.P. Labuan,0,0,0
2021-02-01,CHL,Johor,0,0,0
2021-02-01,CHL,Kedah,0,0,0
2021-02-01,CHL,Kelantan,0,0,0
2021-02-01,CHL,Melaka,0,0,0
2021-02-01,CHL,Pahang,0,0,0
2021-02-01,CHL,Perak,0,0,0
2021-02-01,CHL,Perlis,0,0,0
2021-02-01,CHL,Pulau Pinang,0,0,0
2021-02-01,CHL,Sabah,0,0,0
2021-02-01,CHL,Sarawak,0,0,0
2021-02-01,CHL,Selangor,2,1,1
2021-02-01,CHN,Johor,32,17,15
2021-02-01,CHN,Kedah,0,0,0
2021-02-01,CHN,Kelantan,0,0,0
2021-02-01,CHN,Melaka,0,0,0
2021-02-01,CHN,Pahang,0,0,0
2021-02-01,CHN,Perak,0,0,0
2021-02-01,CHN,Perlis,0,0,0
2021-02-01,CHN,Pulau Pinang,6,1,5
2021-02-01,CHN,Sabah,0,0,0
2021-02-01,CHN,Sarawak,48,46,2
2021-02-01,CHN,Selangor,768,623,145
2021-02-01,CHN,Terengganu,0,0,0
2021-02-01,CHN,W.P. Labuan,0,0,0
2021-02-01,CIV,Johor,0,0,0
2021-02-01,CIV,Kedah,0,0,0
2021-02-01,CIV,Pulau Pinang,0,0,0
2021-02-01,CIV,Sabah,0,0,0
2021-02-01,CIV,Sarawak,0,0,0
2021-02-01,CIV,Selangor,0,0,0
2021-02-01,CMR,Johor,0,0,0
2021-02-01,CMR,Kedah,0,0,0
2021-02-01,CMR,Pulau Pinang,0,0,0
2021-02-01,CMR,Sabah,0,0,0
2021-02-01,CMR,Sarawak,0,0,0
2021-02-01,CMR,Selangor,2,2,0
2021-02-01,COD,Johor,0,0,0
2021-02-01,COD,Pulau Pinang,0,0,0
2021-02-01,COD,Sarawak,0,0,0
2021-02-01,COD,Selangor,0,0,0
2021-02-01,COG,Johor,0,0,0
2021-02-01,COG,Kedah,0,0,0
2021-02-01,COG,Selangor,0,0,0
2021-02-01,COK,Selangor,0,0,0
2021-02-01,COL,Johor,0,0,0
2021-02-01,COL,Kedah,0,0,0
2021-02-01,COL,Perak,0,0,0
2021-02-01,COL,Pulau Pinang,0,0,0
2021-02-01,COL,Sabah,0,0,0
2021-02-01,COL,Sarawak,0,0,0
2021-02-01,COL,Selangor,5,3,2
2021-02-01,COL,W.P. Labuan,0,0,0
2021-02-01,COM,Johor,0,0,0
2021-02-01,COM,Kedah,0,0,0
2021-02-01,COM,Selangor,3,2,1
2021-02-01,CPV,Johor,0,0,0
2021-02-01,CPV,Kedah,0,0,0
2021-02-01,CPV,Pulau Pinang,0,0,0
2021-02-01,CPV,Sabah,0,0,0
2021-02-01,CPV,Selangor,0,0,0
2021-02-01,CRI,Johor,0,0,0
2021-02-01,CRI,Kedah,0,0,0
2021-02-01,CRI,Perak,0,0,0
2021-02-01,CRI,Perlis,0,0,0
2021-02-01,CRI,Pulau Pinang,0,0,0
2021-02-01,CRI,Sabah,0,0,0
2021-02-01,CRI,Sarawak,0,0,0
2021-02-01,CRI,Selangor,18,14,4
2021-02-01,CUB,Johor,0,0,0
2021-02-01,CUB,Kedah,0,0,0
2021-02-01,CUB,Perlis,0,0,0
2021-02-01,CUB,Pulau Pinang,0,0,0
2021-02-01,CUB,Sabah,0,0,0
2021-02-01,CUB,Sarawak,0,0,0
2021-02-01,CUB,Selangor,0,0,0
2021-02-01,CYP,Johor,0,0,0
2021-02-01,CYP,Kedah,0,0,0
2021-02-01,CYP,Perak,0,0,0
2021-02-01,CYP,Perlis,0,0,0
2021-02-01,CYP,Pulau Pinang,0,0,0
2021-02-01,CYP,Sabah,0,0,0
2021-02-01,CYP,Sarawak,0,0,0
2021-02-01,CYP,Selangor,3,2,1
2021-02-01,CZE,Johor,2,2,0
2021-02-01,CZE,Kedah,0,0,0
2021-02-01,CZE,Kelantan,0,0,0
2021-02-01,CZE,Melaka,0,0,0
2021-02-01,CZE,Negeri Sembilan,0,0,0
2021-02-01,CZE,Perak,0,0,0
2021-02-01,CZE,Perlis,0,0,0
2021-02-01,CZE,Pulau Pinang,0,0,0
2021-02-01,CZE,Sabah,0,0,0
2021-02-01,CZE,Sarawak,0,0,0
2021-02-01,CZE,Selangor,4,4,0
2021-02-01,CZE,W.P. Labuan,0,0,0
2021-02-01,DEU,Johor,0,0,0
2021-02-01,DEU,Kedah,0,0,0
2021-02-01,DEU,Kelantan,0,0,0
2021-02-01,DEU,Melaka,0,0,0
2021-02-01,DEU,Negeri Sembilan,0,0,0
2021-02-01,DEU,Pahang,0,0,0
2021-02-01,DEU,Perak,0,0,0
2021-02-01,DEU,Perlis,0,0,0
2021-02-01,DEU,Pulau Pinang,1,1,0
2021-02-01,DEU,Sabah,0,0,0
2021-02-01,DEU,Sarawak,0,0,0
2021-02-01,DEU,Selangor,65,56,9
2021-02-01,DEU,Terengganu,0,0,0
2021-02-01,DEU,W.P. Labuan,0,0,0
2021-02-01,DJI,Johor,0,0,0
2021-02-01,DJI,Selangor,0,0,0
2021-02-01,DMA,Johor,0,0,0
2021-02-01,DMA,Kedah,0,0,0
2021-02-01,DMA,Pulau Pinang,0,0,0
2021-02-01,DMA,Sabah,0,0,0
2021-02-01,DMA,Sarawak,0,0,0
2021-02-01,DMA,Selangor,1,1,0
2021-02-01,DMA,W.P. Labuan,0,0,0
2021-02-01,DNK,Johor,9,9,0
2021-02-01,DNK,Kedah,0,0,0
2021-02-01,DNK,Kelantan,0,0,0
2021-02-01,DNK,Melaka,0,0,0
2021-02-01,DNK,Negeri Sembilan,0,0,0
2021-02-01,DNK,Pahang,0,0,0
2021-02-01,DNK,Perak,0,0,0
2021-02-01,DNK,Perlis,0,0,0
2021-02-01,DNK,Pulau Pinang,0,0,0
2021-02-01,DNK,Sabah,0,0,0
2021-02-01,DNK,Sarawak,0,0,0
2021-02-01,DNK,Selangor,8,8,0
2021-02-01,DNK,W.P. Labuan,0,0,0
2021-02-01,DOM,Johor,0,0,0
2021-02-01,DOM,Kedah,0,0,0
2021-02-01,DOM,Perak,0,0,0
2021-02-01,DOM,Perlis,0,0,0
2021-02-01,DOM,Pulau Pinang,0,0,0
2021-02-01,DOM,Sabah,0,0,0
2021-02-01,DOM,Sarawak,0,0,0
2021-02-01,DOM,Selangor,0,0,0
2021-02-01,DZA,Johor,0,0,0
2021-02-01,DZA,Kedah,0,0,0
2021-02-01,DZA,Kelantan,0,0,0
2021-02-01,DZA,Melaka,0,0,0
2021-02-01,DZA,Perak,0,0,0
2021-02-01,DZA,Perlis,0,0,0
2021-02-01,DZA,Pulau Pinang,0,0,0
2021-02-01,DZA,Sabah,0,0,0
2021-02-01,DZA,Sarawak,0,0,0
2021-02-01,DZA,Selangor,4,3,1
2021-02-01,DZA,W.P. Labuan,0,0,0
2021-02-01,ECU,Johor,0,0,0
2021-02-01,ECU,Kedah,0,0,0
2021-02-01,ECU,Perak,0,0,0
2021-02-01,ECU,Perlis,0,0,0
2021-02-01,ECU,Pulau Pinang,0,0,0
2021-02-01,ECU,Sabah,0,0,0
2021-02-01,ECU,Sarawak,0,0,0
2021-02-01,ECU,Selangor,0,0,0
2021-02-01,EGY,Johor,0,0,0
2021-02-01,EGY,Kedah,0,0,0
2021-02-01,EGY,Kelantan,0,0,0
2021-02-01,EGY,Melaka,0,0,0
2021-02-01,EGY,Pahang,0,0,0
2021-02-01,EGY,Perak,0,0,0
2021-02-01,EGY,Perlis,0,0,0
2021-02-01,EGY,Pulau Pinang,0,0,0
2021-02-01,EGY,Sabah,0,0,0
2021-02-01,EGY,Sarawak,0,0,0
2021-02-01,EGY,Selangor,56,44,12
2021-02-01,EGY,Terengganu,0,0,0
2021-02-01,EGY,W.P. Labuan,0,0,0
2021-02-01,ERI,Johor,0,0,0
2021-02-01,ERI,Pulau Pinang,0,0,0
2021-02-01,ERI,Sabah,0,0,0
2021-02-01,ERI,Selangor,1,1,0
2021-02-01,ESP,Johor,2,2,0
2021-02-01,ESP,Kedah,0,0,0
2021-02-01,ESP,Kelantan,0,0,0
2021-02-01,ESP,Melaka,0,0,0
2021-02-01,ESP,Negeri Sembilan,0,0,0
2021-02-01,ESP,Pahang,0,0,0
2021-02-01,ESP,Perak,0,0,0
2021-02-01,ESP,Perlis,0,0,0
2021-02-01,ESP,Pulau Pinang,0,0,0
2021-02-01,ESP,Sabah,0,0,0
2021-02-01,ESP,Sarawak,0,0,0
2021-02-01,ESP,Selangor,16,13,3
2021-02-01,ESP,W.P. Labuan,0,0,0
2021-02-01,EST,Johor,0,0,0
2021-02-01,EST,Kedah,0,0,0
2021-02-01,EST,Kelantan,0,0,0
2021-02-01,EST,Pahang,0,0,0
2021-02-01,EST,Perak,0,0,0
2021-02-01,EST,Perlis,0,0,0
2021-02-01,EST,Pulau Pinang,0,0,0
2021-02-01,EST,Sabah,0,0,0
2021-02-01,EST,Sarawak,0,0,0
2021-02-01,EST,Selangor,0,0,0
2021-02-01,EST,W.P. Labuan,0,0,0
2021-02-01,ETH,Johor,0,0,0
2021-02-01,ETH,Kedah,0,0,0
2021-02-01,ETH,Pulau Pinang,0,0,0
2021-02-01,ETH,Sarawak,0,0,0
2021-02-01,ETH,Selangor,0,0,0
2021-02-01,FIN,Johor,0,0,0
2021-02-01,FIN,Kedah,0,0,0
2021-02-01,FIN,Kelantan,0,0,0
2021-02-01,FIN,Melaka,0,0,0
2021-02-01,FIN,Negeri Sembilan,0,0,0
2021-02-01,FIN,Pahang,0,0,0
2021-02-01,FIN,Perak,0,0,0
2021-02-01,FIN,Perlis,0,0,0
2021-02-01,FIN,Pulau Pinang,0,0,0
2021-02-01,FIN,Sabah,0,0,0
2021-02-01,FIN,Sarawak,0,0,0
2021-02-01,FIN,Selangor,12,8,4
2021-02-01,FIN,W.P. Labuan,0,0,0
2021-02-01,FJI,Johor,0,0,0
2021-02-01,FJI,Kedah,0,0,0
2021-02-01,FJI,Kelantan,0,0,0
2021-02-01,FJI,Perak,0,0,0
2021-02-01,FJI,Perlis,0,0,0
2021-02-01,FJI,Pulau Pinang,0,0,0
2021-02-01,FJI,Sabah,0,0,0
2021-02-01,FJI,Sarawak,0,0,0
2021-02-01,FJI,Selangor,0,0,0
2021-02-01,FRA,Johor,0,0,0
2021-02-01,FRA,Kedah,0,0,0
2021-02-01,FRA,Kelantan,0,0,0
2021-02-01,FRA,Melaka,0,0,0
2021-02-01,FRA,Negeri Sembilan,0,0,0
2021-02-01,FRA,Pahang,0,0,0
2021-02-01,FRA,Perak,0,0,0
2021-02-01,FRA,Perlis,0,0,0
2021-02-01,FRA,Pulau Pinang,0,0,0
2021-02-01,FRA,Sabah,0,0,0
2021-02-01,FRA,Sarawak,0,0,0
2021-02-01,FRA,Selangor,52,38,14
2021-02-01,FRA,Terengganu,0,0,0
2021-02-01,FRA,W.P. Labuan,0,0,0
2021-02-01,FSM,Johor,0,0,0
2021-02-01,FSM,Pulau Pinang,0,0,0
2021-02-01,FSM,Selangor,0,0,0
2021-02-01,GAB,Johor,0,0,0
2021-02-01,GAB,Pulau Pinang,0,0,0
2021-02-01,GAB,Sarawak,0,0,0
2021-02-01,GAB,Selangor,0,0,0
2021-02-01,GBR,Johor,3,3,0
2021-02-01,GBR,Kedah,0,0,0
2021-02-01,GBR,Kelantan,0,0,0
2021-02-01,GBR,Melaka,0,0,0
2021-02-01,GBR,Negeri Sembilan,0,0,0
2021-02-01,GBR,Pahang,0,0,0
2021-02-01,GBR,Perak,0,0,0
2021-02-01,GBR,Perlis,0,0,0
2021-02-01,GBR,Pulau Pinang,2,2,0
2021-02-01,GBR,Sabah,0,0,0
2021-02-01,GBR,Sarawak,3,2,1
2021-02-01,GBR,Selangor,248,218,30
2021-02-01,GBR,Terengganu,0,0,0
2021-02-01,GBR,W.P. Labuan,0,0,0
2021-02-01,GEO,Johor,0,0,0
2021-02-01,GEO,Kedah,0,0,0
2021-02-01,GEO,Melaka,0,0,0
2021-02-01,GEO,Perak,0,0,0
2021-02-01,GEO,Perlis,0,0,0
2021-02-01,GEO,Pulau Pinang,0,0,0
2021-02-01,GEO,Sabah,0,0,0
2021-02-01,GEO,Sarawak,0,0,0
2021-02-01,GEO,Selangor,1,1,0
2021-02-01,GHA,Johor,1,1,0
2021-02-01,GHA,Kedah,0,0,0
2021-02-01,GHA,Kelantan,0,0,0
2021-02-01,GHA,Pulau Pinang,0,0,0
2021-02-01,GHA,Sabah,0,0,0
2021-02-01,GHA,Sarawak,0,0,0
2021-02-01,GHA,Selangor,8,8,0
2021-02-01,GIB,Johor,0,0,0
2021-02-01,GIB,Sarawak,0,0,0
2021-02-01,GIN,Johor,0,0,0
2021-02-01,GIN,Kedah,0,0,0
2021-02-01,GIN,Kelantan,0,0,0
2021-02-01,GIN,Perlis,0,0,0
2021-02-01,GIN,Pulau Pinang,0,0,0
2021-02-01,GIN,Sabah,0,0,0
2021-02-01,GIN,Sarawak,0,0,0
2021-02-01,GIN,Selangor,10,5,5
2021-02-01,GLP,Selangor,0,0,0
2021-02-01,GMB,Johor,0,0,0
2021-02-01,GMB,Kedah,0,0,0
2021-02-01,GMB,Kelantan,0,0,0
2021-02-01,GMB,Pulau Pinang,0,0,0
2021-02-01,GMB,Sabah,0,0,0
2021-02-01,GMB,Sarawak,0,0,0
2021-02-01,GMB,Selangor,0,0,0
2021-02-01,GNB,Johor,0,0,0
2021-02-01,GNB,Selangor,0,0,0
2021-02-01,GNQ,Johor,0,0,0
2021-02-01,GNQ,Selangor,0,0,0
2021-02-01,GRC,Johor,0,0,0
2021-02-01,GRC,Kedah,0,0,0
2021-02-01,GRC,Kelantan,0,0,0
2021-02-01,GRC,Melaka,0,0,0
2021-02-01,GRC,Negeri Sembilan,0,0,0
2021-02-01,GRC,Pahang,0,0,0
2021-02-01,GRC,Perak,0,0,0
2021-02-01,GRC,Perlis,0,0,0
2021-02-01,GRC,Pulau Pinang,0,0,0
2021-02-01,GRC,Sabah,0,0,0
2021-02-01,GRC,Sarawak,0,0,0
2021-02-01,GRC,Selangor,6,5,1
2021-02-01,GRD,Johor,0,0,0
2021-02-01,GRD,Kedah,0,0,0
2021-02-01,GRD,Pulau Pinang,0,0,0
2021-02-01,GRD,Sabah,0,0,0
2021-02-01,GRD,Sarawak,0,0,0
2021-02-01,GRD,Selangor,0,0,0
2021-02-01,GRL,Johor,0,0,0
2021-02-01,GRL,Selangor,0,0,0
2021-02-01,GTM,Johor,0,0,0
2021-02-01,GTM,Kedah,0,0,0
2021-02-01,GTM,Pahang,0,0,0
2021-02-01,GTM,Perak,0,0,0
2021-02-01,GTM,Pulau Pinang,0,0,0
2021-02-01,GTM,Sabah,0,0,0
2021-02-01,GTM,Sarawak,0,0,0
2021-02-01,GTM,Selangor,0,0,0
2021-02-01,GTM,W.P. Labuan,0,0,0
2021-02-01,GUY,Johor,0,0,0
2021-02-01,GUY,Kedah,0,0,0
2021-02-01,GUY,Pulau Pinang,0,0,0
2021-02-01,GUY,Sarawak,0,0,0
2021-02-01,GUY,Selangor,0,0,0
2021-02-01,HKG,Johor,0,0,0
2021-02-01,HKG,Kedah,0,0,0
2021-02-01,HKG,Kelantan,0,0,0
2021-02-01,HKG,Pahang,0,0,0
2021-02-01,HKG,Perak,1,0,1
2021-02-01,HKG,Perlis,0,0,0
2021-02-01,HKG,Pulau Pinang,0,0,0
2021-02-01,HKG,Sabah,0,0,0
2021-02-01,HKG,Sarawak,0,0,0
2021-02-01,HKG,Selangor,2,2,0
2021-02-01,HKG,Terengganu,0,0,0
2021-02-01,HMD,Johor,0,0,0
2021-02-01,HND,Johor,0,0,0
2021-02-01,HND,Kedah,0,0,0
2021-02-01,HND,Perak,0,0,0
2021-02-01,HND,Pulau Pinang,0,0,0
2021-02-01,HND,Sabah,0,0,0
2021-02-01,HND,Sarawak,0,0,0
2021-02-01,HND,Selangor,1,1,0
2021-02-01,HRV,Johor,3,3,0
2021-02-01,HRV,Kedah,0,0,0
2021-02-01,HRV,Kelantan,0,0,0
2021-02-01,HRV,Melaka,0,0,0
2021-02-01,HRV,Pahang,0,0,0
2021-02-01,HRV,Perak,0,0,0
2021-02-01,HRV,Perlis,0,0,0
2021-02-01,HRV,Pulau Pinang,0,0,0
2021-02-01,HRV,Sabah,0,0,0
2021-02-01,HRV,Sarawak,0,0,0
2021-02-01,HRV,Selangor,60,59,1
2021-02-01,HTI,Johor,0,0,0
2021-02-01,HTI,Kedah,0,0,0
2021-02-01,HTI,Kelantan,0,0,0
2021-02-01,HTI,Perak,0,0,0
2021-02-01,HTI,Pulau Pinang,0,0,0
2021-02-01,HTI,Sabah,0,0,0
2021-02-01,HTI,Selangor,1,1,0
2021-02-01,HUN,Johor,0,0,0
2021-02-01,HUN,Kedah,0,0,0
2021-02-01,HUN,Kelantan,0,0,0
2021-02-01,HUN,Pahang,0,0,0
2021-02-01,HUN,Perak,0,0,0
2021-02-01,HUN,Perlis,0,0,0
2021-02-01,HUN,Pulau Pinang,0,0,0
2021-02-01,HUN,Sabah,0,0,0
2021-02-01,HUN,Sarawak,0,0,0
2021-02-01,HUN,Selangor,1,0,1
2021-02-01,HUN,W.P. Labuan,0,0,0
2021-02-01,IDN,Johor,228,188,40
2021-02-01,IDN,Kedah,1,1,0
2021-02-01,IDN,Kelantan,0,0,0
2021-02-01,IDN,Melaka,0,0,0
2021-02-01,IDN,Negeri Sembilan,0,0,0
2021-02-01,IDN,Pahang,0,0,0
2021-02-01,IDN,Perak,0,0,0
2021-02-01,IDN,Perlis,9,9,0
2021-02-01,IDN,Pulau Pinang,18,9,9
2021-02-01,IDN,Sabah,12,5,7
2021-02-01,IDN,Sarawak,285,284,1
2021-02-01,IDN,Selangor,676,468,208
2021-02-01,IDN,Terengganu,0,0,0
2021-02-01,IDN,W.P. Labuan,0,0,0
2021-02-01,IND,Johor,85,82,3
2021-02-01,IND,Kedah,0,0,0
2021-02-01,IND,Kelantan,0,0,0
2021-02-01,IND,Melaka,0,0,0
2021-02-01,IND,Negeri Sembilan,0,0,0
2021-02-01,IND,Pahang,0,0,0
2021-02-01,IND,Perak,0,0,0
2021-02-01,IND,Perlis,0,0,0
2021-02-01,IND,Pulau Pinang,0,0,0
2021-02-01,IND,Sabah,0,0,0
2021-02-01,IND,Sarawak,0,0,0
2021-02-01,IND,Selangor,876,692,184
2021-02-01,IND,Terengganu,0,0,0
2021-02-01,IND,W.P. Labuan,0,0,0
2021-02-01,IOT,Pulau Pinang,0,0,0
2021-02-01,IOT,Selangor,0,0,0
2021-02-01,IRL,Johor,0,0,0
2021-02-01,IRL,Kedah,0,0,0
2021-02-01,IRL,Kelantan,0,0,0
2021-02-01,IRL,Negeri Sembilan,0,0,0
2021-02-01,IRL,Pahang,0,0,0
2021-02-01,IRL,Perak,0,0,0
2021-02-01,IRL,Perlis,0,0,0
2021-02-01,IRL,Pulau Pinang,0,0,0
2021-02-01,IRL,Sabah,0,0,0
2021-02-01,IRL,Sarawak,0,0,0
2021-02-01,IRL,Selangor,3,3,0
2021-02-01,IRL,Terengganu,0,0,0
2021-02-01,IRL,W.P. Labuan,0,0,0
2021-02-01,IRN,Johor,1,1,0
2021-02-01,IRN,Kedah,0,0,0
2021-02-01,IRN,Kelantan,0,0,0
2021-02-01,IRN,Perak,0,0,0
2021-02-01,IRN,Perlis,0,0,0
2021-02-01,IRN,Pulau Pinang,0,0,0
2021-02-01,IRN,Sabah,0,0,0
2021-02-01,IRN,Sarawak,0,0,0
2021-02-01,IRN,Selangor,75,66,9
2021-02-01,IRN,W.P. Labuan,0,0,0
2021-02-01,IRQ,Johor,0,0,0
2021-02-01,IRQ,Kedah,0,0,0
2021-02-01,IRQ,Kelantan,0,0,0
2021-02-01,IRQ,Melaka,0,0,0
2021-02-01,IRQ,Pahang,0,0,0
2021-02-01,IRQ,Perak,0,0,0
2021-02-01,IRQ,Perlis,0,0,0
2021-02-01,IRQ,Pulau Pinang,0,0,0
2021-02-01,IRQ,Sabah,0,0,0
2021-02-01,IRQ,Sarawak,0,0,0
2021-02-01,IRQ,Selangor,29,22,7
2021-02-01,ISL,Johor,0,0,0
2021-02-01,ISL,Kedah,0,0,0
2021-02-01,ISL,Kelantan,0,0,0
2021-02-01,ISL,Perak,0,0,0
2021-02-01,ISL,Perlis,0,0,0
2021-02-01,ISL,Pulau Pinang,0,0,0
2021-02-01,ISL,Sabah,0,0,0
2021-02-01,ISL,Sarawak,0,0,0
2021-02-01,ISL,Selangor,0,0,0
2021-02-01,ISL,W.P. Labuan,0,0,0
2021-02-01,ISR,Pulau Pinang,0,0,0
2021-02-01,ITA,Johor,1,1,0
2021-02-01,ITA,Kedah,0,0,0
2021-02-01,ITA,Kelantan,0,0,0
2021-02-01,ITA,Melaka,0,0,0
2021-02-01,ITA,Negeri Sembilan,0,0,0
2021-02-01,ITA,Pahang,0,0,0
2021-02-01,ITA,Perak,0,0,0
2021-02-01,ITA,Perlis,0,0,0
2021-02-01,ITA,Pulau Pinang,0,0,0
2021-02-01,ITA,Sabah,0,0,0
2021-02-01,ITA,Sarawak,0,0,0
2021-02-01,ITA,Selangor,42,39,3
2021-02-01,ITA,W.P. Labuan,0,0,0
2021-02-01,JAM,Johor,0,0,0
2021-02-01,JAM,Kedah,0,0,0
2021-02-01,JAM,Perak,0,0,0
2021-02-01,JAM,Pulau Pinang,0,0,0
2021-02-01,JAM,Sabah,0,0,0
2021-02-01,JAM,Sarawak,0,0,0
2021-02-01,JAM,Selangor,1,0,1
2021-02-01,JAM,W.P. Labuan,0,0,0
2021-02-01,JOR,Johor,0,0,0
2021-02-01,JOR,Kedah,0,0,0
2021-02-01,JOR,Kelantan,0,0,0
2021-02-01,JOR,Melaka,0,0,0
2021-02-01,JOR,Perlis,0,0,0
2021-02-01,JOR,Pulau Pinang,0,0,0
2021-02-01,JOR,Sabah,0,0,0
2021-02-01,JOR,Sarawak,0,0,0
2021-02-01,JOR,Selangor,23,21,2
2021-02-01,JOR,W.P. Labuan,0,0,0
2021-02-01,JPN,Johor,1,1,0
2021-02-01,JPN,Kedah,0,0,0
2021-02-01,JPN,Kelantan,0,0,0
2021-02-01,JPN,Melaka,0,0,0
2021-02-01,JPN,Negeri Sembilan,0,0,0
2021-02-01,JPN,Pahang,0,0,0
2021-02-01,JPN,Perak,0,0,0
2021-02-01,JPN,Perlis,0,0,0
2021-02-01,JPN,Pulau Pinang,13,11,2
2021-02-01,JPN,Sabah,0,0,0
2021-02-01,JPN,Sarawak,9,9,0
2021-02-01,JPN,Selangor,336,228,108
2021-02-01,JPN,W.P. Labuan,0,0,0
2021-02-01,KAZ,Johor,0,0,0
2021-02-01,KAZ,Kedah,0,0,0
2021-02-01,KAZ,Kelantan,0,0,0
2021-02-01,KAZ,Melaka,0,0,0
2021-02-01,KAZ,Perak,0,0,0
2021-02-01,KAZ,Perlis,0,0,0
2021-02-01,KAZ,Pulau Pinang,0,0,0
2021-02-01,KAZ,Sabah,0,0,0
2021-02-01,KAZ,Sarawak,0,0,0
2021-02-01,KAZ,Selangor,20,10,10
2021-02-01,KAZ,W.P. Labuan,0,0,0
2021-02-01,KEN,Johor,0,0,0
2021-02-01,KEN,Kedah,0,0,0
2021-02-01,KEN,Kelantan,0,0,0
2021-02-01,KEN,Perak,0,0,0
2021-02-01,KEN,Perlis,0,0,0
2021-02-01,KEN,Pulau Pinang,0,0,0
2021-02-01,KEN,Sabah,0,0,0
2021-02-01,KEN,Sarawak,0,0,0
2021-02-01,KEN,Selangor,8,5,3
2021-02-01,KGZ,Johor,0,0,0
2021-02-01,KGZ,Kedah,0,0,0
2021-02-01,KGZ,Kelantan,0,0,0
2021-02-01,KGZ,Perak,0,0,0
2021-02-01,KGZ,Perlis,0,0,0
2021-02-01,KGZ,Pulau Pinang,0,0,0
2021-02-01,KGZ,Sabah,0,0,0
2021-02-01,KGZ,Sarawak,0,0,0
2021-02-01,KGZ,Selangor,2,2,0
2021-02-01,KHM,Johor,0,0,0
2021-02-01,KHM,Kedah,0,0,0
2021-02-01,KHM,Kelantan,0,0,0
2021-02-01,KHM,Melaka,0,0,0
2021-02-01,KHM,Negeri Sembilan,0,0,0
2021-02-01,KHM,Pahang,0,0,0
2021-02-01,KHM,Perak,0,0,0
2021-02-01,KHM,Perlis,0,0,0
2021-02-01,KHM,Pulau Pinang,0,0,0
2021-02-01,KHM,Sabah,0,0,0
2021-02-01,KHM,Sarawak,0,0,0
2021-02-01,KHM,Selangor,2,0,2
2021-02-01,KHM,W.P. Labuan,0,0,0
2021-02-01,KIR,Johor,0,0,0
2021-02-01,KIR,Sabah,0,0,0
2021-02-01,KIR,Selangor,10,10,0
2021-02-01,KNA,Johor,0,0,0
2021-02-01,KNA,Kedah,0,0,0
2021-02-01,KNA,Perlis,0,0,0
2021-02-01,KNA,Pulau Pinang,0,0,0
2021-02-01,KNA,Sabah,0,0,0
2021-02-01,KNA,Selangor,1,1,0
2021-02-01,KNA,W.P. Labuan,0,0,0
2021-02-01,KOR,Johor,0,0,0
2021-02-01,KOR,Kedah,0,0,0
2021-02-01,KOR,Kelantan,0,0,0
2021-02-01,KOR,Melaka,0,0,0
2021-02-01,KOR,Negeri Sembilan,0,0,0
2021-02-01,KOR,Pahang,0,0,0
2021-02-01,KOR,Perak,0,0,0
2021-02-01,KOR,Perlis,0,0,0
2021-02-01,KOR,Pulau Pinang,2,1,1
2021-02-01,KOR,Sabah,1,1,0
2021-02-01,KOR,Sarawak,9,9,0
2021-02-01,KOR,Selangor,202,146,56
2021-02-01,KOR,Terengganu,0,0,0
2021-02-01,KOR,W.P. Labuan,0,0,0
2021-02-01,KWT,Johor,0,0,0
2021-02-01,KWT,Kedah,0,0,0
2021-02-01,KWT,Kelantan,0,0,0
2021-02-01,KWT,Perak,0,0,0
2021-02-01,KWT,Perlis,0,0,0
2021-02-01,KWT,Pulau Pinang,0,0,0
2021-02-01,KWT,Sabah,0,0,0
2021-02-01,KWT,Sarawak,0,0,0
2021-02-01,KWT,Selangor,5,3,2
2021-02-01,KWT,W.P. Labuan,0,0,0
2021-02-01,LAO,Johor,0,0,0
2021-02-01,LAO,Kedah,1,0,1
2021-02-01,LAO,Kelantan,0,0,0
2021-02-01,LAO,Melaka,0,0,0
2021-02-01,LAO,Perak,0,0,0
2021-02-01,LAO,Perlis,0,0,0
2021-02-01,LAO,Pulau Pinang,0,0,0
2021-02-01,LAO,Sabah,0,0,0
2021-02-01,LAO,Sarawak,0,0,0
2021-02-01,LAO,Selangor,0,0,0
2021-02-01,LAO,W.P. Labuan,0,0,0
2021-02-01,LBN,Johor,0,0,0
2021-02-01,LBN,Kedah,0,0,0
2021-02-01,LBN,Kelantan,0,0,0
2021-02-01,LBN,Pahang,0,0,0
2021-02-01,LBN,Perak,0,0,0
2021-02-01,LBN,Perlis,0,0,0
2021-02-01,LBN,Pulau Pinang,0,0,0
2021-02-01,LBN,Sabah,0,0,0
2021-02-01,LBN,Sarawak,0,0,0
2021-02-01,LBN,Selangor,2,1,1
2021-02-01,LBN,W.P. Labuan,0,0,0
2021-02-01,LBR,Johor,0,0,0
2021-02-01,LBR,Kedah,0,0,0
2021-02-01,LBR,Sabah,0,0,0
2021-02-01,LBR,Sarawak,0,0,0
2021-02-01,LBR,Selangor,0,0,0
2021-02-01,LBY,Johor,0,0,0
2021-02-01,LBY,Kedah,0,0,0
2021-02-01,LBY,Perlis,0,0,0
2021-02-01,LBY,Pulau Pinang,0,0,0
2021-02-01,LBY,Sabah,0,0,0
2021-02-01,LBY,Sarawak,0,0,0
2021-02-01,LBY,Selangor,8,8,0
2021-02-01,LCA,Johor,0,0,0
2021-02-01,LCA,Kedah,0,0,0
2021-02-01,LCA,Pulau Pinang,0,0,0
2021-02-01,LCA,Sarawak,0,0,0
2021-02-01,LCA,Selangor,0,0,0
2021-02-01,LIE,Johor,0,0,0
2021-02-01,LIE,Kedah,0,0,0
2021-02-01,LIE,Perlis,0,0,0
2021-02-01,LIE,Pulau Pinang,0,0,0
2021-02-01,LIE,Sabah,0,0,0
2021-02-01,LIE,Sarawak,0,0,0
2021-02-01,LIE,Selangor,0,0,0
2021-02-01,LKA,Johor,2,2,0
2021-02-01,LKA,Kedah,0,0,0
2021-02-01,LKA,Kelantan,0,0,0
2021-02-01,LKA,Melaka,0,0,0
2021-02-01,LKA,Pahang,0,0,0
2021-02-01,LKA,Perak,0,0,0
2021-02-01,LKA,Perlis,0,0,0
2021-02-01,LKA,Pulau Pinang,0,0,0
2021-02-01,LKA,Sabah,0,0,0
2021-02-01,LKA,Sarawak,0,0,0
2021-02-01,LKA,Selangor,80,51,29
2021-02-01,LKA,W.P. Labuan,0,0,0
2021-02-01,LSO,Johor,0,0,0
2021-02-01,LSO,Kedah,0,0,0
2021-02-01,LSO,Pulau Pinang,0,0,0
2021-02-01,LSO,Sarawak,0,0,0
2021-02-01,LSO,Selangor,0,0,0
2021-02-01,LTU,Johor,1,1,0
2021-02-01,LTU,Kedah,0,0,0
2021-02-01,LTU,Kelantan,0,0,0
2021-02-01,LTU,Pahang,0,0,0
2021-02-01,LTU,Perak,0,0,0
2021-02-01,LTU,Perlis,0,0,0
2021-02-01,LTU,Pulau Pinang,0,0,0
2021-02-01,LTU,Sabah,0,0,0
2021-02-01,LTU,Sarawak,0,0,0
2021-02-01,LTU,Selangor,2,2,0
2021-02-01,LTU,W.P. Labuan,0,0,0
2021-02-01,LUX,Johor,0,0,0
2021-02-01,LUX,Kedah,0,0,0
2021-02-01,LUX,Kelantan,0,0,0
2021-02-01,LUX,Perak,0,0,0
2021-02-01,LUX,Perlis,0,0,0
2021-02-01,LUX,Pulau Pinang,0,0,0
2021-02-01,LUX,Sabah,0,0,0
2021-02-01,LUX,Sarawak,0,0,0
2021-02-01,LUX,Selangor,2,1,1
2021-02-01,LVA,Johor,0,0,0
2021-02-01,LVA,Kedah,0,0,0
2021-02-01,LVA,Kelantan,0,0,0
2021-02-01,LVA,Pahang,0,0,0
2021-02-01,LVA,Perak,0,0,0
2021-02-01,LVA,Perlis,0,0,0
2021-02-01,LVA,Pulau Pinang,0,0,0
2021-02-01,LVA,Sabah,0,0,0
2021-02-01,LVA,Sarawak,0,0,0
2021-02-01,LVA,Selangor,8,7,1
2021-02-01,LVA,W.P. Labuan,0,0,0
2021-02-01,MAC,Johor,0,0,0
2021-02-01,MAC,Pahang,0,0,0
2021-02-01,MAC,Perak,0,0,0
2021-02-01,MAC,Selangor,0,0,0
2021-02-01,MAC,W.P. Labuan,0,0,0
2021-02-01,MAR,Johor,0,0,0
2021-02-01,MAR,Kedah,0,0,0
2021-02-01,MAR,Kelantan,0,0,0
2021-02-01,MAR,Melaka,0,0,0
2021-02-01,MAR,Pahang,0,0,0
2021-02-01,MAR,Perak,0,0,0
2021-02-01,MAR,Perlis,0,0,0
2021-02-01,MAR,Pulau Pinang,0,0,0
2021-02-01,MAR,Sabah,0,0,0
2021-02-01,MAR,Sarawak,0,0,0
2021-02-01,MAR,Selangor,3,1,2
2021-02-01,MAR,W.P. Labuan,0,0,0
2021-02-01,MCO,Johor,0,0,0
2021-02-01,MCO,Kedah,0,0,0
2021-02-01,MCO,Sabah,0,0,0
2021-02-01,MCO,Selangor,0,0,0
2021-02-01,MDA,Johor,0,0,0
2021-02-01,MDA,Kedah,0,0,0
2021-02-01,MDA,Kelantan,0,0,0
2021-02-01,MDA,Negeri Sembilan,0,0,0
2021-02-01,MDA,Perlis,0,0,0
2021-02-01,MDA,Pulau Pinang,0,0,0
2021-02-01,MDA,Sabah,0,0,0
2021-02-01,MDA,Sarawak,0,0,0
2021-02-01,MDA,Selangor,1,1,0
2021-02-01,MDG,Johor,0,0,0
2021-02-01,MDG,Kedah,0,0,0
2021-02-01,MDG,Perak,0,0,0
2021-02-01,MDG,Perlis,0,0,0
2021-02-01,MDG,Pulau Pinang,0,0,0
2021-02-01,MDG,Sabah,0,0,0
2021-02-01,MDG,Sarawak,0,0,0
2021-02-01,MDG,Selangor,0,0,0
2021-02-01,MDV,Johor,0,0,0
2021-02-01,MDV,Kedah,0,0,0
2021-02-01,MDV,Kelantan,0,0,0
2021-02-01,MDV,Perak,0,0,0
2021-02-01,MDV,Perlis,0,0,0
2021-02-01,MDV,Pulau Pinang,0,0,0
2021-02-01,MDV,Sabah,0,0,0
2021-02-01,MDV,Sarawak,0,0,0
2021-02-01,MDV,Selangor,54,27,27
2021-02-01,MEX,Johor,0,0,0
2021-02-01,MEX,Kedah,0,0,0
2021-02-01,MEX,Kelantan,0,0,0
2021-02-01,MEX,Pahang,0,0,0
2021-02-01,MEX,Perak,0,0,0
2021-02-01,MEX,Perlis,0,0,0
2021-02-01,MEX,Pulau Pinang,0,0,0
2021-02-01,MEX,Sabah,0,0,0
2021-02-01,MEX,Sarawak,0,0,0
2021-02-01,MEX,Selangor,3,2,1
2021-02-01,MEX,W.P. Labuan,0,0,0
2021-02-01,MHL,Johor,0,0,0
2021-02-01,MHL,Kedah,0,0,0
2021-02-01,MHL,Perak,0,0,0
2021-02-01,MHL,Pulau Pinang,0,0,0
2021-02-01,MHL,Sabah,0,0,0
2021-02-01,MHL,Selangor,0,0,0
2021-02-01,MKD,Johor,0,0,0
2021-02-01,MKD,Kedah,0,0,0
2021-02-01,MKD,Perak,0,0,0
2021-02-01,MKD,Pulau Pinang,0,0,0
2021-02-01,MKD,Sabah,0,0,0
2021-02-01,MKD,Sarawak,0,0,0
2021-02-01,MKD,Selangor,0,0,0
2021-02-01,MLI,Johor,0,0,0
2021-02-01,MLI,Sabah,0,0,0
2021-02-01,MLI,Selangor,0,0,0
2021-02-01,MLT,Johor,0,0,0
2021-02-01,MLT,Kedah,0,0,0
2021-02-01,MLT,Kelantan,0,0,0
2021-02-01,MLT,Perak,0,0,0
2021-02-01,MLT,Perlis,0,0,0
2021-02-01,MLT,Pulau Pinang,0,0,0
2021-02-01,MLT,Sabah,0,0,0
2021-02-01,MLT,Sarawak,0,0,0
2021-02-01,MLT,Selangor,1,1,0
2021-02-01,MLT,W.P. Labuan,0,0,0
2021-02-01,MMR,Johor,2,2,0
2021-02-01,MMR,Kedah,0,0,0
2021-02-01,MMR,Kelantan,0,0,0
2021-02-01,MMR,Negeri Sembilan,0,0,0
2021-02-01,MMR,Pahang,0,0,0
2021-02-01,MMR,Perak,0,0,0
2021-02-01,MMR,Perlis,0,0,0
2021-02-01,MMR,Pulau Pinang,0,0,0
2021-02-01,MMR,Sabah,0,0,0
2021-02-01,MMR,Sarawak,0,0,0
2021-02-01,MMR,Selangor,73,64,9
2021-02-01,MMR,Terengganu,0,0,0
2021-02-01,MMR,W.P. Labuan,0,0,0
2021-02-01,MNE,Johor,0,0,0
2021-02-01,MNE,Kedah,0,0,0
2021-02-01,MNE,Pulau Pinang,0,0,0
2021-02-01,MNE,Sabah,0,0,0
2021-02-01,MNE,Sarawak,0,0,0
2021-02-01,MNE,Selangor,8,8,0
2021-02-01,MNG,Johor,0,0,0
2021-02-01,MNG,Kedah,0,0,0
2021-02-01,MNG,Kelantan,0,0,0
2021-02-01,MNG,Perak,0,0,0
2021-02-01,MNG,Perlis,0,0,0
2021-02-01,MNG,Pulau Pinang,0,0,0
2021-02-01,MNG,Sabah,0,0,0
2021-02-01,MNG,Sarawak,0,0,0
2021-02-01,MNG,Selangor,0,0,0
2021-02-01,MNP,Selangor,0,0,0
2021-02-01,MOZ,Johor,0,0,0
2021-02-01,MOZ,Kedah,0,0,0
2021-02-01,MOZ,Perak,0,0,0
2021-02-01,MOZ,Pulau Pinang,0,0,0
2021-02-01,MOZ,Sabah,0,0,0
2021-02-01,MOZ,Sarawak,0,0,0
2021-02-01,MOZ,Selangor,3,1,2
2021-02-01,MRT,Johor,0,0,0
2021-02-01,MRT,Kedah,0,0,0
2021-02-01,MRT,Pulau Pinang,0,0,0
2021-02-01,MRT,Sabah,0,0,0
2021-02-01,MRT,Sarawak,0,0,0
2021-02-01,MRT,Selangor,4,4,0
2021-02-01,MUS,Johor,0,0,0
2021-02-01,MUS,Kedah,0,0,0
2021-02-01,MUS,Kelantan,0,0,0
2021-02-01,MUS,Pahang,0,0,0
2021-02-01,MUS,Perak,0,0,0
2021-02-01,MUS,Perlis,0,0,0
2021-02-01,MUS,Pulau Pinang,0,0,0
2021-02-01,MUS,Sabah,0,0,0
2021-02-01,MUS,Sarawak,0,0,0
2021-02-01,MUS,Selangor,7,1,6
2021-02-01,MWI,Johor,0,0,0
2021-02-01,MWI,Pulau Pinang,0,0,0
2021-02-01,MWI,Sabah,0,0,0
2021-02-01,MWI,Sarawak,0,0,0
2021-02-01,MWI,Selangor,0,0,0
2021-02-01,MYT,Selangor,0,0,0
2021-02-01,NAM,Johor,0,0,0
2021-02-01,NAM,Kedah,0,0,0
2021-02-01,NAM,Perak,0,0,0
2021-02-01,NAM,Perlis,0,0,0
2021-02-01,NAM,Pulau Pinang,0,0,0
2021-02-01,NAM,Sabah,0,0,0
2021-02-01,NAM,Sarawak,0,0,0
2021-02-01,NAM,Selangor,5,3,2
2021-02-01,NCL,Selangor,0,0,0
2021-02-01,NER,Johor,0,0,0
2021-02-01,NER,Sabah,0,0,0
2021-02-01,NER,Selangor,0,0,0
2021-02-01,NGA,Johor,0,0,0
2021-02-01,NGA,Kedah,0,0,0
2021-02-01,NGA,Perlis,0,0,0
2021-02-01,NGA,Pulau Pinang,0,0,0
2021-02-01,NGA,Sabah,0,0,0
2021-02-01,NGA,Sarawak,0,0,0
2021-02-01,NGA,Selangor,62,52,10
2021-02-01,NIC,Johor,0,0,0
2021-02-01,NIC,Kedah,0,0,0
2021-02-01,NIC,Pulau Pinang,0,0,0
2021-02-01,NIC,Sabah,0,0,0
2021-02-01,NIC,Selangor,0,0,0
2021-02-01,NLD,Johor,2,2,0
2021-02-01,NLD,Kedah,0,0,0
2021-02-01,NLD,Kelantan,0,0,0
2021-02-01,NLD,Melaka,0,0,0
2021-02-01,NLD,Negeri Sembilan,0,0,0
2021-02-01,NLD,Pahang,0,0,0
2021-02-01,NLD,Perak,0,0,0
2021-02-01,NLD,Perlis,0,0,0
2021-02-01,NLD,Pulau Pinang,0,0,0
2021-02-01,NLD,Sabah,0,0,0
2021-02-01,NLD,Sarawak,0,0,0
2021-02-01,NLD,Selangor,28,20,8
2021-02-01,NLD,Terengganu,0,0,0
2021-02-01,NLD,W.P. Labuan,0,0,0
2021-02-01,NOR,Johor,0,0,0
2021-02-01,NOR,Kedah,0,0,0
2021-02-01,NOR,Kelantan,0,0,0
2021-02-01,NOR,Melaka,0,0,0
2021-02-01,NOR,Pahang,0,0,0
2021-02-01,NOR,Perak,0,0,0
2021-02-01,NOR,Perlis,0,0,0
2021-02-01,NOR,Pulau Pinang,0,0,0
2021-02-01,NOR,Sabah,0,0,0
2021-02-01,NOR,Sarawak,0,0,0
2021-02-01,NOR,Selangor,10,10,0
2021-02-01,NOR,W.P. Labuan,0,0,0
2021-02-01,NPL,Johor,0,0,0
2021-02-01,NPL,Kedah,0,0,0
2021-02-01,NPL,Pahang,0,0,0
2021-02-01,NPL,Perak,0,0,0
2021-02-01,NPL,Perlis,0,0,0
2021-02-01,NPL,Pulau Pinang,0,0,0
2021-02-01,NPL,Sabah,0,0,0
2021-02-01,NPL,Sarawak,0,0,0
2021-02-01,NPL,Selangor,34,30,4
2021-02-01,NPL,W.P. Labuan,0,0,0
2021-02-01,NRU,Johor,0,0,0
2021-02-01,NRU,Pulau Pinang,0,0,0
2021-02-01,NRU,Selangor,0,0,0
2021-02-01,NZL,Johor,0,0,0
2021-02-01,NZL,Kedah,0,0,0
2021-02-01,NZL,Kelantan,0,0,0
2021-02-01,NZL,Melaka,0,0,0
2021-02-01,NZL,Negeri Sembilan,0,0,0
2021-02-01,NZL,Pahang,0,0,0
2021-02-01,NZL,Perak,0,0,0
2021-02-01,NZL,Perlis,0,0,0
2021-02-01,NZL,Pulau Pinang,0,0,0
2021-02-01,NZL,Sabah,0,0,0
2021-02-01,NZL,Sarawak,0,0,0
2021-02-01,NZL,Selangor,15,13,2
2021-02-01,NZL,Terengganu,0,0,0
2021-02-01,NZL,W.P. Labuan,0,0,0
2021-02-01,OMN,Johor,0,0,0
2021-02-01,OMN,Kedah,0,0,0
2021-02-01,OMN,Kelantan,0,0,0
2021-02-01,OMN,Melaka,0,0,0
2021-02-01,OMN,Perak,0,0,0
2021-02-01,OMN,Perlis,0,0,0
2021-02-01,OMN,Pulau Pinang,0,0,0
2021-02-01,OMN,Sabah,0,0,0
2021-02-01,OMN,Sarawak,0,0,0
2021-02-01,OMN,Selangor,3,3,0
2021-02-01,PAK,Johor,13,13,0
2021-02-01,PAK,Kedah,0,0,0
2021-02-01,PAK,Kelantan,0,0,0
2021-02-01,PAK,Melaka,0,0,0
2021-02-01,PAK,Negeri Sembilan,0,0,0
2021-02-01,PAK,Pahang,0,0,0
2021-02-01,PAK,Perak,0,0,0
2021-02-01,PAK,Perlis,0,0,0
2021-02-01,PAK,Pulau Pinang,0,0,0
2021-02-01,PAK,Sabah,0,0,0
2021-02-01,PAK,Sarawak,0,0,0
2021-02-01,PAK,Selangor,224,194,30
2021-02-01,PAK,W.P. Labuan,0,0,0
2021-02-01,PAN,Johor,0,0,0
2021-02-01,PAN,Kedah,0,0,0
2021-02-01,PAN,Perak,0,0,0
2021-02-01,PAN,Perlis,0,0,0
2021-02-01,PAN,Pulau Pinang,0,0,0
2021-02-01,PAN,Sabah,0,0,0
2021-02-01,PAN,Sarawak,0,0,0
2021-02-01,PAN,Selangor,2,2,0
2021-02-01,PER,Johor,0,0,0
2021-02-01,PER,Kedah,0,0,0
2021-02-01,PER,Kelantan,0,0,0
2021-02-01,PER,Pahang,0,0,0
2021-02-01,PER,Perak,0,0,0
2021-02-01,PER,Perlis,0,0,0
2021-02-01,PER,Pulau Pinang,0,0,0
2021-02-01,PER,Sabah,0,0,0
2021-02-01,PER,Sarawak,0,0,0
2021-02-01,PER,Selangor,0,0,0
2021-02-01,PER,W.P. Labuan,0,0,0
2021-02-01,PHL,Johor,78,77,1
2021-02-01,PHL,Kedah,0,0,0
2021-02-01,PHL,Kelantan,0,0,0
2021-02-01,PHL,Melaka,0,0,0
2021-02-01,PHL,Negeri Sembilan,0,0,0
2021-02-01,PHL,Pahang,0,0,0
2021-02-01,PHL,Perak,0,0,0
2021-02-01,PHL,Perlis,0,0,0
2021-02-01,PHL,Pulau Pinang,0,0,0
2021-02-01,PHL,Sabah,4,1,3
2021-02-01,PHL,Sarawak,32,32,0
2021-02-01,PHL,Selangor,424,347,77
2021-02-01,PHL,Terengganu,0,0,0
2021-02-01,PHL,W.P. Labuan,8,8,0
2021-02-01,PLW,Johor,0,0,0
2021-02-01,PLW,Pulau Pinang,0,0,0
2021-02-01,PLW,Selangor,0,0,0
2021-02-01,PNG,Johor,0,0,0
2021-02-01,PNG,Kedah,0,0,0
2021-02-01,PNG,Kelantan,0,0,0
2021-02-01,PNG,Perak,0,0,0
2021-02-01,PNG,Pulau Pinang,0,0,0
2021-02-01,PNG,Sabah,0,0,0
2021-02-01,PNG,Sarawak,0,0,0
2021-02-01,PNG,Selangor,0,0,0
2021-02-01,POL,Johor,6,6,0
2021-02-01,POL,Kedah,0,0,0
2021-02-01,POL,Kelantan,0,0,0
2021-02-01,POL,Melaka,0,0,0
2021-02-01,POL,Negeri Sembilan,0,0,0
2021-02-01,POL,Pahang,0,0,0
2021-02-01,POL,Perak,0,0,0
2021-02-01,POL,Perlis,0,0,0
2021-02-01,POL,Pulau Pinang,0,0,0
2021-02-01,POL,Sabah,0,0,0
2021-02-01,POL,Sarawak,0,0,0
2021-02-01,POL,Selangor,27,25,2
2021-02-01,POL,Terengganu,0,0,0
2021-02-01,POL,W.P. Labuan,0,0,0
2021-02-01,PRK,Selangor,0,0,0
2021-02-01,PRT,Johor,0,0,0
2021-02-01,PRT,Kedah,0,0,0
2021-02-01,PRT,Kelantan,0,0,0
2021-02-01,PRT,Melaka,0,0,0
2021-02-01,PRT,Pahang,0,0,0
2021-02-01,PRT,Perak,0,0,0
2021-02-01,PRT,Perlis,0,0,0
2021-02-01,PRT,Pulau Pinang,0,0,0
2021-02-01,PRT,Sabah,0,0,0
2021-02-01,PRT,Sarawak,0,0,0
2021-02-01,PRT,Selangor,11,5,6
2021-02-01,PRT,W.P. Labuan,0,0,0
2021-02-01,PRY,Johor,0,0,0
2021-02-01,PRY,Kedah,0,0,0
2021-02-01,PRY,Perak,0,0,0
2021-02-01,PRY,Perlis,0,0,0
2021-02-01,PRY,Pulau Pinang,0,0,0
2021-02-01,PRY,Sabah,0,0,0
2021-02-01,PRY,Sarawak,0,0,0
2021-02-01,PRY,Selangor,0,0,0
2021-02-01,PSE,Johor,0,0,0
2021-02-01,PSE,Kedah,0,0,0
2021-02-01,PSE,Kelantan,0,0,0
2021-02-01,PSE,Melaka,0,0,0
2021-02-01,PSE,Perak,0,0,0
2021-02-01,PSE,Perlis,0,0,0
2021-02-01,PSE,Pulau Pinang,0,0,0
2021-02-01,PSE,Sabah,1,1,0
2021-02-01,PSE,Sarawak,0,0,0
2021-02-01,PSE,Selangor,7,6,1
2021-02-01,QAT,Johor,0,0,0
2021-02-01,QAT,Kedah,0,0,0
2021-02-01,QAT,Perlis,0,0,0
2021-02-01,QAT,Pulau Pinang,0,0,0
2021-02-01,QAT,Sabah,0,0,0
2021-02-01,QAT,Sarawak,0,0,0
2021-02-01,QAT,Selangor,1,0,1
2021-02-01,REU,Johor,0,0,0
2021-02-01,REU,Sarawak,0,0,0
2021-02-01,ROU,Johor,5,5,0
2021-02-01,ROU,Kedah,0,0,0
2021-02-01,ROU,Kelantan,0,0,0
2021-02-01,ROU,Negeri Sembilan,0,0,0
2021-02-01,ROU,Pahang,0,0,0
2021-02-01,ROU,Perak,0,0,0
2021-02-01,ROU,Perlis,0,0,0
2021-02-01,ROU,Pulau Pinang,0,0,0
2021-02-01,ROU,Sabah,0,0,0
2021-02-01,ROU,Sarawak,0,0,0
2021-02-01,ROU,Selangor,55,42,13
2021-02-01,ROU,W.P. Labuan,0,0,0
2021-02-01,RUS,Johor,44,40,4
2021-02-01,RUS,Kedah,0,0,0
2021-02-01,RUS,Kelantan,0,0,0
2021-02-01,RUS,Melaka,0,0,0
2021-02-01,RUS,Negeri Sembilan,0,0,0
2021-02-01,RUS,Pahang,0,0,0
2021-02-01,RUS,Perak,0,0,0
2021-02-01,RUS,Perlis,0,0,0
2021-02-01,RUS,Pulau Pinang,0,0,0
2021-02-01,RUS,Sabah,0,0,0
2021-02-01,RUS,Sarawak,0,0,0
2021-02-01,RUS,Selangor,39,32,7
2021-02-01,RUS,W.P. Labuan,0,0,0
2021-02-01,RWA,Johor,0,0,0
2021-02-01,RWA,Kedah,0,0,0
2021-02-01,RWA,Pulau Pinang,0,0,0
2021-02-01,RWA,Selangor,0,0,0
2021-02-01,SAU,Johor,0,0,0
2021-02-01,SAU,Kedah,0,0,0
2021-02-01,SAU,Kelantan,0,0,0
2021-02-01,SAU,Melaka,0,0,0
2021-02-01,SAU,Perak,0,0,0
2021-02-01,SAU,Perlis,0,0,0
2021-02-01,SAU,Pulau Pinang,0,0,0
2021-02-01,SAU,Sabah,0,0,0
2021-02-01,SAU,Sarawak,0,0,0
2021-02-01,SAU,Selangor,39,23,16
2021-02-01,SAU,W.P. Labuan,0,0,0
2021-02-01,SDN,Johor,0,0,0
2021-02-01,SDN,Kedah,0,0,0
2021-02-01,SDN,Kelantan,0,0,0
2021-02-01,SDN,Perlis,0,0,0
2021-02-01,SDN,Pulau Pinang,0,0,0
2021-02-01,SDN,Sabah,0,0,0
2021-02-01,SDN,Sarawak,0,0,0
2021-02-01,SDN,Selangor,32,17,15
2021-02-01,SDN,W.P. Labuan,0,0,0
2021-02-01,SEN,Johor,0,0,0
2021-02-01,SEN,Kedah,0,0,0
2021-02-01,SEN,Kelantan,0,0,0
2021-02-01,SEN,Perak,0,0,0
2021-02-01,SEN,Perlis,0,0,0
2021-02-01,SEN,Pulau Pinang,0,0,0
2021-02-01,SEN,Sabah,0,0,0
2021-02-01,SEN,Sarawak,0,0,0
2021-02-01,SEN,Selangor,4,4,0
2021-02-01,SGP,Johor,232,198,34
2021-02-01,SGP,Kedah,1,1,0
2021-02-01,SGP,Kelantan,0,0,0
2021-02-01,SGP,Melaka,0,0,0
2021-02-01,SGP,Negeri Sembilan,0,0,0
2021-02-01,SGP,Pahang,0,0,0
2021-02-01,SGP,Perak,3,1,2
2021-02-01,SGP,Perlis,1,1,0
2021-02-01,SGP,Pulau Pinang,26,17,9
2021-02-01,SGP,Sabah,0,0,0
2021-02-01,SGP,Sarawak,5,1,4
2021-02-01,SGP,Selangor,123,84,39
2021-02-01,SGP,Terengganu,0,0,0
2021-02-01,SGP,W.P. Labuan,0,0,0
2021-02-01,SGS,Johor,1,1,0
2021-02-01,SGS,Sabah,0,0,0
2021-02-01,SGS,Selangor,0,0,0
2021-02-01,SHN,Sarawak,0,0,0
2021-02-01,SLB,Johor,0,0,0
2021-02-01,SLB,Perlis,0,0,0
2021-02-01,SLB,Pulau Pinang,0,0,0
2021-02-01,SLB,Sabah,0,0,0
2021-02-01,SLB,Sarawak,0,0,0
2021-02-01,SLB,Selangor,0,0,0
2021-02-01,SLB,W.P. Labuan,0,0,0
2021-02-01,SLE,Johor,0,0,0
2021-02-01,SLE,Kedah,0,0,0
2021-02-01,SLE,Perak,0,0,0
2021-02-01,SLE,Pulau Pinang,0,0,0
2021-02-01,SLE,Sabah,0,0,0
2021-02-01,SLE,Selangor,0,0,0
2021-02-01,SLV,Johor,0,0,0
2021-02-01,SLV,Kedah,0,0,0
2021-02-01,SLV,Perak,0,0,0
2021-02-01,SLV,Perlis,0,0,0
2021-02-01,SLV,Pulau Pinang,0,0,0
2021-02-01,SLV,Sabah,0,0,0
2021-02-01,SLV,Selangor,0,0,0
2021-02-01,SLV,W.P. Labuan,0,0,0
2021-02-01,SMR,Johor,0,0,0
2021-02-01,SMR,Selangor,0,0,0
2021-02-01,SOM,Johor,0,0,0
2021-02-01,SOM,Kedah,0,0,0
2021-02-01,SOM,Kelantan,0,0,0
2021-02-01,SOM,Perlis,0,0,0
2021-02-01,SOM,Sabah,0,0,0
2021-02-01,SOM,Sarawak,0,0,0
2021-02-01,SOM,Selangor,15,12,3
2021-02-01,SRB,Johor,0,0,0
2021-02-01,SRB,Kedah,0,0,0
2021-02-01,SRB,Kelantan,0,0,0
2021-02-01,SRB,Pahang,0,0,0
2021-02-01,SRB,Perak,0,0,0
2021-02-01,SRB,Perlis,0,0,0
2021-02-01,SRB,Pulau Pinang,0,0,0
2021-02-01,SRB,Sabah,0,0,0
2021-02-01,SRB,Sarawak,0,0,0
2021-02-01,SRB,Selangor,3,2,1
2021-02-01,SSD,Johor,0,0,0
2021-02-01,SSD,Kedah,0,0,0
2021-02-01,SSD,Sarawak,0,0,0
2021-02-01,SSD,Selangor,0,0,0
2021-02-01,SSD,W.P. Labuan,0,0,0
2021-02-01,STP,Selangor,0,0,0
2021-02-01,SUR,Johor,0,0,0
2021-02-01,SUR,Kedah,0,0,0
2021-02-01,SUR,Kelantan,0,0,0
2021-02-01,SUR,Perak,0,0,0
2021-02-01,SUR,Perlis,0,0,0
2021-02-01,SUR,Pulau Pinang,0,0,0
2021-02-01,SUR,Sabah,0,0,0
2021-02-01,SUR,Sarawak,0,0,0
2021-02-01,SUR,Selangor,0,0,0
2021-02-01,SVK,Johor,0,0,0
2021-02-01,SVK,Kedah,0,0,0
2021-02-01,SVK,Kelantan,0,0,0
2021-02-01,SVK,Negeri Sembilan,0,0,0
2021-02-01,SVK,Pahang,0,0,0
2021-02-01,SVK,Perak,0,0,0
2021-02-01,SVK,Perlis,0,0,0
2021-02-01,SVK,Pulau Pinang,0,0,0
2021-02-01,SVK,Sabah,0,0,0
2021-02-01,SVK,Sarawak,0,0,0
2021-02-01,SVK,Selangor,11,11,0
2021-02-01,SVK,W.P. Labuan,0,0,0
2021-02-01,SVN,Johor,0,0,0
2021-02-01,SVN,Kedah,0,0,0
2021-02-01,SVN,Kelantan,0,0,0
2021-02-01,SVN,Perak,0,0,0
2021-02-01,SVN,Perlis,0,0,0
2021-02-01,SVN,Pulau Pinang,0,0,0
2021-02-01,SVN,Sabah,0,0,0
2021-02-01,SVN,Sarawak,0,0,0
2021-02-01,SVN,Selangor,0,0,0
2021-02-01,SVN,W.P. Labuan,0,0,0
2021-02-01,SWE,Johor,0,0,0
2021-02-01,SWE,Kedah,0,0,0
2021-02-01,SWE,Kelantan,0,0,0
2021-02-01,SWE,Melaka,0,0,0
2021-02-01,SWE,Negeri Sembilan,0,0,0
2021-02-01,SWE,Pahang,0,0,0
2021-02-01,SWE,Perak,0,0,0
2021-02-01,SWE,Perlis,0,0,0
2021-02-01,SWE,Pulau Pinang,0,0,0
2021-02-01,SWE,Sabah,0,0,0
2021-02-01,SWE,Sarawak,0,0,0
2021-02-01,SWE,Selangor,28,25,3
2021-02-01,SWE,W.P. Labuan,0,0,0
2021-02-01,SWZ,Johor,0,0,0
2021-02-01,SWZ,Kedah,0,0,0
2021-02-01,SWZ,Pulau Pinang,0,0,0
2021-02-01,SWZ,Sabah,0,0,0
2021-02-01,SWZ,Selangor,0,0,0
2021-02-01,SYC,Johor,0,0,0
2021-02-01,SYC,Kedah,0,0,0
2021-02-01,SYC,Pulau Pinang,0,0,0
2021-02-01,SYC,Sabah,0,0,0
2021-02-01,SYC,Sarawak,0,0,0
2021-02-01,SYC,Selangor,5,0,5
2021-02-01,SYR,Johor,0,0,0
2021-02-01,SYR,Kedah,0,0,0
2021-02-01,SYR,Kelantan,0,0,0
2021-02-01,SYR,Pahang,0,0,0
2021-02-01,SYR,Perlis,0,0,0
2021-02-01,SYR,Pulau Pinang,0,0,0
2021-02-01,SYR,Sabah,0,0,0
2021-02-01,SYR,Sarawak,0,0,0
2021-02-01,SYR,Selangor,18,16,2
2021-02-01,SYR,W.P. Labuan,0,0,0
2021-02-01,TCA,Perlis,0,0,0
2021-02-01,TCD,Johor,0,0,0
2021-02-01,TCD,Kedah,0,0,0
2021-02-01,TCD,Perlis,0,0,0
2021-02-01,TCD,Selangor,0,0,0
2021-02-01,TGO,Johor,0,0,0
2021-02-01,TGO,Perak,0,0,0
2021-02-01,TGO,Pulau Pinang,0,0,0
2021-02-01,TGO,Selangor,0,0,0
2021-02-01,THA,Johor,0,0,0
2021-02-01,THA,Kedah,16128,16086,42
2021-02-01,THA,Kelantan,3,1,2
2021-02-01,THA,Melaka,0,0,0
2021-02-01,THA,Negeri Sembilan,0,0,0
2021-02-01,THA,Pahang,0,0,0
2021-02-01,THA,Perak,0,0,0
2021-02-01,THA,Perlis,9325,8941,384
2021-02-01,THA,Pulau Pinang,9,4,5
2021-02-01,THA,Sabah,0,0,0
2021-02-01,THA,Sarawak,10,10,0
2021-02-01,THA,Selangor,100,51,49
2021-02-01,THA,Terengganu,6,6,0
2021-02-01,THA,W.P. Labuan,0,0,0
2021-02-01,TJK,Johor,0,0,0
2021-02-01,TJK,Kedah,0,0,0
2021-02-01,TJK,Perlis,0,0,0
2021-02-01,TJK,Pulau Pinang,0,0,0
2021-02-01,TJK,Sabah,0,0,0
2021-02-01,TJK,Selangor,5,3,2
2021-02-01,TKL,Selangor,0,0,0
2021-02-01,TKM,Johor,0,0,0
2021-02-01,TKM,Kedah,0,0,0
2021-02-01,TKM,Kelantan,0,0,0
2021-02-01,TKM,Perlis,0,0,0
2021-02-01,TKM,Pulau Pinang,0,0,0
2021-02-01,TKM,Sabah,0,0,0
2021-02-01,TKM,Sarawak,0,0,0
2021-02-01,TKM,Selangor,2,1,1
2021-02-01,TLS,Johor,0,0,0
2021-02-01,TLS,Kedah,0,0,0
2021-02-01,TLS,Perlis,0,0,0
2021-02-01,TLS,Pulau Pinang,0,0,0
2021-02-01,TLS,Sabah,0,0,0
2021-02-01,TLS,Sarawak,0,0,0
2021-02-01,TLS,Selangor,1,1,0
2021-02-01,TON,Johor,0,0,0
2021-02-01,TON,Pulau Pinang,0,0,0
2021-02-01,TON,Sarawak,0,0,0
2021-02-01,TON,Selangor,0,0,0
2021-02-01,TTO,Johor,0,0,0
2021-02-01,TTO,Kedah,0,0,0
2021-02-01,TTO,Pahang,0,0,0
2021-02-01,TTO,Pulau Pinang,0,0,0
2021-02-01,TTO,Sabah,0,0,0
2021-02-01,TTO,Sarawak,0,0,0
2021-02-01,TTO,Selangor,1,1,0
2021-02-01,TUN,Johor,0,0,0
2021-02-01,TUN,Kedah,0,0,0
2021-02-01,TUN,Kelantan,0,0,0
2021-02-01,TUN,Melaka,0,0,0
2021-02-01,TUN,Perak,0,0,0
2021-02-01,TUN,Perlis,0,0,0
2021-02-01,TUN,Pulau Pinang,0,0,0
2021-02-01,TUN,Sabah,0,0,0
2021-02-01,TUN,Sarawak,0,0,0
2021-02-01,TUN,Selangor,3,2,1
2021-02-01,TUN,W.P. Labuan,0,0,0
2021-02-01,TUR,Johor,2,2,0
2021-02-01,TUR,Kedah,0,0,0
2021-02-01,TUR,Kelantan,0,0,0
2021-02-01,TUR,Melaka,0,0,0
2021-02-01,TUR,Negeri Sembilan,0,0,0
2021-02-01,TUR,Pahang,0,0,0
2021-02-01,TUR,Perak,0,0,0
2021-02-01,TUR,Perlis,0,0,0
2021-02-01,TUR,Pulau Pinang,0,0,0
2021-02-01,TUR,Sabah,0,0,0
2021-02-01,TUR,Sarawak,0,0,0
2021-02-01,TUR,Selangor,44,39,5
2021-02-01,TUR,W.P. Labuan,0,0,0
2021-02-01,TUV,Selangor,0,0,0
2021-02-01,TWN,Johor,0,0,0
2021-02-01,TWN,Kedah,0,0,0
2021-02-01,TWN,Kelantan,0,0,0
2021-02-01,TWN,Melaka,0,0,0
2021-02-01,TWN,Negeri Sembilan,0,0,0
2021-02-01,TWN,Pahang,0,0,0
2021-02-01,TWN,Perak,0,0,0
2021-02-01,TWN,Perlis,0,0,0
2021-02-01,TWN,Pulau Pinang,16,14,2
2021-02-01,TWN,Sabah,0,0,0
2021-02-01,TWN,Sarawak,0,0,0
2021-02-01,TWN,Selangor,70,49,21
2021-02-01,TWN,W.P. Labuan,0,0,0
2021-02-01,TZA,Johor,0,0,0
2021-02-01,TZA,Kedah,0,0,0
2021-02-01,TZA,Perak,0,0,0
2021-02-01,TZA,Perlis,0,0,0
2021-02-01,TZA,Pulau Pinang,0,0,0
2021-02-01,TZA,Sabah,0,0,0
2021-02-01,TZA,Sarawak,0,0,0
2021-02-01,TZA,Selangor,3,2,1
2021-02-01,UGA,Johor,0,0,0
2021-02-01,UGA,Kedah,0,0,0
2021-02-01,UGA,Perak,0,0,0
2021-02-01,UGA,Perlis,0,0,0
2021-02-01,UGA,Pulau Pinang,0,0,0
2021-02-01,UGA,Sabah,0,0,0
2021-02-01,UGA,Sarawak,0,0,0
2021-02-01,UGA,Selangor,1,0,1
2021-02-01,UKR,Johor,38,38,0
2021-02-01,UKR,Kedah,0,0,0
2021-02-01,UKR,Kelantan,0,0,0
2021-02-01,UKR,Melaka,0,0,0
2021-02-01,UKR,Negeri Sembilan,0,0,0
2021-02-01,UKR,Pahang,0,0,0
2021-02-01,UKR,Perak,0,0,0
2021-02-01,UKR,Perlis,0,0,0
2021-02-01,UKR,Pulau Pinang,0,0,0
2021-02-01,UKR,Sabah,0,0,0
2021-02-01,UKR,Sarawak,0,0,0
2021-02-01,UKR,Selangor,45,42,3
2021-02-01,UKR,W.P. Labuan,0,0,0
2021-02-01,URY,Johor,0,0,0
2021-02-01,URY,Kedah,0,0,0
2021-02-01,URY,Kelantan,0,0,0
2021-02-01,URY,Perak,0,0,0
2021-02-01,URY,Perlis,0,0,0
2021-02-01,URY,Pulau Pinang,0,0,0
2021-02-01,URY,Sabah,0,0,0
2021-02-01,URY,Sarawak,0,0,0
2021-02-01,URY,Selangor,0,0,0
2021-02-01,URY,W.P. Labuan,0,0,0
2021-02-01,USA,Johor,2,1,1
2021-02-01,USA,Kedah,0,0,0
2021-02-01,USA,Kelantan,0,0,0
2021-02-01,USA,Melaka,0,0,0
2021-02-01,USA,Negeri Sembilan,0,0,0
2021-02-01,USA,Pahang,0,0,0
2021-02-01,USA,Perak,0,0,0
2021-02-01,USA,Perlis,0,0,0
2021-02-01,USA,Pulau Pinang,2,1,1
2021-02-01,USA,Sabah,0,0,0
2021-02-01,USA,Sarawak,0,0,0
2021-02-01,USA,Selangor,117,81,36
2021-02-01,USA,Terengganu,0,0,0
2021-02-01,USA,W.P. Labuan,0,0,0
2021-02-01,UZB,Johor,0,0,0
2021-02-01,UZB,Kedah,0,0,0
2021-02-01,UZB,Kelantan,0,0,0
2021-02-01,UZB,Perak,0,0,0
2021-02-01,UZB,Perlis,0,0,0
2021-02-01,UZB,Pulau Pinang,0,0,0
2021-02-01,UZB,Sabah,0,0,0
2021-02-01,UZB,Sarawak,0,0,0
2021-02-01,UZB,Selangor,10,5,5
2021-02-01,VAT,Johor,0,0,0
2021-02-01,VAT,Sarawak,0,0,0
2021-02-01,VAT,Selangor,0,0,0
2021-02-01,VCT,Johor,0,0,0
2021-02-01,VCT,Kedah,0,0,0
2021-02-01,VCT,Pulau Pinang,0,0,0
2021-02-01,VCT,Sarawak,0,0,0
2021-02-01,VCT,Selangor,0,0,0
2021-02-01,VEN,Johor,0,0,0
2021-02-01,VEN,Kedah,0,0,0
2021-02-01,VEN,Kelantan,0,0,0
2021-02-01,VEN,Melaka,0,0,0
2021-02-01,VEN,Perak,0,0,0
2021-02-01,VEN,Perlis,0,0,0
2021-02-01,VEN,Pulau Pinang,0,0,0
2021-02-01,VEN,Sabah,0,0,0
2021-02-01,VEN,Sarawak,0,0,0
2021-02-01,VEN,Selangor,1,1,0
2021-02-01,VEN,W.P. Labuan,0,0,0
2021-02-01,VNM,Johor,1,0,1
2021-02-01,VNM,Kedah,0,0,0
2021-02-01,VNM,Kelantan,0,0,0
2021-02-01,VNM,Melaka,0,0,0
2021-02-01,VNM,Negeri Sembilan,0,0,0
2021-02-01,VNM,Pahang,0,0,0
2021-02-01,VNM,Perak,0,0,0
2021-02-01,VNM,Perlis,0,0,0
2021-02-01,VNM,Pulau Pinang,0,0,0
2021-02-01,VNM,Sabah,0,0,0
2021-02-01,VNM,Sarawak,0,0,0
2021-02-01,VNM,Selangor,75,19,56
2021-02-01,VNM,Terengganu,5,5,0
2021-02-01,VNM,W.P. Labuan,0,0,0
2021-02-01,VUT,Johor,0,0,0
2021-02-01,VUT,Kedah,0,0,0
2021-02-01,VUT,Pulau Pinang,0,0,0
2021-02-01,VUT,Sabah,0,0,0
2021-02-01,VUT,Sarawak,0,0,0
2021-02-01,VUT,Selangor,1,1,0
2021-02-01,WSM,Johor,0,0,0
2021-02-01,WSM,Sarawak,0,0,0
2021-02-01,WSM,Selangor,0,0,0
2021-02-01,XXX,Johor,0,0,0
2021-02-01,XXX,Kedah,0,0,0
2021-02-01,XXX,Kelantan,0,0,0
2021-02-01,XXX,Melaka,0,0,0
2021-02-01,XXX,Pahang,0,0,0
2021-02-01,XXX,Perak,0,0,0
2021-02-01,XXX,Perlis,0,0,0
2021-02-01,XXX,Pulau Pinang,0,0,0
2021-02-01,XXX,Sabah,0,0,0
2021-02-01,XXX,Sarawak,0,0,0
2021-02-01,XXX,Selangor,10,7,3
2021-02-01,XXX,W.P. Labuan,0,0,0
2021-02-01,YEM,Johor,0,0,0
2021-02-01,YEM,Kedah,0,0,0
2021-02-01,YEM,Kelantan,0,0,0
2021-02-01,YEM,Melaka,0,0,0
2021-02-01,YEM,Pahang,0,0,0
2021-02-01,YEM,Perak,0,0,0
2021-02-01,YEM,Perlis,0,0,0
2021-02-01,YEM,Pulau Pinang,0,0,0
2021-02-01,YEM,Sabah,0,0,0
2021-02-01,YEM,Sarawak,0,0,0
2021-02-01,YEM,Selangor,48,39,9
2021-02-01,YEM,W.P. Labuan,0,0,0
2021-02-01,ZAF,Johor,5,5,0
2021-02-01,ZAF,Kedah,0,0,0
2021-02-01,ZAF,Kelantan,0,0,0
2021-02-01,ZAF,Melaka,0,0,0
2021-02-01,ZAF,Pahang,0,0,0
2021-02-01,ZAF,Perak,0,0,0
2021-02-01,ZAF,Perlis,0,0,0
2021-02-01,ZAF,Pulau Pinang,0,0,0
2021-02-01,ZAF,Sabah,0,0,0
2021-02-01,ZAF,Sarawak,0,0,0
2021-02-01,ZAF,Selangor,50,47,3
2021-02-01,ZAF,Terengganu,0,0,0
2021-02-01,ZAF,W.P. Labuan,0,0,0
2021-02-01,ZAR,Selangor,0,0,0
2021-02-01,ZMB,Johor,0,0,0
2021-02-01,ZMB,Kedah,0,0,0
2021-02-01,ZMB,Perak,0,0,0
2021-02-01,ZMB,Perlis,0,0,0
2021-02-01,ZMB,Pulau Pinang,0,0,0
2021-02-01,ZMB,Sabah,0,0,0
2021-02-01,ZMB,Sarawak,0,0,0
2021-02-01,ZMB,Selangor,9,5,4
2021-02-01,ZWE,Johor,0,0,0
2021-02-01,ZWE,Kedah,0,0,0
2021-02-01,ZWE,Kelantan,0,0,0
2021-02-01,ZWE,Perak,0,0,0
2021-02-01,ZWE,Perlis,0,0,0
2021-02-01,ZWE,Pulau Pinang,0,0,0
2021-02-01,ZWE,Sabah,0,0,0
2021-02-01,ZWE,Sarawak,0,0,0
2021-02-01,ZWE,Selangor,1,1,0
2021-03-01,ABW,Kedah,0,0,0
2021-03-01,ABW,Pulau Pinang,0,0,0
2021-03-01,AFG,Johor,0,0,0
2021-03-01,AFG,Kedah,0,0,0
2021-03-01,AFG,Perlis,0,0,0
2021-03-01,AFG,Pulau Pinang,0,0,0
2021-03-01,AFG,Sarawak,0,0,0
2021-03-01,AFG,Selangor,36,29,7
2021-03-01,AGO,Johor,0,0,0
2021-03-01,AGO,Kedah,0,0,0
2021-03-01,AGO,Sabah,0,0,0
2021-03-01,AGO,Selangor,0,0,0
2021-03-01,AIA,Selangor,0,0,0
2021-03-01,ALB,Johor,0,0,0
2021-03-01,ALB,Kedah,0,0,0
2021-03-01,ALB,Perak,0,0,0
2021-03-01,ALB,Perlis,0,0,0
2021-03-01,ALB,Pulau Pinang,0,0,0
2021-03-01,ALB,Sabah,0,0,0
2021-03-01,ALB,Sarawak,0,0,0
2021-03-01,ALB,Selangor,0,0,0
2021-03-01,AND,Johor,0,0,0
2021-03-01,AND,Kedah,0,0,0
2021-03-01,AND,Perlis,0,0,0
2021-03-01,AND,Pulau Pinang,0,0,0
2021-03-01,AND,Selangor,0,0,0
2021-03-01,ANT,Selangor,0,0,0
2021-03-01,ARE,Johor,0,0,0
2021-03-01,ARE,Kedah,0,0,0
2021-03-01,ARE,Kelantan,0,0,0
2021-03-01,ARE,Perak,0,0,0
2021-03-01,ARE,Perlis,0,0,0
2021-03-01,ARE,Pulau Pinang,0,0,0
2021-03-01,ARE,Sabah,0,0,0
2021-03-01,ARE,Sarawak,0,0,0
2021-03-01,ARE,Selangor,4,4,0
2021-03-01,ARG,Johor,0,0,0
2021-03-01,ARG,Kedah,0,0,0
2021-03-01,ARG,Kelantan,0,0,0
2021-03-01,ARG,Melaka,0,0,0
2021-03-01,ARG,Perak,0,0,0
2021-03-01,ARG,Perlis,0,0,0
2021-03-01,ARG,Pulau Pinang,0,0,0
2021-03-01,ARG,Sabah,0,0,0
2021-03-01,ARG,Sarawak,0,0,0
2021-03-01,ARG,Selangor,8,6,2
2021-03-01,ARG,W.P. Labuan,0,0,0
2021-03-01,ARM,Johor,0,0,0
2021-03-01,ARM,Kedah,0,0,0
2021-03-01,ARM,Kelantan,0,0,0
2021-03-01,ARM,Perak,0,0,0
2021-03-01,ARM,Perlis,0,0,0
2021-03-01,ARM,Pulau Pinang,0,0,0
2021-03-01,ARM,Sabah,0,0,0
2021-03-01,ARM,Sarawak,0,0,0
2021-03-01,ARM,Selangor,1,0,1
2021-03-01,ATA,Selangor,0,0,0
2021-03-01,ATG,Johor,0,0,0
2021-03-01,ATG,Kedah,0,0,0
2021-03-01,ATG,Pulau Pinang,0,0,0
2021-03-01,ATG,Sarawak,0,0,0
2021-03-01,ATG,Selangor,0,0,0
2021-03-01,AUS,Johor,2,1,1
2021-03-01,AUS,Kedah,0,0,0
2021-03-01,AUS,Kelantan,0,0,0
2021-03-01,AUS,Melaka,0,0,0
2021-03-01,AUS,Negeri Sembilan,0,0,0
2021-03-01,AUS,Pahang,0,0,0
2021-03-01,AUS,Perak,0,0,0
2021-03-01,AUS,Perlis,0,0,0
2021-03-01,AUS,Pulau Pinang,4,3,1
2021-03-01,AUS,Sabah,2,2,0
2021-03-01,AUS,Sarawak,0,0,0
2021-03-01,AUS,Selangor,86,69,17
2021-03-01,AUS,Terengganu,0,0,0
2021-03-01,AUS,W.P. Labuan,0,0,0
2021-03-01,AUT,Johor,0,0,0
2021-03-01,AUT,Kedah,0,0,0
2021-03-01,AUT,Kelantan,0,0,0
2021-03-01,AUT,Melaka,0,0,0
2021-03-01,AUT,Negeri Sembilan,0,0,0
2021-03-01,AUT,Pahang,0,0,0
2021-03-01,AUT,Perak,0,0,0
2021-03-01,AUT,Perlis,0,0,0
2021-03-01,AUT,Pulau Pinang,0,0,0
2021-03-01,AUT,Sabah,0,0,0
2021-03-01,AUT,Sarawak,0,0,0
2021-03-01,AUT,Selangor,7,7,0
2021-03-01,AUT,Terengganu,0,0,0
2021-03-01,AUT,W.P. Labuan,0,0,0
2021-03-01,AZE,Johor,0,0,0
2021-03-01,AZE,Kedah,0,0,0
2021-03-01,AZE,Kelantan,0,0,0
2021-03-01,AZE,Melaka,0,0,0
2021-03-01,AZE,Perlis,0,0,0
2021-03-01,AZE,Pulau Pinang,0,0,0
2021-03-01,AZE,Sabah,0,0,0
2021-03-01,AZE,Sarawak,0,0,0
2021-03-01,AZE,Selangor,4,2,2
2021-03-01,AZE,W.P. Labuan,0,0,0
2021-03-01,BDI,Pulau Pinang,0,0,0
2021-03-01,BDI,Sarawak,0,0,0
2021-03-01,BDI,Selangor,1,1,0
2021-03-01,BEL,Johor,0,0,0
2021-03-01,BEL,Kedah,0,0,0
2021-03-01,BEL,Kelantan,0,0,0
2021-03-01,BEL,Melaka,0,0,0
2021-03-01,BEL,Negeri Sembilan,0,0,0
2021-03-01,BEL,Pahang,0,0,0
2021-03-01,BEL,Perak,0,0,0
2021-03-01,BEL,Perlis,0,0,0
2021-03-01,BEL,Pulau Pinang,0,0,0
2021-03-01,BEL,Sabah,0,0,0
2021-03-01,BEL,Sarawak,0,0,0
2021-03-01,BEL,Selangor,22,20,2
2021-03-01,BEL,W.P. Labuan,0,0,0
2021-03-01,BEN,Johor,0,0,0
2021-03-01,BEN,Kedah,0,0,0
2021-03-01,BEN,Perak,0,0,0
2021-03-01,BEN,Pulau Pinang,0,0,0
2021-03-01,BEN,Sabah,0,0,0
2021-03-01,BEN,Sarawak,0,0,0
2021-03-01,BEN,Selangor,0,0,0
2021-03-01,BFA,Perak,0,0,0
2021-03-01,BFA,Pulau Pinang,0,0,0
2021-03-01,BFA,Selangor,0,0,0
2021-03-01,BGD,Johor,10,10,0
2021-03-01,BGD,Kedah,0,0,0
2021-03-01,BGD,Kelantan,0,0,0
2021-03-01,BGD,Melaka,0,0,0
2021-03-01,BGD,Negeri Sembilan,0,0,0
2021-03-01,BGD,Pahang,0,0,0
2021-03-01,BGD,Perak,0,0,0
2021-03-01,BGD,Perlis,0,0,0
2021-03-01,BGD,Pulau Pinang,1,1,0
2021-03-01,BGD,Sabah,0,0,0
2021-03-01,BGD,Sarawak,0,0,0
2021-03-01,BGD,Selangor,296,205,91
2021-03-01,BGD,W.P. Labuan,0,0,0
2021-03-01,BGR,Johor,0,0,0
2021-03-01,BGR,Kedah,0,0,0
2021-03-01,BGR,Kelantan,0,0,0
2021-03-01,BGR,Pahang,0,0,0
2021-03-01,BGR,Perak,0,0,0
2021-03-01,BGR,Perlis,0,0,0
2021-03-01,BGR,Pulau Pinang,0,0,0
2021-03-01,BGR,Sabah,0,0,0
2021-03-01,BGR,Sarawak,0,0,0
2021-03-01,BGR,Selangor,13,12,1
2021-03-01,BGR,W.P. Labuan,0,0,0
2021-03-01,BHR,Johor,0,0,0
2021-03-01,BHR,Kedah,0,0,0
2021-03-01,BHR,Kelantan,0,0,0
2021-03-01,BHR,Perlis,0,0,0
2021-03-01,BHR,Pulau Pinang,0,0,0
2021-03-01,BHR,Sabah,0,0,0
2021-03-01,BHR,Sarawak,0,0,0
2021-03-01,BHR,Selangor,5,2,3
2021-03-01,BHS,Johor,0,0,0
2021-03-01,BHS,Kedah,0,0,0
2021-03-01,BHS,Perak,0,0,0
2021-03-01,BHS,Sabah,0,0,0
2021-03-01,BHS,Sarawak,0,0,0
2021-03-01,BHS,Selangor,0,0,0
2021-03-01,BIH,Johor,0,0,0
2021-03-01,BIH,Kedah,0,0,0
2021-03-01,BIH,Perlis,0,0,0
2021-03-01,BIH,Pulau Pinang,0,0,0
2021-03-01,BIH,Sabah,0,0,0
2021-03-01,BIH,Sarawak,0,0,0
2021-03-01,BIH,Selangor,2,0,2
2021-03-01,BLR,Johor,0,0,0
2021-03-01,BLR,Kedah,0,0,0
2021-03-01,BLR,Kelantan,0,0,0
2021-03-01,BLR,Pahang,0,0,0
2021-03-01,BLR,Perak,0,0,0
2021-03-01,BLR,Perlis,0,0,0
2021-03-01,BLR,Pulau Pinang,0,0,0
2021-03-01,BLR,Sabah,0,0,0
2021-03-01,BLR,Sarawak,0,0,0
2021-03-01,BLR,Selangor,0,0,0
2021-03-01,BLR,W.P. Labuan,0,0,0
2021-03-01,BLZ,Johor,0,0,0
2021-03-01,BLZ,Pulau Pinang,0,0,0
2021-03-01,BLZ,Sarawak,0,0,0
2021-03-01,BLZ,Selangor,0,0,0
2021-03-01,BMU,Selangor,0,0,0
2021-03-01,BOL,Johor,0,0,0
2021-03-01,BOL,Kedah,0,0,0
2021-03-01,BOL,Melaka,0,0,0
2021-03-01,BOL,Perak,0,0,0
2021-03-01,BOL,Perlis,0,0,0
2021-03-01,BOL,Pulau Pinang,0,0,0
2021-03-01,BOL,Sabah,0,0,0
2021-03-01,BOL,Sarawak,0,0,0
2021-03-01,BOL,Selangor,0,0,0
2021-03-01,BRA,Johor,0,0,0
2021-03-01,BRA,Kedah,0,0,0
2021-03-01,BRA,Kelantan,0,0,0
2021-03-01,BRA,Melaka,0,0,0
2021-03-01,BRA,Pahang,0,0,0
2021-03-01,BRA,Perak,0,0,0
2021-03-01,BRA,Perlis,0,0,0
2021-03-01,BRA,Pulau Pinang,0,0,0
2021-03-01,BRA,Sabah,0,0,0
2021-03-01,BRA,Sarawak,0,0,0
2021-03-01,BRA,Selangor,18,12,6
2021-03-01,BRA,W.P. Labuan,0,0,0
2021-03-01,BRB,Johor,0,0,0
2021-03-01,BRB,Kedah,0,0,0
2021-03-01,BRB,Perlis,0,0,0
2021-03-01,BRB,Pulau Pinang,0,0,0
2021-03-01,BRB,Selangor,0,0,0
2021-03-01,BRN,Johor,1,0,1
2021-03-01,BRN,Kedah,0,0,0
2021-03-01,BRN,Kelantan,0,0,0
2021-03-01,BRN,Melaka,0,0,0
2021-03-01,BRN,Pahang,0,0,0
2021-03-01,BRN,Perak,0,0,0
2021-03-01,BRN,Perlis,0,0,0
2021-03-01,BRN,Pulau Pinang,0,0,0
2021-03-01,BRN,Sabah,0,0,0
2021-03-01,BRN,Sarawak,422,406,16
2021-03-01,BRN,Selangor,27,10,17
2021-03-01,BRN,W.P. Labuan,1,0,1
2021-03-01,BTN,Johor,0,0,0
2021-03-01,BTN,Kedah,0,0,0
2021-03-01,BTN,Perak,0,0,0
2021-03-01,BTN,Perlis,0,0,0
2021-03-01,BTN,Pulau Pinang,0,0,0
2021-03-01,BTN,Sabah,0,0,0
2021-03-01,BTN,Sarawak,0,0,0
2021-03-01,BTN,Selangor,2,2,0
2021-03-01,BWA,Johor,0,0,0
2021-03-01,BWA,Kedah,0,0,0
2021-03-01,BWA,Perlis,0,0,0
2021-03-01,BWA,Pulau Pinang,0,0,0
2021-03-01,BWA,Sabah,0,0,0
2021-03-01,BWA,Sarawak,0,0,0
2021-03-01,BWA,Selangor,0,0,0
2021-03-01,CAF,Kedah,0,0,0
2021-03-01,CAF,Selangor,0,0,0
2021-03-01,CAN,Johor,0,0,0
2021-03-01,CAN,Kedah,0,0,0
2021-03-01,CAN,Kelantan,0,0,0
2021-03-01,CAN,Melaka,0,0,0
2021-03-01,CAN,Negeri Sembilan,0,0,0
2021-03-01,CAN,Pahang,0,0,0
2021-03-01,CAN,Perak,0,0,0
2021-03-01,CAN,Perlis,0,0,0
2021-03-01,CAN,Pulau Pinang,1,0,1
2021-03-01,CAN,Sabah,0,0,0
2021-03-01,CAN,Sarawak,0,0,0
2021-03-01,CAN,Selangor,36,27,9
2021-03-01,CAN,Terengganu,0,0,0
2021-03-01,CAN,W.P. Labuan,0,0,0
2021-03-01,CCK,Selangor,0,0,0
2021-03-01,CHE,Johor,0,0,0
2021-03-01,CHE,Kedah,0,0,0
2021-03-01,CHE,Kelantan,0,0,0
2021-03-01,CHE,Melaka,0,0,0
2021-03-01,CHE,Negeri Sembilan,0,0,0
2021-03-01,CHE,Pahang,0,0,0
2021-03-01,CHE,Perak,0,0,0
2021-03-01,CHE,Perlis,0,0,0
2021-03-01,CHE,Pulau Pinang,3,1,2
2021-03-01,CHE,Sabah,0,0,0
2021-03-01,CHE,Sarawak,0,0,0
2021-03-01,CHE,Selangor,17,10,7
2021-03-01,CHE,W.P. Labuan,0,0,0
2021-03-01,CHL,Johor,0,0,0
2021-03-01,CHL,Kedah,0,0,0
2021-03-01,CHL,Kelantan,0,0,0
2021-03-01,CHL,Melaka,0,0,0
2021-03-01,CHL,Pahang,0,0,0
2021-03-01,CHL,Perak,0,0,0
2021-03-01,CHL,Perlis,0,0,0
2021-03-01,CHL,Pulau Pinang,0,0,0
2021-03-01,CHL,Sabah,0,0,0
2021-03-01,CHL,Sarawak,0,0,0
2021-03-01,CHL,Selangor,0,0,0
2021-03-01,CHN,Johor,12,10,2
2021-03-01,CHN,Kedah,4,1,3
2021-03-01,CHN,Kelantan,0,0,0
2021-03-01,CHN,Melaka,0,0,0
2021-03-01,CHN,Pahang,0,0,0
2021-03-01,CHN,Perak,0,0,0
2021-03-01,CHN,Perlis,0,0,0
2021-03-01,CHN,Pulau Pinang,14,6,8
2021-03-01,CHN,Sabah,8,8,0
2021-03-01,CHN,Sarawak,84,77,7
2021-03-01,CHN,Selangor,1765,1479,286
2021-03-01,CHN,Terengganu,0,0,0
2021-03-01,CHN,W.P. Labuan,0,0,0
2021-03-01,CIV,Johor,0,0,0
2021-03-01,CIV,Kedah,0,0,0
2021-03-01,CIV,Pulau Pinang,0,0,0
2021-03-01,CIV,Sabah,0,0,0
2021-03-01,CIV,Sarawak,0,0,0
2021-03-01,CIV,Selangor,2,1,1
2021-03-01,CMR,Johor,0,0,0
2021-03-01,CMR,Kedah,0,0,0
2021-03-01,CMR,Pulau Pinang,0,0,0
2021-03-01,CMR,Sabah,0,0,0
2021-03-01,CMR,Sarawak,0,0,0
2021-03-01,CMR,Selangor,3,3,0
2021-03-01,COD,Johor,0,0,0
2021-03-01,COD,Pulau Pinang,0,0,0
2021-03-01,COD,Sarawak,0,0,0
2021-03-01,COD,Selangor,1,1,0
2021-03-01,COG,Johor,0,0,0
2021-03-01,COG,Kedah,0,0,0
2021-03-01,COG,Selangor,0,0,0
2021-03-01,COK,Selangor,0,0,0
2021-03-01,COL,Johor,0,0,0
2021-03-01,COL,Kedah,0,0,0
2021-03-01,COL,Perak,0,0,0
2021-03-01,COL,Pulau Pinang,0,0,0
2021-03-01,COL,Sabah,0,0,0
2021-03-01,COL,Sarawak,0,0,0
2021-03-01,COL,Selangor,10,3,7
2021-03-01,COL,W.P. Labuan,0,0,0
2021-03-01,COM,Johor,0,0,0
2021-03-01,COM,Kedah,0,0,0
2021-03-01,COM,Selangor,4,3,1
2021-03-01,CPV,Johor,0,0,0
2021-03-01,CPV,Kedah,0,0,0
2021-03-01,CPV,Pulau Pinang,0,0,0
2021-03-01,CPV,Sabah,0,0,0
2021-03-01,CPV,Selangor,0,0,0
2021-03-01,CRI,Johor,0,0,0
2021-03-01,CRI,Kedah,0,0,0
2021-03-01,CRI,Perak,0,0,0
2021-03-01,CRI,Perlis,0,0,0
2021-03-01,CRI,Pulau Pinang,0,0,0
2021-03-01,CRI,Sabah,0,0,0
2021-03-01,CRI,Sarawak,0,0,0
2021-03-01,CRI,Selangor,4,2,2
2021-03-01,CUB,Johor,0,0,0
2021-03-01,CUB,Kedah,0,0,0
2021-03-01,CUB,Perlis,0,0,0
2021-03-01,CUB,Pulau Pinang,0,0,0
2021-03-01,CUB,Sabah,0,0,0
2021-03-01,CUB,Sarawak,0,0,0
2021-03-01,CUB,Selangor,2,1,1
2021-03-01,CYP,Johor,0,0,0
2021-03-01,CYP,Kedah,0,0,0
2021-03-01,CYP,Perak,0,0,0
2021-03-01,CYP,Perlis,0,0,0
2021-03-01,CYP,Pulau Pinang,0,0,0
2021-03-01,CYP,Sabah,0,0,0
2021-03-01,CYP,Sarawak,0,0,0
2021-03-01,CYP,Selangor,1,1,0
2021-03-01,CZE,Johor,0,0,0
2021-03-01,CZE,Kedah,0,0,0
2021-03-01,CZE,Kelantan,0,0,0
2021-03-01,CZE,Melaka,0,0,0
2021-03-01,CZE,Negeri Sembilan,0,0,0
2021-03-01,CZE,Perak,0,0,0
2021-03-01,CZE,Perlis,0,0,0
2021-03-01,CZE,Pulau Pinang,0,0,0
2021-03-01,CZE,Sabah,0,0,0
2021-03-01,CZE,Sarawak,0,0,0
2021-03-01,CZE,Selangor,7,4,3
2021-03-01,CZE,W.P. Labuan,0,0,0
2021-03-01,DEU,Johor,0,0,0
2021-03-01,DEU,Kedah,0,0,0
2021-03-01,DEU,Kelantan,0,0,0
2021-03-01,DEU,Melaka,0,0,0
2021-03-01,DEU,Negeri Sembilan,0,0,0
2021-03-01,DEU,Pahang,0,0,0
2021-03-01,DEU,Perak,0,0,0
2021-03-01,DEU,Perlis,0,0,0
2021-03-01,DEU,Pulau Pinang,1,1,0
2021-03-01,DEU,Sabah,0,0,0
2021-03-01,DEU,Sarawak,0,0,0
2021-03-01,DEU,Selangor,93,87,6
2021-03-01,DEU,Terengganu,0,0,0
2021-03-01,DEU,W.P. Labuan,0,0,0
2021-03-01,DJI,Johor,0,0,0
2021-03-01,DJI,Selangor,10,0,10
2021-03-01,DMA,Johor,0,0,0
2021-03-01,DMA,Kedah,0,0,0
2021-03-01,DMA,Pulau Pinang,0,0,0
2021-03-01,DMA,Sabah,0,0,0
2021-03-01,DMA,Sarawak,0,0,0
2021-03-01,DMA,Selangor,1,1,0
2021-03-01,DMA,W.P. Labuan,0,0,0
2021-03-01,DNK,Johor,3,3,0
2021-03-01,DNK,Kedah,0,0,0
2021-03-01,DNK,Kelantan,0,0,0
2021-03-01,DNK,Melaka,0,0,0
2021-03-01,DNK,Negeri Sembilan,0,0,0
2021-03-01,DNK,Pahang,0,0,0
2021-03-01,DNK,Perak,0,0,0
2021-03-01,DNK,Perlis,0,0,0
2021-03-01,DNK,Pulau Pinang,0,0,0
2021-03-01,DNK,Sabah,0,0,0
2021-03-01,DNK,Sarawak,0,0,0
2021-03-01,DNK,Selangor,18,15,3
2021-03-01,DNK,W.P. Labuan,0,0,0
2021-03-01,DOM,Johor,0,0,0
2021-03-01,DOM,Kedah,0,0,0
2021-03-01,DOM,Perak,0,0,0
2021-03-01,DOM,Perlis,0,0,0
2021-03-01,DOM,Pulau Pinang,0,0,0
2021-03-01,DOM,Sabah,0,0,0
2021-03-01,DOM,Sarawak,0,0,0
2021-03-01,DOM,Selangor,0,0,0
2021-03-01,DZA,Johor,0,0,0
2021-03-01,DZA,Kedah,0,0,0
2021-03-01,DZA,Kelantan,0,0,0
2021-03-01,DZA,Melaka,0,0,0
2021-03-01,DZA,Perak,0,0,0
2021-03-01,DZA,Perlis,0,0,0
2021-03-01,DZA,Pulau Pinang,0,0,0
2021-03-01,DZA,Sabah,0,0,0
2021-03-01,DZA,Sarawak,0,0,0
2021-03-01,DZA,Selangor,4,2,2
2021-03-01,DZA,W.P. Labuan,0,0,0
2021-03-01,ECU,Johor,0,0,0
2021-03-01,ECU,Kedah,0,0,0
2021-03-01,ECU,Perak,0,0,0
2021-03-01,ECU,Perlis,0,0,0
2021-03-01,ECU,Pulau Pinang,0,0,0
2021-03-01,ECU,Sabah,0,0,0
2021-03-01,ECU,Sarawak,0,0,0
2021-03-01,ECU,Selangor,0,0,0
2021-03-01,EGY,Johor,0,0,0
2021-03-01,EGY,Kedah,0,0,0
2021-03-01,EGY,Kelantan,0,0,0
2021-03-01,EGY,Melaka,0,0,0
2021-03-01,EGY,Pahang,0,0,0
2021-03-01,EGY,Perak,0,0,0
2021-03-01,EGY,Perlis,0,0,0
2021-03-01,EGY,Pulau Pinang,0,0,0
2021-03-01,EGY,Sabah,0,0,0
2021-03-01,EGY,Sarawak,0,0,0
2021-03-01,EGY,Selangor,114,86,28
2021-03-01,EGY,Terengganu,0,0,0
2021-03-01,EGY,W.P. Labuan,0,0,0
2021-03-01,ERI,Johor,0,0,0
2021-03-01,ERI,Pulau Pinang,0,0,0
2021-03-01,ERI,Sabah,0,0,0
2021-03-01,ERI,Selangor,2,1,1
2021-03-01,ESP,Johor,0,0,0
2021-03-01,ESP,Kedah,0,0,0
2021-03-01,ESP,Kelantan,0,0,0
2021-03-01,ESP,Melaka,0,0,0
2021-03-01,ESP,Negeri Sembilan,0,0,0
2021-03-01,ESP,Pahang,0,0,0
2021-03-01,ESP,Perak,0,0,0
2021-03-01,ESP,Perlis,0,0,0
2021-03-01,ESP,Pulau Pinang,0,0,0
2021-03-01,ESP,Sabah,1,1,0
2021-03-01,ESP,Sarawak,0,0,0
2021-03-01,ESP,Selangor,26,17,9
2021-03-01,ESP,W.P. Labuan,0,0,0
2021-03-01,EST,Johor,0,0,0
2021-03-01,EST,Kedah,0,0,0
2021-03-01,EST,Kelantan,0,0,0
2021-03-01,EST,Pahang,0,0,0
2021-03-01,EST,Perak,0,0,0
2021-03-01,EST,Perlis,0,0,0
2021-03-01,EST,Pulau Pinang,0,0,0
2021-03-01,EST,Sabah,0,0,0
2021-03-01,EST,Sarawak,0,0,0
2021-03-01,EST,Selangor,2,2,0
2021-03-01,EST,W.P. Labuan,0,0,0
2021-03-01,ETH,Johor,3,3,0
2021-03-01,ETH,Kedah,0,0,0
2021-03-01,ETH,Pulau Pinang,0,0,0
2021-03-01,ETH,Sarawak,0,0,0
2021-03-01,ETH,Selangor,6,5,1
2021-03-01,FIN,Johor,0,0,0
2021-03-01,FIN,Kedah,0,0,0
2021-03-01,FIN,Kelantan,0,0,0
2021-03-01,FIN,Melaka,0,0,0
2021-03-01,FIN,Negeri Sembilan,0,0,0
2021-03-01,FIN,Pahang,0,0,0
2021-03-01,FIN,Perak,0,0,0
2021-03-01,FIN,Perlis,0,0,0
2021-03-01,FIN,Pulau Pinang,0,0,0
2021-03-01,FIN,Sabah,0,0,0
2021-03-01,FIN,Sarawak,0,0,0
2021-03-01,FIN,Selangor,15,13,2
2021-03-01,FIN,W.P. Labuan,0,0,0
2021-03-01,FJI,Johor,0,0,0
2021-03-01,FJI,Kedah,0,0,0
2021-03-01,FJI,Kelantan,0,0,0
2021-03-01,FJI,Perak,0,0,0
2021-03-01,FJI,Perlis,0,0,0
2021-03-01,FJI,Pulau Pinang,0,0,0
2021-03-01,FJI,Sabah,0,0,0
2021-03-01,FJI,Sarawak,0,0,0
2021-03-01,FJI,Selangor,1,0,1
2021-03-01,FRA,Johor,3,3,0
2021-03-01,FRA,Kedah,0,0,0
2021-03-01,FRA,Kelantan,0,0,0
2021-03-01,FRA,Melaka,0,0,0
2021-03-01,FRA,Negeri Sembilan,0,0,0
2021-03-01,FRA,Pahang,0,0,0
2021-03-01,FRA,Perak,0,0,0
2021-03-01,FRA,Perlis,0,0,0
2021-03-01,FRA,Pulau Pinang,3,3,0
2021-03-01,FRA,Sabah,0,0,0
2021-03-01,FRA,Sarawak,1,1,0
2021-03-01,FRA,Selangor,72,57,15
2021-03-01,FRA,Terengganu,0,0,0
2021-03-01,FRA,W.P. Labuan,0,0,0
2021-03-01,FSM,Johor,0,0,0
2021-03-01,FSM,Pulau Pinang,0,0,0
2021-03-01,FSM,Selangor,0,0,0
2021-03-01,GAB,Johor,0,0,0
2021-03-01,GAB,Pulau Pinang,0,0,0
2021-03-01,GAB,Sarawak,0,0,0
2021-03-01,GAB,Selangor,1,1,0
2021-03-01,GBR,Johor,2,2,0
2021-03-01,GBR,Kedah,0,0,0
2021-03-01,GBR,Kelantan,0,0,0
2021-03-01,GBR,Melaka,0,0,0
2021-03-01,GBR,Negeri Sembilan,0,0,0
2021-03-01,GBR,Pahang,0,0,0
2021-03-01,GBR,Perak,0,0,0
2021-03-01,GBR,Perlis,0,0,0
2021-03-01,GBR,Pulau Pinang,1,1,0
2021-03-01,GBR,Sabah,1,1,0
2021-03-01,GBR,Sarawak,1,1,0
2021-03-01,GBR,Selangor,233,186,47
2021-03-01,GBR,Terengganu,0,0,0
2021-03-01,GBR,W.P. Labuan,0,0,0
2021-03-01,GEO,Johor,2,2,0
2021-03-01,GEO,Kedah,0,0,0
2021-03-01,GEO,Melaka,0,0,0
2021-03-01,GEO,Perak,0,0,0
2021-03-01,GEO,Perlis,0,0,0
2021-03-01,GEO,Pulau Pinang,0,0,0
2021-03-01,GEO,Sabah,0,0,0
2021-03-01,GEO,Sarawak,0,0,0
2021-03-01,GEO,Selangor,3,3,0
2021-03-01,GHA,Johor,0,0,0
2021-03-01,GHA,Kedah,0,0,0
2021-03-01,GHA,Kelantan,0,0,0
2021-03-01,GHA,Pulau Pinang,0,0,0
2021-03-01,GHA,Sabah,1,1,0
2021-03-01,GHA,Sarawak,0,0,0
2021-03-01,GHA,Selangor,8,4,4
2021-03-01,GIB,Johor,0,0,0
2021-03-01,GIB,Sarawak,0,0,0
2021-03-01,GIN,Johor,0,0,0
2021-03-01,GIN,Kedah,0,0,0
2021-03-01,GIN,Kelantan,0,0,0
2021-03-01,GIN,Perlis,0,0,0
2021-03-01,GIN,Pulau Pinang,0,0,0
2021-03-01,GIN,Sabah,0,0,0
2021-03-01,GIN,Sarawak,0,0,0
2021-03-01,GIN,Selangor,11,4,7
2021-03-01,GLP,Selangor,0,0,0
2021-03-01,GMB,Johor,0,0,0
2021-03-01,GMB,Kedah,0,0,0
2021-03-01,GMB,Kelantan,0,0,0
2021-03-01,GMB,Pulau Pinang,0,0,0
2021-03-01,GMB,Sabah,0,0,0
2021-03-01,GMB,Sarawak,0,0,0
2021-03-01,GMB,Selangor,1,1,0
2021-03-01,GNB,Johor,0,0,0
2021-03-01,GNB,Selangor,0,0,0
2021-03-01,GNQ,Johor,0,0,0
2021-03-01,GNQ,Selangor,0,0,0
2021-03-01,GRC,Johor,0,0,0
2021-03-01,GRC,Kedah,0,0,0
2021-03-01,GRC,Kelantan,0,0,0
2021-03-01,GRC,Melaka,0,0,0
2021-03-01,GRC,Negeri Sembilan,0,0,0
2021-03-01,GRC,Pahang,0,0,0
2021-03-01,GRC,Perak,0,0,0
2021-03-01,GRC,Perlis,0,0,0
2021-03-01,GRC,Pulau Pinang,0,0,0
2021-03-01,GRC,Sabah,0,0,0
2021-03-01,GRC,Sarawak,0,0,0
2021-03-01,GRC,Selangor,5,5,0
2021-03-01,GRD,Johor,0,0,0
2021-03-01,GRD,Kedah,0,0,0
2021-03-01,GRD,Pulau Pinang,0,0,0
2021-03-01,GRD,Sabah,0,0,0
2021-03-01,GRD,Sarawak,0,0,0
2021-03-01,GRD,Selangor,0,0,0
2021-03-01,GRL,Johor,0,0,0
2021-03-01,GRL,Selangor,0,0,0
2021-03-01,GTM,Johor,0,0,0
2021-03-01,GTM,Kedah,0,0,0
2021-03-01,GTM,Pahang,0,0,0
2021-03-01,GTM,Perak,0,0,0
2021-03-01,GTM,Pulau Pinang,0,0,0
2021-03-01,GTM,Sabah,0,0,0
2021-03-01,GTM,Sarawak,0,0,0
2021-03-01,GTM,Selangor,0,0,0
2021-03-01,GTM,W.P. Labuan,0,0,0
2021-03-01,GUY,Johor,0,0,0
2021-03-01,GUY,Kedah,0,0,0
2021-03-01,GUY,Pulau Pinang,0,0,0
2021-03-01,GUY,Sarawak,0,0,0
2021-03-01,GUY,Selangor,0,0,0
2021-03-01,HKG,Johor,0,0,0
2021-03-01,HKG,Kedah,0,0,0
2021-03-01,HKG,Kelantan,0,0,0
2021-03-01,HKG,Pahang,0,0,0
2021-03-01,HKG,Perak,0,0,0
2021-03-01,HKG,Perlis,0,0,0
2021-03-01,HKG,Pulau Pinang,5,2,3
2021-03-01,HKG,Sabah,0,0,0
2021-03-01,HKG,Sarawak,0,0,0
2021-03-01,HKG,Selangor,0,0,0
2021-03-01,HKG,Terengganu,0,0,0
2021-03-01,HMD,Johor,0,0,0
2021-03-01,HND,Johor,0,0,0
2021-03-01,HND,Kedah,0,0,0
2021-03-01,HND,Perak,0,0,0
2021-03-01,HND,Pulau Pinang,0,0,0
2021-03-01,HND,Sabah,0,0,0
2021-03-01,HND,Sarawak,0,0,0
2021-03-01,HND,Selangor,0,0,0
2021-03-01,HRV,Johor,4,4,0
2021-03-01,HRV,Kedah,0,0,0
2021-03-01,HRV,Kelantan,0,0,0
2021-03-01,HRV,Melaka,0,0,0
2021-03-01,HRV,Pahang,0,0,0
2021-03-01,HRV,Perak,0,0,0
2021-03-01,HRV,Perlis,0,0,0
2021-03-01,HRV,Pulau Pinang,0,0,0
2021-03-01,HRV,Sabah,0,0,0
2021-03-01,HRV,Sarawak,0,0,0
2021-03-01,HRV,Selangor,45,41,4
2021-03-01,HTI,Johor,0,0,0
2021-03-01,HTI,Kedah,0,0,0
2021-03-01,HTI,Kelantan,0,0,0
2021-03-01,HTI,Perak,0,0,0
2021-03-01,HTI,Pulau Pinang,0,0,0
2021-03-01,HTI,Sabah,0,0,0
2021-03-01,HTI,Selangor,0,0,0
2021-03-01,HUN,Johor,0,0,0
2021-03-01,HUN,Kedah,0,0,0
2021-03-01,HUN,Kelantan,0,0,0
2021-03-01,HUN,Pahang,0,0,0
2021-03-01,HUN,Perak,0,0,0
2021-03-01,HUN,Perlis,0,0,0
2021-03-01,HUN,Pulau Pinang,0,0,0
2021-03-01,HUN,Sabah,0,0,0
2021-03-01,HUN,Sarawak,0,0,0
2021-03-01,HUN,Selangor,5,1,4
2021-03-01,HUN,W.P. Labuan,0,0,0
2021-03-01,IDN,Johor,322,254,68
2021-03-01,IDN,Kedah,6,6,0
2021-03-01,IDN,Kelantan,0,0,0
2021-03-01,IDN,Melaka,2,0,2
2021-03-01,IDN,Negeri Sembilan,0,0,0
2021-03-01,IDN,Pahang,1,1,0
2021-03-01,IDN,Perak,0,0,0
2021-03-01,IDN,Perlis,9,9,0
2021-03-01,IDN,Pulau Pinang,25,12,13
2021-03-01,IDN,Sabah,1,1,0
2021-03-01,IDN,Sarawak,488,488,0
2021-03-01,IDN,Selangor,1234,703,531
2021-03-01,IDN,Terengganu,0,0,0
2021-03-01,IDN,W.P. Labuan,2,0,2
2021-03-01,IND,Johor,117,116,1
2021-03-01,IND,Kedah,0,0,0
2021-03-01,IND,Kelantan,0,0,0
2021-03-01,IND,Melaka,0,0,0
2021-03-01,IND,Negeri Sembilan,0,0,0
2021-03-01,IND,Pahang,0,0,0
2021-03-01,IND,Perak,0,0,0
2021-03-01,IND,Perlis,0,0,0
2021-03-01,IND,Pulau Pinang,1,1,0
2021-03-01,IND,Sabah,0,0,0
2021-03-01,IND,Sarawak,0,0,0
2021-03-01,IND,Selangor,1441,1036,405
2021-03-01,IND,Terengganu,0,0,0
2021-03-01,IND,W.P. Labuan,0,0,0
2021-03-01,IOT,Pulau Pinang,0,0,0
2021-03-01,IOT,Selangor,0,0,0
2021-03-01,IRL,Johor,0,0,0
2021-03-01,IRL,Kedah,0,0,0
2021-03-01,IRL,Kelantan,0,0,0
2021-03-01,IRL,Negeri Sembilan,0,0,0
2021-03-01,IRL,Pahang,0,0,0
2021-03-01,IRL,Perak,0,0,0
2021-03-01,IRL,Perlis,0,0,0
2021-03-01,IRL,Pulau Pinang,0,0,0
2021-03-01,IRL,Sabah,0,0,0
2021-03-01,IRL,Sarawak,0,0,0
2021-03-01,IRL,Selangor,17,10,7
2021-03-01,IRL,Terengganu,0,0,0
2021-03-01,IRL,W.P. Labuan,0,0,0
2021-03-01,IRN,Johor,0,0,0
2021-03-01,IRN,Kedah,0,0,0
2021-03-01,IRN,Kelantan,0,0,0
2021-03-01,IRN,Perak,0,0,0
2021-03-01,IRN,Perlis,0,0,0
2021-03-01,IRN,Pulau Pinang,0,0,0
2021-03-01,IRN,Sabah,0,0,0
2021-03-01,IRN,Sarawak,0,0,0
2021-03-01,IRN,Selangor,51,33,18
2021-03-01,IRN,W.P. Labuan,0,0,0
2021-03-01,IRQ,Johor,0,0,0
2021-03-01,IRQ,Kedah,0,0,0
2021-03-01,IRQ,Kelantan,0,0,0
2021-03-01,IRQ,Melaka,0,0,0
2021-03-01,IRQ,Pahang,0,0,0
2021-03-01,IRQ,Perak,0,0,0
2021-03-01,IRQ,Perlis,0,0,0
2021-03-01,IRQ,Pulau Pinang,0,0,0
2021-03-01,IRQ,Sabah,0,0,0
2021-03-01,IRQ,Sarawak,0,0,0
2021-03-01,IRQ,Selangor,52,41,11
2021-03-01,ISL,Johor,0,0,0
2021-03-01,ISL,Kedah,0,0,0
2021-03-01,ISL,Kelantan,0,0,0
2021-03-01,ISL,Perak,0,0,0
2021-03-01,ISL,Perlis,0,0,0
2021-03-01,ISL,Pulau Pinang,0,0,0
2021-03-01,ISL,Sabah,0,0,0
2021-03-01,ISL,Sarawak,0,0,0
2021-03-01,ISL,Selangor,0,0,0
2021-03-01,ISL,W.P. Labuan,0,0,0
2021-03-01,ISR,Pulau Pinang,0,0,0
2021-03-01,ITA,Johor,0,0,0
2021-03-01,ITA,Kedah,0,0,0
2021-03-01,ITA,Kelantan,0,0,0
2021-03-01,ITA,Melaka,0,0,0
2021-03-01,ITA,Negeri Sembilan,0,0,0
2021-03-01,ITA,Pahang,0,0,0
2021-03-01,ITA,Perak,0,0,0
2021-03-01,ITA,Perlis,0,0,0
2021-03-01,ITA,Pulau Pinang,0,0,0
2021-03-01,ITA,Sabah,0,0,0
2021-03-01,ITA,Sarawak,1,1,0
2021-03-01,ITA,Selangor,26,19,7
2021-03-01,ITA,W.P. Labuan,0,0,0
2021-03-01,JAM,Johor,0,0,0
2021-03-01,JAM,Kedah,0,0,0
2021-03-01,JAM,Perak,0,0,0
2021-03-01,JAM,Pulau Pinang,0,0,0
2021-03-01,JAM,Sabah,0,0,0
2021-03-01,JAM,Sarawak,0,0,0
2021-03-01,JAM,Selangor,0,0,0
2021-03-01,JAM,W.P. Labuan,0,0,0
2021-03-01,JOR,Johor,0,0,0
2021-03-01,JOR,Kedah,0,0,0
2021-03-01,JOR,Kelantan,0,0,0
2021-03-01,JOR,Melaka,0,0,0
2021-03-01,JOR,Perlis,0,0,0
2021-03-01,JOR,Pulau Pinang,0,0,0
2021-03-01,JOR,Sabah,0,0,0
2021-03-01,JOR,Sarawak,0,0,0
2021-03-01,JOR,Selangor,43,33,10
2021-03-01,JOR,W.P. Labuan,0,0,0
2021-03-01,JPN,Johor,2,2,0
2021-03-01,JPN,Kedah,0,0,0
2021-03-01,JPN,Kelantan,0,0,0
2021-03-01,JPN,Melaka,0,0,0
2021-03-01,JPN,Negeri Sembilan,0,0,0
2021-03-01,JPN,Pahang,0,0,0
2021-03-01,JPN,Perak,0,0,0
2021-03-01,JPN,Perlis,0,0,0
2021-03-01,JPN,Pulau Pinang,37,26,11
2021-03-01,JPN,Sabah,0,0,0
2021-03-01,JPN,Sarawak,1,1,0
2021-03-01,JPN,Selangor,386,262,124
2021-03-01,JPN,W.P. Labuan,0,0,0
2021-03-01,KAZ,Johor,0,0,0
2021-03-01,KAZ,Kedah,0,0,0
2021-03-01,KAZ,Kelantan,0,0,0
2021-03-01,KAZ,Melaka,0,0,0
2021-03-01,KAZ,Perak,0,0,0
2021-03-01,KAZ,Perlis,0,0,0
2021-03-01,KAZ,Pulau Pinang,0,0,0
2021-03-01,KAZ,Sabah,0,0,0
2021-03-01,KAZ,Sarawak,0,0,0
2021-03-01,KAZ,Selangor,20,8,12
2021-03-01,KAZ,W.P. Labuan,0,0,0
2021-03-01,KEN,Johor,0,0,0
2021-03-01,KEN,Kedah,0,0,0
2021-03-01,KEN,Kelantan,0,0,0
2021-03-01,KEN,Perak,0,0,0
2021-03-01,KEN,Perlis,0,0,0
2021-03-01,KEN,Pulau Pinang,0,0,0
2021-03-01,KEN,Sabah,0,0,0
2021-03-01,KEN,Sarawak,0,0,0
2021-03-01,KEN,Selangor,33,14,19
2021-03-01,KGZ,Johor,0,0,0
2021-03-01,KGZ,Kedah,0,0,0
2021-03-01,KGZ,Kelantan,0,0,0
2021-03-01,KGZ,Perak,0,0,0
2021-03-01,KGZ,Perlis,0,0,0
2021-03-01,KGZ,Pulau Pinang,0,0,0
2021-03-01,KGZ,Sabah,0,0,0
2021-03-01,KGZ,Sarawak,0,0,0
2021-03-01,KGZ,Selangor,6,5,1
2021-03-01,KHM,Johor,0,0,0
2021-03-01,KHM,Kedah,0,0,0
2021-03-01,KHM,Kelantan,0,0,0
2021-03-01,KHM,Melaka,0,0,0
2021-03-01,KHM,Negeri Sembilan,0,0,0
2021-03-01,KHM,Pahang,0,0,0
2021-03-01,KHM,Perak,0,0,0
2021-03-01,KHM,Perlis,0,0,0
2021-03-01,KHM,Pulau Pinang,0,0,0
2021-03-01,KHM,Sabah,0,0,0
2021-03-01,KHM,Sarawak,0,0,0
2021-03-01,KHM,Selangor,12,3,9
2021-03-01,KHM,W.P. Labuan,0,0,0
2021-03-01,KIR,Johor,0,0,0
2021-03-01,KIR,Sabah,0,0,0
2021-03-01,KIR,Selangor,4,4,0
2021-03-01,KNA,Johor,0,0,0
2021-03-01,KNA,Kedah,0,0,0
2021-03-01,KNA,Perlis,0,0,0
2021-03-01,KNA,Pulau Pinang,0,0,0
2021-03-01,KNA,Sabah,0,0,0
2021-03-01,KNA,Selangor,0,0,0
2021-03-01,KNA,W.P. Labuan,0,0,0
2021-03-01,KOR,Johor,1,1,0
2021-03-01,KOR,Kedah,0,0,0
2021-03-01,KOR,Kelantan,0,0,0
2021-03-01,KOR,Melaka,0,0,0
2021-03-01,KOR,Negeri Sembilan,0,0,0
2021-03-01,KOR,Pahang,0,0,0
2021-03-01,KOR,Perak,0,0,0
2021-03-01,KOR,Perlis,0,0,0
2021-03-01,KOR,Pulau Pinang,1,1,0
2021-03-01,KOR,Sabah,1,1,0
2021-03-01,KOR,Sarawak,2,2,0
2021-03-01,KOR,Selangor,339,230,109
2021-03-01,KOR,Terengganu,0,0,0
2021-03-01,KOR,W.P. Labuan,0,0,0
2021-03-01,KWT,Johor,0,0,0
2021-03-01,KWT,Kedah,0,0,0
2021-03-01,KWT,Kelantan,0,0,0
2021-03-01,KWT,Perak,0,0,0
2021-03-01,KWT,Perlis,0,0,0
2021-03-01,KWT,Pulau Pinang,0,0,0
2021-03-01,KWT,Sabah,0,0,0
2021-03-01,KWT,Sarawak,0,0,0
2021-03-01,KWT,Selangor,4,3,1
2021-03-01,KWT,W.P. Labuan,0,0,0
2021-03-01,LAO,Johor,0,0,0
2021-03-01,LAO,Kedah,0,0,0
2021-03-01,LAO,Kelantan,0,0,0
2021-03-01,LAO,Melaka,0,0,0
2021-03-01,LAO,Perak,0,0,0
2021-03-01,LAO,Perlis,0,0,0
2021-03-01,LAO,Pulau Pinang,0,0,0
2021-03-01,LAO,Sabah,0,0,0
2021-03-01,LAO,Sarawak,0,0,0
2021-03-01,LAO,Selangor,2,1,1
2021-03-01,LAO,W.P. Labuan,0,0,0
2021-03-01,LBN,Johor,0,0,0
2021-03-01,LBN,Kedah,0,0,0
2021-03-01,LBN,Kelantan,0,0,0
2021-03-01,LBN,Pahang,0,0,0
2021-03-01,LBN,Perak,0,0,0
2021-03-01,LBN,Perlis,0,0,0
2021-03-01,LBN,Pulau Pinang,0,0,0
2021-03-01,LBN,Sabah,0,0,0
2021-03-01,LBN,Sarawak,0,0,0
2021-03-01,LBN,Selangor,4,3,1
2021-03-01,LBN,W.P. Labuan,0,0,0
2021-03-01,LBR,Johor,0,0,0
2021-03-01,LBR,Kedah,0,0,0
2021-03-01,LBR,Sabah,0,0,0
2021-03-01,LBR,Sarawak,0,0,0
2021-03-01,LBR,Selangor,4,3,1
2021-03-01,LBY,Johor,0,0,0
2021-03-01,LBY,Kedah,0,0,0
2021-03-01,LBY,Perlis,0,0,0
2021-03-01,LBY,Pulau Pinang,0,0,0
2021-03-01,LBY,Sabah,0,0,0
2021-03-01,LBY,Sarawak,0,0,0
2021-03-01,LBY,Selangor,66,59,7
2021-03-01,LCA,Johor,0,0,0
2021-03-01,LCA,Kedah,0,0,0
2021-03-01,LCA,Pulau Pinang,0,0,0
2021-03-01,LCA,Sarawak,0,0,0
2021-03-01,LCA,Selangor,0,0,0
2021-03-01,LIE,Johor,0,0,0
2021-03-01,LIE,Kedah,0,0,0
2021-03-01,LIE,Perlis,0,0,0
2021-03-01,LIE,Pulau Pinang,0,0,0
2021-03-01,LIE,Sabah,0,0,0
2021-03-01,LIE,Sarawak,0,0,0
2021-03-01,LIE,Selangor,0,0,0
2021-03-01,LKA,Johor,1,1,0
2021-03-01,LKA,Kedah,0,0,0
2021-03-01,LKA,Kelantan,0,0,0
2021-03-01,LKA,Melaka,0,0,0
2021-03-01,LKA,Pahang,0,0,0
2021-03-01,LKA,Perak,0,0,0
2021-03-01,LKA,Perlis,0,0,0
2021-03-01,LKA,Pulau Pinang,0,0,0
2021-03-01,LKA,Sabah,1,1,0
2021-03-01,LKA,Sarawak,0,0,0
2021-03-01,LKA,Selangor,119,62,57
2021-03-01,LKA,W.P. Labuan,0,0,0
2021-03-01,LSO,Johor,0,0,0
2021-03-01,LSO,Kedah,0,0,0
2021-03-01,LSO,Pulau Pinang,0,0,0
2021-03-01,LSO,Sarawak,0,0,0
2021-03-01,LSO,Selangor,0,0,0
2021-03-01,LTU,Johor,0,0,0
2021-03-01,LTU,Kedah,0,0,0
2021-03-01,LTU,Kelantan,0,0,0
2021-03-01,LTU,Pahang,0,0,0
2021-03-01,LTU,Perak,0,0,0
2021-03-01,LTU,Perlis,0,0,0
2021-03-01,LTU,Pulau Pinang,0,0,0
2021-03-01,LTU,Sabah,0,0,0
2021-03-01,LTU,Sarawak,0,0,0
2021-03-01,LTU,Selangor,1,1,0
2021-03-01,LTU,W.P. Labuan,0,0,0
2021-03-01,LUX,Johor,0,0,0
2021-03-01,LUX,Kedah,0,0,0
2021-03-01,LUX,Kelantan,0,0,0
2021-03-01,LUX,Perak,0,0,0
2021-03-01,LUX,Perlis,0,0,0
2021-03-01,LUX,Pulau Pinang,0,0,0
2021-03-01,LUX,Sabah,0,0,0
2021-03-01,LUX,Sarawak,0,0,0
2021-03-01,LUX,Selangor,0,0,0
2021-03-01,LVA,Johor,0,0,0
2021-03-01,LVA,Kedah,0,0,0
2021-03-01,LVA,Kelantan,0,0,0
2021-03-01,LVA,Pahang,0,0,0
2021-03-01,LVA,Perak,0,0,0
2021-03-01,LVA,Perlis,0,0,0
2021-03-01,LVA,Pulau Pinang,0,0,0
2021-03-01,LVA,Sabah,0,0,0
2021-03-01,LVA,Sarawak,0,0,0
2021-03-01,LVA,Selangor,12,11,1
2021-03-01,LVA,W.P. Labuan,0,0,0
2021-03-01,MAC,Johor,0,0,0
2021-03-01,MAC,Pahang,0,0,0
2021-03-01,MAC,Perak,0,0,0
2021-03-01,MAC,Selangor,0,0,0
2021-03-01,MAC,W.P. Labuan,0,0,0
2021-03-01,MAR,Johor,0,0,0
2021-03-01,MAR,Kedah,0,0,0
2021-03-01,MAR,Kelantan,0,0,0
2021-03-01,MAR,Melaka,0,0,0
2021-03-01,MAR,Pahang,0,0,0
2021-03-01,MAR,Perak,0,0,0
2021-03-01,MAR,Perlis,0,0,0
2021-03-01,MAR,Pulau Pinang,0,0,0
2021-03-01,MAR,Sabah,0,0,0
2021-03-01,MAR,Sarawak,0,0,0
2021-03-01,MAR,Selangor,11,5,6
2021-03-01,MAR,W.P. Labuan,0,0,0
2021-03-01,MCO,Johor,0,0,0
2021-03-01,MCO,Kedah,0,0,0
2021-03-01,MCO,Sabah,0,0,0
2021-03-01,MCO,Selangor,0,0,0
2021-03-01,MDA,Johor,0,0,0
2021-03-01,MDA,Kedah,0,0,0
2021-03-01,MDA,Kelantan,0,0,0
2021-03-01,MDA,Negeri Sembilan,0,0,0
2021-03-01,MDA,Perlis,0,0,0
2021-03-01,MDA,Pulau Pinang,0,0,0
2021-03-01,MDA,Sabah,0,0,0
2021-03-01,MDA,Sarawak,0,0,0
2021-03-01,MDA,Selangor,0,0,0
2021-03-01,MDG,Johor,0,0,0
2021-03-01,MDG,Kedah,0,0,0
2021-03-01,MDG,Perak,0,0,0
2021-03-01,MDG,Perlis,0,0,0
2021-03-01,MDG,Pulau Pinang,0,0,0
2021-03-01,MDG,Sabah,0,0,0
2021-03-01,MDG,Sarawak,0,0,0
2021-03-01,MDG,Selangor,0,0,0
2021-03-01,MDV,Johor,0,0,0
2021-03-01,MDV,Kedah,0,0,0
2021-03-01,MDV,Kelantan,0,0,0
2021-03-01,MDV,Perak,0,0,0
2021-03-01,MDV,Perlis,0,0,0
2021-03-01,MDV,Pulau Pinang,0,0,0
2021-03-01,MDV,Sabah,0,0,0
2021-03-01,MDV,Sarawak,0,0,0
2021-03-01,MDV,Selangor,76,36,40
2021-03-01,MEX,Johor,0,0,0
2021-03-01,MEX,Kedah,0,0,0
2021-03-01,MEX,Kelantan,0,0,0
2021-03-01,MEX,Pahang,0,0,0
2021-03-01,MEX,Perak,0,0,0
2021-03-01,MEX,Perlis,0,0,0
2021-03-01,MEX,Pulau Pinang,0,0,0
2021-03-01,MEX,Sabah,0,0,0
2021-03-01,MEX,Sarawak,0,0,0
2021-03-01,MEX,Selangor,3,3,0
2021-03-01,MEX,W.P. Labuan,0,0,0
2021-03-01,MHL,Johor,0,0,0
2021-03-01,MHL,Kedah,0,0,0
2021-03-01,MHL,Perak,0,0,0
2021-03-01,MHL,Pulau Pinang,0,0,0
2021-03-01,MHL,Sabah,0,0,0
2021-03-01,MHL,Selangor,0,0,0
2021-03-01,MKD,Johor,0,0,0
2021-03-01,MKD,Kedah,0,0,0
2021-03-01,MKD,Perak,0,0,0
2021-03-01,MKD,Pulau Pinang,0,0,0
2021-03-01,MKD,Sabah,0,0,0
2021-03-01,MKD,Sarawak,0,0,0
2021-03-01,MKD,Selangor,1,1,0
2021-03-01,MLI,Johor,0,0,0
2021-03-01,MLI,Sabah,1,1,0
2021-03-01,MLI,Selangor,2,2,0
2021-03-01,MLT,Johor,0,0,0
2021-03-01,MLT,Kedah,0,0,0
2021-03-01,MLT,Kelantan,0,0,0
2021-03-01,MLT,Perak,0,0,0
2021-03-01,MLT,Perlis,0,0,0
2021-03-01,MLT,Pulau Pinang,0,0,0
2021-03-01,MLT,Sabah,0,0,0
2021-03-01,MLT,Sarawak,0,0,0
2021-03-01,MLT,Selangor,2,1,1
2021-03-01,MLT,W.P. Labuan,0,0,0
2021-03-01,MMR,Johor,9,9,0
2021-03-01,MMR,Kedah,0,0,0
2021-03-01,MMR,Kelantan,0,0,0
2021-03-01,MMR,Negeri Sembilan,0,0,0
2021-03-01,MMR,Pahang,0,0,0
2021-03-01,MMR,Perak,0,0,0
2021-03-01,MMR,Perlis,0,0,0
2021-03-01,MMR,Pulau Pinang,0,0,0
2021-03-01,MMR,Sabah,0,0,0
2021-03-01,MMR,Sarawak,0,0,0
2021-03-01,MMR,Selangor,123,101,22
2021-03-01,MMR,Terengganu,0,0,0
2021-03-01,MMR,W.P. Labuan,0,0,0
2021-03-01,MNE,Johor,4,4,0
2021-03-01,MNE,Kedah,0,0,0
2021-03-01,MNE,Pulau Pinang,0,0,0
2021-03-01,MNE,Sabah,0,0,0
2021-03-01,MNE,Sarawak,0,0,0
2021-03-01,MNE,Selangor,15,15,0
2021-03-01,MNG,Johor,0,0,0
2021-03-01,MNG,Kedah,0,0,0
2021-03-01,MNG,Kelantan,0,0,0
2021-03-01,MNG,Perak,0,0,0
2021-03-01,MNG,Perlis,0,0,0
2021-03-01,MNG,Pulau Pinang,0,0,0
2021-03-01,MNG,Sabah,0,0,0
2021-03-01,MNG,Sarawak,0,0,0
2021-03-01,MNG,Selangor,0,0,0
2021-03-01,MNP,Selangor,0,0,0
2021-03-01,MOZ,Johor,0,0,0
2021-03-01,MOZ,Kedah,0,0,0
2021-03-01,MOZ,Perak,0,0,0
2021-03-01,MOZ,Pulau Pinang,0,0,0
2021-03-01,MOZ,Sabah,0,0,0
2021-03-01,MOZ,Sarawak,0,0,0
2021-03-01,MOZ,Selangor,10,7,3
2021-03-01,MRT,Johor,0,0,0
2021-03-01,MRT,Kedah,0,0,0
2021-03-01,MRT,Pulau Pinang,0,0,0
2021-03-01,MRT,Sabah,0,0,0
2021-03-01,MRT,Sarawak,0,0,0
2021-03-01,MRT,Selangor,2,2,0
2021-03-01,MUS,Johor,0,0,0
2021-03-01,MUS,Kedah,0,0,0
2021-03-01,MUS,Kelantan,0,0,0
2021-03-01,MUS,Pahang,0,0,0
2021-03-01,MUS,Perak,0,0,0
2021-03-01,MUS,Perlis,0,0,0
2021-03-01,MUS,Pulau Pinang,0,0,0
2021-03-01,MUS,Sabah,0,0,0
2021-03-01,MUS,Sarawak,0,0,0
2021-03-01,MUS,Selangor,27,7,20
2021-03-01,MWI,Johor,0,0,0
2021-03-01,MWI,Pulau Pinang,0,0,0
2021-03-01,MWI,Sabah,0,0,0
2021-03-01,MWI,Sarawak,0,0,0
2021-03-01,MWI,Selangor,8,4,4
2021-03-01,MYT,Selangor,0,0,0
2021-03-01,NAM,Johor,0,0,0
2021-03-01,NAM,Kedah,0,0,0
2021-03-01,NAM,Perak,0,0,0
2021-03-01,NAM,Perlis,0,0,0
2021-03-01,NAM,Pulau Pinang,0,0,0
2021-03-01,NAM,Sabah,0,0,0
2021-03-01,NAM,Sarawak,0,0,0
2021-03-01,NAM,Selangor,2,0,2
2021-03-01,NCL,Selangor,0,0,0
2021-03-01,NER,Johor,0,0,0
2021-03-01,NER,Sabah,0,0,0
2021-03-01,NER,Selangor,0,0,0
2021-03-01,NGA,Johor,0,0,0
2021-03-01,NGA,Kedah,0,0,0
2021-03-01,NGA,Perlis,0,0,0
2021-03-01,NGA,Pulau Pinang,0,0,0
2021-03-01,NGA,Sabah,0,0,0
2021-03-01,NGA,Sarawak,0,0,0
2021-03-01,NGA,Selangor,139,129,10
2021-03-01,NIC,Johor,0,0,0
2021-03-01,NIC,Kedah,0,0,0
2021-03-01,NIC,Pulau Pinang,0,0,0
2021-03-01,NIC,Sabah,0,0,0
2021-03-01,NIC,Selangor,0,0,0
2021-03-01,NLD,Johor,0,0,0
2021-03-01,NLD,Kedah,0,0,0
2021-03-01,NLD,Kelantan,0,0,0
2021-03-01,NLD,Melaka,0,0,0
2021-03-01,NLD,Negeri Sembilan,0,0,0
2021-03-01,NLD,Pahang,0,0,0
2021-03-01,NLD,Perak,0,0,0
2021-03-01,NLD,Perlis,0,0,0
2021-03-01,NLD,Pulau Pinang,0,0,0
2021-03-01,NLD,Sabah,0,0,0
2021-03-01,NLD,Sarawak,0,0,0
2021-03-01,NLD,Selangor,46,35,11
2021-03-01,NLD,Terengganu,0,0,0
2021-03-01,NLD,W.P. Labuan,0,0,0
2021-03-01,NOR,Johor,1,1,0
2021-03-01,NOR,Kedah,0,0,0
2021-03-01,NOR,Kelantan,0,0,0
2021-03-01,NOR,Melaka,0,0,0
2021-03-01,NOR,Pahang,0,0,0
2021-03-01,NOR,Perak,0,0,0
2021-03-01,NOR,Perlis,0,0,0
2021-03-01,NOR,Pulau Pinang,0,0,0
2021-03-01,NOR,Sabah,0,0,0
2021-03-01,NOR,Sarawak,0,0,0
2021-03-01,NOR,Selangor,13,12,1
2021-03-01,NOR,W.P. Labuan,0,0,0
2021-03-01,NPL,Johor,0,0,0
2021-03-01,NPL,Kedah,0,0,0
2021-03-01,NPL,Pahang,0,0,0
2021-03-01,NPL,Perak,0,0,0
2021-03-01,NPL,Perlis,0,0,0
2021-03-01,NPL,Pulau Pinang,0,0,0
2021-03-01,NPL,Sabah,0,0,0
2021-03-01,NPL,Sarawak,0,0,0
2021-03-01,NPL,Selangor,49,46,3
2021-03-01,NPL,W.P. Labuan,0,0,0
2021-03-01,NRU,Johor,0,0,0
2021-03-01,NRU,Pulau Pinang,0,0,0
2021-03-01,NRU,Selangor,0,0,0
2021-03-01,NZL,Johor,0,0,0
2021-03-01,NZL,Kedah,0,0,0
2021-03-01,NZL,Kelantan,0,0,0
2021-03-01,NZL,Melaka,0,0,0
2021-03-01,NZL,Negeri Sembilan,0,0,0
2021-03-01,NZL,Pahang,0,0,0
2021-03-01,NZL,Perak,0,0,0
2021-03-01,NZL,Perlis,0,0,0
2021-03-01,NZL,Pulau Pinang,0,0,0
2021-03-01,NZL,Sabah,0,0,0
2021-03-01,NZL,Sarawak,0,0,0
2021-03-01,NZL,Selangor,11,11,0
2021-03-01,NZL,Terengganu,0,0,0
2021-03-01,NZL,W.P. Labuan,0,0,0
2021-03-01,OMN,Johor,0,0,0
2021-03-01,OMN,Kedah,0,0,0
2021-03-01,OMN,Kelantan,0,0,0
2021-03-01,OMN,Melaka,0,0,0
2021-03-01,OMN,Perak,0,0,0
2021-03-01,OMN,Perlis,0,0,0
2021-03-01,OMN,Pulau Pinang,0,0,0
2021-03-01,OMN,Sabah,0,0,0
2021-03-01,OMN,Sarawak,0,0,0
2021-03-01,OMN,Selangor,34,26,8
2021-03-01,PAK,Johor,9,9,0
2021-03-01,PAK,Kedah,0,0,0
2021-03-01,PAK,Kelantan,0,0,0
2021-03-01,PAK,Melaka,0,0,0
2021-03-01,PAK,Negeri Sembilan,0,0,0
2021-03-01,PAK,Pahang,0,0,0
2021-03-01,PAK,Perak,0,0,0
2021-03-01,PAK,Perlis,0,0,0
2021-03-01,PAK,Pulau Pinang,0,0,0
2021-03-01,PAK,Sabah,0,0,0
2021-03-01,PAK,Sarawak,1,1,0
2021-03-01,PAK,Selangor,337,275,62
2021-03-01,PAK,W.P. Labuan,0,0,0
2021-03-01,PAN,Johor,0,0,0
2021-03-01,PAN,Kedah,0,0,0
2021-03-01,PAN,Perak,0,0,0
2021-03-01,PAN,Perlis,0,0,0
2021-03-01,PAN,Pulau Pinang,0,0,0
2021-03-01,PAN,Sabah,0,0,0
2021-03-01,PAN,Sarawak,0,0,0
2021-03-01,PAN,Selangor,0,0,0
2021-03-01,PER,Johor,0,0,0
2021-03-01,PER,Kedah,0,0,0
2021-03-01,PER,Kelantan,0,0,0
2021-03-01,PER,Pahang,0,0,0
2021-03-01,PER,Perak,0,0,0
2021-03-01,PER,Perlis,0,0,0
2021-03-01,PER,Pulau Pinang,0,0,0
2021-03-01,PER,Sabah,0,0,0
2021-03-01,PER,Sarawak,0,0,0
2021-03-01,PER,Selangor,0,0,0
2021-03-01,PER,W.P. Labuan,0,0,0
2021-03-01,PHL,Johor,97,94,3
2021-03-01,PHL,Kedah,0,0,0
2021-03-01,PHL,Kelantan,0,0,0
2021-03-01,PHL,Melaka,0,0,0
2021-03-01,PHL,Negeri Sembilan,0,0,0
2021-03-01,PHL,Pahang,0,0,0
2021-03-01,PHL,Perak,0,0,0
2021-03-01,PHL,Perlis,0,0,0
2021-03-01,PHL,Pulau Pinang,1,0,1
2021-03-01,PHL,Sabah,0,0,0
2021-03-01,PHL,Sarawak,66,66,0
2021-03-01,PHL,Selangor,467,368,99
2021-03-01,PHL,Terengganu,0,0,0
2021-03-01,PHL,W.P. Labuan,3,3,0
2021-03-01,PLW,Johor,0,0,0
2021-03-01,PLW,Pulau Pinang,0,0,0
2021-03-01,PLW,Selangor,0,0,0
2021-03-01,PNG,Johor,0,0,0
2021-03-01,PNG,Kedah,0,0,0
2021-03-01,PNG,Kelantan,0,0,0
2021-03-01,PNG,Perak,0,0,0
2021-03-01,PNG,Pulau Pinang,0,0,0
2021-03-01,PNG,Sabah,0,0,0
2021-03-01,PNG,Sarawak,0,0,0
2021-03-01,PNG,Selangor,0,0,0
2021-03-01,POL,Johor,1,1,0
2021-03-01,POL,Kedah,0,0,0
2021-03-01,POL,Kelantan,0,0,0
2021-03-01,POL,Melaka,0,0,0
2021-03-01,POL,Negeri Sembilan,0,0,0
2021-03-01,POL,Pahang,0,0,0
2021-03-01,POL,Perak,0,0,0
2021-03-01,POL,Perlis,0,0,0
2021-03-01,POL,Pulau Pinang,0,0,0
2021-03-01,POL,Sabah,1,1,0
2021-03-01,POL,Sarawak,0,0,0
2021-03-01,POL,Selangor,27,23,4
2021-03-01,POL,Terengganu,0,0,0
2021-03-01,POL,W.P. Labuan,0,0,0
2021-03-01,PRK,Selangor,1,1,0
2021-03-01,PRT,Johor,0,0,0
2021-03-01,PRT,Kedah,0,0,0
2021-03-01,PRT,Kelantan,0,0,0
2021-03-01,PRT,Melaka,0,0,0
2021-03-01,PRT,Pahang,0,0,0
2021-03-01,PRT,Perak,0,0,0
2021-03-01,PRT,Perlis,0,0,0
2021-03-01,PRT,Pulau Pinang,0,0,0
2021-03-01,PRT,Sabah,0,0,0
2021-03-01,PRT,Sarawak,0,0,0
2021-03-01,PRT,Selangor,6,2,4
2021-03-01,PRT,W.P. Labuan,0,0,0
2021-03-01,PRY,Johor,0,0,0
2021-03-01,PRY,Kedah,0,0,0
2021-03-01,PRY,Perak,0,0,0
2021-03-01,PRY,Perlis,0,0,0
2021-03-01,PRY,Pulau Pinang,0,0,0
2021-03-01,PRY,Sabah,0,0,0
2021-03-01,PRY,Sarawak,0,0,0
2021-03-01,PRY,Selangor,0,0,0
2021-03-01,PSE,Johor,0,0,0
2021-03-01,PSE,Kedah,0,0,0
2021-03-01,PSE,Kelantan,0,0,0
2021-03-01,PSE,Melaka,0,0,0
2021-03-01,PSE,Perak,0,0,0
2021-03-01,PSE,Perlis,0,0,0
2021-03-01,PSE,Pulau Pinang,0,0,0
2021-03-01,PSE,Sabah,0,0,0
2021-03-01,PSE,Sarawak,0,0,0
2021-03-01,PSE,Selangor,20,17,3
2021-03-01,QAT,Johor,0,0,0
2021-03-01,QAT,Kedah,0,0,0
2021-03-01,QAT,Perlis,0,0,0
2021-03-01,QAT,Pulau Pinang,0,0,0
2021-03-01,QAT,Sabah,0,0,0
2021-03-01,QAT,Sarawak,0,0,0
2021-03-01,QAT,Selangor,8,6,2
2021-03-01,REU,Johor,0,0,0
2021-03-01,REU,Sarawak,0,0,0
2021-03-01,ROU,Johor,0,0,0
2021-03-01,ROU,Kedah,0,0,0
2021-03-01,ROU,Kelantan,0,0,0
2021-03-01,ROU,Negeri Sembilan,0,0,0
2021-03-01,ROU,Pahang,0,0,0
2021-03-01,ROU,Perak,0,0,0
2021-03-01,ROU,Perlis,0,0,0
2021-03-01,ROU,Pulau Pinang,0,0,0
2021-03-01,ROU,Sabah,0,0,0
2021-03-01,ROU,Sarawak,0,0,0
2021-03-01,ROU,Selangor,28,24,4
2021-03-01,ROU,W.P. Labuan,0,0,0
2021-03-01,RUS,Johor,0,0,0
2021-03-01,RUS,Kedah,0,0,0
2021-03-01,RUS,Kelantan,0,0,0
2021-03-01,RUS,Melaka,0,0,0
2021-03-01,RUS,Negeri Sembilan,0,0,0
2021-03-01,RUS,Pahang,0,0,0
2021-03-01,RUS,Perak,0,0,0
2021-03-01,RUS,Perlis,0,0,0
2021-03-01,RUS,Pulau Pinang,0,0,0
2021-03-01,RUS,Sabah,0,0,0
2021-03-01,RUS,Sarawak,0,0,0
2021-03-01,RUS,Selangor,58,45,13
2021-03-01,RUS,W.P. Labuan,0,0,0
2021-03-01,RWA,Johor,0,0,0
2021-03-01,RWA,Kedah,0,0,0
2021-03-01,RWA,Pulau Pinang,0,0,0
2021-03-01,RWA,Selangor,0,0,0
2021-03-01,SAU,Johor,0,0,0
2021-03-01,SAU,Kedah,0,0,0
2021-03-01,SAU,Kelantan,0,0,0
2021-03-01,SAU,Melaka,0,0,0
2021-03-01,SAU,Perak,0,0,0
2021-03-01,SAU,Perlis,0,0,0
2021-03-01,SAU,Pulau Pinang,0,0,0
2021-03-01,SAU,Sabah,0,0,0
2021-03-01,SAU,Sarawak,0,0,0
2021-03-01,SAU,Selangor,81,46,35
2021-03-01,SAU,W.P. Labuan,0,0,0
2021-03-01,SDN,Johor,0,0,0
2021-03-01,SDN,Kedah,0,0,0
2021-03-01,SDN,Kelantan,0,0,0
2021-03-01,SDN,Perlis,0,0,0
2021-03-01,SDN,Pulau Pinang,0,0,0
2021-03-01,SDN,Sabah,0,0,0
2021-03-01,SDN,Sarawak,0,0,0
2021-03-01,SDN,Selangor,59,40,19
2021-03-01,SDN,W.P. Labuan,0,0,0
2021-03-01,SEN,Johor,0,0,0
2021-03-01,SEN,Kedah,0,0,0
2021-03-01,SEN,Kelantan,0,0,0
2021-03-01,SEN,Perak,0,0,0
2021-03-01,SEN,Perlis,0,0,0
2021-03-01,SEN,Pulau Pinang,0,0,0
2021-03-01,SEN,Sabah,0,0,0
2021-03-01,SEN,Sarawak,0,0,0
2021-03-01,SEN,Selangor,3,2,1
2021-03-01,SGP,Johor,297,261,36
2021-03-01,SGP,Kedah,0,0,0
2021-03-01,SGP,Kelantan,0,0,0
2021-03-01,SGP,Melaka,0,0,0
2021-03-01,SGP,Negeri Sembilan,0,0,0
2021-03-01,SGP,Pahang,0,0,0
2021-03-01,SGP,Perak,2,0,2
2021-03-01,SGP,Perlis,0,0,0
2021-03-01,SGP,Pulau Pinang,23,13,10
2021-03-01,SGP,Sabah,0,0,0
2021-03-01,SGP,Sarawak,8,4,4
2021-03-01,SGP,Selangor,163,116,47
2021-03-01,SGP,Terengganu,0,0,0
2021-03-01,SGP,W.P. Labuan,0,0,0
2021-03-01,SGS,Johor,0,0,0
2021-03-01,SGS,Sabah,0,0,0
2021-03-01,SGS,Selangor,0,0,0
2021-03-01,SHN,Sarawak,0,0,0
2021-03-01,SLB,Johor,0,0,0
2021-03-01,SLB,Perlis,0,0,0
2021-03-01,SLB,Pulau Pinang,0,0,0
2021-03-01,SLB,Sabah,0,0,0
2021-03-01,SLB,Sarawak,0,0,0
2021-03-01,SLB,Selangor,0,0,0
2021-03-01,SLB,W.P. Labuan,0,0,0
2021-03-01,SLE,Johor,0,0,0
2021-03-01,SLE,Kedah,0,0,0
2021-03-01,SLE,Perak,0,0,0
2021-03-01,SLE,Pulau Pinang,0,0,0
2021-03-01,SLE,Sabah,0,0,0
2021-03-01,SLE,Selangor,5,0,5
2021-03-01,SLV,Johor,0,0,0
2021-03-01,SLV,Kedah,0,0,0
2021-03-01,SLV,Perak,0,0,0
2021-03-01,SLV,Perlis,0,0,0
2021-03-01,SLV,Pulau Pinang,0,0,0
2021-03-01,SLV,Sabah,0,0,0
2021-03-01,SLV,Selangor,1,1,0
2021-03-01,SLV,W.P. Labuan,0,0,0
2021-03-01,SMR,Johor,0,0,0
2021-03-01,SMR,Selangor,0,0,0
2021-03-01,SOM,Johor,0,0,0
2021-03-01,SOM,Kedah,0,0,0
2021-03-01,SOM,Kelantan,0,0,0
2021-03-01,SOM,Perlis,0,0,0
2021-03-01,SOM,Sabah,0,0,0
2021-03-01,SOM,Sarawak,0,0,0
2021-03-01,SOM,Selangor,36,26,10
2021-03-01,SRB,Johor,0,0,0
2021-03-01,SRB,Kedah,0,0,0
2021-03-01,SRB,Kelantan,0,0,0
2021-03-01,SRB,Pahang,0,0,0
2021-03-01,SRB,Perak,0,0,0
2021-03-01,SRB,Perlis,0,0,0
2021-03-01,SRB,Pulau Pinang,0,0,0
2021-03-01,SRB,Sabah,0,0,0
2021-03-01,SRB,Sarawak,0,0,0
2021-03-01,SRB,Selangor,1,1,0
2021-03-01,SSD,Johor,0,0,0
2021-03-01,SSD,Kedah,0,0,0
2021-03-01,SSD,Sarawak,0,0,0
2021-03-01,SSD,Selangor,13,11,2
2021-03-01,SSD,W.P. Labuan,0,0,0
2021-03-01,STP,Selangor,0,0,0
2021-03-01,SUR,Johor,0,0,0
2021-03-01,SUR,Kedah,0,0,0
2021-03-01,SUR,Kelantan,0,0,0
2021-03-01,SUR,Perak,0,0,0
2021-03-01,SUR,Perlis,0,0,0
2021-03-01,SUR,Pulau Pinang,0,0,0
2021-03-01,SUR,Sabah,0,0,0
2021-03-01,SUR,Sarawak,0,0,0
2021-03-01,SUR,Selangor,0,0,0
2021-03-01,SVK,Johor,0,0,0
2021-03-01,SVK,Kedah,0,0,0
2021-03-01,SVK,Kelantan,0,0,0
2021-03-01,SVK,Negeri Sembilan,0,0,0
2021-03-01,SVK,Pahang,0,0,0
2021-03-01,SVK,Perak,0,0,0
2021-03-01,SVK,Perlis,0,0,0
2021-03-01,SVK,Pulau Pinang,0,0,0
2021-03-01,SVK,Sabah,0,0,0
2021-03-01,SVK,Sarawak,0,0,0
2021-03-01,SVK,Selangor,12,10,2
2021-03-01,SVK,W.P. Labuan,0,0,0
2021-03-01,SVN,Johor,0,0,0
2021-03-01,SVN,Kedah,0,0,0
2021-03-01,SVN,Kelantan,0,0,0
2021-03-01,SVN,Perak,0,0,0
2021-03-01,SVN,Perlis,0,0,0
2021-03-01,SVN,Pulau Pinang,0,0,0
2021-03-01,SVN,Sabah,0,0,0
2021-03-01,SVN,Sarawak,0,0,0
2021-03-01,SVN,Selangor,2,2,0
2021-03-01,SVN,W.P. Labuan,0,0,0
2021-03-01,SWE,Johor,0,0,0
2021-03-01,SWE,Kedah,0,0,0
2021-03-01,SWE,Kelantan,0,0,0
2021-03-01,SWE,Melaka,0,0,0
2021-03-01,SWE,Negeri Sembilan,0,0,0
2021-03-01,SWE,Pahang,0,0,0
2021-03-01,SWE,Perak,0,0,0
2021-03-01,SWE,Perlis,0,0,0
2021-03-01,SWE,Pulau Pinang,0,0,0
2021-03-01,SWE,Sabah,0,0,0
2021-03-01,SWE,Sarawak,0,0,0
2021-03-01,SWE,Selangor,28,26,2
2021-03-01,SWE,W.P. Labuan,0,0,0
2021-03-01,SWZ,Johor,0,0,0
2021-03-01,SWZ,Kedah,0,0,0
2021-03-01,SWZ,Pulau Pinang,0,0,0
2021-03-01,SWZ,Sabah,0,0,0
2021-03-01,SWZ,Selangor,3,0,3
2021-03-01,SYC,Johor,0,0,0
2021-03-01,SYC,Kedah,0,0,0
2021-03-01,SYC,Pulau Pinang,0,0,0
2021-03-01,SYC,Sabah,0,0,0
2021-03-01,SYC,Sarawak,0,0,0
2021-03-01,SYC,Selangor,13,8,5
2021-03-01,SYR,Johor,0,0,0
2021-03-01,SYR,Kedah,0,0,0
2021-03-01,SYR,Kelantan,0,0,0
2021-03-01,SYR,Pahang,0,0,0
2021-03-01,SYR,Perlis,0,0,0
2021-03-01,SYR,Pulau Pinang,0,0,0
2021-03-01,SYR,Sabah,0,0,0
2021-03-01,SYR,Sarawak,0,0,0
2021-03-01,SYR,Selangor,51,30,21
2021-03-01,SYR,W.P. Labuan,0,0,0
2021-03-01,TCA,Perlis,0,0,0
2021-03-01,TCD,Johor,0,0,0
2021-03-01,TCD,Kedah,0,0,0
2021-03-01,TCD,Perlis,0,0,0
2021-03-01,TCD,Selangor,2,2,0
2021-03-01,TGO,Johor,0,0,0
2021-03-01,TGO,Perak,0,0,0
2021-03-01,TGO,Pulau Pinang,0,0,0
2021-03-01,TGO,Selangor,0,0,0
2021-03-01,THA,Johor,0,0,0
2021-03-01,THA,Kedah,19195,19146,49
2021-03-01,THA,Kelantan,4,2,2
2021-03-01,THA,Melaka,0,0,0
2021-03-01,THA,Negeri Sembilan,0,0,0
2021-03-01,THA,Pahang,0,0,0
2021-03-01,THA,Perak,2,0,2
2021-03-01,THA,Perlis,10965,10607,358
2021-03-01,THA,Pulau Pinang,19,17,2
2021-03-01,THA,Sabah,0,0,0
2021-03-01,THA,Sarawak,11,10,1
2021-03-01,THA,Selangor,369,223,146
2021-03-01,THA,Terengganu,0,0,0
2021-03-01,THA,W.P. Labuan,0,0,0
2021-03-01,TJK,Johor,0,0,0
2021-03-01,TJK,Kedah,0,0,0
2021-03-01,TJK,Perlis,0,0,0
2021-03-01,TJK,Pulau Pinang,0,0,0
2021-03-01,TJK,Sabah,0,0,0
2021-03-01,TJK,Selangor,1,1,0
2021-03-01,TKL,Selangor,0,0,0
2021-03-01,TKM,Johor,0,0,0
2021-03-01,TKM,Kedah,0,0,0
2021-03-01,TKM,Kelantan,0,0,0
2021-03-01,TKM,Perlis,0,0,0
2021-03-01,TKM,Pulau Pinang,0,0,0
2021-03-01,TKM,Sabah,0,0,0
2021-03-01,TKM,Sarawak,0,0,0
2021-03-01,TKM,Selangor,0,0,0
2021-03-01,TLS,Johor,0,0,0
2021-03-01,TLS,Kedah,0,0,0
2021-03-01,TLS,Perlis,0,0,0
2021-03-01,TLS,Pulau Pinang,0,0,0
2021-03-01,TLS,Sabah,0,0,0
2021-03-01,TLS,Sarawak,0,0,0
2021-03-01,TLS,Selangor,1,0,1
2021-03-01,TON,Johor,0,0,0
2021-03-01,TON,Pulau Pinang,0,0,0
2021-03-01,TON,Sarawak,0,0,0
2021-03-01,TON,Selangor,0,0,0
2021-03-01,TTO,Johor,0,0,0
2021-03-01,TTO,Kedah,0,0,0
2021-03-01,TTO,Pahang,0,0,0
2021-03-01,TTO,Pulau Pinang,0,0,0
2021-03-01,TTO,Sabah,0,0,0
2021-03-01,TTO,Sarawak,0,0,0
2021-03-01,TTO,Selangor,0,0,0
2021-03-01,TUN,Johor,0,0,0
2021-03-01,TUN,Kedah,0,0,0
2021-03-01,TUN,Kelantan,0,0,0
2021-03-01,TUN,Melaka,0,0,0
2021-03-01,TUN,Perak,0,0,0
2021-03-01,TUN,Perlis,0,0,0
2021-03-01,TUN,Pulau Pinang,0,0,0
2021-03-01,TUN,Sabah,0,0,0
2021-03-01,TUN,Sarawak,0,0,0
2021-03-01,TUN,Selangor,9,2,7
2021-03-01,TUN,W.P. Labuan,0,0,0
2021-03-01,TUR,Johor,0,0,0
2021-03-01,TUR,Kedah,0,0,0
2021-03-01,TUR,Kelantan,0,0,0
2021-03-01,TUR,Melaka,0,0,0
2021-03-01,TUR,Negeri Sembilan,0,0,0
2021-03-01,TUR,Pahang,0,0,0
2021-03-01,TUR,Perak,0,0,0
2021-03-01,TUR,Perlis,0,0,0
2021-03-01,TUR,Pulau Pinang,0,0,0
2021-03-01,TUR,Sabah,0,0,0
2021-03-01,TUR,Sarawak,0,0,0
2021-03-01,TUR,Selangor,30,25,5
2021-03-01,TUR,W.P. Labuan,0,0,0
2021-03-01,TUV,Selangor,0,0,0
2021-03-01,TWN,Johor,0,0,0
2021-03-01,TWN,Kedah,0,0,0
2021-03-01,TWN,Kelantan,0,0,0
2021-03-01,TWN,Melaka,0,0,0
2021-03-01,TWN,Negeri Sembilan,0,0,0
2021-03-01,TWN,Pahang,0,0,0
2021-03-01,TWN,Perak,0,0,0
2021-03-01,TWN,Perlis,0,0,0
2021-03-01,TWN,Pulau Pinang,11,7,4
2021-03-01,TWN,Sabah,0,0,0
2021-03-01,TWN,Sarawak,0,0,0
2021-03-01,TWN,Selangor,111,71,40
2021-03-01,TWN,W.P. Labuan,0,0,0
2021-03-01,TZA,Johor,0,0,0
2021-03-01,TZA,Kedah,0,0,0
2021-03-01,TZA,Perak,0,0,0
2021-03-01,TZA,Perlis,0,0,0
2021-03-01,TZA,Pulau Pinang,0,0,0
2021-03-01,TZA,Sabah,0,0,0
2021-03-01,TZA,Sarawak,0,0,0
2021-03-01,TZA,Selangor,38,20,18
2021-03-01,UGA,Johor,0,0,0
2021-03-01,UGA,Kedah,0,0,0
2021-03-01,UGA,Perak,0,0,0
2021-03-01,UGA,Perlis,0,0,0
2021-03-01,UGA,Pulau Pinang,0,0,0
2021-03-01,UGA,Sabah,0,0,0
2021-03-01,UGA,Sarawak,0,0,0
2021-03-01,UGA,Selangor,5,3,2
2021-03-01,UKR,Johor,24,24,0
2021-03-01,UKR,Kedah,0,0,0
2021-03-01,UKR,Kelantan,0,0,0
2021-03-01,UKR,Melaka,0,0,0
2021-03-01,UKR,Negeri Sembilan,0,0,0
2021-03-01,UKR,Pahang,0,0,0
2021-03-01,UKR,Perak,0,0,0
2021-03-01,UKR,Perlis,0,0,0
2021-03-01,UKR,Pulau Pinang,0,0,0
2021-03-01,UKR,Sabah,0,0,0
2021-03-01,UKR,Sarawak,0,0,0
2021-03-01,UKR,Selangor,47,44,3
2021-03-01,UKR,W.P. Labuan,0,0,0
2021-03-01,URY,Johor,0,0,0
2021-03-01,URY,Kedah,0,0,0
2021-03-01,URY,Kelantan,0,0,0
2021-03-01,URY,Perak,0,0,0
2021-03-01,URY,Perlis,0,0,0
2021-03-01,URY,Pulau Pinang,0,0,0
2021-03-01,URY,Sabah,0,0,0
2021-03-01,URY,Sarawak,0,0,0
2021-03-01,URY,Selangor,0,0,0
2021-03-01,URY,W.P. Labuan,0,0,0
2021-03-01,USA,Johor,1,1,0
2021-03-01,USA,Kedah,0,0,0
2021-03-01,USA,Kelantan,0,0,0
2021-03-01,USA,Melaka,0,0,0
2021-03-01,USA,Negeri Sembilan,0,0,0
2021-03-01,USA,Pahang,0,0,0
2021-03-01,USA,Perak,0,0,0
2021-03-01,USA,Perlis,0,0,0
2021-03-01,USA,Pulau Pinang,4,4,0
2021-03-01,USA,Sabah,0,0,0
2021-03-01,USA,Sarawak,1,1,0
2021-03-01,USA,Selangor,150,108,42
2021-03-01,USA,Terengganu,0,0,0
2021-03-01,USA,W.P. Labuan,0,0,0
2021-03-01,UZB,Johor,0,0,0
2021-03-01,UZB,Kedah,0,0,0
2021-03-01,UZB,Kelantan,0,0,0
2021-03-01,UZB,Perak,0,0,0
2021-03-01,UZB,Perlis,0,0,0
2021-03-01,UZB,Pulau Pinang,0,0,0
2021-03-01,UZB,Sabah,0,0,0
2021-03-01,UZB,Sarawak,0,0,0
2021-03-01,UZB,Selangor,14,11,3
2021-03-01,VAT,Johor,0,0,0
2021-03-01,VAT,Sarawak,0,0,0
2021-03-01,VAT,Selangor,1,1,0
2021-03-01,VCT,Johor,0,0,0
2021-03-01,VCT,Kedah,0,0,0
2021-03-01,VCT,Pulau Pinang,0,0,0
2021-03-01,VCT,Sarawak,0,0,0
2021-03-01,VCT,Selangor,0,0,0
2021-03-01,VEN,Johor,0,0,0
2021-03-01,VEN,Kedah,0,0,0
2021-03-01,VEN,Kelantan,0,0,0
2021-03-01,VEN,Melaka,0,0,0
2021-03-01,VEN,Perak,0,0,0
2021-03-01,VEN,Perlis,0,0,0
2021-03-01,VEN,Pulau Pinang,0,0,0
2021-03-01,VEN,Sabah,0,0,0
2021-03-01,VEN,Sarawak,0,0,0
2021-03-01,VEN,Selangor,2,2,0
2021-03-01,VEN,W.P. Labuan,0,0,0
2021-03-01,VNM,Johor,1,0,1
2021-03-01,VNM,Kedah,0,0,0
2021-03-01,VNM,Kelantan,0,0,0
2021-03-01,VNM,Melaka,0,0,0
2021-03-01,VNM,Negeri Sembilan,0,0,0
2021-03-01,VNM,Pahang,0,0,0
2021-03-01,VNM,Perak,0,0,0
2021-03-01,VNM,Perlis,0,0,0
2021-03-01,VNM,Pulau Pinang,1,0,1
2021-03-01,VNM,Sabah,0,0,0
2021-03-01,VNM,Sarawak,0,0,0
2021-03-01,VNM,Selangor,113,34,79
2021-03-01,VNM,Terengganu,18,18,0
2021-03-01,VNM,W.P. Labuan,0,0,0
2021-03-01,VUT,Johor,0,0,0
2021-03-01,VUT,Kedah,0,0,0
2021-03-01,VUT,Pulau Pinang,0,0,0
2021-03-01,VUT,Sabah,0,0,0
2021-03-01,VUT,Sarawak,0,0,0
2021-03-01,VUT,Selangor,1,1,0
2021-03-01,WSM,Johor,0,0,0
2021-03-01,WSM,Sarawak,0,0,0
2021-03-01,WSM,Selangor,0,0,0
2021-03-01,XXX,Johor,0,0,0
2021-03-01,XXX,Kedah,0,0,0
2021-03-01,XXX,Kelantan,0,0,0
2021-03-01,XXX,Melaka,0,0,0
2021-03-01,XXX,Pahang,0,0,0
2021-03-01,XXX,Perak,0,0,0
2021-03-01,XXX,Perlis,0,0,0
2021-03-01,XXX,Pulau Pinang,1,0,1
2021-03-01,XXX,Sabah,0,0,0
2021-03-01,XXX,Sarawak,0,0,0
2021-03-01,XXX,Selangor,13,10,3
2021-03-01,XXX,W.P. Labuan,0,0,0
2021-03-01,YEM,Johor,0,0,0
2021-03-01,YEM,Kedah,0,0,0
2021-03-01,YEM,Kelantan,0,0,0
2021-03-01,YEM,Melaka,0,0,0
2021-03-01,YEM,Pahang,0,0,0
2021-03-01,YEM,Perak,0,0,0
2021-03-01,YEM,Perlis,0,0,0
2021-03-01,YEM,Pulau Pinang,0,0,0
2021-03-01,YEM,Sabah,0,0,0
2021-03-01,YEM,Sarawak,0,0,0
2021-03-01,YEM,Selangor,83,70,13
2021-03-01,YEM,W.P. Labuan,0,0,0
2021-03-01,ZAF,Johor,3,3,0
2021-03-01,ZAF,Kedah,0,0,0
2021-03-01,ZAF,Kelantan,0,0,0
2021-03-01,ZAF,Melaka,0,0,0
2021-03-01,ZAF,Pahang,0,0,0
2021-03-01,ZAF,Perak,0,0,0
2021-03-01,ZAF,Perlis,0,0,0
2021-03-01,ZAF,Pulau Pinang,0,0,0
2021-03-01,ZAF,Sabah,0,0,0
2021-03-01,ZAF,Sarawak,0,0,0
2021-03-01,ZAF,Selangor,68,50,18
2021-03-01,ZAF,Terengganu,0,0,0
2021-03-01,ZAF,W.P. Labuan,0,0,0
2021-03-01,ZAR,Selangor,0,0,0
2021-03-01,ZMB,Johor,0,0,0
2021-03-01,ZMB,Kedah,0,0,0
2021-03-01,ZMB,Perak,0,0,0
2021-03-01,ZMB,Perlis,0,0,0
2021-03-01,ZMB,Pulau Pinang,0,0,0
2021-03-01,ZMB,Sabah,0,0,0
2021-03-01,ZMB,Sarawak,0,0,0
2021-03-01,ZMB,Selangor,24,13,11
2021-03-01,ZWE,Johor,0,0,0
2021-03-01,ZWE,Kedah,0,0,0
2021-03-01,ZWE,Kelantan,0,0,0
2021-03-01,ZWE,Perak,0,0,0
2021-03-01,ZWE,Perlis,0,0,0
2021-03-01,ZWE,Pulau Pinang,0,0,0
2021-03-01,ZWE,Sabah,0,0,0
2021-03-01,ZWE,Sarawak,0,0,0
2021-03-01,ZWE,Selangor,11,5,6
2021-04-01,ABW,Kedah,0,0,0
2021-04-01,ABW,Pulau Pinang,0,0,0
2021-04-01,AFG,Johor,0,0,0
2021-04-01,AFG,Kedah,0,0,0
2021-04-01,AFG,Perlis,0,0,0
2021-04-01,AFG,Pulau Pinang,0,0,0
2021-04-01,AFG,Sarawak,0,0,0
2021-04-01,AFG,Selangor,30,26,4
2021-04-01,AGO,Johor,0,0,0
2021-04-01,AGO,Kedah,0,0,0
2021-04-01,AGO,Sabah,0,0,0
2021-04-01,AGO,Selangor,0,0,0
2021-04-01,AIA,Selangor,0,0,0
2021-04-01,ALB,Johor,0,0,0
2021-04-01,ALB,Kedah,0,0,0
2021-04-01,ALB,Perak,0,0,0
2021-04-01,ALB,Perlis,0,0,0
2021-04-01,ALB,Pulau Pinang,0,0,0
2021-04-01,ALB,Sabah,0,0,0
2021-04-01,ALB,Sarawak,0,0,0
2021-04-01,ALB,Selangor,4,3,1
2021-04-01,AND,Johor,0,0,0
2021-04-01,AND,Kedah,0,0,0
2021-04-01,AND,Perlis,0,0,0
2021-04-01,AND,Pulau Pinang,0,0,0
2021-04-01,AND,Selangor,0,0,0
2021-04-01,ANT,Selangor,0,0,0
2021-04-01,ARE,Johor,0,0,0
2021-04-01,ARE,Kedah,0,0,0
2021-04-01,ARE,Kelantan,0,0,0
2021-04-01,ARE,Perak,0,0,0
2021-04-01,ARE,Perlis,0,0,0
2021-04-01,ARE,Pulau Pinang,0,0,0
2021-04-01,ARE,Sabah,0,0,0
2021-04-01,ARE,Sarawak,0,0,0
2021-04-01,ARE,Selangor,5,4,1
2021-04-01,ARG,Johor,0,0,0
2021-04-01,ARG,Kedah,0,0,0
2021-04-01,ARG,Kelantan,0,0,0
2021-04-01,ARG,Melaka,0,0,0
2021-04-01,ARG,Perak,0,0,0
2021-04-01,ARG,Perlis,0,0,0
2021-04-01,ARG,Pulau Pinang,0,0,0
2021-04-01,ARG,Sabah,0,0,0
2021-04-01,ARG,Sarawak,0,0,0
2021-04-01,ARG,Selangor,2,1,1
2021-04-01,ARG,W.P. Labuan,0,0,0
2021-04-01,ARM,Johor,0,0,0
2021-04-01,ARM,Kedah,0,0,0
2021-04-01,ARM,Kelantan,0,0,0
2021-04-01,ARM,Perak,0,0,0
2021-04-01,ARM,Perlis,0,0,0
2021-04-01,ARM,Pulau Pinang,0,0,0
2021-04-01,ARM,Sabah,0,0,0
2021-04-01,ARM,Sarawak,0,0,0
2021-04-01,ARM,Selangor,1,1,0
2021-04-01,ATA,Selangor,0,0,0
2021-04-01,ATG,Johor,0,0,0
2021-04-01,ATG,Kedah,0,0,0
2021-04-01,ATG,Pulau Pinang,0,0,0
2021-04-01,ATG,Sarawak,0,0,0
2021-04-01,ATG,Selangor,0,0,0
2021-04-01,AUS,Johor,1,1,0
2021-04-01,AUS,Kedah,0,0,0
2021-04-01,AUS,Kelantan,0,0,0
2021-04-01,AUS,Melaka,0,0,0
2021-04-01,AUS,Negeri Sembilan,0,0,0
2021-04-01,AUS,Pahang,0,0,0
2021-04-01,AUS,Perak,0,0,0
2021-04-01,AUS,Perlis,0,0,0
2021-04-01,AUS,Pulau Pinang,9,5,4
2021-04-01,AUS,Sabah,0,0,0
2021-04-01,AUS,Sarawak,1,1,0
2021-04-01,AUS,Selangor,102,68,34
2021-04-01,AUS,Terengganu,0,0,0
2021-04-01,AUS,W.P. Labuan,0,0,0
2021-04-01,AUT,Johor,0,0,0
2021-04-01,AUT,Kedah,0,0,0
2021-04-01,AUT,Kelantan,0,0,0
2021-04-01,AUT,Melaka,0,0,0
2021-04-01,AUT,Negeri Sembilan,0,0,0
2021-04-01,AUT,Pahang,0,0,0
2021-04-01,AUT,Perak,0,0,0
2021-04-01,AUT,Perlis,0,0,0
2021-04-01,AUT,Pulau Pinang,0,0,0
2021-04-01,AUT,Sabah,0,0,0
2021-04-01,AUT,Sarawak,0,0,0
2021-04-01,AUT,Selangor,17,13,4
2021-04-01,AUT,Terengganu,0,0,0
2021-04-01,AUT,W.P. Labuan,0,0,0
2021-04-01,AZE,Johor,0,0,0
2021-04-01,AZE,Kedah,0,0,0
2021-04-01,AZE,Kelantan,0,0,0
2021-04-01,AZE,Melaka,0,0,0
2021-04-01,AZE,Perlis,0,0,0
2021-04-01,AZE,Pulau Pinang,0,0,0
2021-04-01,AZE,Sabah,0,0,0
2021-04-01,AZE,Sarawak,0,0,0
2021-04-01,AZE,Selangor,1,1,0
2021-04-01,AZE,W.P. Labuan,0,0,0
2021-04-01,BDI,Pulau Pinang,0,0,0
2021-04-01,BDI,Sarawak,0,0,0
2021-04-01,BDI,Selangor,3,1,2
2021-04-01,BEL,Johor,1,1,0
2021-04-01,BEL,Kedah,0,0,0
2021-04-01,BEL,Kelantan,0,0,0
2021-04-01,BEL,Melaka,0,0,0
2021-04-01,BEL,Negeri Sembilan,0,0,0
2021-04-01,BEL,Pahang,0,0,0
2021-04-01,BEL,Perak,0,0,0
2021-04-01,BEL,Perlis,0,0,0
2021-04-01,BEL,Pulau Pinang,0,0,0
2021-04-01,BEL,Sabah,0,0,0
2021-04-01,BEL,Sarawak,0,0,0
2021-04-01,BEL,Selangor,9,6,3
2021-04-01,BEL,W.P. Labuan,0,0,0
2021-04-01,BEN,Johor,0,0,0
2021-04-01,BEN,Kedah,0,0,0
2021-04-01,BEN,Perak,0,0,0
2021-04-01,BEN,Pulau Pinang,0,0,0
2021-04-01,BEN,Sabah,0,0,0
2021-04-01,BEN,Sarawak,0,0,0
2021-04-01,BEN,Selangor,1,1,0
2021-04-01,BFA,Perak,0,0,0
2021-04-01,BFA,Pulau Pinang,0,0,0
2021-04-01,BFA,Selangor,0,0,0
2021-04-01,BGD,Johor,6,6,0
2021-04-01,BGD,Kedah,0,0,0
2021-04-01,BGD,Kelantan,0,0,0
2021-04-01,BGD,Melaka,0,0,0
2021-04-01,BGD,Negeri Sembilan,0,0,0
2021-04-01,BGD,Pahang,0,0,0
2021-04-01,BGD,Perak,0,0,0
2021-04-01,BGD,Perlis,0,0,0
2021-04-01,BGD,Pulau Pinang,0,0,0
2021-04-01,BGD,Sabah,0,0,0
2021-04-01,BGD,Sarawak,0,0,0
2021-04-01,BGD,Selangor,265,235,30
2021-04-01,BGD,W.P. Labuan,0,0,0
2021-04-01,BGR,Johor,0,0,0
2021-04-01,BGR,Kedah,0,0,0
2021-04-01,BGR,Kelantan,0,0,0
2021-04-01,BGR,Pahang,0,0,0
2021-04-01,BGR,Perak,0,0,0
2021-04-01,BGR,Perlis,0,0,0
2021-04-01,BGR,Pulau Pinang,0,0,0
2021-04-01,BGR,Sabah,0,0,0
2021-04-01,BGR,Sarawak,0,0,0
2021-04-01,BGR,Selangor,10,9,1
2021-04-01,BGR,W.P. Labuan,0,0,0
2021-04-01,BHR,Johor,0,0,0
2021-04-01,BHR,Kedah,0,0,0
2021-04-01,BHR,Kelantan,0,0,0
2021-04-01,BHR,Perlis,0,0,0
2021-04-01,BHR,Pulau Pinang,0,0,0
2021-04-01,BHR,Sabah,0,0,0
2021-04-01,BHR,Sarawak,0,0,0
2021-04-01,BHR,Selangor,1,0,1
2021-04-01,BHS,Johor,0,0,0
2021-04-01,BHS,Kedah,0,0,0
2021-04-01,BHS,Perak,0,0,0
2021-04-01,BHS,Sabah,0,0,0
2021-04-01,BHS,Sarawak,0,0,0
2021-04-01,BHS,Selangor,0,0,0
2021-04-01,BIH,Johor,0,0,0
2021-04-01,BIH,Kedah,0,0,0
2021-04-01,BIH,Perlis,0,0,0
2021-04-01,BIH,Pulau Pinang,0,0,0
2021-04-01,BIH,Sabah,0,0,0
2021-04-01,BIH,Sarawak,0,0,0
2021-04-01,BIH,Selangor,3,2,1
2021-04-01,BLR,Johor,0,0,0
2021-04-01,BLR,Kedah,0,0,0
2021-04-01,BLR,Kelantan,0,0,0
2021-04-01,BLR,Pahang,0,0,0
2021-04-01,BLR,Perak,0,0,0
2021-04-01,BLR,Perlis,0,0,0
2021-04-01,BLR,Pulau Pinang,0,0,0
2021-04-01,BLR,Sabah,0,0,0
2021-04-01,BLR,Sarawak,0,0,0
2021-04-01,BLR,Selangor,1,1,0
2021-04-01,BLR,W.P. Labuan,0,0,0
2021-04-01,BLZ,Johor,0,0,0
2021-04-01,BLZ,Pulau Pinang,0,0,0
2021-04-01,BLZ,Sarawak,0,0,0
2021-04-01,BLZ,Selangor,0,0,0
2021-04-01,BMU,Selangor,0,0,0
2021-04-01,BOL,Johor,0,0,0
2021-04-01,BOL,Kedah,0,0,0
2021-04-01,BOL,Melaka,0,0,0
2021-04-01,BOL,Perak,0,0,0
2021-04-01,BOL,Perlis,0,0,0
2021-04-01,BOL,Pulau Pinang,0,0,0
2021-04-01,BOL,Sabah,0,0,0
2021-04-01,BOL,Sarawak,0,0,0
2021-04-01,BOL,Selangor,0,0,0
2021-04-01,BRA,Johor,0,0,0
2021-04-01,BRA,Kedah,0,0,0
2021-04-01,BRA,Kelantan,0,0,0
2021-04-01,BRA,Melaka,0,0,0
2021-04-01,BRA,Pahang,0,0,0
2021-04-01,BRA,Perak,0,0,0
2021-04-01,BRA,Perlis,0,0,0
2021-04-01,BRA,Pulau Pinang,0,0,0
2021-04-01,BRA,Sabah,0,0,0
2021-04-01,BRA,Sarawak,0,0,0
2021-04-01,BRA,Selangor,27,13,14
2021-04-01,BRA,W.P. Labuan,0,0,0
2021-04-01,BRB,Johor,0,0,0
2021-04-01,BRB,Kedah,0,0,0
2021-04-01,BRB,Perlis,0,0,0
2021-04-01,BRB,Pulau Pinang,0,0,0
2021-04-01,BRB,Selangor,0,0,0
2021-04-01,BRN,Johor,0,0,0
2021-04-01,BRN,Kedah,0,0,0
2021-04-01,BRN,Kelantan,0,0,0
2021-04-01,BRN,Melaka,0,0,0
2021-04-01,BRN,Pahang,0,0,0
2021-04-01,BRN,Perak,0,0,0
2021-04-01,BRN,Perlis,0,0,0
2021-04-01,BRN,Pulau Pinang,0,0,0
2021-04-01,BRN,Sabah,0,0,0
2021-04-01,BRN,Sarawak,385,368,17
2021-04-01,BRN,Selangor,22,8,14
2021-04-01,BRN,W.P. Labuan,4,4,0
2021-04-01,BTN,Johor,0,0,0
2021-04-01,BTN,Kedah,0,0,0
2021-04-01,BTN,Perak,0,0,0
2021-04-01,BTN,Perlis,0,0,0
2021-04-01,BTN,Pulau Pinang,0,0,0
2021-04-01,BTN,Sabah,0,0,0
2021-04-01,BTN,Sarawak,0,0,0
2021-04-01,BTN,Selangor,0,0,0
2021-04-01,BWA,Johor,0,0,0
2021-04-01,BWA,Kedah,0,0,0
2021-04-01,BWA,Perlis,0,0,0
2021-04-01,BWA,Pulau Pinang,0,0,0
2021-04-01,BWA,Sabah,0,0,0
2021-04-01,BWA,Sarawak,0,0,0
2021-04-01,BWA,Selangor,0,0,0
2021-04-01,CAF,Kedah,0,0,0
2021-04-01,CAF,Selangor,0,0,0
2021-04-01,CAN,Johor,0,0,0
2021-04-01,CAN,Kedah,0,0,0
2021-04-01,CAN,Kelantan,0,0,0
2021-04-01,CAN,Melaka,0,0,0
2021-04-01,CAN,Negeri Sembilan,0,0,0
2021-04-01,CAN,Pahang,0,0,0
2021-04-01,CAN,Perak,0,0,0
2021-04-01,CAN,Perlis,0,0,0
2021-04-01,CAN,Pulau Pinang,0,0,0
2021-04-01,CAN,Sabah,0,0,0
2021-04-01,CAN,Sarawak,0,0,0
2021-04-01,CAN,Selangor,36,29,7
2021-04-01,CAN,Terengganu,0,0,0
2021-04-01,CAN,W.P. Labuan,0,0,0
2021-04-01,CCK,Selangor,0,0,0
2021-04-01,CHE,Johor,0,0,0
2021-04-01,CHE,Kedah,0,0,0
2021-04-01,CHE,Kelantan,0,0,0
2021-04-01,CHE,Melaka,0,0,0
2021-04-01,CHE,Negeri Sembilan,0,0,0
2021-04-01,CHE,Pahang,0,0,0
2021-04-01,CHE,Perak,0,0,0
2021-04-01,CHE,Perlis,0,0,0
2021-04-01,CHE,Pulau Pinang,0,0,0
2021-04-01,CHE,Sabah,0,0,0
2021-04-01,CHE,Sarawak,0,0,0
2021-04-01,CHE,Selangor,21,17,4
2021-04-01,CHE,W.P. Labuan,0,0,0
2021-04-01,CHL,Johor,0,0,0
2021-04-01,CHL,Kedah,0,0,0
2021-04-01,CHL,Kelantan,0,0,0
2021-04-01,CHL,Melaka,0,0,0
2021-04-01,CHL,Pahang,0,0,0
2021-04-01,CHL,Perak,0,0,0
2021-04-01,CHL,Perlis,0,0,0
2021-04-01,CHL,Pulau Pinang,0,0,0
2021-04-01,CHL,Sabah,0,0,0
2021-04-01,CHL,Sarawak,0,0,0
2021-04-01,CHL,Selangor,1,0,1
2021-04-01,CHN,Johor,35,34,1
2021-04-01,CHN,Kedah,0,0,0
2021-04-01,CHN,Kelantan,0,0,0
2021-04-01,CHN,Melaka,0,0,0
2021-04-01,CHN,Pahang,1,1,0
2021-04-01,CHN,Perak,0,0,0
2021-04-01,CHN,Perlis,0,0,0
2021-04-01,CHN,Pulau Pinang,2,2,0
2021-04-01,CHN,Sabah,0,0,0
2021-04-01,CHN,Sarawak,67,60,7
2021-04-01,CHN,Selangor,1570,1181,389
2021-04-01,CHN,Terengganu,0,0,0
2021-04-01,CHN,W.P. Labuan,0,0,0
2021-04-01,CIV,Johor,0,0,0
2021-04-01,CIV,Kedah,0,0,0
2021-04-01,CIV,Pulau Pinang,0,0,0
2021-04-01,CIV,Sabah,0,0,0
2021-04-01,CIV,Sarawak,0,0,0
2021-04-01,CIV,Selangor,0,0,0
2021-04-01,CMR,Johor,0,0,0
2021-04-01,CMR,Kedah,0,0,0
2021-04-01,CMR,Pulau Pinang,0,0,0
2021-04-01,CMR,Sabah,0,0,0
2021-04-01,CMR,Sarawak,0,0,0
2021-04-01,CMR,Selangor,3,1,2
2021-04-01,COD,Johor,0,0,0
2021-04-01,COD,Pulau Pinang,0,0,0
2021-04-01,COD,Sarawak,0,0,0
2021-04-01,COD,Selangor,4,3,1
2021-04-01,COG,Johor,0,0,0
2021-04-01,COG,Kedah,0,0,0
2021-04-01,COG,Selangor,0,0,0
2021-04-01,COK,Selangor,0,0,0
2021-04-01,COL,Johor,0,0,0
2021-04-01,COL,Kedah,0,0,0
2021-04-01,COL,Perak,0,0,0
2021-04-01,COL,Pulau Pinang,0,0,0
2021-04-01,COL,Sabah,0,0,0
2021-04-01,COL,Sarawak,0,0,0
2021-04-01,COL,Selangor,7,3,4
2021-04-01,COL,W.P. Labuan,0,0,0
2021-04-01,COM,Johor,0,0,0
2021-04-01,COM,Kedah,0,0,0
2021-04-01,COM,Selangor,2,1,1
2021-04-01,CPV,Johor,0,0,0
2021-04-01,CPV,Kedah,0,0,0
2021-04-01,CPV,Pulau Pinang,0,0,0
2021-04-01,CPV,Sabah,0,0,0
2021-04-01,CPV,Selangor,0,0,0
2021-04-01,CRI,Johor,0,0,0
2021-04-01,CRI,Kedah,0,0,0
2021-04-01,CRI,Perak,0,0,0
2021-04-01,CRI,Perlis,0,0,0
2021-04-01,CRI,Pulau Pinang,0,0,0
2021-04-01,CRI,Sabah,0,0,0
2021-04-01,CRI,Sarawak,0,0,0
2021-04-01,CRI,Selangor,1,0,1
2021-04-01,CUB,Johor,0,0,0
2021-04-01,CUB,Kedah,0,0,0
2021-04-01,CUB,Perlis,0,0,0
2021-04-01,CUB,Pulau Pinang,0,0,0
2021-04-01,CUB,Sabah,0,0,0
2021-04-01,CUB,Sarawak,0,0,0
2021-04-01,CUB,Selangor,0,0,0
2021-04-01,CYP,Johor,0,0,0
2021-04-01,CYP,Kedah,0,0,0
2021-04-01,CYP,Perak,0,0,0
2021-04-01,CYP,Perlis,0,0,0
2021-04-01,CYP,Pulau Pinang,0,0,0
2021-04-01,CYP,Sabah,0,0,0
2021-04-01,CYP,Sarawak,0,0,0
2021-04-01,CYP,Selangor,1,1,0
2021-04-01,CZE,Johor,0,0,0
2021-04-01,CZE,Kedah,0,0,0
2021-04-01,CZE,Kelantan,0,0,0
2021-04-01,CZE,Melaka,0,0,0
2021-04-01,CZE,Negeri Sembilan,0,0,0
2021-04-01,CZE,Perak,0,0,0
2021-04-01,CZE,Perlis,0,0,0
2021-04-01,CZE,Pulau Pinang,0,0,0
2021-04-01,CZE,Sabah,0,0,0
2021-04-01,CZE,Sarawak,0,0,0
2021-04-01,CZE,Selangor,9,8,1
2021-04-01,CZE,W.P. Labuan,0,0,0
2021-04-01,DEU,Johor,2,2,0
2021-04-01,DEU,Kedah,0,0,0
2021-04-01,DEU,Kelantan,0,0,0
2021-04-01,DEU,Melaka,0,0,0
2021-04-01,DEU,Negeri Sembilan,0,0,0
2021-04-01,DEU,Pahang,0,0,0
2021-04-01,DEU,Perak,0,0,0
2021-04-01,DEU,Perlis,0,0,0
2021-04-01,DEU,Pulau Pinang,1,1,0
2021-04-01,DEU,Sabah,0,0,0
2021-04-01,DEU,Sarawak,0,0,0
2021-04-01,DEU,Selangor,101,92,9
2021-04-01,DEU,Terengganu,0,0,0
2021-04-01,DEU,W.P. Labuan,0,0,0
2021-04-01,DJI,Johor,0,0,0
2021-04-01,DJI,Selangor,24,15,9
2021-04-01,DMA,Johor,0,0,0
2021-04-01,DMA,Kedah,0,0,0
2021-04-01,DMA,Pulau Pinang,0,0,0
2021-04-01,DMA,Sabah,0,0,0
2021-04-01,DMA,Sarawak,0,0,0
2021-04-01,DMA,Selangor,0,0,0
2021-04-01,DMA,W.P. Labuan,0,0,0
2021-04-01,DNK,Johor,9,7,2
2021-04-01,DNK,Kedah,0,0,0
2021-04-01,DNK,Kelantan,0,0,0
2021-04-01,DNK,Melaka,0,0,0
2021-04-01,DNK,Negeri Sembilan,0,0,0
2021-04-01,DNK,Pahang,0,0,0
2021-04-01,DNK,Perak,0,0,0
2021-04-01,DNK,Perlis,0,0,0
2021-04-01,DNK,Pulau Pinang,2,1,1
2021-04-01,DNK,Sabah,0,0,0
2021-04-01,DNK,Sarawak,0,0,0
2021-04-01,DNK,Selangor,23,19,4
2021-04-01,DNK,W.P. Labuan,0,0,0
2021-04-01,DOM,Johor,0,0,0
2021-04-01,DOM,Kedah,0,0,0
2021-04-01,DOM,Perak,0,0,0
2021-04-01,DOM,Perlis,0,0,0
2021-04-01,DOM,Pulau Pinang,0,0,0
2021-04-01,DOM,Sabah,0,0,0
2021-04-01,DOM,Sarawak,0,0,0
2021-04-01,DOM,Selangor,0,0,0
2021-04-01,DZA,Johor,0,0,0
2021-04-01,DZA,Kedah,0,0,0
2021-04-01,DZA,Kelantan,0,0,0
2021-04-01,DZA,Melaka,0,0,0
2021-04-01,DZA,Perak,0,0,0
2021-04-01,DZA,Perlis,0,0,0
2021-04-01,DZA,Pulau Pinang,0,0,0
2021-04-01,DZA,Sabah,0,0,0
2021-04-01,DZA,Sarawak,0,0,0
2021-04-01,DZA,Selangor,3,2,1
2021-04-01,DZA,W.P. Labuan,0,0,0
2021-04-01,ECU,Johor,0,0,0
2021-04-01,ECU,Kedah,0,0,0
2021-04-01,ECU,Perak,0,0,0
2021-04-01,ECU,Perlis,0,0,0
2021-04-01,ECU,Pulau Pinang,0,0,0
2021-04-01,ECU,Sabah,0,0,0
2021-04-01,ECU,Sarawak,0,0,0
2021-04-01,ECU,Selangor,1,1,0
2021-04-01,EGY,Johor,0,0,0
2021-04-01,EGY,Kedah,0,0,0
2021-04-01,EGY,Kelantan,0,0,0
2021-04-01,EGY,Melaka,0,0,0
2021-04-01,EGY,Pahang,0,0,0
2021-04-01,EGY,Perak,0,0,0
2021-04-01,EGY,Perlis,0,0,0
2021-04-01,EGY,Pulau Pinang,0,0,0
2021-04-01,EGY,Sabah,0,0,0
2021-04-01,EGY,Sarawak,0,0,0
2021-04-01,EGY,Selangor,98,75,23
2021-04-01,EGY,Terengganu,0,0,0
2021-04-01,EGY,W.P. Labuan,0,0,0
2021-04-01,ERI,Johor,0,0,0
2021-04-01,ERI,Pulau Pinang,0,0,0
2021-04-01,ERI,Sabah,0,0,0
2021-04-01,ERI,Selangor,1,1,0
2021-04-01,ESP,Johor,0,0,0
2021-04-01,ESP,Kedah,0,0,0
2021-04-01,ESP,Kelantan,0,0,0
2021-04-01,ESP,Melaka,0,0,0
2021-04-01,ESP,Negeri Sembilan,0,0,0
2021-04-01,ESP,Pahang,0,0,0
2021-04-01,ESP,Perak,0,0,0
2021-04-01,ESP,Perlis,0,0,0
2021-04-01,ESP,Pulau Pinang,0,0,0
2021-04-01,ESP,Sabah,0,0,0
2021-04-01,ESP,Sarawak,0,0,0
2021-04-01,ESP,Selangor,21,16,5
2021-04-01,ESP,W.P. Labuan,0,0,0
2021-04-01,EST,Johor,0,0,0
2021-04-01,EST,Kedah,0,0,0
2021-04-01,EST,Kelantan,0,0,0
2021-04-01,EST,Pahang,0,0,0
2021-04-01,EST,Perak,0,0,0
2021-04-01,EST,Perlis,0,0,0
2021-04-01,EST,Pulau Pinang,0,0,0
2021-04-01,EST,Sabah,0,0,0
2021-04-01,EST,Sarawak,0,0,0
2021-04-01,EST,Selangor,3,3,0
2021-04-01,EST,W.P. Labuan,0,0,0
2021-04-01,ETH,Johor,0,0,0
2021-04-01,ETH,Kedah,0,0,0
2021-04-01,ETH,Pulau Pinang,0,0,0
2021-04-01,ETH,Sarawak,0,0,0
2021-04-01,ETH,Selangor,4,2,2
2021-04-01,FIN,Johor,0,0,0
2021-04-01,FIN,Kedah,0,0,0
2021-04-01,FIN,Kelantan,0,0,0
2021-04-01,FIN,Melaka,0,0,0
2021-04-01,FIN,Negeri Sembilan,0,0,0
2021-04-01,FIN,Pahang,0,0,0
2021-04-01,FIN,Perak,0,0,0
2021-04-01,FIN,Perlis,0,0,0
2021-04-01,FIN,Pulau Pinang,0,0,0
2021-04-01,FIN,Sabah,0,0,0
2021-04-01,FIN,Sarawak,0,0,0
2021-04-01,FIN,Selangor,6,4,2
2021-04-01,FIN,W.P. Labuan,0,0,0
2021-04-01,FJI,Johor,0,0,0
2021-04-01,FJI,Kedah,0,0,0
2021-04-01,FJI,Kelantan,0,0,0
2021-04-01,FJI,Perak,0,0,0
2021-04-01,FJI,Perlis,0,0,0
2021-04-01,FJI,Pulau Pinang,0,0,0
2021-04-01,FJI,Sabah,0,0,0
2021-04-01,FJI,Sarawak,0,0,0
2021-04-01,FJI,Selangor,1,1,0
2021-04-01,FRA,Johor,3,3,0
2021-04-01,FRA,Kedah,0,0,0
2021-04-01,FRA,Kelantan,0,0,0
2021-04-01,FRA,Melaka,0,0,0
2021-04-01,FRA,Negeri Sembilan,0,0,0
2021-04-01,FRA,Pahang,0,0,0
2021-04-01,FRA,Perak,0,0,0
2021-04-01,FRA,Perlis,0,0,0
2021-04-01,FRA,Pulau Pinang,0,0,0
2021-04-01,FRA,Sabah,0,0,0
2021-04-01,FRA,Sarawak,0,0,0
2021-04-01,FRA,Selangor,65,51,14
2021-04-01,FRA,Terengganu,0,0,0
2021-04-01,FRA,W.P. Labuan,0,0,0
2021-04-01,FSM,Johor,0,0,0
2021-04-01,FSM,Pulau Pinang,0,0,0
2021-04-01,FSM,Selangor,0,0,0
2021-04-01,GAB,Johor,0,0,0
2021-04-01,GAB,Pulau Pinang,0,0,0
2021-04-01,GAB,Sarawak,0,0,0
2021-04-01,GAB,Selangor,1,1,0
2021-04-01,GBR,Johor,4,4,0
2021-04-01,GBR,Kedah,0,0,0
2021-04-01,GBR,Kelantan,0,0,0
2021-04-01,GBR,Melaka,0,0,0
2021-04-01,GBR,Negeri Sembilan,0,0,0
2021-04-01,GBR,Pahang,0,0,0
2021-04-01,GBR,Perak,1,0,1
2021-04-01,GBR,Perlis,0,0,0
2021-04-01,GBR,Pulau Pinang,3,3,0
2021-04-01,GBR,Sabah,1,0,1
2021-04-01,GBR,Sarawak,0,0,0
2021-04-01,GBR,Selangor,221,187,34
2021-04-01,GBR,Terengganu,0,0,0
2021-04-01,GBR,W.P. Labuan,0,0,0
2021-04-01,GEO,Johor,0,0,0
2021-04-01,GEO,Kedah,0,0,0
2021-04-01,GEO,Melaka,0,0,0
2021-04-01,GEO,Perak,0,0,0
2021-04-01,GEO,Perlis,0,0,0
2021-04-01,GEO,Pulau Pinang,0,0,0
2021-04-01,GEO,Sabah,0,0,0
2021-04-01,GEO,Sarawak,0,0,0
2021-04-01,GEO,Selangor,2,2,0
2021-04-01,GHA,Johor,0,0,0
2021-04-01,GHA,Kedah,0,0,0
2021-04-01,GHA,Kelantan,0,0,0
2021-04-01,GHA,Pulau Pinang,0,0,0
2021-04-01,GHA,Sabah,0,0,0
2021-04-01,GHA,Sarawak,0,0,0
2021-04-01,GHA,Selangor,10,8,2
2021-04-01,GIB,Johor,0,0,0
2021-04-01,GIB,Sarawak,0,0,0
2021-04-01,GIN,Johor,0,0,0
2021-04-01,GIN,Kedah,0,0,0
2021-04-01,GIN,Kelantan,0,0,0
2021-04-01,GIN,Perlis,0,0,0
2021-04-01,GIN,Pulau Pinang,0,0,0
2021-04-01,GIN,Sabah,0,0,0
2021-04-01,GIN,Sarawak,0,0,0
2021-04-01,GIN,Selangor,24,10,14
2021-04-01,GLP,Selangor,0,0,0
2021-04-01,GMB,Johor,0,0,0
2021-04-01,GMB,Kedah,0,0,0
2021-04-01,GMB,Kelantan,0,0,0
2021-04-01,GMB,Pulau Pinang,0,0,0
2021-04-01,GMB,Sabah,0,0,0
2021-04-01,GMB,Sarawak,0,0,0
2021-04-01,GMB,Selangor,1,1,0
2021-04-01,GNB,Johor,0,0,0
2021-04-01,GNB,Selangor,0,0,0
2021-04-01,GNQ,Johor,0,0,0
2021-04-01,GNQ,Selangor,2,1,1
2021-04-01,GRC,Johor,6,5,1
2021-04-01,GRC,Kedah,0,0,0
2021-04-01,GRC,Kelantan,0,0,0
2021-04-01,GRC,Melaka,0,0,0
2021-04-01,GRC,Negeri Sembilan,0,0,0
2021-04-01,GRC,Pahang,0,0,0
2021-04-01,GRC,Perak,0,0,0
2021-04-01,GRC,Perlis,0,0,0
2021-04-01,GRC,Pulau Pinang,0,0,0
2021-04-01,GRC,Sabah,0,0,0
2021-04-01,GRC,Sarawak,0,0,0
2021-04-01,GRC,Selangor,3,3,0
2021-04-01,GRD,Johor,0,0,0
2021-04-01,GRD,Kedah,0,0,0
2021-04-01,GRD,Pulau Pinang,0,0,0
2021-04-01,GRD,Sabah,0,0,0
2021-04-01,GRD,Sarawak,0,0,0
2021-04-01,GRD,Selangor,0,0,0
2021-04-01,GRL,Johor,0,0,0
2021-04-01,GRL,Selangor,0,0,0
2021-04-01,GTM,Johor,0,0,0
2021-04-01,GTM,Kedah,0,0,0
2021-04-01,GTM,Pahang,0,0,0
2021-04-01,GTM,Perak,0,0,0
2021-04-01,GTM,Pulau Pinang,0,0,0
2021-04-01,GTM,Sabah,0,0,0
2021-04-01,GTM,Sarawak,0,0,0
2021-04-01,GTM,Selangor,0,0,0
2021-04-01,GTM,W.P. Labuan,0,0,0
2021-04-01,GUY,Johor,0,0,0
2021-04-01,GUY,Kedah,0,0,0
2021-04-01,GUY,Pulau Pinang,0,0,0
2021-04-01,GUY,Sarawak,0,0,0
2021-04-01,GUY,Selangor,0,0,0
2021-04-01,HKG,Johor,0,0,0
2021-04-01,HKG,Kedah,0,0,0
2021-04-01,HKG,Kelantan,0,0,0
2021-04-01,HKG,Pahang,0,0,0
2021-04-01,HKG,Perak,0,0,0
2021-04-01,HKG,Perlis,0,0,0
2021-04-01,HKG,Pulau Pinang,1,1,0
2021-04-01,HKG,Sabah,0,0,0
2021-04-01,HKG,Sarawak,0,0,0
2021-04-01,HKG,Selangor,0,0,0
2021-04-01,HKG,Terengganu,0,0,0
2021-04-01,HMD,Johor,0,0,0
2021-04-01,HND,Johor,0,0,0
2021-04-01,HND,Kedah,0,0,0
2021-04-01,HND,Perak,0,0,0
2021-04-01,HND,Pulau Pinang,0,0,0
2021-04-01,HND,Sabah,0,0,0
2021-04-01,HND,Sarawak,0,0,0
2021-04-01,HND,Selangor,5,5,0
2021-04-01,HRV,Johor,0,0,0
2021-04-01,HRV,Kedah,0,0,0
2021-04-01,HRV,Kelantan,0,0,0
2021-04-01,HRV,Melaka,0,0,0
2021-04-01,HRV,Pahang,0,0,0
2021-04-01,HRV,Perak,0,0,0
2021-04-01,HRV,Perlis,0,0,0
2021-04-01,HRV,Pulau Pinang,0,0,0
2021-04-01,HRV,Sabah,0,0,0
2021-04-01,HRV,Sarawak,0,0,0
2021-04-01,HRV,Selangor,15,13,2
2021-04-01,HTI,Johor,0,0,0
2021-04-01,HTI,Kedah,0,0,0
2021-04-01,HTI,Kelantan,0,0,0
2021-04-01,HTI,Perak,0,0,0
2021-04-01,HTI,Pulau Pinang,0,0,0
2021-04-01,HTI,Sabah,0,0,0
2021-04-01,HTI,Selangor,0,0,0
2021-04-01,HUN,Johor,0,0,0
2021-04-01,HUN,Kedah,0,0,0
2021-04-01,HUN,Kelantan,0,0,0
2021-04-01,HUN,Pahang,0,0,0
2021-04-01,HUN,Perak,0,0,0
2021-04-01,HUN,Perlis,0,0,0
2021-04-01,HUN,Pulau Pinang,0,0,0
2021-04-01,HUN,Sabah,0,0,0
2021-04-01,HUN,Sarawak,0,0,0
2021-04-01,HUN,Selangor,9,5,4
2021-04-01,HUN,W.P. Labuan,0,0,0
2021-04-01,IDN,Johor,210,152,58
2021-04-01,IDN,Kedah,3,3,0
2021-04-01,IDN,Kelantan,0,0,0
2021-04-01,IDN,Melaka,0,0,0
2021-04-01,IDN,Negeri Sembilan,0,0,0
2021-04-01,IDN,Pahang,0,0,0
2021-04-01,IDN,Perak,0,0,0
2021-04-01,IDN,Perlis,5,5,0
2021-04-01,IDN,Pulau Pinang,17,1,16
2021-04-01,IDN,Sabah,1,1,0
2021-04-01,IDN,Sarawak,424,423,1
2021-04-01,IDN,Selangor,1117,740,377
2021-04-01,IDN,Terengganu,0,0,0
2021-04-01,IDN,W.P. Labuan,4,4,0
2021-04-01,IND,Johor,101,101,0
2021-04-01,IND,Kedah,0,0,0
2021-04-01,IND,Kelantan,0,0,0
2021-04-01,IND,Melaka,0,0,0
2021-04-01,IND,Negeri Sembilan,0,0,0
2021-04-01,IND,Pahang,2,2,0
2021-04-01,IND,Perak,0,0,0
2021-04-01,IND,Perlis,0,0,0
2021-04-01,IND,Pulau Pinang,3,3,0
2021-04-01,IND,Sabah,2,2,0
2021-04-01,IND,Sarawak,0,0,0
2021-04-01,IND,Selangor,1359,963,396
2021-04-01,IND,Terengganu,0,0,0
2021-04-01,IND,W.P. Labuan,0,0,0
2021-04-01,IOT,Pulau Pinang,0,0,0
2021-04-01,IOT,Selangor,0,0,0
2021-04-01,IRL,Johor,0,0,0
2021-04-01,IRL,Kedah,0,0,0
2021-04-01,IRL,Kelantan,0,0,0
2021-04-01,IRL,Negeri Sembilan,0,0,0
2021-04-01,IRL,Pahang,0,0,0
2021-04-01,IRL,Perak,0,0,0
2021-04-01,IRL,Perlis,0,0,0
2021-04-01,IRL,Pulau Pinang,0,0,0
2021-04-01,IRL,Sabah,0,0,0
2021-04-01,IRL,Sarawak,0,0,0
2021-04-01,IRL,Selangor,10,6,4
2021-04-01,IRL,Terengganu,0,0,0
2021-04-01,IRL,W.P. Labuan,0,0,0
2021-04-01,IRN,Johor,0,0,0
2021-04-01,IRN,Kedah,0,0,0
2021-04-01,IRN,Kelantan,0,0,0
2021-04-01,IRN,Perak,0,0,0
2021-04-01,IRN,Perlis,0,0,0
2021-04-01,IRN,Pulau Pinang,0,0,0
2021-04-01,IRN,Sabah,0,0,0
2021-04-01,IRN,Sarawak,0,0,0
2021-04-01,IRN,Selangor,46,30,16
2021-04-01,IRN,W.P. Labuan,0,0,0
2021-04-01,IRQ,Johor,0,0,0
2021-04-01,IRQ,Kedah,0,0,0
2021-04-01,IRQ,Kelantan,0,0,0
2021-04-01,IRQ,Melaka,0,0,0
2021-04-01,IRQ,Pahang,0,0,0
2021-04-01,IRQ,Perak,0,0,0
2021-04-01,IRQ,Perlis,0,0,0
2021-04-01,IRQ,Pulau Pinang,0,0,0
2021-04-01,IRQ,Sabah,0,0,0
2021-04-01,IRQ,Sarawak,0,0,0
2021-04-01,IRQ,Selangor,39,24,15
2021-04-01,ISL,Johor,0,0,0
2021-04-01,ISL,Kedah,0,0,0
2021-04-01,ISL,Kelantan,0,0,0
2021-04-01,ISL,Perak,0,0,0
2021-04-01,ISL,Perlis,0,0,0
2021-04-01,ISL,Pulau Pinang,0,0,0
2021-04-01,ISL,Sabah,0,0,0
2021-04-01,ISL,Sarawak,0,0,0
2021-04-01,ISL,Selangor,0,0,0
2021-04-01,ISL,W.P. Labuan,0,0,0
2021-04-01,ISR,Pulau Pinang,0,0,0
2021-04-01,ITA,Johor,0,0,0
2021-04-01,ITA,Kedah,0,0,0
2021-04-01,ITA,Kelantan,0,0,0
2021-04-01,ITA,Melaka,0,0,0
2021-04-01,ITA,Negeri Sembilan,0,0,0
2021-04-01,ITA,Pahang,0,0,0
2021-04-01,ITA,Perak,0,0,0
2021-04-01,ITA,Perlis,0,0,0
2021-04-01,ITA,Pulau Pinang,1,1,0
2021-04-01,ITA,Sabah,0,0,0
2021-04-01,ITA,Sarawak,0,0,0
2021-04-01,ITA,Selangor,67,61,6
2021-04-01,ITA,W.P. Labuan,0,0,0
2021-04-01,JAM,Johor,0,0,0
2021-04-01,JAM,Kedah,0,0,0
2021-04-01,JAM,Perak,0,0,0
2021-04-01,JAM,Pulau Pinang,0,0,0
2021-04-01,JAM,Sabah,0,0,0
2021-04-01,JAM,Sarawak,0,0,0
2021-04-01,JAM,Selangor,1,0,1
2021-04-01,JAM,W.P. Labuan,0,0,0
2021-04-01,JOR,Johor,0,0,0
2021-04-01,JOR,Kedah,0,0,0
2021-04-01,JOR,Kelantan,0,0,0
2021-04-01,JOR,Melaka,0,0,0
2021-04-01,JOR,Perlis,0,0,0
2021-04-01,JOR,Pulau Pinang,0,0,0
2021-04-01,JOR,Sabah,0,0,0
2021-04-01,JOR,Sarawak,0,0,0
2021-04-01,JOR,Selangor,25,18,7
2021-04-01,JOR,W.P. Labuan,0,0,0
2021-04-01,JPN,Johor,2,1,1
2021-04-01,JPN,Kedah,0,0,0
2021-04-01,JPN,Kelantan,0,0,0
2021-04-01,JPN,Melaka,0,0,0
2021-04-01,JPN,Negeri Sembilan,0,0,0
2021-04-01,JPN,Pahang,0,0,0
2021-04-01,JPN,Perak,0,0,0
2021-04-01,JPN,Perlis,0,0,0
2021-04-01,JPN,Pulau Pinang,24,18,6
2021-04-01,JPN,Sabah,1,0,1
2021-04-01,JPN,Sarawak,4,4,0
2021-04-01,JPN,Selangor,600,409,191
2021-04-01,JPN,W.P. Labuan,0,0,0
2021-04-01,KAZ,Johor,0,0,0
2021-04-01,KAZ,Kedah,0,0,0
2021-04-01,KAZ,Kelantan,0,0,0
2021-04-01,KAZ,Melaka,0,0,0
2021-04-01,KAZ,Perak,0,0,0
2021-04-01,KAZ,Perlis,0,0,0
2021-04-01,KAZ,Pulau Pinang,0,0,0
2021-04-01,KAZ,Sabah,0,0,0
2021-04-01,KAZ,Sarawak,0,0,0
2021-04-01,KAZ,Selangor,21,6,15
2021-04-01,KAZ,W.P. Labuan,0,0,0
2021-04-01,KEN,Johor,0,0,0
2021-04-01,KEN,Kedah,0,0,0
2021-04-01,KEN,Kelantan,0,0,0
2021-04-01,KEN,Perak,0,0,0
2021-04-01,KEN,Perlis,0,0,0
2021-04-01,KEN,Pulau Pinang,0,0,0
2021-04-01,KEN,Sabah,0,0,0
2021-04-01,KEN,Sarawak,0,0,0
2021-04-01,KEN,Selangor,18,9,9
2021-04-01,KGZ,Johor,0,0,0
2021-04-01,KGZ,Kedah,0,0,0
2021-04-01,KGZ,Kelantan,0,0,0
2021-04-01,KGZ,Perak,0,0,0
2021-04-01,KGZ,Perlis,0,0,0
2021-04-01,KGZ,Pulau Pinang,0,0,0
2021-04-01,KGZ,Sabah,0,0,0
2021-04-01,KGZ,Sarawak,0,0,0
2021-04-01,KGZ,Selangor,6,4,2
2021-04-01,KHM,Johor,0,0,0
2021-04-01,KHM,Kedah,0,0,0
2021-04-01,KHM,Kelantan,0,0,0
2021-04-01,KHM,Melaka,0,0,0
2021-04-01,KHM,Negeri Sembilan,0,0,0
2021-04-01,KHM,Pahang,0,0,0
2021-04-01,KHM,Perak,0,0,0
2021-04-01,KHM,Perlis,0,0,0
2021-04-01,KHM,Pulau Pinang,0,0,0
2021-04-01,KHM,Sabah,0,0,0
2021-04-01,KHM,Sarawak,0,0,0
2021-04-01,KHM,Selangor,9,1,8
2021-04-01,KHM,W.P. Labuan,0,0,0
2021-04-01,KIR,Johor,0,0,0
2021-04-01,KIR,Sabah,0,0,0
2021-04-01,KIR,Selangor,0,0,0
2021-04-01,KNA,Johor,0,0,0
2021-04-01,KNA,Kedah,0,0,0
2021-04-01,KNA,Perlis,0,0,0
2021-04-01,KNA,Pulau Pinang,0,0,0
2021-04-01,KNA,Sabah,0,0,0
2021-04-01,KNA,Selangor,0,0,0
2021-04-01,KNA,W.P. Labuan,0,0,0
2021-04-01,KOR,Johor,0,0,0
2021-04-01,KOR,Kedah,0,0,0
2021-04-01,KOR,Kelantan,0,0,0
2021-04-01,KOR,Melaka,0,0,0
2021-04-01,KOR,Negeri Sembilan,0,0,0
2021-04-01,KOR,Pahang,0,0,0
2021-04-01,KOR,Perak,1,1,0
2021-04-01,KOR,Perlis,0,0,0
2021-04-01,KOR,Pulau Pinang,2,1,1
2021-04-01,KOR,Sabah,0,0,0
2021-04-01,KOR,Sarawak,4,3,1
2021-04-01,KOR,Selangor,332,235,97
2021-04-01,KOR,Terengganu,0,0,0
2021-04-01,KOR,W.P. Labuan,0,0,0
2021-04-01,KWT,Johor,0,0,0
2021-04-01,KWT,Kedah,0,0,0
2021-04-01,KWT,Kelantan,0,0,0
2021-04-01,KWT,Perak,0,0,0
2021-04-01,KWT,Perlis,0,0,0
2021-04-01,KWT,Pulau Pinang,0,0,0
2021-04-01,KWT,Sabah,0,0,0
2021-04-01,KWT,Sarawak,0,0,0
2021-04-01,KWT,Selangor,0,0,0
2021-04-01,KWT,W.P. Labuan,0,0,0
2021-04-01,LAO,Johor,0,0,0
2021-04-01,LAO,Kedah,0,0,0
2021-04-01,LAO,Kelantan,0,0,0
2021-04-01,LAO,Melaka,0,0,0
2021-04-01,LAO,Perak,0,0,0
2021-04-01,LAO,Perlis,0,0,0
2021-04-01,LAO,Pulau Pinang,0,0,0
2021-04-01,LAO,Sabah,0,0,0
2021-04-01,LAO,Sarawak,0,0,0
2021-04-01,LAO,Selangor,46,42,4
2021-04-01,LAO,W.P. Labuan,0,0,0
2021-04-01,LBN,Johor,0,0,0
2021-04-01,LBN,Kedah,0,0,0
2021-04-01,LBN,Kelantan,0,0,0
2021-04-01,LBN,Pahang,0,0,0
2021-04-01,LBN,Perak,0,0,0
2021-04-01,LBN,Perlis,0,0,0
2021-04-01,LBN,Pulau Pinang,0,0,0
2021-04-01,LBN,Sabah,0,0,0
2021-04-01,LBN,Sarawak,0,0,0
2021-04-01,LBN,Selangor,5,5,0
2021-04-01,LBN,W.P. Labuan,0,0,0
2021-04-01,LBR,Johor,0,0,0
2021-04-01,LBR,Kedah,0,0,0
2021-04-01,LBR,Sabah,0,0,0
2021-04-01,LBR,Sarawak,0,0,0
2021-04-01,LBR,Selangor,4,4,0
2021-04-01,LBY,Johor,0,0,0
2021-04-01,LBY,Kedah,0,0,0
2021-04-01,LBY,Perlis,0,0,0
2021-04-01,LBY,Pulau Pinang,0,0,0
2021-04-01,LBY,Sabah,0,0,0
2021-04-01,LBY,Sarawak,0,0,0
2021-04-01,LBY,Selangor,50,36,14
2021-04-01,LCA,Johor,0,0,0
2021-04-01,LCA,Kedah,0,0,0
2021-04-01,LCA,Pulau Pinang,0,0,0
2021-04-01,LCA,Sarawak,0,0,0
2021-04-01,LCA,Selangor,0,0,0
2021-04-01,LIE,Johor,0,0,0
2021-04-01,LIE,Kedah,0,0,0
2021-04-01,LIE,Perlis,0,0,0
2021-04-01,LIE,Pulau Pinang,0,0,0
2021-04-01,LIE,Sabah,0,0,0
2021-04-01,LIE,Sarawak,0,0,0
2021-04-01,LIE,Selangor,1,1,0
2021-04-01,LKA,Johor,3,3,0
2021-04-01,LKA,Kedah,0,0,0
2021-04-01,LKA,Kelantan,0,0,0
2021-04-01,LKA,Melaka,0,0,0
2021-04-01,LKA,Pahang,0,0,0
2021-04-01,LKA,Perak,0,0,0
2021-04-01,LKA,Perlis,0,0,0
2021-04-01,LKA,Pulau Pinang,0,0,0
2021-04-01,LKA,Sabah,0,0,0
2021-04-01,LKA,Sarawak,0,0,0
2021-04-01,LKA,Selangor,118,67,51
2021-04-01,LKA,W.P. Labuan,0,0,0
2021-04-01,LSO,Johor,0,0,0
2021-04-01,LSO,Kedah,0,0,0
2021-04-01,LSO,Pulau Pinang,0,0,0
2021-04-01,LSO,Sarawak,0,0,0
2021-04-01,LSO,Selangor,0,0,0
2021-04-01,LTU,Johor,1,1,0
2021-04-01,LTU,Kedah,0,0,0
2021-04-01,LTU,Kelantan,0,0,0
2021-04-01,LTU,Pahang,0,0,0
2021-04-01,LTU,Perak,0,0,0
2021-04-01,LTU,Perlis,0,0,0
2021-04-01,LTU,Pulau Pinang,0,0,0
2021-04-01,LTU,Sabah,0,0,0
2021-04-01,LTU,Sarawak,0,0,0
2021-04-01,LTU,Selangor,3,1,2
2021-04-01,LTU,W.P. Labuan,0,0,0
2021-04-01,LUX,Johor,0,0,0
2021-04-01,LUX,Kedah,0,0,0
2021-04-01,LUX,Kelantan,0,0,0
2021-04-01,LUX,Perak,0,0,0
2021-04-01,LUX,Perlis,0,0,0
2021-04-01,LUX,Pulau Pinang,0,0,0
2021-04-01,LUX,Sabah,0,0,0
2021-04-01,LUX,Sarawak,0,0,0
2021-04-01,LUX,Selangor,2,1,1
2021-04-01,LVA,Johor,0,0,0
2021-04-01,LVA,Kedah,0,0,0
2021-04-01,LVA,Kelantan,0,0,0
2021-04-01,LVA,Pahang,0,0,0
2021-04-01,LVA,Perak,0,0,0
2021-04-01,LVA,Perlis,0,0,0
2021-04-01,LVA,Pulau Pinang,0,0,0
2021-04-01,LVA,Sabah,0,0,0
2021-04-01,LVA,Sarawak,0,0,0
2021-04-01,LVA,Selangor,2,2,0
2021-04-01,LVA,W.P. Labuan,0,0,0
2021-04-01,MAC,Johor,0,0,0
2021-04-01,MAC,Pahang,0,0,0
2021-04-01,MAC,Perak,0,0,0
2021-04-01,MAC,Selangor,0,0,0
2021-04-01,MAC,W.P. Labuan,0,0,0
2021-04-01,MAR,Johor,0,0,0
2021-04-01,MAR,Kedah,0,0,0
2021-04-01,MAR,Kelantan,0,0,0
2021-04-01,MAR,Melaka,0,0,0
2021-04-01,MAR,Pahang,0,0,0
2021-04-01,MAR,Perak,0,0,0
2021-04-01,MAR,Perlis,0,0,0
2021-04-01,MAR,Pulau Pinang,0,0,0
2021-04-01,MAR,Sabah,0,0,0
2021-04-01,MAR,Sarawak,0,0,0
2021-04-01,MAR,Selangor,12,6,6
2021-04-01,MAR,W.P. Labuan,0,0,0
2021-04-01,MCO,Johor,0,0,0
2021-04-01,MCO,Kedah,0,0,0
2021-04-01,MCO,Sabah,0,0,0
2021-04-01,MCO,Selangor,0,0,0
2021-04-01,MDA,Johor,0,0,0
2021-04-01,MDA,Kedah,0,0,0
2021-04-01,MDA,Kelantan,0,0,0
2021-04-01,MDA,Negeri Sembilan,0,0,0
2021-04-01,MDA,Perlis,0,0,0
2021-04-01,MDA,Pulau Pinang,0,0,0
2021-04-01,MDA,Sabah,0,0,0
2021-04-01,MDA,Sarawak,0,0,0
2021-04-01,MDA,Selangor,1,0,1
2021-04-01,MDG,Johor,0,0,0
2021-04-01,MDG,Kedah,0,0,0
2021-04-01,MDG,Perak,0,0,0
2021-04-01,MDG,Perlis,0,0,0
2021-04-01,MDG,Pulau Pinang,0,0,0
2021-04-01,MDG,Sabah,0,0,0
2021-04-01,MDG,Sarawak,0,0,0
2021-04-01,MDG,Selangor,1,1,0
2021-04-01,MDV,Johor,0,0,0
2021-04-01,MDV,Kedah,0,0,0
2021-04-01,MDV,Kelantan,0,0,0
2021-04-01,MDV,Perak,0,0,0
2021-04-01,MDV,Perlis,0,0,0
2021-04-01,MDV,Pulau Pinang,0,0,0
2021-04-01,MDV,Sabah,0,0,0
2021-04-01,MDV,Sarawak,0,0,0
2021-04-01,MDV,Selangor,97,42,55
2021-04-01,MEX,Johor,0,0,0
2021-04-01,MEX,Kedah,0,0,0
2021-04-01,MEX,Kelantan,0,0,0
2021-04-01,MEX,Pahang,0,0,0
2021-04-01,MEX,Perak,0,0,0
2021-04-01,MEX,Perlis,0,0,0
2021-04-01,MEX,Pulau Pinang,0,0,0
2021-04-01,MEX,Sabah,0,0,0
2021-04-01,MEX,Sarawak,0,0,0
2021-04-01,MEX,Selangor,11,7,4
2021-04-01,MEX,W.P. Labuan,0,0,0
2021-04-01,MHL,Johor,0,0,0
2021-04-01,MHL,Kedah,0,0,0
2021-04-01,MHL,Perak,0,0,0
2021-04-01,MHL,Pulau Pinang,0,0,0
2021-04-01,MHL,Sabah,0,0,0
2021-04-01,MHL,Selangor,1,1,0
2021-04-01,MKD,Johor,0,0,0
2021-04-01,MKD,Kedah,0,0,0
2021-04-01,MKD,Perak,0,0,0
2021-04-01,MKD,Pulau Pinang,0,0,0
2021-04-01,MKD,Sabah,0,0,0
2021-04-01,MKD,Sarawak,0,0,0
2021-04-01,MKD,Selangor,2,2,0
2021-04-01,MLI,Johor,0,0,0
2021-04-01,MLI,Sabah,0,0,0
2021-04-01,MLI,Selangor,6,4,2
2021-04-01,MLT,Johor,0,0,0
2021-04-01,MLT,Kedah,0,0,0
2021-04-01,MLT,Kelantan,0,0,0
2021-04-01,MLT,Perak,0,0,0
2021-04-01,MLT,Perlis,0,0,0
2021-04-01,MLT,Pulau Pinang,0,0,0
2021-04-01,MLT,Sabah,0,0,0
2021-04-01,MLT,Sarawak,0,0,0
2021-04-01,MLT,Selangor,1,1,0
2021-04-01,MLT,W.P. Labuan,0,0,0
2021-04-01,MMR,Johor,6,5,1
2021-04-01,MMR,Kedah,0,0,0
2021-04-01,MMR,Kelantan,0,0,0
2021-04-01,MMR,Negeri Sembilan,0,0,0
2021-04-01,MMR,Pahang,0,0,0
2021-04-01,MMR,Perak,0,0,0
2021-04-01,MMR,Perlis,0,0,0
2021-04-01,MMR,Pulau Pinang,0,0,0
2021-04-01,MMR,Sabah,0,0,0
2021-04-01,MMR,Sarawak,0,0,0
2021-04-01,MMR,Selangor,103,90,13
2021-04-01,MMR,Terengganu,0,0,0
2021-04-01,MMR,W.P. Labuan,0,0,0
2021-04-01,MNE,Johor,0,0,0
2021-04-01,MNE,Kedah,0,0,0
2021-04-01,MNE,Pulau Pinang,0,0,0
2021-04-01,MNE,Sabah,0,0,0
2021-04-01,MNE,Sarawak,0,0,0
2021-04-01,MNE,Selangor,6,6,0
2021-04-01,MNG,Johor,0,0,0
2021-04-01,MNG,Kedah,0,0,0
2021-04-01,MNG,Kelantan,0,0,0
2021-04-01,MNG,Perak,0,0,0
2021-04-01,MNG,Perlis,0,0,0
2021-04-01,MNG,Pulau Pinang,0,0,0
2021-04-01,MNG,Sabah,0,0,0
2021-04-01,MNG,Sarawak,0,0,0
2021-04-01,MNG,Selangor,0,0,0
2021-04-01,MNP,Selangor,0,0,0
2021-04-01,MOZ,Johor,0,0,0
2021-04-01,MOZ,Kedah,0,0,0
2021-04-01,MOZ,Perak,0,0,0
2021-04-01,MOZ,Pulau Pinang,0,0,0
2021-04-01,MOZ,Sabah,0,0,0
2021-04-01,MOZ,Sarawak,0,0,0
2021-04-01,MOZ,Selangor,4,4,0
2021-04-01,MRT,Johor,0,0,0
2021-04-01,MRT,Kedah,0,0,0
2021-04-01,MRT,Pulau Pinang,0,0,0
2021-04-01,MRT,Sabah,0,0,0
2021-04-01,MRT,Sarawak,0,0,0
2021-04-01,MRT,Selangor,2,1,1
2021-04-01,MUS,Johor,0,0,0
2021-04-01,MUS,Kedah,0,0,0
2021-04-01,MUS,Kelantan,0,0,0
2021-04-01,MUS,Pahang,0,0,0
2021-04-01,MUS,Perak,0,0,0
2021-04-01,MUS,Perlis,0,0,0
2021-04-01,MUS,Pulau Pinang,0,0,0
2021-04-01,MUS,Sabah,0,0,0
2021-04-01,MUS,Sarawak,0,0,0
2021-04-01,MUS,Selangor,8,4,4
2021-04-01,MWI,Johor,0,0,0
2021-04-01,MWI,Pulau Pinang,0,0,0
2021-04-01,MWI,Sabah,0,0,0
2021-04-01,MWI,Sarawak,0,0,0
2021-04-01,MWI,Selangor,7,5,2
2021-04-01,MYT,Selangor,0,0,0
2021-04-01,NAM,Johor,0,0,0
2021-04-01,NAM,Kedah,0,0,0
2021-04-01,NAM,Perak,0,0,0
2021-04-01,NAM,Perlis,0,0,0
2021-04-01,NAM,Pulau Pinang,0,0,0
2021-04-01,NAM,Sabah,0,0,0
2021-04-01,NAM,Sarawak,0,0,0
2021-04-01,NAM,Selangor,4,3,1
2021-04-01,NCL,Selangor,0,0,0
2021-04-01,NER,Johor,0,0,0
2021-04-01,NER,Sabah,0,0,0
2021-04-01,NER,Selangor,0,0,0
2021-04-01,NGA,Johor,0,0,0
2021-04-01,NGA,Kedah,0,0,0
2021-04-01,NGA,Perlis,0,0,0
2021-04-01,NGA,Pulau Pinang,0,0,0
2021-04-01,NGA,Sabah,0,0,0
2021-04-01,NGA,Sarawak,0,0,0
2021-04-01,NGA,Selangor,164,155,9
2021-04-01,NIC,Johor,0,0,0
2021-04-01,NIC,Kedah,0,0,0
2021-04-01,NIC,Pulau Pinang,0,0,0
2021-04-01,NIC,Sabah,0,0,0
2021-04-01,NIC,Selangor,5,5,0
2021-04-01,NLD,Johor,4,4,0
2021-04-01,NLD,Kedah,0,0,0
2021-04-01,NLD,Kelantan,0,0,0
2021-04-01,NLD,Melaka,0,0,0
2021-04-01,NLD,Negeri Sembilan,0,0,0
2021-04-01,NLD,Pahang,0,0,0
2021-04-01,NLD,Perak,0,0,0
2021-04-01,NLD,Perlis,0,0,0
2021-04-01,NLD,Pulau Pinang,0,0,0
2021-04-01,NLD,Sabah,0,0,0
2021-04-01,NLD,Sarawak,0,0,0
2021-04-01,NLD,Selangor,61,50,11
2021-04-01,NLD,Terengganu,0,0,0
2021-04-01,NLD,W.P. Labuan,0,0,0
2021-04-01,NOR,Johor,1,1,0
2021-04-01,NOR,Kedah,0,0,0
2021-04-01,NOR,Kelantan,0,0,0
2021-04-01,NOR,Melaka,0,0,0
2021-04-01,NOR,Pahang,0,0,0
2021-04-01,NOR,Perak,0,0,0
2021-04-01,NOR,Perlis,0,0,0
2021-04-01,NOR,Pulau Pinang,0,0,0
2021-04-01,NOR,Sabah,0,0,0
2021-04-01,NOR,Sarawak,0,0,0
2021-04-01,NOR,Selangor,12,10,2
2021-04-01,NOR,W.P. Labuan,0,0,0
2021-04-01,NPL,Johor,0,0,0
2021-04-01,NPL,Kedah,0,0,0
2021-04-01,NPL,Pahang,0,0,0
2021-04-01,NPL,Perak,0,0,0
2021-04-01,NPL,Perlis,0,0,0
2021-04-01,NPL,Pulau Pinang,0,0,0
2021-04-01,NPL,Sabah,0,0,0
2021-04-01,NPL,Sarawak,0,0,0
2021-04-01,NPL,Selangor,182,178,4
2021-04-01,NPL,W.P. Labuan,0,0,0
2021-04-01,NRU,Johor,0,0,0
2021-04-01,NRU,Pulau Pinang,0,0,0
2021-04-01,NRU,Selangor,0,0,0
2021-04-01,NZL,Johor,0,0,0
2021-04-01,NZL,Kedah,0,0,0
2021-04-01,NZL,Kelantan,0,0,0
2021-04-01,NZL,Melaka,0,0,0
2021-04-01,NZL,Negeri Sembilan,0,0,0
2021-04-01,NZL,Pahang,0,0,0
2021-04-01,NZL,Perak,0,0,0
2021-04-01,NZL,Perlis,0,0,0
2021-04-01,NZL,Pulau Pinang,0,0,0
2021-04-01,NZL,Sabah,0,0,0
2021-04-01,NZL,Sarawak,0,0,0
2021-04-01,NZL,Selangor,26,17,9
2021-04-01,NZL,Terengganu,0,0,0
2021-04-01,NZL,W.P. Labuan,0,0,0
2021-04-01,OMN,Johor,0,0,0
2021-04-01,OMN,Kedah,0,0,0
2021-04-01,OMN,Kelantan,0,0,0
2021-04-01,OMN,Melaka,0,0,0
2021-04-01,OMN,Perak,0,0,0
2021-04-01,OMN,Perlis,0,0,0
2021-04-01,OMN,Pulau Pinang,0,0,0
2021-04-01,OMN,Sabah,0,0,0
2021-04-01,OMN,Sarawak,0,0,0
2021-04-01,OMN,Selangor,10,6,4
2021-04-01,PAK,Johor,13,13,0
2021-04-01,PAK,Kedah,0,0,0
2021-04-01,PAK,Kelantan,0,0,0
2021-04-01,PAK,Melaka,0,0,0
2021-04-01,PAK,Negeri Sembilan,0,0,0
2021-04-01,PAK,Pahang,0,0,0
2021-04-01,PAK,Perak,0,0,0
2021-04-01,PAK,Perlis,0,0,0
2021-04-01,PAK,Pulau Pinang,0,0,0
2021-04-01,PAK,Sabah,1,1,0
2021-04-01,PAK,Sarawak,0,0,0
2021-04-01,PAK,Selangor,298,232,66
2021-04-01,PAK,W.P. Labuan,0,0,0
2021-04-01,PAN,Johor,0,0,0
2021-04-01,PAN,Kedah,0,0,0
2021-04-01,PAN,Perak,0,0,0
2021-04-01,PAN,Perlis,0,0,0
2021-04-01,PAN,Pulau Pinang,0,0,0
2021-04-01,PAN,Sabah,0,0,0
2021-04-01,PAN,Sarawak,0,0,0
2021-04-01,PAN,Selangor,1,1,0
2021-04-01,PER,Johor,0,0,0
2021-04-01,PER,Kedah,0,0,0
2021-04-01,PER,Kelantan,0,0,0
2021-04-01,PER,Pahang,0,0,0
2021-04-01,PER,Perak,0,0,0
2021-04-01,PER,Perlis,0,0,0
2021-04-01,PER,Pulau Pinang,0,0,0
2021-04-01,PER,Sabah,0,0,0
2021-04-01,PER,Sarawak,0,0,0
2021-04-01,PER,Selangor,2,1,1
2021-04-01,PER,W.P. Labuan,0,0,0
2021-04-01,PHL,Johor,158,156,2
2021-04-01,PHL,Kedah,0,0,0
2021-04-01,PHL,Kelantan,0,0,0
2021-04-01,PHL,Melaka,0,0,0
2021-04-01,PHL,Negeri Sembilan,0,0,0
2021-04-01,PHL,Pahang,0,0,0
2021-04-01,PHL,Perak,0,0,0
2021-04-01,PHL,Perlis,0,0,0
2021-04-01,PHL,Pulau Pinang,1,1,0
2021-04-01,PHL,Sabah,0,0,0
2021-04-01,PHL,Sarawak,72,72,0
2021-04-01,PHL,Selangor,622,512,110
2021-04-01,PHL,Terengganu,0,0,0
2021-04-01,PHL,W.P. Labuan,2,2,0
2021-04-01,PLW,Johor,0,0,0
2021-04-01,PLW,Pulau Pinang,0,0,0
2021-04-01,PLW,Selangor,0,0,0
2021-04-01,PNG,Johor,0,0,0
2021-04-01,PNG,Kedah,0,0,0
2021-04-01,PNG,Kelantan,0,0,0
2021-04-01,PNG,Perak,0,0,0
2021-04-01,PNG,Pulau Pinang,0,0,0
2021-04-01,PNG,Sabah,0,0,0
2021-04-01,PNG,Sarawak,0,0,0
2021-04-01,PNG,Selangor,1,0,1
2021-04-01,POL,Johor,4,4,0
2021-04-01,POL,Kedah,0,0,0
2021-04-01,POL,Kelantan,0,0,0
2021-04-01,POL,Melaka,0,0,0
2021-04-01,POL,Negeri Sembilan,0,0,0
2021-04-01,POL,Pahang,0,0,0
2021-04-01,POL,Perak,0,0,0
2021-04-01,POL,Perlis,0,0,0
2021-04-01,POL,Pulau Pinang,0,0,0
2021-04-01,POL,Sabah,0,0,0
2021-04-01,POL,Sarawak,0,0,0
2021-04-01,POL,Selangor,26,26,0
2021-04-01,POL,Terengganu,0,0,0
2021-04-01,POL,W.P. Labuan,0,0,0
2021-04-01,PRK,Selangor,0,0,0
2021-04-01,PRT,Johor,0,0,0
2021-04-01,PRT,Kedah,0,0,0
2021-04-01,PRT,Kelantan,0,0,0
2021-04-01,PRT,Melaka,0,0,0
2021-04-01,PRT,Pahang,0,0,0
2021-04-01,PRT,Perak,0,0,0
2021-04-01,PRT,Perlis,0,0,0
2021-04-01,PRT,Pulau Pinang,0,0,0
2021-04-01,PRT,Sabah,0,0,0
2021-04-01,PRT,Sarawak,0,0,0
2021-04-01,PRT,Selangor,7,4,3
2021-04-01,PRT,W.P. Labuan,0,0,0
2021-04-01,PRY,Johor,0,0,0
2021-04-01,PRY,Kedah,0,0,0
2021-04-01,PRY,Perak,0,0,0
2021-04-01,PRY,Perlis,0,0,0
2021-04-01,PRY,Pulau Pinang,0,0,0
2021-04-01,PRY,Sabah,0,0,0
2021-04-01,PRY,Sarawak,0,0,0
2021-04-01,PRY,Selangor,0,0,0
2021-04-01,PSE,Johor,0,0,0
2021-04-01,PSE,Kedah,0,0,0
2021-04-01,PSE,Kelantan,0,0,0
2021-04-01,PSE,Melaka,0,0,0
2021-04-01,PSE,Perak,0,0,0
2021-04-01,PSE,Perlis,0,0,0
2021-04-01,PSE,Pulau Pinang,0,0,0
2021-04-01,PSE,Sabah,0,0,0
2021-04-01,PSE,Sarawak,0,0,0
2021-04-01,PSE,Selangor,15,14,1
2021-04-01,QAT,Johor,0,0,0
2021-04-01,QAT,Kedah,0,0,0
2021-04-01,QAT,Perlis,0,0,0
2021-04-01,QAT,Pulau Pinang,0,0,0
2021-04-01,QAT,Sabah,0,0,0
2021-04-01,QAT,Sarawak,0,0,0
2021-04-01,QAT,Selangor,8,4,4
2021-04-01,REU,Johor,0,0,0
2021-04-01,REU,Sarawak,0,0,0
2021-04-01,ROU,Johor,0,0,0
2021-04-01,ROU,Kedah,0,0,0
2021-04-01,ROU,Kelantan,0,0,0
2021-04-01,ROU,Negeri Sembilan,0,0,0
2021-04-01,ROU,Pahang,0,0,0
2021-04-01,ROU,Perak,0,0,0
2021-04-01,ROU,Perlis,0,0,0
2021-04-01,ROU,Pulau Pinang,0,0,0
2021-04-01,ROU,Sabah,0,0,0
2021-04-01,ROU,Sarawak,0,0,0
2021-04-01,ROU,Selangor,22,19,3
2021-04-01,ROU,W.P. Labuan,0,0,0
2021-04-01,RUS,Johor,5,5,0
2021-04-01,RUS,Kedah,3,3,0
2021-04-01,RUS,Kelantan,0,0,0
2021-04-01,RUS,Melaka,0,0,0
2021-04-01,RUS,Negeri Sembilan,0,0,0
2021-04-01,RUS,Pahang,0,0,0
2021-04-01,RUS,Perak,0,0,0
2021-04-01,RUS,Perlis,0,0,0
2021-04-01,RUS,Pulau Pinang,0,0,0
2021-04-01,RUS,Sabah,0,0,0
2021-04-01,RUS,Sarawak,0,0,0
2021-04-01,RUS,Selangor,101,84,17
2021-04-01,RUS,W.P. Labuan,0,0,0
2021-04-01,RWA,Johor,0,0,0
2021-04-01,RWA,Kedah,0,0,0
2021-04-01,RWA,Pulau Pinang,0,0,0
2021-04-01,RWA,Selangor,4,3,1
2021-04-01,SAU,Johor,0,0,0
2021-04-01,SAU,Kedah,0,0,0
2021-04-01,SAU,Kelantan,0,0,0
2021-04-01,SAU,Melaka,0,0,0
2021-04-01,SAU,Perak,0,0,0
2021-04-01,SAU,Perlis,0,0,0
2021-04-01,SAU,Pulau Pinang,0,0,0
2021-04-01,SAU,Sabah,0,0,0
2021-04-01,SAU,Sarawak,0,0,0
2021-04-01,SAU,Selangor,64,36,28
2021-04-01,SAU,W.P. Labuan,0,0,0
2021-04-01,SDN,Johor,0,0,0
2021-04-01,SDN,Kedah,0,0,0
2021-04-01,SDN,Kelantan,0,0,0
2021-04-01,SDN,Perlis,0,0,0
2021-04-01,SDN,Pulau Pinang,0,0,0
2021-04-01,SDN,Sabah,0,0,0
2021-04-01,SDN,Sarawak,0,0,0
2021-04-01,SDN,Selangor,67,40,27
2021-04-01,SDN,W.P. Labuan,0,0,0
2021-04-01,SEN,Johor,0,0,0
2021-04-01,SEN,Kedah,0,0,0
2021-04-01,SEN,Kelantan,0,0,0
2021-04-01,SEN,Perak,0,0,0
2021-04-01,SEN,Perlis,0,0,0
2021-04-01,SEN,Pulau Pinang,0,0,0
2021-04-01,SEN,Sabah,0,0,0
2021-04-01,SEN,Sarawak,0,0,0
2021-04-01,SEN,Selangor,2,2,0
2021-04-01,SGP,Johor,244,217,27
2021-04-01,SGP,Kedah,0,0,0
2021-04-01,SGP,Kelantan,0,0,0
2021-04-01,SGP,Melaka,0,0,0
2021-04-01,SGP,Negeri Sembilan,0,0,0
2021-04-01,SGP,Pahang,0,0,0
2021-04-01,SGP,Perak,8,3,5
2021-04-01,SGP,Perlis,1,0,1
2021-04-01,SGP,Pulau Pinang,20,14,6
2021-04-01,SGP,Sabah,1,1,0
2021-04-01,SGP,Sarawak,6,4,2
2021-04-01,SGP,Selangor,162,104,58
2021-04-01,SGP,Terengganu,0,0,0
2021-04-01,SGP,W.P. Labuan,0,0,0
2021-04-01,SGS,Johor,0,0,0
2021-04-01,SGS,Sabah,0,0,0
2021-04-01,SGS,Selangor,0,0,0
2021-04-01,SHN,Sarawak,0,0,0
2021-04-01,SLB,Johor,0,0,0
2021-04-01,SLB,Perlis,0,0,0
2021-04-01,SLB,Pulau Pinang,0,0,0
2021-04-01,SLB,Sabah,0,0,0
2021-04-01,SLB,Sarawak,0,0,0
2021-04-01,SLB,Selangor,0,0,0
2021-04-01,SLB,W.P. Labuan,0,0,0
2021-04-01,SLE,Johor,0,0,0
2021-04-01,SLE,Kedah,0,0,0
2021-04-01,SLE,Perak,0,0,0
2021-04-01,SLE,Pulau Pinang,0,0,0
2021-04-01,SLE,Sabah,0,0,0
2021-04-01,SLE,Selangor,2,2,0
2021-04-01,SLV,Johor,0,0,0
2021-04-01,SLV,Kedah,0,0,0
2021-04-01,SLV,Perak,0,0,0
2021-04-01,SLV,Perlis,0,0,0
2021-04-01,SLV,Pulau Pinang,0,0,0
2021-04-01,SLV,Sabah,0,0,0
2021-04-01,SLV,Selangor,0,0,0
2021-04-01,SLV,W.P. Labuan,0,0,0
2021-04-01,SMR,Johor,0,0,0
2021-04-01,SMR,Selangor,0,0,0
2021-04-01,SOM,Johor,0,0,0
2021-04-01,SOM,Kedah,0,0,0
2021-04-01,SOM,Kelantan,0,0,0
2021-04-01,SOM,Perlis,0,0,0
2021-04-01,SOM,Sabah,0,0,0
2021-04-01,SOM,Sarawak,0,0,0
2021-04-01,SOM,Selangor,48,38,10
2021-04-01,SRB,Johor,0,0,0
2021-04-01,SRB,Kedah,0,0,0
2021-04-01,SRB,Kelantan,0,0,0
2021-04-01,SRB,Pahang,0,0,0
2021-04-01,SRB,Perak,0,0,0
2021-04-01,SRB,Perlis,0,0,0
2021-04-01,SRB,Pulau Pinang,0,0,0
2021-04-01,SRB,Sabah,0,0,0
2021-04-01,SRB,Sarawak,0,0,0
2021-04-01,SRB,Selangor,2,1,1
2021-04-01,SSD,Johor,0,0,0
2021-04-01,SSD,Kedah,0,0,0
2021-04-01,SSD,Sarawak,0,0,0
2021-04-01,SSD,Selangor,4,3,1
2021-04-01,SSD,W.P. Labuan,0,0,0
2021-04-01,STP,Selangor,0,0,0
2021-04-01,SUR,Johor,0,0,0
2021-04-01,SUR,Kedah,0,0,0
2021-04-01,SUR,Kelantan,0,0,0
2021-04-01,SUR,Perak,0,0,0
2021-04-01,SUR,Perlis,0,0,0
2021-04-01,SUR,Pulau Pinang,0,0,0
2021-04-01,SUR,Sabah,0,0,0
2021-04-01,SUR,Sarawak,0,0,0
2021-04-01,SUR,Selangor,0,0,0
2021-04-01,SVK,Johor,0,0,0
2021-04-01,SVK,Kedah,0,0,0
2021-04-01,SVK,Kelantan,0,0,0
2021-04-01,SVK,Negeri Sembilan,0,0,0
2021-04-01,SVK,Pahang,0,0,0
2021-04-01,SVK,Perak,0,0,0
2021-04-01,SVK,Perlis,0,0,0
2021-04-01,SVK,Pulau Pinang,0,0,0
2021-04-01,SVK,Sabah,0,0,0
2021-04-01,SVK,Sarawak,0,0,0
2021-04-01,SVK,Selangor,11,8,3
2021-04-01,SVK,W.P. Labuan,0,0,0
2021-04-01,SVN,Johor,0,0,0
2021-04-01,SVN,Kedah,0,0,0
2021-04-01,SVN,Kelantan,0,0,0
2021-04-01,SVN,Perak,0,0,0
2021-04-01,SVN,Perlis,0,0,0
2021-04-01,SVN,Pulau Pinang,0,0,0
2021-04-01,SVN,Sabah,0,0,0
2021-04-01,SVN,Sarawak,0,0,0
2021-04-01,SVN,Selangor,1,1,0
2021-04-01,SVN,W.P. Labuan,0,0,0
2021-04-01,SWE,Johor,2,2,0
2021-04-01,SWE,Kedah,0,0,0
2021-04-01,SWE,Kelantan,0,0,0
2021-04-01,SWE,Melaka,0,0,0
2021-04-01,SWE,Negeri Sembilan,0,0,0
2021-04-01,SWE,Pahang,0,0,0
2021-04-01,SWE,Perak,0,0,0
2021-04-01,SWE,Perlis,0,0,0
2021-04-01,SWE,Pulau Pinang,0,0,0
2021-04-01,SWE,Sabah,0,0,0
2021-04-01,SWE,Sarawak,0,0,0
2021-04-01,SWE,Selangor,32,27,5
2021-04-01,SWE,W.P. Labuan,0,0,0
2021-04-01,SWZ,Johor,0,0,0
2021-04-01,SWZ,Kedah,0,0,0
2021-04-01,SWZ,Pulau Pinang,0,0,0
2021-04-01,SWZ,Sabah,0,0,0
2021-04-01,SWZ,Selangor,1,1,0
2021-04-01,SYC,Johor,0,0,0
2021-04-01,SYC,Kedah,0,0,0
2021-04-01,SYC,Pulau Pinang,0,0,0
2021-04-01,SYC,Sabah,0,0,0
2021-04-01,SYC,Sarawak,0,0,0
2021-04-01,SYC,Selangor,6,1,5
2021-04-01,SYR,Johor,0,0,0
2021-04-01,SYR,Kedah,0,0,0
2021-04-01,SYR,Kelantan,0,0,0
2021-04-01,SYR,Pahang,0,0,0
2021-04-01,SYR,Perlis,0,0,0
2021-04-01,SYR,Pulau Pinang,0,0,0
2021-04-01,SYR,Sabah,0,0,0
2021-04-01,SYR,Sarawak,0,0,0
2021-04-01,SYR,Selangor,33,22,11
2021-04-01,SYR,W.P. Labuan,0,0,0
2021-04-01,TCA,Perlis,0,0,0
2021-04-01,TCD,Johor,0,0,0
2021-04-01,TCD,Kedah,0,0,0
2021-04-01,TCD,Perlis,0,0,0
2021-04-01,TCD,Selangor,3,3,0
2021-04-01,TGO,Johor,0,0,0
2021-04-01,TGO,Perak,0,0,0
2021-04-01,TGO,Pulau Pinang,0,0,0
2021-04-01,TGO,Selangor,1,1,0
2021-04-01,THA,Johor,7,7,0
2021-04-01,THA,Kedah,17845,17805,40
2021-04-01,THA,Kelantan,5,2,3
2021-04-01,THA,Melaka,0,0,0
2021-04-01,THA,Negeri Sembilan,0,0,0
2021-04-01,THA,Pahang,0,0,0
2021-04-01,THA,Perak,0,0,0
2021-04-01,THA,Perlis,8154,7874,280
2021-04-01,THA,Pulau Pinang,2,1,1
2021-04-01,THA,Sabah,0,0,0
2021-04-01,THA,Sarawak,14,14,0
2021-04-01,THA,Selangor,243,144,99
2021-04-01,THA,Terengganu,0,0,0
2021-04-01,THA,W.P. Labuan,0,0,0
2021-04-01,TJK,Johor,0,0,0
2021-04-01,TJK,Kedah,0,0,0
2021-04-01,TJK,Perlis,0,0,0
2021-04-01,TJK,Pulau Pinang,0,0,0
2021-04-01,TJK,Sabah,0,0,0
2021-04-01,TJK,Selangor,3,3,0
2021-04-01,TKL,Selangor,0,0,0
2021-04-01,TKM,Johor,0,0,0
2021-04-01,TKM,Kedah,0,0,0
2021-04-01,TKM,Kelantan,0,0,0
2021-04-01,TKM,Perlis,0,0,0
2021-04-01,TKM,Pulau Pinang,0,0,0
2021-04-01,TKM,Sabah,0,0,0
2021-04-01,TKM,Sarawak,0,0,0
2021-04-01,TKM,Selangor,1,0,1
2021-04-01,TLS,Johor,0,0,0
2021-04-01,TLS,Kedah,0,0,0
2021-04-01,TLS,Perlis,0,0,0
2021-04-01,TLS,Pulau Pinang,0,0,0
2021-04-01,TLS,Sabah,0,0,0
2021-04-01,TLS,Sarawak,0,0,0
2021-04-01,TLS,Selangor,2,1,1
2021-04-01,TON,Johor,0,0,0
2021-04-01,TON,Pulau Pinang,0,0,0
2021-04-01,TON,Sarawak,0,0,0
2021-04-01,TON,Selangor,0,0,0
2021-04-01,TTO,Johor,0,0,0
2021-04-01,TTO,Kedah,0,0,0
2021-04-01,TTO,Pahang,0,0,0
2021-04-01,TTO,Pulau Pinang,0,0,0
2021-04-01,TTO,Sabah,0,0,0
2021-04-01,TTO,Sarawak,0,0,0
2021-04-01,TTO,Selangor,1,0,1
2021-04-01,TUN,Johor,0,0,0
2021-04-01,TUN,Kedah,0,0,0
2021-04-01,TUN,Kelantan,0,0,0
2021-04-01,TUN,Melaka,0,0,0
2021-04-01,TUN,Perak,0,0,0
2021-04-01,TUN,Perlis,0,0,0
2021-04-01,TUN,Pulau Pinang,0,0,0
2021-04-01,TUN,Sabah,0,0,0
2021-04-01,TUN,Sarawak,0,0,0
2021-04-01,TUN,Selangor,6,3,3
2021-04-01,TUN,W.P. Labuan,0,0,0
2021-04-01,TUR,Johor,1,1,0
2021-04-01,TUR,Kedah,0,0,0
2021-04-01,TUR,Kelantan,0,0,0
2021-04-01,TUR,Melaka,0,0,0
2021-04-01,TUR,Negeri Sembilan,0,0,0
2021-04-01,TUR,Pahang,0,0,0
2021-04-01,TUR,Perak,0,0,0
2021-04-01,TUR,Perlis,0,0,0
2021-04-01,TUR,Pulau Pinang,0,0,0
2021-04-01,TUR,Sabah,0,0,0
2021-04-01,TUR,Sarawak,0,0,0
2021-04-01,TUR,Selangor,27,22,5
2021-04-01,TUR,W.P. Labuan,0,0,0
2021-04-01,TUV,Selangor,0,0,0
2021-04-01,TWN,Johor,2,2,0
2021-04-01,TWN,Kedah,0,0,0
2021-04-01,TWN,Kelantan,0,0,0
2021-04-01,TWN,Melaka,0,0,0
2021-04-01,TWN,Negeri Sembilan,0,0,0
2021-04-01,TWN,Pahang,0,0,0
2021-04-01,TWN,Perak,0,0,0
2021-04-01,TWN,Perlis,0,0,0
2021-04-01,TWN,Pulau Pinang,15,10,5
2021-04-01,TWN,Sabah,0,0,0
2021-04-01,TWN,Sarawak,2,2,0
2021-04-01,TWN,Selangor,89,65,24
2021-04-01,TWN,W.P. Labuan,0,0,0
2021-04-01,TZA,Johor,0,0,0
2021-04-01,TZA,Kedah,0,0,0
2021-04-01,TZA,Perak,0,0,0
2021-04-01,TZA,Perlis,0,0,0
2021-04-01,TZA,Pulau Pinang,0,0,0
2021-04-01,TZA,Sabah,0,0,0
2021-04-01,TZA,Sarawak,0,0,0
2021-04-01,TZA,Selangor,32,14,18
2021-04-01,UGA,Johor,0,0,0
2021-04-01,UGA,Kedah,0,0,0
2021-04-01,UGA,Perak,0,0,0
2021-04-01,UGA,Perlis,0,0,0
2021-04-01,UGA,Pulau Pinang,0,0,0
2021-04-01,UGA,Sabah,0,0,0
2021-04-01,UGA,Sarawak,0,0,0
2021-04-01,UGA,Selangor,9,3,6
2021-04-01,UKR,Johor,8,8,0
2021-04-01,UKR,Kedah,0,0,0
2021-04-01,UKR,Kelantan,0,0,0
2021-04-01,UKR,Melaka,0,0,0
2021-04-01,UKR,Negeri Sembilan,0,0,0
2021-04-01,UKR,Pahang,0,0,0
2021-04-01,UKR,Perak,0,0,0
2021-04-01,UKR,Perlis,0,0,0
2021-04-01,UKR,Pulau Pinang,0,0,0
2021-04-01,UKR,Sabah,0,0,0
2021-04-01,UKR,Sarawak,0,0,0
2021-04-01,UKR,Selangor,63,62,1
2021-04-01,UKR,W.P. Labuan,0,0,0
2021-04-01,URY,Johor,0,0,0
2021-04-01,URY,Kedah,0,0,0
2021-04-01,URY,Kelantan,0,0,0
2021-04-01,URY,Perak,0,0,0
2021-04-01,URY,Perlis,0,0,0
2021-04-01,URY,Pulau Pinang,0,0,0
2021-04-01,URY,Sabah,0,0,0
2021-04-01,URY,Sarawak,0,0,0
2021-04-01,URY,Selangor,0,0,0
2021-04-01,URY,W.P. Labuan,0,0,0
2021-04-01,USA,Johor,0,0,0
2021-04-01,USA,Kedah,0,0,0
2021-04-01,USA,Kelantan,0,0,0
2021-04-01,USA,Melaka,0,0,0
2021-04-01,USA,Negeri Sembilan,0,0,0
2021-04-01,USA,Pahang,0,0,0
2021-04-01,USA,Perak,0,0,0
2021-04-01,USA,Perlis,0,0,0
2021-04-01,USA,Pulau Pinang,4,0,4
2021-04-01,USA,Sabah,0,0,0
2021-04-01,USA,Sarawak,2,1,1
2021-04-01,USA,Selangor,164,119,45
2021-04-01,USA,Terengganu,0,0,0
2021-04-01,USA,W.P. Labuan,0,0,0
2021-04-01,UZB,Johor,0,0,0
2021-04-01,UZB,Kedah,0,0,0
2021-04-01,UZB,Kelantan,0,0,0
2021-04-01,UZB,Perak,0,0,0
2021-04-01,UZB,Perlis,0,0,0
2021-04-01,UZB,Pulau Pinang,0,0,0
2021-04-01,UZB,Sabah,0,0,0
2021-04-01,UZB,Sarawak,0,0,0
2021-04-01,UZB,Selangor,13,12,1
2021-04-01,VAT,Johor,0,0,0
2021-04-01,VAT,Sarawak,0,0,0
2021-04-01,VAT,Selangor,0,0,0
2021-04-01,VCT,Johor,0,0,0
2021-04-01,VCT,Kedah,0,0,0
2021-04-01,VCT,Pulau Pinang,0,0,0
2021-04-01,VCT,Sarawak,0,0,0
2021-04-01,VCT,Selangor,0,0,0
2021-04-01,VEN,Johor,0,0,0
2021-04-01,VEN,Kedah,0,0,0
2021-04-01,VEN,Kelantan,0,0,0
2021-04-01,VEN,Melaka,0,0,0
2021-04-01,VEN,Perak,0,0,0
2021-04-01,VEN,Perlis,0,0,0
2021-04-01,VEN,Pulau Pinang,0,0,0
2021-04-01,VEN,Sabah,0,0,0
2021-04-01,VEN,Sarawak,0,0,0
2021-04-01,VEN,Selangor,2,2,0
2021-04-01,VEN,W.P. Labuan,0,0,0
2021-04-01,VNM,Johor,1,0,1
2021-04-01,VNM,Kedah,0,0,0
2021-04-01,VNM,Kelantan,0,0,0
2021-04-01,VNM,Melaka,0,0,0
2021-04-01,VNM,Negeri Sembilan,0,0,0
2021-04-01,VNM,Pahang,0,0,0
2021-04-01,VNM,Perak,0,0,0
2021-04-01,VNM,Perlis,0,0,0
2021-04-01,VNM,Pulau Pinang,1,0,1
2021-04-01,VNM,Sabah,0,0,0
2021-04-01,VNM,Sarawak,0,0,0
2021-04-01,VNM,Selangor,118,31,87
2021-04-01,VNM,Terengganu,0,0,0
2021-04-01,VNM,W.P. Labuan,0,0,0
2021-04-01,VUT,Johor,0,0,0
2021-04-01,VUT,Kedah,0,0,0
2021-04-01,VUT,Pulau Pinang,0,0,0
2021-04-01,VUT,Sabah,0,0,0
2021-04-01,VUT,Sarawak,0,0,0
2021-04-01,VUT,Selangor,0,0,0
2021-04-01,WSM,Johor,0,0,0
2021-04-01,WSM,Sarawak,0,0,0
2021-04-01,WSM,Selangor,0,0,0
2021-04-01,XXX,Johor,0,0,0
2021-04-01,XXX,Kedah,0,0,0
2021-04-01,XXX,Kelantan,0,0,0
2021-04-01,XXX,Melaka,0,0,0
2021-04-01,XXX,Pahang,0,0,0
2021-04-01,XXX,Perak,0,0,0
2021-04-01,XXX,Perlis,0,0,0
2021-04-01,XXX,Pulau Pinang,1,0,1
2021-04-01,XXX,Sabah,0,0,0
2021-04-01,XXX,Sarawak,0,0,0
2021-04-01,XXX,Selangor,9,7,2
2021-04-01,XXX,W.P. Labuan,0,0,0
2021-04-01,YEM,Johor,0,0,0
2021-04-01,YEM,Kedah,0,0,0
2021-04-01,YEM,Kelantan,0,0,0
2021-04-01,YEM,Melaka,0,0,0
2021-04-01,YEM,Pahang,0,0,0
2021-04-01,YEM,Perak,0,0,0
2021-04-01,YEM,Perlis,0,0,0
2021-04-01,YEM,Pulau Pinang,0,0,0
2021-04-01,YEM,Sabah,0,0,0
2021-04-01,YEM,Sarawak,0,0,0
2021-04-01,YEM,Selangor,96,77,19
2021-04-01,YEM,W.P. Labuan,0,0,0
2021-04-01,ZAF,Johor,2,2,0
2021-04-01,ZAF,Kedah,0,0,0
2021-04-01,ZAF,Kelantan,0,0,0
2021-04-01,ZAF,Melaka,0,0,0
2021-04-01,ZAF,Pahang,0,0,0
2021-04-01,ZAF,Perak,0,0,0
2021-04-01,ZAF,Perlis,0,0,0
2021-04-01,ZAF,Pulau Pinang,0,0,0
2021-04-01,ZAF,Sabah,0,0,0
2021-04-01,ZAF,Sarawak,0,0,0
2021-04-01,ZAF,Selangor,41,32,9
2021-04-01,ZAF,Terengganu,0,0,0
2021-04-01,ZAF,W.P. Labuan,0,0,0
2021-04-01,ZAR,Selangor,0,0,0
2021-04-01,ZMB,Johor,0,0,0
2021-04-01,ZMB,Kedah,0,0,0
2021-04-01,ZMB,Perak,0,0,0
2021-04-01,ZMB,Perlis,0,0,0
2021-04-01,ZMB,Pulau Pinang,0,0,0
2021-04-01,ZMB,Sabah,0,0,0
2021-04-01,ZMB,Sarawak,0,0,0
2021-04-01,ZMB,Selangor,15,4,11
2021-04-01,ZWE,Johor,0,0,0
2021-04-01,ZWE,Kedah,0,0,0
2021-04-01,ZWE,Kelantan,0,0,0
2021-04-01,ZWE,Perak,0,0,0
2021-04-01,ZWE,Perlis,0,0,0
2021-04-01,ZWE,Pulau Pinang,0,0,0
2021-04-01,ZWE,Sabah,0,0,0
2021-04-01,ZWE,Sarawak,0,0,0
2021-04-01,ZWE,Selangor,12,6,6
2021-05-01,ABW,Kedah,0,0,0
2021-05-01,ABW,Pulau Pinang,0,0,0
2021-05-01,AFG,Johor,0,0,0
2021-05-01,AFG,Kedah,0,0,0
2021-05-01,AFG,Perlis,0,0,0
2021-05-01,AFG,Pulau Pinang,0,0,0
2021-05-01,AFG,Sarawak,0,0,0
2021-05-01,AFG,Selangor,26,18,8
2021-05-01,AGO,Johor,0,0,0
2021-05-01,AGO,Kedah,0,0,0
2021-05-01,AGO,Sabah,0,0,0
2021-05-01,AGO,Selangor,0,0,0
2021-05-01,AIA,Selangor,0,0,0
2021-05-01,ALB,Johor,0,0,0
2021-05-01,ALB,Kedah,0,0,0
2021-05-01,ALB,Perak,0,0,0
2021-05-01,ALB,Perlis,0,0,0
2021-05-01,ALB,Pulau Pinang,0,0,0
2021-05-01,ALB,Sabah,0,0,0
2021-05-01,ALB,Sarawak,0,0,0
2021-05-01,ALB,Selangor,1,0,1
2021-05-01,AND,Johor,0,0,0
2021-05-01,AND,Kedah,0,0,0
2021-05-01,AND,Perlis,0,0,0
2021-05-01,AND,Pulau Pinang,0,0,0
2021-05-01,AND,Selangor,0,0,0
2021-05-01,ANT,Selangor,0,0,0
2021-05-01,ARE,Johor,0,0,0
2021-05-01,ARE,Kedah,0,0,0
2021-05-01,ARE,Kelantan,0,0,0
2021-05-01,ARE,Perak,0,0,0
2021-05-01,ARE,Perlis,0,0,0
2021-05-01,ARE,Pulau Pinang,0,0,0
2021-05-01,ARE,Sabah,0,0,0
2021-05-01,ARE,Sarawak,0,0,0
2021-05-01,ARE,Selangor,11,6,5
2021-05-01,ARG,Johor,0,0,0
2021-05-01,ARG,Kedah,0,0,0
2021-05-01,ARG,Kelantan,0,0,0
2021-05-01,ARG,Melaka,0,0,0
2021-05-01,ARG,Perak,0,0,0
2021-05-01,ARG,Perlis,0,0,0
2021-05-01,ARG,Pulau Pinang,0,0,0
2021-05-01,ARG,Sabah,0,0,0
2021-05-01,ARG,Sarawak,0,0,0
2021-05-01,ARG,Selangor,6,6,0
2021-05-01,ARG,W.P. Labuan,0,0,0
2021-05-01,ARM,Johor,0,0,0
2021-05-01,ARM,Kedah,0,0,0
2021-05-01,ARM,Kelantan,0,0,0
2021-05-01,ARM,Perak,0,0,0
2021-05-01,ARM,Perlis,0,0,0
2021-05-01,ARM,Pulau Pinang,0,0,0
2021-05-01,ARM,Sabah,0,0,0
2021-05-01,ARM,Sarawak,0,0,0
2021-05-01,ARM,Selangor,1,0,1
2021-05-01,ATA,Selangor,0,0,0
2021-05-01,ATG,Johor,0,0,0
2021-05-01,ATG,Kedah,0,0,0
2021-05-01,ATG,Pulau Pinang,0,0,0
2021-05-01,ATG,Sarawak,0,0,0
2021-05-01,ATG,Selangor,0,0,0
2021-05-01,AUS,Johor,0,0,0
2021-05-01,AUS,Kedah,0,0,0
2021-05-01,AUS,Kelantan,0,0,0
2021-05-01,AUS,Melaka,0,0,0
2021-05-01,AUS,Negeri Sembilan,0,0,0
2021-05-01,AUS,Pahang,0,0,0
2021-05-01,AUS,Perak,0,0,0
2021-05-01,AUS,Perlis,0,0,0
2021-05-01,AUS,Pulau Pinang,1,1,0
2021-05-01,AUS,Sabah,0,0,0
2021-05-01,AUS,Sarawak,0,0,0
2021-05-01,AUS,Selangor,77,55,22
2021-05-01,AUS,Terengganu,0,0,0
2021-05-01,AUS,W.P. Labuan,0,0,0
2021-05-01,AUT,Johor,0,0,0
2021-05-01,AUT,Kedah,0,0,0
2021-05-01,AUT,Kelantan,0,0,0
2021-05-01,AUT,Melaka,0,0,0
2021-05-01,AUT,Negeri Sembilan,0,0,0
2021-05-01,AUT,Pahang,0,0,0
2021-05-01,AUT,Perak,0,0,0
2021-05-01,AUT,Perlis,0,0,0
2021-05-01,AUT,Pulau Pinang,0,0,0
2021-05-01,AUT,Sabah,0,0,0
2021-05-01,AUT,Sarawak,1,1,0
2021-05-01,AUT,Selangor,10,9,1
2021-05-01,AUT,Terengganu,0,0,0
2021-05-01,AUT,W.P. Labuan,0,0,0
2021-05-01,AZE,Johor,0,0,0
2021-05-01,AZE,Kedah,0,0,0
2021-05-01,AZE,Kelantan,0,0,0
2021-05-01,AZE,Melaka,0,0,0
2021-05-01,AZE,Perlis,0,0,0
2021-05-01,AZE,Pulau Pinang,0,0,0
2021-05-01,AZE,Sabah,0,0,0
2021-05-01,AZE,Sarawak,0,0,0
2021-05-01,AZE,Selangor,4,3,1
2021-05-01,AZE,W.P. Labuan,0,0,0
2021-05-01,BDI,Pulau Pinang,0,0,0
2021-05-01,BDI,Sarawak,0,0,0
2021-05-01,BDI,Selangor,5,2,3
2021-05-01,BEL,Johor,0,0,0
2021-05-01,BEL,Kedah,0,0,0
2021-05-01,BEL,Kelantan,0,0,0
2021-05-01,BEL,Melaka,0,0,0
2021-05-01,BEL,Negeri Sembilan,0,0,0
2021-05-01,BEL,Pahang,0,0,0
2021-05-01,BEL,Perak,0,0,0
2021-05-01,BEL,Perlis,0,0,0
2021-05-01,BEL,Pulau Pinang,0,0,0
2021-05-01,BEL,Sabah,0,0,0
2021-05-01,BEL,Sarawak,0,0,0
2021-05-01,BEL,Selangor,7,4,3
2021-05-01,BEL,W.P. Labuan,0,0,0
2021-05-01,BEN,Johor,0,0,0
2021-05-01,BEN,Kedah,0,0,0
2021-05-01,BEN,Perak,0,0,0
2021-05-01,BEN,Pulau Pinang,0,0,0
2021-05-01,BEN,Sabah,0,0,0
2021-05-01,BEN,Sarawak,0,0,0
2021-05-01,BEN,Selangor,0,0,0
2021-05-01,BFA,Perak,0,0,0
2021-05-01,BFA,Pulau Pinang,0,0,0
2021-05-01,BFA,Selangor,0,0,0
2021-05-01,BGD,Johor,2,2,0
2021-05-01,BGD,Kedah,0,0,0
2021-05-01,BGD,Kelantan,0,0,0
2021-05-01,BGD,Melaka,0,0,0
2021-05-01,BGD,Negeri Sembilan,0,0,0
2021-05-01,BGD,Pahang,0,0,0
2021-05-01,BGD,Perak,0,0,0
2021-05-01,BGD,Perlis,0,0,0
2021-05-01,BGD,Pulau Pinang,0,0,0
2021-05-01,BGD,Sabah,0,0,0
2021-05-01,BGD,Sarawak,0,0,0
2021-05-01,BGD,Selangor,98,78,20
2021-05-01,BGD,W.P. Labuan,0,0,0
2021-05-01,BGR,Johor,0,0,0
2021-05-01,BGR,Kedah,0,0,0
2021-05-01,BGR,Kelantan,0,0,0
2021-05-01,BGR,Pahang,0,0,0
2021-05-01,BGR,Perak,0,0,0
2021-05-01,BGR,Perlis,0,0,0
2021-05-01,BGR,Pulau Pinang,0,0,0
2021-05-01,BGR,Sabah,0,0,0
2021-05-01,BGR,Sarawak,0,0,0
2021-05-01,BGR,Selangor,17,17,0
2021-05-01,BGR,W.P. Labuan,0,0,0
2021-05-01,BHR,Johor,0,0,0
2021-05-01,BHR,Kedah,0,0,0
2021-05-01,BHR,Kelantan,0,0,0
2021-05-01,BHR,Perlis,0,0,0
2021-05-01,BHR,Pulau Pinang,0,0,0
2021-05-01,BHR,Sabah,0,0,0
2021-05-01,BHR,Sarawak,0,0,0
2021-05-01,BHR,Selangor,2,1,1
2021-05-01,BHS,Johor,0,0,0
2021-05-01,BHS,Kedah,0,0,0
2021-05-01,BHS,Perak,0,0,0
2021-05-01,BHS,Sabah,0,0,0
2021-05-01,BHS,Sarawak,0,0,0
2021-05-01,BHS,Selangor,0,0,0
2021-05-01,BIH,Johor,0,0,0
2021-05-01,BIH,Kedah,0,0,0
2021-05-01,BIH,Perlis,0,0,0
2021-05-01,BIH,Pulau Pinang,0,0,0
2021-05-01,BIH,Sabah,0,0,0
2021-05-01,BIH,Sarawak,0,0,0
2021-05-01,BIH,Selangor,2,1,1
2021-05-01,BLR,Johor,0,0,0
2021-05-01,BLR,Kedah,0,0,0
2021-05-01,BLR,Kelantan,0,0,0
2021-05-01,BLR,Pahang,0,0,0
2021-05-01,BLR,Perak,0,0,0
2021-05-01,BLR,Perlis,0,0,0
2021-05-01,BLR,Pulau Pinang,0,0,0
2021-05-01,BLR,Sabah,0,0,0
2021-05-01,BLR,Sarawak,0,0,0
2021-05-01,BLR,Selangor,1,1,0
2021-05-01,BLR,W.P. Labuan,0,0,0
2021-05-01,BLZ,Johor,0,0,0
2021-05-01,BLZ,Pulau Pinang,0,0,0
2021-05-01,BLZ,Sarawak,0,0,0
2021-05-01,BLZ,Selangor,0,0,0
2021-05-01,BMU,Selangor,0,0,0
2021-05-01,BOL,Johor,0,0,0
2021-05-01,BOL,Kedah,0,0,0
2021-05-01,BOL,Melaka,0,0,0
2021-05-01,BOL,Perak,0,0,0
2021-05-01,BOL,Perlis,0,0,0
2021-05-01,BOL,Pulau Pinang,0,0,0
2021-05-01,BOL,Sabah,0,0,0
2021-05-01,BOL,Sarawak,0,0,0
2021-05-01,BOL,Selangor,0,0,0
2021-05-01,BRA,Johor,0,0,0
2021-05-01,BRA,Kedah,0,0,0
2021-05-01,BRA,Kelantan,0,0,0
2021-05-01,BRA,Melaka,0,0,0
2021-05-01,BRA,Pahang,0,0,0
2021-05-01,BRA,Perak,0,0,0
2021-05-01,BRA,Perlis,0,0,0
2021-05-01,BRA,Pulau Pinang,0,0,0
2021-05-01,BRA,Sabah,0,0,0
2021-05-01,BRA,Sarawak,0,0,0
2021-05-01,BRA,Selangor,20,19,1
2021-05-01,BRA,W.P. Labuan,0,0,0
2021-05-01,BRB,Johor,0,0,0
2021-05-01,BRB,Kedah,0,0,0
2021-05-01,BRB,Perlis,0,0,0
2021-05-01,BRB,Pulau Pinang,0,0,0
2021-05-01,BRB,Selangor,0,0,0
2021-05-01,BRN,Johor,0,0,0
2021-05-01,BRN,Kedah,0,0,0
2021-05-01,BRN,Kelantan,0,0,0
2021-05-01,BRN,Melaka,0,0,0
2021-05-01,BRN,Pahang,0,0,0
2021-05-01,BRN,Perak,0,0,0
2021-05-01,BRN,Perlis,0,0,0
2021-05-01,BRN,Pulau Pinang,0,0,0
2021-05-01,BRN,Sabah,0,0,0
2021-05-01,BRN,Sarawak,265,261,4
2021-05-01,BRN,Selangor,24,10,14
2021-05-01,BRN,W.P. Labuan,1,1,0
2021-05-01,BTN,Johor,0,0,0
2021-05-01,BTN,Kedah,0,0,0
2021-05-01,BTN,Perak,0,0,0
2021-05-01,BTN,Perlis,0,0,0
2021-05-01,BTN,Pulau Pinang,0,0,0
2021-05-01,BTN,Sabah,0,0,0
2021-05-01,BTN,Sarawak,0,0,0
2021-05-01,BTN,Selangor,0,0,0
2021-05-01,BWA,Johor,0,0,0
2021-05-01,BWA,Kedah,0,0,0
2021-05-01,BWA,Perlis,0,0,0
2021-05-01,BWA,Pulau Pinang,0,0,0
2021-05-01,BWA,Sabah,0,0,0
2021-05-01,BWA,Sarawak,0,0,0
2021-05-01,BWA,Selangor,2,1,1
2021-05-01,CAF,Kedah,0,0,0
2021-05-01,CAF,Selangor,1,1,0
2021-05-01,CAN,Johor,0,0,0
2021-05-01,CAN,Kedah,0,0,0
2021-05-01,CAN,Kelantan,0,0,0
2021-05-01,CAN,Melaka,0,0,0
2021-05-01,CAN,Negeri Sembilan,0,0,0
2021-05-01,CAN,Pahang,0,0,0
2021-05-01,CAN,Perak,0,0,0
2021-05-01,CAN,Perlis,0,0,0
2021-05-01,CAN,Pulau Pinang,0,0,0
2021-05-01,CAN,Sabah,0,0,0
2021-05-01,CAN,Sarawak,0,0,0
2021-05-01,CAN,Selangor,28,20,8
2021-05-01,CAN,Terengganu,0,0,0
2021-05-01,CAN,W.P. Labuan,0,0,0
2021-05-01,CCK,Selangor,0,0,0
2021-05-01,CHE,Johor,0,0,0
2021-05-01,CHE,Kedah,0,0,0
2021-05-01,CHE,Kelantan,0,0,0
2021-05-01,CHE,Melaka,0,0,0
2021-05-01,CHE,Negeri Sembilan,0,0,0
2021-05-01,CHE,Pahang,0,0,0
2021-05-01,CHE,Perak,0,0,0
2021-05-01,CHE,Perlis,0,0,0
2021-05-01,CHE,Pulau Pinang,0,0,0
2021-05-01,CHE,Sabah,0,0,0
2021-05-01,CHE,Sarawak,0,0,0
2021-05-01,CHE,Selangor,11,10,1
2021-05-01,CHE,W.P. Labuan,0,0,0
2021-05-01,CHL,Johor,0,0,0
2021-05-01,CHL,Kedah,0,0,0
2021-05-01,CHL,Kelantan,0,0,0
2021-05-01,CHL,Melaka,0,0,0
2021-05-01,CHL,Pahang,0,0,0
2021-05-01,CHL,Perak,0,0,0
2021-05-01,CHL,Perlis,0,0,0
2021-05-01,CHL,Pulau Pinang,0,0,0
2021-05-01,CHL,Sabah,0,0,0
2021-05-01,CHL,Sarawak,0,0,0
2021-05-01,CHL,Selangor,1,0,1
2021-05-01,CHN,Johor,29,28,1
2021-05-01,CHN,Kedah,0,0,0
2021-05-01,CHN,Kelantan,0,0,0
2021-05-01,CHN,Melaka,0,0,0
2021-05-01,CHN,Pahang,0,0,0
2021-05-01,CHN,Perak,0,0,0
2021-05-01,CHN,Perlis,0,0,0
2021-05-01,CHN,Pulau Pinang,2,1,1
2021-05-01,CHN,Sabah,3,0,3
2021-05-01,CHN,Sarawak,206,199,7
2021-05-01,CHN,Selangor,1261,1018,243
2021-05-01,CHN,Terengganu,0,0,0
2021-05-01,CHN,W.P. Labuan,0,0,0
2021-05-01,CIV,Johor,0,0,0
2021-05-01,CIV,Kedah,0,0,0
2021-05-01,CIV,Pulau Pinang,0,0,0
2021-05-01,CIV,Sabah,0,0,0
2021-05-01,CIV,Sarawak,0,0,0
2021-05-01,CIV,Selangor,2,2,0
2021-05-01,CMR,Johor,0,0,0
2021-05-01,CMR,Kedah,0,0,0
2021-05-01,CMR,Pulau Pinang,0,0,0
2021-05-01,CMR,Sabah,0,0,0
2021-05-01,CMR,Sarawak,0,0,0
2021-05-01,CMR,Selangor,1,1,0
2021-05-01,COD,Johor,0,0,0
2021-05-01,COD,Pulau Pinang,0,0,0
2021-05-01,COD,Sarawak,0,0,0
2021-05-01,COD,Selangor,1,1,0
2021-05-01,COG,Johor,0,0,0
2021-05-01,COG,Kedah,0,0,0
2021-05-01,COG,Selangor,0,0,0
2021-05-01,COK,Selangor,0,0,0
2021-05-01,COL,Johor,0,0,0
2021-05-01,COL,Kedah,0,0,0
2021-05-01,COL,Perak,0,0,0
2021-05-01,COL,Pulau Pinang,0,0,0
2021-05-01,COL,Sabah,0,0,0
2021-05-01,COL,Sarawak,0,0,0
2021-05-01,COL,Selangor,4,3,1
2021-05-01,COL,W.P. Labuan,0,0,0
2021-05-01,COM,Johor,0,0,0
2021-05-01,COM,Kedah,0,0,0
2021-05-01,COM,Selangor,4,2,2
2021-05-01,CPV,Johor,0,0,0
2021-05-01,CPV,Kedah,0,0,0
2021-05-01,CPV,Pulau Pinang,0,0,0
2021-05-01,CPV,Sabah,0,0,0
2021-05-01,CPV,Selangor,0,0,0
2021-05-01,CRI,Johor,0,0,0
2021-05-01,CRI,Kedah,0,0,0
2021-05-01,CRI,Perak,0,0,0
2021-05-01,CRI,Perlis,0,0,0
2021-05-01,CRI,Pulau Pinang,0,0,0
2021-05-01,CRI,Sabah,0,0,0
2021-05-01,CRI,Sarawak,0,0,0
2021-05-01,CRI,Selangor,37,30,7
2021-05-01,CUB,Johor,0,0,0
2021-05-01,CUB,Kedah,0,0,0
2021-05-01,CUB,Perlis,0,0,0
2021-05-01,CUB,Pulau Pinang,0,0,0
2021-05-01,CUB,Sabah,0,0,0
2021-05-01,CUB,Sarawak,0,0,0
2021-05-01,CUB,Selangor,0,0,0
2021-05-01,CYP,Johor,0,0,0
2021-05-01,CYP,Kedah,0,0,0
2021-05-01,CYP,Perak,0,0,0
2021-05-01,CYP,Perlis,0,0,0
2021-05-01,CYP,Pulau Pinang,0,0,0
2021-05-01,CYP,Sabah,0,0,0
2021-05-01,CYP,Sarawak,0,0,0
2021-05-01,CYP,Selangor,3,2,1
2021-05-01,CZE,Johor,0,0,0
2021-05-01,CZE,Kedah,0,0,0
2021-05-01,CZE,Kelantan,0,0,0
2021-05-01,CZE,Melaka,0,0,0
2021-05-01,CZE,Negeri Sembilan,0,0,0
2021-05-01,CZE,Perak,0,0,0
2021-05-01,CZE,Perlis,0,0,0
2021-05-01,CZE,Pulau Pinang,0,0,0
2021-05-01,CZE,Sabah,0,0,0
2021-05-01,CZE,Sarawak,0,0,0
2021-05-01,CZE,Selangor,6,6,0
2021-05-01,CZE,W.P. Labuan,0,0,0
2021-05-01,DEU,Johor,0,0,0
2021-05-01,DEU,Kedah,0,0,0
2021-05-01,DEU,Kelantan,0,0,0
2021-05-01,DEU,Melaka,0,0,0
2021-05-01,DEU,Negeri Sembilan,0,0,0
2021-05-01,DEU,Pahang,0,0,0
2021-05-01,DEU,Perak,0,0,0
2021-05-01,DEU,Perlis,0,0,0
2021-05-01,DEU,Pulau Pinang,1,1,0
2021-05-01,DEU,Sabah,0,0,0
2021-05-01,DEU,Sarawak,0,0,0
2021-05-01,DEU,Selangor,67,54,13
2021-05-01,DEU,Terengganu,0,0,0
2021-05-01,DEU,W.P. Labuan,0,0,0
2021-05-01,DJI,Johor,0,0,0
2021-05-01,DJI,Selangor,1,0,1
2021-05-01,DMA,Johor,0,0,0
2021-05-01,DMA,Kedah,0,0,0
2021-05-01,DMA,Pulau Pinang,0,0,0
2021-05-01,DMA,Sabah,0,0,0
2021-05-01,DMA,Sarawak,0,0,0
2021-05-01,DMA,Selangor,0,0,0
2021-05-01,DMA,W.P. Labuan,0,0,0
2021-05-01,DNK,Johor,0,0,0
2021-05-01,DNK,Kedah,0,0,0
2021-05-01,DNK,Kelantan,0,0,0
2021-05-01,DNK,Melaka,0,0,0
2021-05-01,DNK,Negeri Sembilan,0,0,0
2021-05-01,DNK,Pahang,0,0,0
2021-05-01,DNK,Perak,0,0,0
2021-05-01,DNK,Perlis,0,0,0
2021-05-01,DNK,Pulau Pinang,0,0,0
2021-05-01,DNK,Sabah,0,0,0
2021-05-01,DNK,Sarawak,1,1,0
2021-05-01,DNK,Selangor,10,9,1
2021-05-01,DNK,W.P. Labuan,0,0,0
2021-05-01,DOM,Johor,0,0,0
2021-05-01,DOM,Kedah,0,0,0
2021-05-01,DOM,Perak,0,0,0
2021-05-01,DOM,Perlis,0,0,0
2021-05-01,DOM,Pulau Pinang,0,0,0
2021-05-01,DOM,Sabah,0,0,0
2021-05-01,DOM,Sarawak,0,0,0
2021-05-01,DOM,Selangor,0,0,0
2021-05-01,DZA,Johor,0,0,0
2021-05-01,DZA,Kedah,0,0,0
2021-05-01,DZA,Kelantan,0,0,0
2021-05-01,DZA,Melaka,0,0,0
2021-05-01,DZA,Perak,0,0,0
2021-05-01,DZA,Perlis,0,0,0
2021-05-01,DZA,Pulau Pinang,0,0,0
2021-05-01,DZA,Sabah,0,0,0
2021-05-01,DZA,Sarawak,0,0,0
2021-05-01,DZA,Selangor,4,4,0
2021-05-01,DZA,W.P. Labuan,0,0,0
2021-05-01,ECU,Johor,0,0,0
2021-05-01,ECU,Kedah,0,0,0
2021-05-01,ECU,Perak,0,0,0
2021-05-01,ECU,Perlis,0,0,0
2021-05-01,ECU,Pulau Pinang,0,0,0
2021-05-01,ECU,Sabah,0,0,0
2021-05-01,ECU,Sarawak,0,0,0
2021-05-01,ECU,Selangor,2,2,0
2021-05-01,EGY,Johor,0,0,0
2021-05-01,EGY,Kedah,0,0,0
2021-05-01,EGY,Kelantan,0,0,0
2021-05-01,EGY,Melaka,0,0,0
2021-05-01,EGY,Pahang,0,0,0
2021-05-01,EGY,Perak,0,0,0
2021-05-01,EGY,Perlis,0,0,0
2021-05-01,EGY,Pulau Pinang,0,0,0
2021-05-01,EGY,Sabah,1,1,0
2021-05-01,EGY,Sarawak,0,0,0
2021-05-01,EGY,Selangor,75,58,17
2021-05-01,EGY,Terengganu,0,0,0
2021-05-01,EGY,W.P. Labuan,0,0,0
2021-05-01,ERI,Johor,0,0,0
2021-05-01,ERI,Pulau Pinang,0,0,0
2021-05-01,ERI,Sabah,0,0,0
2021-05-01,ERI,Selangor,2,1,1
2021-05-01,ESP,Johor,0,0,0
2021-05-01,ESP,Kedah,0,0,0
2021-05-01,ESP,Kelantan,0,0,0
2021-05-01,ESP,Melaka,0,0,0
2021-05-01,ESP,Negeri Sembilan,0,0,0
2021-05-01,ESP,Pahang,0,0,0
2021-05-01,ESP,Perak,0,0,0
2021-05-01,ESP,Perlis,0,0,0
2021-05-01,ESP,Pulau Pinang,0,0,0
2021-05-01,ESP,Sabah,0,0,0
2021-05-01,ESP,Sarawak,0,0,0
2021-05-01,ESP,Selangor,27,23,4
2021-05-01,ESP,W.P. Labuan,0,0,0
2021-05-01,EST,Johor,0,0,0
2021-05-01,EST,Kedah,0,0,0
2021-05-01,EST,Kelantan,0,0,0
2021-05-01,EST,Pahang,0,0,0
2021-05-01,EST,Perak,0,0,0
2021-05-01,EST,Perlis,0,0,0
2021-05-01,EST,Pulau Pinang,0,0,0
2021-05-01,EST,Sabah,0,0,0
2021-05-01,EST,Sarawak,0,0,0
2021-05-01,EST,Selangor,4,3,1
2021-05-01,EST,W.P. Labuan,0,0,0
2021-05-01,ETH,Johor,0,0,0
2021-05-01,ETH,Kedah,0,0,0
2021-05-01,ETH,Pulau Pinang,0,0,0
2021-05-01,ETH,Sarawak,0,0,0
2021-05-01,ETH,Selangor,8,4,4
2021-05-01,FIN,Johor,2,2,0
2021-05-01,FIN,Kedah,0,0,0
2021-05-01,FIN,Kelantan,0,0,0
2021-05-01,FIN,Melaka,0,0,0
2021-05-01,FIN,Negeri Sembilan,0,0,0
2021-05-01,FIN,Pahang,0,0,0
2021-05-01,FIN,Perak,0,0,0
2021-05-01,FIN,Perlis,0,0,0
2021-05-01,FIN,Pulau Pinang,0,0,0
2021-05-01,FIN,Sabah,0,0,0
2021-05-01,FIN,Sarawak,0,0,0
2021-05-01,FIN,Selangor,9,9,0
2021-05-01,FIN,W.P. Labuan,0,0,0
2021-05-01,FJI,Johor,0,0,0
2021-05-01,FJI,Kedah,0,0,0
2021-05-01,FJI,Kelantan,0,0,0
2021-05-01,FJI,Perak,0,0,0
2021-05-01,FJI,Perlis,0,0,0
2021-05-01,FJI,Pulau Pinang,0,0,0
2021-05-01,FJI,Sabah,0,0,0
2021-05-01,FJI,Sarawak,0,0,0
2021-05-01,FJI,Selangor,0,0,0
2021-05-01,FRA,Johor,0,0,0
2021-05-01,FRA,Kedah,0,0,0
2021-05-01,FRA,Kelantan,0,0,0
2021-05-01,FRA,Melaka,0,0,0
2021-05-01,FRA,Negeri Sembilan,0,0,0
2021-05-01,FRA,Pahang,0,0,0
2021-05-01,FRA,Perak,0,0,0
2021-05-01,FRA,Perlis,0,0,0
2021-05-01,FRA,Pulau Pinang,0,0,0
2021-05-01,FRA,Sabah,0,0,0
2021-05-01,FRA,Sarawak,0,0,0
2021-05-01,FRA,Selangor,80,60,20
2021-05-01,FRA,Terengganu,0,0,0
2021-05-01,FRA,W.P. Labuan,0,0,0
2021-05-01,FSM,Johor,0,0,0
2021-05-01,FSM,Pulau Pinang,0,0,0
2021-05-01,FSM,Selangor,0,0,0
2021-05-01,GAB,Johor,0,0,0
2021-05-01,GAB,Pulau Pinang,0,0,0
2021-05-01,GAB,Sarawak,0,0,0
2021-05-01,GAB,Selangor,0,0,0
2021-05-01,GBR,Johor,25,23,2
2021-05-01,GBR,Kedah,0,0,0
2021-05-01,GBR,Kelantan,0,0,0
2021-05-01,GBR,Melaka,0,0,0
2021-05-01,GBR,Negeri Sembilan,0,0,0
2021-05-01,GBR,Pahang,0,0,0
2021-05-01,GBR,Perak,0,0,0
2021-05-01,GBR,Perlis,0,0,0
2021-05-01,GBR,Pulau Pinang,3,2,1
2021-05-01,GBR,Sabah,0,0,0
2021-05-01,GBR,Sarawak,0,0,0
2021-05-01,GBR,Selangor,218,189,29
2021-05-01,GBR,Terengganu,0,0,0
2021-05-01,GBR,W.P. Labuan,0,0,0
2021-05-01,GEO,Johor,0,0,0
2021-05-01,GEO,Kedah,0,0,0
2021-05-01,GEO,Melaka,0,0,0
2021-05-01,GEO,Perak,0,0,0
2021-05-01,GEO,Perlis,0,0,0
2021-05-01,GEO,Pulau Pinang,0,0,0
2021-05-01,GEO,Sabah,0,0,0
2021-05-01,GEO,Sarawak,0,0,0
2021-05-01,GEO,Selangor,0,0,0
2021-05-01,GHA,Johor,0,0,0
2021-05-01,GHA,Kedah,0,0,0
2021-05-01,GHA,Kelantan,0,0,0
2021-05-01,GHA,Pulau Pinang,0,0,0
2021-05-01,GHA,Sabah,0,0,0
2021-05-01,GHA,Sarawak,0,0,0
2021-05-01,GHA,Selangor,8,6,2
2021-05-01,GIB,Johor,0,0,0
2021-05-01,GIB,Sarawak,0,0,0
2021-05-01,GIN,Johor,0,0,0
2021-05-01,GIN,Kedah,0,0,0
2021-05-01,GIN,Kelantan,0,0,0
2021-05-01,GIN,Perlis,0,0,0
2021-05-01,GIN,Pulau Pinang,0,0,0
2021-05-01,GIN,Sabah,0,0,0
2021-05-01,GIN,Sarawak,0,0,0
2021-05-01,GIN,Selangor,6,4,2
2021-05-01,GLP,Selangor,0,0,0
2021-05-01,GMB,Johor,0,0,0
2021-05-01,GMB,Kedah,0,0,0
2021-05-01,GMB,Kelantan,0,0,0
2021-05-01,GMB,Pulau Pinang,0,0,0
2021-05-01,GMB,Sabah,0,0,0
2021-05-01,GMB,Sarawak,0,0,0
2021-05-01,GMB,Selangor,2,1,1
2021-05-01,GNB,Johor,0,0,0
2021-05-01,GNB,Selangor,0,0,0
2021-05-01,GNQ,Johor,0,0,0
2021-05-01,GNQ,Selangor,1,0,1
2021-05-01,GRC,Johor,2,2,0
2021-05-01,GRC,Kedah,0,0,0
2021-05-01,GRC,Kelantan,0,0,0
2021-05-01,GRC,Melaka,0,0,0
2021-05-01,GRC,Negeri Sembilan,0,0,0
2021-05-01,GRC,Pahang,0,0,0
2021-05-01,GRC,Perak,0,0,0
2021-05-01,GRC,Perlis,0,0,0
2021-05-01,GRC,Pulau Pinang,0,0,0
2021-05-01,GRC,Sabah,0,0,0
2021-05-01,GRC,Sarawak,0,0,0
2021-05-01,GRC,Selangor,13,13,0
2021-05-01,GRD,Johor,0,0,0
2021-05-01,GRD,Kedah,0,0,0
2021-05-01,GRD,Pulau Pinang,0,0,0
2021-05-01,GRD,Sabah,0,0,0
2021-05-01,GRD,Sarawak,0,0,0
2021-05-01,GRD,Selangor,0,0,0
2021-05-01,GRL,Johor,0,0,0
2021-05-01,GRL,Selangor,0,0,0
2021-05-01,GTM,Johor,0,0,0
2021-05-01,GTM,Kedah,0,0,0
2021-05-01,GTM,Pahang,0,0,0
2021-05-01,GTM,Perak,0,0,0
2021-05-01,GTM,Pulau Pinang,0,0,0
2021-05-01,GTM,Sabah,0,0,0
2021-05-01,GTM,Sarawak,0,0,0
2021-05-01,GTM,Selangor,0,0,0
2021-05-01,GTM,W.P. Labuan,0,0,0
2021-05-01,GUY,Johor,0,0,0
2021-05-01,GUY,Kedah,0,0,0
2021-05-01,GUY,Pulau Pinang,0,0,0
2021-05-01,GUY,Sarawak,0,0,0
2021-05-01,GUY,Selangor,0,0,0
2021-05-01,HKG,Johor,0,0,0
2021-05-01,HKG,Kedah,0,0,0
2021-05-01,HKG,Kelantan,0,0,0
2021-05-01,HKG,Pahang,0,0,0
2021-05-01,HKG,Perak,0,0,0
2021-05-01,HKG,Perlis,0,0,0
2021-05-01,HKG,Pulau Pinang,1,1,0
2021-05-01,HKG,Sabah,0,0,0
2021-05-01,HKG,Sarawak,0,0,0
2021-05-01,HKG,Selangor,0,0,0
2021-05-01,HKG,Terengganu,0,0,0
2021-05-01,HMD,Johor,0,0,0
2021-05-01,HND,Johor,0,0,0
2021-05-01,HND,Kedah,0,0,0
2021-05-01,HND,Perak,0,0,0
2021-05-01,HND,Pulau Pinang,0,0,0
2021-05-01,HND,Sabah,0,0,0
2021-05-01,HND,Sarawak,0,0,0
2021-05-01,HND,Selangor,0,0,0
2021-05-01,HRV,Johor,0,0,0
2021-05-01,HRV,Kedah,0,0,0
2021-05-01,HRV,Kelantan,0,0,0
2021-05-01,HRV,Melaka,0,0,0
2021-05-01,HRV,Pahang,0,0,0
2021-05-01,HRV,Perak,0,0,0
2021-05-01,HRV,Perlis,0,0,0
2021-05-01,HRV,Pulau Pinang,0,0,0
2021-05-01,HRV,Sabah,0,0,0
2021-05-01,HRV,Sarawak,0,0,0
2021-05-01,HRV,Selangor,43,41,2
2021-05-01,HTI,Johor,0,0,0
2021-05-01,HTI,Kedah,0,0,0
2021-05-01,HTI,Kelantan,0,0,0
2021-05-01,HTI,Perak,0,0,0
2021-05-01,HTI,Pulau Pinang,0,0,0
2021-05-01,HTI,Sabah,0,0,0
2021-05-01,HTI,Selangor,0,0,0
2021-05-01,HUN,Johor,0,0,0
2021-05-01,HUN,Kedah,0,0,0
2021-05-01,HUN,Kelantan,0,0,0
2021-05-01,HUN,Pahang,0,0,0
2021-05-01,HUN,Perak,0,0,0
2021-05-01,HUN,Perlis,0,0,0
2021-05-01,HUN,Pulau Pinang,0,0,0
2021-05-01,HUN,Sabah,0,0,0
2021-05-01,HUN,Sarawak,0,0,0
2021-05-01,HUN,Selangor,4,4,0
2021-05-01,HUN,W.P. Labuan,0,0,0
2021-05-01,IDN,Johor,131,109,22
2021-05-01,IDN,Kedah,6,6,0
2021-05-01,IDN,Kelantan,0,0,0
2021-05-01,IDN,Melaka,0,0,0
2021-05-01,IDN,Negeri Sembilan,0,0,0
2021-05-01,IDN,Pahang,0,0,0
2021-05-01,IDN,Perak,0,0,0
2021-05-01,IDN,Perlis,5,5,0
2021-05-01,IDN,Pulau Pinang,35,11,24
2021-05-01,IDN,Sabah,2,1,1
2021-05-01,IDN,Sarawak,336,332,4
2021-05-01,IDN,Selangor,806,532,274
2021-05-01,IDN,Terengganu,4,4,0
2021-05-01,IDN,W.P. Labuan,6,6,0
2021-05-01,IND,Johor,3,3,0
2021-05-01,IND,Kedah,0,0,0
2021-05-01,IND,Kelantan,0,0,0
2021-05-01,IND,Melaka,0,0,0
2021-05-01,IND,Negeri Sembilan,0,0,0
2021-05-01,IND,Pahang,0,0,0
2021-05-01,IND,Perak,0,0,0
2021-05-01,IND,Perlis,0,0,0
2021-05-01,IND,Pulau Pinang,0,0,0
2021-05-01,IND,Sabah,0,0,0
2021-05-01,IND,Sarawak,0,0,0
2021-05-01,IND,Selangor,36,21,15
2021-05-01,IND,Terengganu,0,0,0
2021-05-01,IND,W.P. Labuan,0,0,0
2021-05-01,IOT,Pulau Pinang,0,0,0
2021-05-01,IOT,Selangor,0,0,0
2021-05-01,IRL,Johor,0,0,0
2021-05-01,IRL,Kedah,0,0,0
2021-05-01,IRL,Kelantan,0,0,0
2021-05-01,IRL,Negeri Sembilan,0,0,0
2021-05-01,IRL,Pahang,0,0,0
2021-05-01,IRL,Perak,0,0,0
2021-05-01,IRL,Perlis,0,0,0
2021-05-01,IRL,Pulau Pinang,0,0,0
2021-05-01,IRL,Sabah,0,0,0
2021-05-01,IRL,Sarawak,0,0,0
2021-05-01,IRL,Selangor,12,12,0
2021-05-01,IRL,Terengganu,0,0,0
2021-05-01,IRL,W.P. Labuan,0,0,0
2021-05-01,IRN,Johor,2,2,0
2021-05-01,IRN,Kedah,0,0,0
2021-05-01,IRN,Kelantan,0,0,0
2021-05-01,IRN,Perak,0,0,0
2021-05-01,IRN,Perlis,0,0,0
2021-05-01,IRN,Pulau Pinang,0,0,0
2021-05-01,IRN,Sabah,0,0,0
2021-05-01,IRN,Sarawak,0,0,0
2021-05-01,IRN,Selangor,40,21,19
2021-05-01,IRN,W.P. Labuan,0,0,0
2021-05-01,IRQ,Johor,0,0,0
2021-05-01,IRQ,Kedah,0,0,0
2021-05-01,IRQ,Kelantan,0,0,0
2021-05-01,IRQ,Melaka,0,0,0
2021-05-01,IRQ,Pahang,0,0,0
2021-05-01,IRQ,Perak,0,0,0
2021-05-01,IRQ,Perlis,0,0,0
2021-05-01,IRQ,Pulau Pinang,0,0,0
2021-05-01,IRQ,Sabah,0,0,0
2021-05-01,IRQ,Sarawak,0,0,0
2021-05-01,IRQ,Selangor,25,20,5
2021-05-01,ISL,Johor,0,0,0
2021-05-01,ISL,Kedah,0,0,0
2021-05-01,ISL,Kelantan,0,0,0
2021-05-01,ISL,Perak,0,0,0
2021-05-01,ISL,Perlis,0,0,0
2021-05-01,ISL,Pulau Pinang,0,0,0
2021-05-01,ISL,Sabah,0,0,0
2021-05-01,ISL,Sarawak,0,0,0
2021-05-01,ISL,Selangor,0,0,0
2021-05-01,ISL,W.P. Labuan,0,0,0
2021-05-01,ISR,Pulau Pinang,0,0,0
2021-05-01,ITA,Johor,0,0,0
2021-05-01,ITA,Kedah,2,2,0
2021-05-01,ITA,Kelantan,0,0,0
2021-05-01,ITA,Melaka,0,0,0
2021-05-01,ITA,Negeri Sembilan,0,0,0
2021-05-01,ITA,Pahang,0,0,0
2021-05-01,ITA,Perak,0,0,0
2021-05-01,ITA,Perlis,0,0,0
2021-05-01,ITA,Pulau Pinang,0,0,0
2021-05-01,ITA,Sabah,0,0,0
2021-05-01,ITA,Sarawak,0,0,0
2021-05-01,ITA,Selangor,49,41,8
2021-05-01,ITA,W.P. Labuan,0,0,0
2021-05-01,JAM,Johor,0,0,0
2021-05-01,JAM,Kedah,0,0,0
2021-05-01,JAM,Perak,0,0,0
2021-05-01,JAM,Pulau Pinang,0,0,0
2021-05-01,JAM,Sabah,0,0,0
2021-05-01,JAM,Sarawak,0,0,0
2021-05-01,JAM,Selangor,0,0,0
2021-05-01,JAM,W.P. Labuan,0,0,0
2021-05-01,JOR,Johor,0,0,0
2021-05-01,JOR,Kedah,0,0,0
2021-05-01,JOR,Kelantan,0,0,0
2021-05-01,JOR,Melaka,0,0,0
2021-05-01,JOR,Perlis,0,0,0
2021-05-01,JOR,Pulau Pinang,0,0,0
2021-05-01,JOR,Sabah,0,0,0
2021-05-01,JOR,Sarawak,0,0,0
2021-05-01,JOR,Selangor,45,35,10
2021-05-01,JOR,W.P. Labuan,0,0,0
2021-05-01,JPN,Johor,0,0,0
2021-05-01,JPN,Kedah,0,0,0
2021-05-01,JPN,Kelantan,0,0,0
2021-05-01,JPN,Melaka,0,0,0
2021-05-01,JPN,Negeri Sembilan,0,0,0
2021-05-01,JPN,Pahang,0,0,0
2021-05-01,JPN,Perak,0,0,0
2021-05-01,JPN,Perlis,0,0,0
2021-05-01,JPN,Pulau Pinang,15,14,1
2021-05-01,JPN,Sabah,0,0,0
2021-05-01,JPN,Sarawak,7,7,0
2021-05-01,JPN,Selangor,459,318,141
2021-05-01,JPN,W.P. Labuan,0,0,0
2021-05-01,KAZ,Johor,0,0,0
2021-05-01,KAZ,Kedah,0,0,0
2021-05-01,KAZ,Kelantan,0,0,0
2021-05-01,KAZ,Melaka,0,0,0
2021-05-01,KAZ,Perak,0,0,0
2021-05-01,KAZ,Perlis,0,0,0
2021-05-01,KAZ,Pulau Pinang,0,0,0
2021-05-01,KAZ,Sabah,0,0,0
2021-05-01,KAZ,Sarawak,0,0,0
2021-05-01,KAZ,Selangor,15,7,8
2021-05-01,KAZ,W.P. Labuan,0,0,0
2021-05-01,KEN,Johor,0,0,0
2021-05-01,KEN,Kedah,0,0,0
2021-05-01,KEN,Kelantan,0,0,0
2021-05-01,KEN,Perak,0,0,0
2021-05-01,KEN,Perlis,0,0,0
2021-05-01,KEN,Pulau Pinang,0,0,0
2021-05-01,KEN,Sabah,0,0,0
2021-05-01,KEN,Sarawak,0,0,0
2021-05-01,KEN,Selangor,37,26,11
2021-05-01,KGZ,Johor,0,0,0
2021-05-01,KGZ,Kedah,0,0,0
2021-05-01,KGZ,Kelantan,0,0,0
2021-05-01,KGZ,Perak,0,0,0
2021-05-01,KGZ,Perlis,0,0,0
2021-05-01,KGZ,Pulau Pinang,0,0,0
2021-05-01,KGZ,Sabah,0,0,0
2021-05-01,KGZ,Sarawak,0,0,0
2021-05-01,KGZ,Selangor,1,0,1
2021-05-01,KHM,Johor,0,0,0
2021-05-01,KHM,Kedah,0,0,0
2021-05-01,KHM,Kelantan,0,0,0
2021-05-01,KHM,Melaka,0,0,0
2021-05-01,KHM,Negeri Sembilan,0,0,0
2021-05-01,KHM,Pahang,0,0,0
2021-05-01,KHM,Perak,1,0,1
2021-05-01,KHM,Perlis,0,0,0
2021-05-01,KHM,Pulau Pinang,2,1,1
2021-05-01,KHM,Sabah,0,0,0
2021-05-01,KHM,Sarawak,0,0,0
2021-05-01,KHM,Selangor,9,5,4
2021-05-01,KHM,W.P. Labuan,0,0,0
2021-05-01,KIR,Johor,11,11,0
2021-05-01,KIR,Sabah,0,0,0
2021-05-01,KIR,Selangor,0,0,0
2021-05-01,KNA,Johor,0,0,0
2021-05-01,KNA,Kedah,0,0,0
2021-05-01,KNA,Perlis,0,0,0
2021-05-01,KNA,Pulau Pinang,0,0,0
2021-05-01,KNA,Sabah,0,0,0
2021-05-01,KNA,Selangor,0,0,0
2021-05-01,KNA,W.P. Labuan,0,0,0
2021-05-01,KOR,Johor,2,2,0
2021-05-01,KOR,Kedah,0,0,0
2021-05-01,KOR,Kelantan,0,0,0
2021-05-01,KOR,Melaka,0,0,0
2021-05-01,KOR,Negeri Sembilan,0,0,0
2021-05-01,KOR,Pahang,0,0,0
2021-05-01,KOR,Perak,0,0,0
2021-05-01,KOR,Perlis,0,0,0
2021-05-01,KOR,Pulau Pinang,1,0,1
2021-05-01,KOR,Sabah,0,0,0
2021-05-01,KOR,Sarawak,12,11,1
2021-05-01,KOR,Selangor,291,221,70
2021-05-01,KOR,Terengganu,0,0,0
2021-05-01,KOR,W.P. Labuan,0,0,0
2021-05-01,KWT,Johor,0,0,0
2021-05-01,KWT,Kedah,0,0,0
2021-05-01,KWT,Kelantan,0,0,0
2021-05-01,KWT,Perak,0,0,0
2021-05-01,KWT,Perlis,0,0,0
2021-05-01,KWT,Pulau Pinang,0,0,0
2021-05-01,KWT,Sabah,0,0,0
2021-05-01,KWT,Sarawak,0,0,0
2021-05-01,KWT,Selangor,1,1,0
2021-05-01,KWT,W.P. Labuan,0,0,0
2021-05-01,LAO,Johor,0,0,0
2021-05-01,LAO,Kedah,0,0,0
2021-05-01,LAO,Kelantan,0,0,0
2021-05-01,LAO,Melaka,0,0,0
2021-05-01,LAO,Perak,0,0,0
2021-05-01,LAO,Perlis,0,0,0
2021-05-01,LAO,Pulau Pinang,0,0,0
2021-05-01,LAO,Sabah,0,0,0
2021-05-01,LAO,Sarawak,0,0,0
2021-05-01,LAO,Selangor,74,73,1
2021-05-01,LAO,W.P. Labuan,0,0,0
2021-05-01,LBN,Johor,0,0,0
2021-05-01,LBN,Kedah,0,0,0
2021-05-01,LBN,Kelantan,0,0,0
2021-05-01,LBN,Pahang,0,0,0
2021-05-01,LBN,Perak,0,0,0
2021-05-01,LBN,Perlis,0,0,0
2021-05-01,LBN,Pulau Pinang,0,0,0
2021-05-01,LBN,Sabah,0,0,0
2021-05-01,LBN,Sarawak,0,0,0
2021-05-01,LBN,Selangor,4,1,3
2021-05-01,LBN,W.P. Labuan,0,0,0
2021-05-01,LBR,Johor,0,0,0
2021-05-01,LBR,Kedah,0,0,0
2021-05-01,LBR,Sabah,0,0,0
2021-05-01,LBR,Sarawak,0,0,0
2021-05-01,LBR,Selangor,4,2,2
2021-05-01,LBY,Johor,0,0,0
2021-05-01,LBY,Kedah,0,0,0
2021-05-01,LBY,Perlis,0,0,0
2021-05-01,LBY,Pulau Pinang,0,0,0
2021-05-01,LBY,Sabah,0,0,0
2021-05-01,LBY,Sarawak,0,0,0
2021-05-01,LBY,Selangor,35,32,3
2021-05-01,LCA,Johor,0,0,0
2021-05-01,LCA,Kedah,0,0,0
2021-05-01,LCA,Pulau Pinang,0,0,0
2021-05-01,LCA,Sarawak,0,0,0
2021-05-01,LCA,Selangor,0,0,0
2021-05-01,LIE,Johor,0,0,0
2021-05-01,LIE,Kedah,0,0,0
2021-05-01,LIE,Perlis,0,0,0
2021-05-01,LIE,Pulau Pinang,0,0,0
2021-05-01,LIE,Sabah,0,0,0
2021-05-01,LIE,Sarawak,0,0,0
2021-05-01,LIE,Selangor,0,0,0
2021-05-01,LKA,Johor,0,0,0
2021-05-01,LKA,Kedah,0,0,0
2021-05-01,LKA,Kelantan,0,0,0
2021-05-01,LKA,Melaka,0,0,0
2021-05-01,LKA,Pahang,0,0,0
2021-05-01,LKA,Perak,0,0,0
2021-05-01,LKA,Perlis,0,0,0
2021-05-01,LKA,Pulau Pinang,0,0,0
2021-05-01,LKA,Sabah,0,0,0
2021-05-01,LKA,Sarawak,1,1,0
2021-05-01,LKA,Selangor,43,33,10
2021-05-01,LKA,W.P. Labuan,0,0,0
2021-05-01,LSO,Johor,0,0,0
2021-05-01,LSO,Kedah,0,0,0
2021-05-01,LSO,Pulau Pinang,0,0,0
2021-05-01,LSO,Sarawak,0,0,0
2021-05-01,LSO,Selangor,2,1,1
2021-05-01,LTU,Johor,0,0,0
2021-05-01,LTU,Kedah,0,0,0
2021-05-01,LTU,Kelantan,0,0,0
2021-05-01,LTU,Pahang,0,0,0
2021-05-01,LTU,Perak,0,0,0
2021-05-01,LTU,Perlis,0,0,0
2021-05-01,LTU,Pulau Pinang,0,0,0
2021-05-01,LTU,Sabah,0,0,0
2021-05-01,LTU,Sarawak,0,0,0
2021-05-01,LTU,Selangor,9,9,0
2021-05-01,LTU,W.P. Labuan,0,0,0
2021-05-01,LUX,Johor,0,0,0
2021-05-01,LUX,Kedah,0,0,0
2021-05-01,LUX,Kelantan,0,0,0
2021-05-01,LUX,Perak,0,0,0
2021-05-01,LUX,Perlis,0,0,0
2021-05-01,LUX,Pulau Pinang,0,0,0
2021-05-01,LUX,Sabah,0,0,0
2021-05-01,LUX,Sarawak,0,0,0
2021-05-01,LUX,Selangor,0,0,0
2021-05-01,LVA,Johor,0,0,0
2021-05-01,LVA,Kedah,0,0,0
2021-05-01,LVA,Kelantan,0,0,0
2021-05-01,LVA,Pahang,0,0,0
2021-05-01,LVA,Perak,0,0,0
2021-05-01,LVA,Perlis,0,0,0
2021-05-01,LVA,Pulau Pinang,0,0,0
2021-05-01,LVA,Sabah,0,0,0
2021-05-01,LVA,Sarawak,0,0,0
2021-05-01,LVA,Selangor,3,3,0
2021-05-01,LVA,W.P. Labuan,0,0,0
2021-05-01,MAC,Johor,0,0,0
2021-05-01,MAC,Pahang,0,0,0
2021-05-01,MAC,Perak,0,0,0
2021-05-01,MAC,Selangor,0,0,0
2021-05-01,MAC,W.P. Labuan,0,0,0
2021-05-01,MAR,Johor,0,0,0
2021-05-01,MAR,Kedah,0,0,0
2021-05-01,MAR,Kelantan,0,0,0
2021-05-01,MAR,Melaka,0,0,0
2021-05-01,MAR,Pahang,0,0,0
2021-05-01,MAR,Perak,0,0,0
2021-05-01,MAR,Perlis,0,0,0
2021-05-01,MAR,Pulau Pinang,0,0,0
2021-05-01,MAR,Sabah,0,0,0
2021-05-01,MAR,Sarawak,0,0,0
2021-05-01,MAR,Selangor,7,5,2
2021-05-01,MAR,W.P. Labuan,0,0,0
2021-05-01,MCO,Johor,0,0,0
2021-05-01,MCO,Kedah,0,0,0
2021-05-01,MCO,Sabah,0,0,0
2021-05-01,MCO,Selangor,0,0,0
2021-05-01,MDA,Johor,0,0,0
2021-05-01,MDA,Kedah,0,0,0
2021-05-01,MDA,Kelantan,0,0,0
2021-05-01,MDA,Negeri Sembilan,0,0,0
2021-05-01,MDA,Perlis,0,0,0
2021-05-01,MDA,Pulau Pinang,0,0,0
2021-05-01,MDA,Sabah,0,0,0
2021-05-01,MDA,Sarawak,0,0,0
2021-05-01,MDA,Selangor,0,0,0
2021-05-01,MDG,Johor,0,0,0
2021-05-01,MDG,Kedah,0,0,0
2021-05-01,MDG,Perak,0,0,0
2021-05-01,MDG,Perlis,0,0,0
2021-05-01,MDG,Pulau Pinang,0,0,0
2021-05-01,MDG,Sabah,0,0,0
2021-05-01,MDG,Sarawak,0,0,0
2021-05-01,MDG,Selangor,0,0,0
2021-05-01,MDV,Johor,0,0,0
2021-05-01,MDV,Kedah,0,0,0
2021-05-01,MDV,Kelantan,0,0,0
2021-05-01,MDV,Perak,0,0,0
2021-05-01,MDV,Perlis,0,0,0
2021-05-01,MDV,Pulau Pinang,0,0,0
2021-05-01,MDV,Sabah,0,0,0
2021-05-01,MDV,Sarawak,0,0,0
2021-05-01,MDV,Selangor,103,32,71
2021-05-01,MEX,Johor,0,0,0
2021-05-01,MEX,Kedah,0,0,0
2021-05-01,MEX,Kelantan,0,0,0
2021-05-01,MEX,Pahang,0,0,0
2021-05-01,MEX,Perak,0,0,0
2021-05-01,MEX,Perlis,0,0,0
2021-05-01,MEX,Pulau Pinang,0,0,0
2021-05-01,MEX,Sabah,0,0,0
2021-05-01,MEX,Sarawak,0,0,0
2021-05-01,MEX,Selangor,11,8,3
2021-05-01,MEX,W.P. Labuan,0,0,0
2021-05-01,MHL,Johor,0,0,0
2021-05-01,MHL,Kedah,0,0,0
2021-05-01,MHL,Perak,0,0,0
2021-05-01,MHL,Pulau Pinang,0,0,0
2021-05-01,MHL,Sabah,0,0,0
2021-05-01,MHL,Selangor,0,0,0
2021-05-01,MKD,Johor,0,0,0
2021-05-01,MKD,Kedah,0,0,0
2021-05-01,MKD,Perak,0,0,0
2021-05-01,MKD,Pulau Pinang,0,0,0
2021-05-01,MKD,Sabah,0,0,0
2021-05-01,MKD,Sarawak,0,0,0
2021-05-01,MKD,Selangor,2,2,0
2021-05-01,MLI,Johor,0,0,0
2021-05-01,MLI,Sabah,0,0,0
2021-05-01,MLI,Selangor,1,1,0
2021-05-01,MLT,Johor,0,0,0
2021-05-01,MLT,Kedah,0,0,0
2021-05-01,MLT,Kelantan,0,0,0
2021-05-01,MLT,Perak,0,0,0
2021-05-01,MLT,Perlis,0,0,0
2021-05-01,MLT,Pulau Pinang,0,0,0
2021-05-01,MLT,Sabah,0,0,0
2021-05-01,MLT,Sarawak,0,0,0
2021-05-01,MLT,Selangor,2,2,0
2021-05-01,MLT,W.P. Labuan,0,0,0
2021-05-01,MMR,Johor,9,9,0
2021-05-01,MMR,Kedah,0,0,0
2021-05-01,MMR,Kelantan,0,0,0
2021-05-01,MMR,Negeri Sembilan,0,0,0
2021-05-01,MMR,Pahang,0,0,0
2021-05-01,MMR,Perak,0,0,0
2021-05-01,MMR,Perlis,0,0,0
2021-05-01,MMR,Pulau Pinang,0,0,0
2021-05-01,MMR,Sabah,0,0,0
2021-05-01,MMR,Sarawak,0,0,0
2021-05-01,MMR,Selangor,60,50,10
2021-05-01,MMR,Terengganu,0,0,0
2021-05-01,MMR,W.P. Labuan,0,0,0
2021-05-01,MNE,Johor,0,0,0
2021-05-01,MNE,Kedah,0,0,0
2021-05-01,MNE,Pulau Pinang,0,0,0
2021-05-01,MNE,Sabah,0,0,0
2021-05-01,MNE,Sarawak,0,0,0
2021-05-01,MNE,Selangor,3,3,0
2021-05-01,MNG,Johor,0,0,0
2021-05-01,MNG,Kedah,0,0,0
2021-05-01,MNG,Kelantan,0,0,0
2021-05-01,MNG,Perak,0,0,0
2021-05-01,MNG,Perlis,0,0,0
2021-05-01,MNG,Pulau Pinang,0,0,0
2021-05-01,MNG,Sabah,0,0,0
2021-05-01,MNG,Sarawak,0,0,0
2021-05-01,MNG,Selangor,3,0,3
2021-05-01,MNP,Selangor,0,0,0
2021-05-01,MOZ,Johor,0,0,0
2021-05-01,MOZ,Kedah,0,0,0
2021-05-01,MOZ,Perak,0,0,0
2021-05-01,MOZ,Pulau Pinang,0,0,0
2021-05-01,MOZ,Sabah,0,0,0
2021-05-01,MOZ,Sarawak,0,0,0
2021-05-01,MOZ,Selangor,8,3,5
2021-05-01,MRT,Johor,0,0,0
2021-05-01,MRT,Kedah,0,0,0
2021-05-01,MRT,Pulau Pinang,0,0,0
2021-05-01,MRT,Sabah,0,0,0
2021-05-01,MRT,Sarawak,0,0,0
2021-05-01,MRT,Selangor,3,3,0
2021-05-01,MUS,Johor,0,0,0
2021-05-01,MUS,Kedah,0,0,0
2021-05-01,MUS,Kelantan,0,0,0
2021-05-01,MUS,Pahang,0,0,0
2021-05-01,MUS,Perak,0,0,0
2021-05-01,MUS,Perlis,0,0,0
2021-05-01,MUS,Pulau Pinang,0,0,0
2021-05-01,MUS,Sabah,0,0,0
2021-05-01,MUS,Sarawak,0,0,0
2021-05-01,MUS,Selangor,13,4,9
2021-05-01,MWI,Johor,0,0,0
2021-05-01,MWI,Pulau Pinang,0,0,0
2021-05-01,MWI,Sabah,0,0,0
2021-05-01,MWI,Sarawak,0,0,0
2021-05-01,MWI,Selangor,5,1,4
2021-05-01,MYT,Selangor,0,0,0
2021-05-01,NAM,Johor,0,0,0
2021-05-01,NAM,Kedah,0,0,0
2021-05-01,NAM,Perak,0,0,0
2021-05-01,NAM,Perlis,0,0,0
2021-05-01,NAM,Pulau Pinang,0,0,0
2021-05-01,NAM,Sabah,0,0,0
2021-05-01,NAM,Sarawak,0,0,0
2021-05-01,NAM,Selangor,2,2,0
2021-05-01,NCL,Selangor,0,0,0
2021-05-01,NER,Johor,0,0,0
2021-05-01,NER,Sabah,0,0,0
2021-05-01,NER,Selangor,0,0,0
2021-05-01,NGA,Johor,0,0,0
2021-05-01,NGA,Kedah,0,0,0
2021-05-01,NGA,Perlis,0,0,0
2021-05-01,NGA,Pulau Pinang,0,0,0
2021-05-01,NGA,Sabah,0,0,0
2021-05-01,NGA,Sarawak,0,0,0
2021-05-01,NGA,Selangor,132,111,21
2021-05-01,NIC,Johor,0,0,0
2021-05-01,NIC,Kedah,0,0,0
2021-05-01,NIC,Pulau Pinang,0,0,0
2021-05-01,NIC,Sabah,0,0,0
2021-05-01,NIC,Selangor,0,0,0
2021-05-01,NLD,Johor,0,0,0
2021-05-01,NLD,Kedah,0,0,0
2021-05-01,NLD,Kelantan,0,0,0
2021-05-01,NLD,Melaka,0,0,0
2021-05-01,NLD,Negeri Sembilan,0,0,0
2021-05-01,NLD,Pahang,0,0,0
2021-05-01,NLD,Perak,0,0,0
2021-05-01,NLD,Perlis,0,0,0
2021-05-01,NLD,Pulau Pinang,1,0,1
2021-05-01,NLD,Sabah,1,1,0
2021-05-01,NLD,Sarawak,0,0,0
2021-05-01,NLD,Selangor,38,32,6
2021-05-01,NLD,Terengganu,0,0,0
2021-05-01,NLD,W.P. Labuan,0,0,0
2021-05-01,NOR,Johor,0,0,0
2021-05-01,NOR,Kedah,0,0,0
2021-05-01,NOR,Kelantan,0,0,0
2021-05-01,NOR,Melaka,0,0,0
2021-05-01,NOR,Pahang,0,0,0
2021-05-01,NOR,Perak,0,0,0
2021-05-01,NOR,Perlis,0,0,0
2021-05-01,NOR,Pulau Pinang,0,0,0
2021-05-01,NOR,Sabah,0,0,0
2021-05-01,NOR,Sarawak,1,0,1
2021-05-01,NOR,Selangor,14,14,0
2021-05-01,NOR,W.P. Labuan,0,0,0
2021-05-01,NPL,Johor,0,0,0
2021-05-01,NPL,Kedah,0,0,0
2021-05-01,NPL,Pahang,0,0,0
2021-05-01,NPL,Perak,0,0,0
2021-05-01,NPL,Perlis,0,0,0
2021-05-01,NPL,Pulau Pinang,0,0,0
2021-05-01,NPL,Sabah,0,0,0
2021-05-01,NPL,Sarawak,0,0,0
2021-05-01,NPL,Selangor,74,73,1
2021-05-01,NPL,W.P. Labuan,0,0,0
2021-05-01,NRU,Johor,0,0,0
2021-05-01,NRU,Pulau Pinang,0,0,0
2021-05-01,NRU,Selangor,0,0,0
2021-05-01,NZL,Johor,0,0,0
2021-05-01,NZL,Kedah,0,0,0
2021-05-01,NZL,Kelantan,0,0,0
2021-05-01,NZL,Melaka,0,0,0
2021-05-01,NZL,Negeri Sembilan,0,0,0
2021-05-01,NZL,Pahang,0,0,0
2021-05-01,NZL,Perak,0,0,0
2021-05-01,NZL,Perlis,0,0,0
2021-05-01,NZL,Pulau Pinang,1,1,0
2021-05-01,NZL,Sabah,0,0,0
2021-05-01,NZL,Sarawak,1,1,0
2021-05-01,NZL,Selangor,6,5,1
2021-05-01,NZL,Terengganu,0,0,0
2021-05-01,NZL,W.P. Labuan,0,0,0
2021-05-01,OMN,Johor,0,0,0
2021-05-01,OMN,Kedah,0,0,0
2021-05-01,OMN,Kelantan,0,0,0
2021-05-01,OMN,Melaka,0,0,0
2021-05-01,OMN,Perak,0,0,0
2021-05-01,OMN,Perlis,0,0,0
2021-05-01,OMN,Pulau Pinang,0,0,0
2021-05-01,OMN,Sabah,0,0,0
2021-05-01,OMN,Sarawak,0,0,0
2021-05-01,OMN,Selangor,9,8,1
2021-05-01,PAK,Johor,0,0,0
2021-05-01,PAK,Kedah,0,0,0
2021-05-01,PAK,Kelantan,0,0,0
2021-05-01,PAK,Melaka,0,0,0
2021-05-01,PAK,Negeri Sembilan,0,0,0
2021-05-01,PAK,Pahang,0,0,0
2021-05-01,PAK,Perak,0,0,0
2021-05-01,PAK,Perlis,0,0,0
2021-05-01,PAK,Pulau Pinang,1,1,0
2021-05-01,PAK,Sabah,1,1,0
2021-05-01,PAK,Sarawak,0,0,0
2021-05-01,PAK,Selangor,57,40,17
2021-05-01,PAK,W.P. Labuan,0,0,0
2021-05-01,PAN,Johor,0,0,0
2021-05-01,PAN,Kedah,0,0,0
2021-05-01,PAN,Perak,0,0,0
2021-05-01,PAN,Perlis,0,0,0
2021-05-01,PAN,Pulau Pinang,0,0,0
2021-05-01,PAN,Sabah,0,0,0
2021-05-01,PAN,Sarawak,0,0,0
2021-05-01,PAN,Selangor,1,1,0
2021-05-01,PER,Johor,0,0,0
2021-05-01,PER,Kedah,0,0,0
2021-05-01,PER,Kelantan,0,0,0
2021-05-01,PER,Pahang,0,0,0
2021-05-01,PER,Perak,0,0,0
2021-05-01,PER,Perlis,0,0,0
2021-05-01,PER,Pulau Pinang,0,0,0
2021-05-01,PER,Sabah,0,0,0
2021-05-01,PER,Sarawak,0,0,0
2021-05-01,PER,Selangor,1,1,0
2021-05-01,PER,W.P. Labuan,0,0,0
2021-05-01,PHL,Johor,78,77,1
2021-05-01,PHL,Kedah,0,0,0
2021-05-01,PHL,Kelantan,0,0,0
2021-05-01,PHL,Melaka,0,0,0
2021-05-01,PHL,Negeri Sembilan,0,0,0
2021-05-01,PHL,Pahang,1,1,0
2021-05-01,PHL,Perak,0,0,0
2021-05-01,PHL,Perlis,0,0,0
2021-05-01,PHL,Pulau Pinang,2,1,1
2021-05-01,PHL,Sabah,2,1,1
2021-05-01,PHL,Sarawak,47,46,1
2021-05-01,PHL,Selangor,775,647,128
2021-05-01,PHL,Terengganu,0,0,0
2021-05-01,PHL,W.P. Labuan,7,7,0
2021-05-01,PLW,Johor,0,0,0
2021-05-01,PLW,Pulau Pinang,0,0,0
2021-05-01,PLW,Selangor,0,0,0
2021-05-01,PNG,Johor,0,0,0
2021-05-01,PNG,Kedah,0,0,0
2021-05-01,PNG,Kelantan,0,0,0
2021-05-01,PNG,Perak,0,0,0
2021-05-01,PNG,Pulau Pinang,0,0,0
2021-05-01,PNG,Sabah,0,0,0
2021-05-01,PNG,Sarawak,0,0,0
2021-05-01,PNG,Selangor,1,1,0
2021-05-01,POL,Johor,0,0,0
2021-05-01,POL,Kedah,0,0,0
2021-05-01,POL,Kelantan,0,0,0
2021-05-01,POL,Melaka,0,0,0
2021-05-01,POL,Negeri Sembilan,0,0,0
2021-05-01,POL,Pahang,0,0,0
2021-05-01,POL,Perak,0,0,0
2021-05-01,POL,Perlis,0,0,0
2021-05-01,POL,Pulau Pinang,0,0,0
2021-05-01,POL,Sabah,0,0,0
2021-05-01,POL,Sarawak,0,0,0
2021-05-01,POL,Selangor,38,32,6
2021-05-01,POL,Terengganu,0,0,0
2021-05-01,POL,W.P. Labuan,0,0,0
2021-05-01,PRK,Selangor,0,0,0
2021-05-01,PRT,Johor,0,0,0
2021-05-01,PRT,Kedah,0,0,0
2021-05-01,PRT,Kelantan,0,0,0
2021-05-01,PRT,Melaka,0,0,0
2021-05-01,PRT,Pahang,0,0,0
2021-05-01,PRT,Perak,0,0,0
2021-05-01,PRT,Perlis,0,0,0
2021-05-01,PRT,Pulau Pinang,0,0,0
2021-05-01,PRT,Sabah,0,0,0
2021-05-01,PRT,Sarawak,0,0,0
2021-05-01,PRT,Selangor,8,5,3
2021-05-01,PRT,W.P. Labuan,0,0,0
2021-05-01,PRY,Johor,0,0,0
2021-05-01,PRY,Kedah,0,0,0
2021-05-01,PRY,Perak,0,0,0
2021-05-01,PRY,Perlis,0,0,0
2021-05-01,PRY,Pulau Pinang,0,0,0
2021-05-01,PRY,Sabah,0,0,0
2021-05-01,PRY,Sarawak,0,0,0
2021-05-01,PRY,Selangor,0,0,0
2021-05-01,PSE,Johor,0,0,0
2021-05-01,PSE,Kedah,0,0,0
2021-05-01,PSE,Kelantan,0,0,0
2021-05-01,PSE,Melaka,0,0,0
2021-05-01,PSE,Perak,0,0,0
2021-05-01,PSE,Perlis,0,0,0
2021-05-01,PSE,Pulau Pinang,0,0,0
2021-05-01,PSE,Sabah,0,0,0
2021-05-01,PSE,Sarawak,0,0,0
2021-05-01,PSE,Selangor,18,15,3
2021-05-01,QAT,Johor,0,0,0
2021-05-01,QAT,Kedah,0,0,0
2021-05-01,QAT,Perlis,0,0,0
2021-05-01,QAT,Pulau Pinang,0,0,0
2021-05-01,QAT,Sabah,0,0,0
2021-05-01,QAT,Sarawak,0,0,0
2021-05-01,QAT,Selangor,3,3,0
2021-05-01,REU,Johor,0,0,0
2021-05-01,REU,Sarawak,0,0,0
2021-05-01,ROU,Johor,0,0,0
2021-05-01,ROU,Kedah,0,0,0
2021-05-01,ROU,Kelantan,0,0,0
2021-05-01,ROU,Negeri Sembilan,0,0,0
2021-05-01,ROU,Pahang,0,0,0
2021-05-01,ROU,Perak,0,0,0
2021-05-01,ROU,Perlis,0,0,0
2021-05-01,ROU,Pulau Pinang,0,0,0
2021-05-01,ROU,Sabah,0,0,0
2021-05-01,ROU,Sarawak,0,0,0
2021-05-01,ROU,Selangor,36,30,6
2021-05-01,ROU,W.P. Labuan,0,0,0
2021-05-01,RUS,Johor,3,3,0
2021-05-01,RUS,Kedah,0,0,0
2021-05-01,RUS,Kelantan,0,0,0
2021-05-01,RUS,Melaka,0,0,0
2021-05-01,RUS,Negeri Sembilan,0,0,0
2021-05-01,RUS,Pahang,0,0,0
2021-05-01,RUS,Perak,0,0,0
2021-05-01,RUS,Perlis,0,0,0
2021-05-01,RUS,Pulau Pinang,0,0,0
2021-05-01,RUS,Sabah,0,0,0
2021-05-01,RUS,Sarawak,0,0,0
2021-05-01,RUS,Selangor,64,55,9
2021-05-01,RUS,W.P. Labuan,0,0,0
2021-05-01,RWA,Johor,0,0,0
2021-05-01,RWA,Kedah,0,0,0
2021-05-01,RWA,Pulau Pinang,0,0,0
2021-05-01,RWA,Selangor,2,1,1
2021-05-01,SAU,Johor,0,0,0
2021-05-01,SAU,Kedah,0,0,0
2021-05-01,SAU,Kelantan,0,0,0
2021-05-01,SAU,Melaka,0,0,0
2021-05-01,SAU,Perak,0,0,0
2021-05-01,SAU,Perlis,0,0,0
2021-05-01,SAU,Pulau Pinang,0,0,0
2021-05-01,SAU,Sabah,0,0,0
2021-05-01,SAU,Sarawak,0,0,0
2021-05-01,SAU,Selangor,61,46,15
2021-05-01,SAU,W.P. Labuan,0,0,0
2021-05-01,SDN,Johor,0,0,0
2021-05-01,SDN,Kedah,0,0,0
2021-05-01,SDN,Kelantan,0,0,0
2021-05-01,SDN,Perlis,0,0,0
2021-05-01,SDN,Pulau Pinang,0,0,0
2021-05-01,SDN,Sabah,0,0,0
2021-05-01,SDN,Sarawak,0,0,0
2021-05-01,SDN,Selangor,47,36,11
2021-05-01,SDN,W.P. Labuan,0,0,0
2021-05-01,SEN,Johor,0,0,0
2021-05-01,SEN,Kedah,0,0,0
2021-05-01,SEN,Kelantan,0,0,0
2021-05-01,SEN,Perak,0,0,0
2021-05-01,SEN,Perlis,0,0,0
2021-05-01,SEN,Pulau Pinang,0,0,0
2021-05-01,SEN,Sabah,0,0,0
2021-05-01,SEN,Sarawak,0,0,0
2021-05-01,SEN,Selangor,2,1,1
2021-05-01,SGP,Johor,139,129,10
2021-05-01,SGP,Kedah,1,1,0
2021-05-01,SGP,Kelantan,0,0,0
2021-05-01,SGP,Melaka,0,0,0
2021-05-01,SGP,Negeri Sembilan,0,0,0
2021-05-01,SGP,Pahang,2,2,0
2021-05-01,SGP,Perak,7,2,5
2021-05-01,SGP,Perlis,0,0,0
2021-05-01,SGP,Pulau Pinang,13,10,3
2021-05-01,SGP,Sabah,1,1,0
2021-05-01,SGP,Sarawak,7,5,2
2021-05-01,SGP,Selangor,103,71,32
2021-05-01,SGP,Terengganu,0,0,0
2021-05-01,SGP,W.P. Labuan,0,0,0
2021-05-01,SGS,Johor,0,0,0
2021-05-01,SGS,Sabah,0,0,0
2021-05-01,SGS,Selangor,0,0,0
2021-05-01,SHN,Sarawak,0,0,0
2021-05-01,SLB,Johor,0,0,0
2021-05-01,SLB,Perlis,0,0,0
2021-05-01,SLB,Pulau Pinang,0,0,0
2021-05-01,SLB,Sabah,0,0,0
2021-05-01,SLB,Sarawak,0,0,0
2021-05-01,SLB,Selangor,0,0,0
2021-05-01,SLB,W.P. Labuan,0,0,0
2021-05-01,SLE,Johor,0,0,0
2021-05-01,SLE,Kedah,0,0,0
2021-05-01,SLE,Perak,0,0,0
2021-05-01,SLE,Pulau Pinang,0,0,0
2021-05-01,SLE,Sabah,0,0,0
2021-05-01,SLE,Selangor,3,3,0
2021-05-01,SLV,Johor,0,0,0
2021-05-01,SLV,Kedah,0,0,0
2021-05-01,SLV,Perak,0,0,0
2021-05-01,SLV,Perlis,0,0,0
2021-05-01,SLV,Pulau Pinang,0,0,0
2021-05-01,SLV,Sabah,0,0,0
2021-05-01,SLV,Selangor,0,0,0
2021-05-01,SLV,W.P. Labuan,0,0,0
2021-05-01,SMR,Johor,0,0,0
2021-05-01,SMR,Selangor,0,0,0
2021-05-01,SOM,Johor,0,0,0
2021-05-01,SOM,Kedah,0,0,0
2021-05-01,SOM,Kelantan,0,0,0
2021-05-01,SOM,Perlis,0,0,0
2021-05-01,SOM,Sabah,0,0,0
2021-05-01,SOM,Sarawak,0,0,0
2021-05-01,SOM,Selangor,16,11,5
2021-05-01,SRB,Johor,0,0,0
2021-05-01,SRB,Kedah,0,0,0
2021-05-01,SRB,Kelantan,0,0,0
2021-05-01,SRB,Pahang,0,0,0
2021-05-01,SRB,Perak,0,0,0
2021-05-01,SRB,Perlis,0,0,0
2021-05-01,SRB,Pulau Pinang,0,0,0
2021-05-01,SRB,Sabah,0,0,0
2021-05-01,SRB,Sarawak,0,0,0
2021-05-01,SRB,Selangor,4,4,0
2021-05-01,SSD,Johor,0,0,0
2021-05-01,SSD,Kedah,0,0,0
2021-05-01,SSD,Sarawak,0,0,0
2021-05-01,SSD,Selangor,5,4,1
2021-05-01,SSD,W.P. Labuan,0,0,0
2021-05-01,STP,Selangor,0,0,0
2021-05-01,SUR,Johor,0,0,0
2021-05-01,SUR,Kedah,0,0,0
2021-05-01,SUR,Kelantan,0,0,0
2021-05-01,SUR,Perak,0,0,0
2021-05-01,SUR,Perlis,0,0,0
2021-05-01,SUR,Pulau Pinang,0,0,0
2021-05-01,SUR,Sabah,0,0,0
2021-05-01,SUR,Sarawak,0,0,0
2021-05-01,SUR,Selangor,0,0,0
2021-05-01,SVK,Johor,0,0,0
2021-05-01,SVK,Kedah,0,0,0
2021-05-01,SVK,Kelantan,0,0,0
2021-05-01,SVK,Negeri Sembilan,0,0,0
2021-05-01,SVK,Pahang,0,0,0
2021-05-01,SVK,Perak,0,0,0
2021-05-01,SVK,Perlis,0,0,0
2021-05-01,SVK,Pulau Pinang,0,0,0
2021-05-01,SVK,Sabah,0,0,0
2021-05-01,SVK,Sarawak,0,0,0
2021-05-01,SVK,Selangor,7,5,2
2021-05-01,SVK,W.P. Labuan,0,0,0
2021-05-01,SVN,Johor,0,0,0
2021-05-01,SVN,Kedah,0,0,0
2021-05-01,SVN,Kelantan,0,0,0
2021-05-01,SVN,Perak,0,0,0
2021-05-01,SVN,Perlis,0,0,0
2021-05-01,SVN,Pulau Pinang,0,0,0
2021-05-01,SVN,Sabah,0,0,0
2021-05-01,SVN,Sarawak,1,1,0
2021-05-01,SVN,Selangor,1,1,0
2021-05-01,SVN,W.P. Labuan,0,0,0
2021-05-01,SWE,Johor,0,0,0
2021-05-01,SWE,Kedah,0,0,0
2021-05-01,SWE,Kelantan,0,0,0
2021-05-01,SWE,Melaka,0,0,0
2021-05-01,SWE,Negeri Sembilan,0,0,0
2021-05-01,SWE,Pahang,0,0,0
2021-05-01,SWE,Perak,0,0,0
2021-05-01,SWE,Perlis,0,0,0
2021-05-01,SWE,Pulau Pinang,0,0,0
2021-05-01,SWE,Sabah,1,0,1
2021-05-01,SWE,Sarawak,0,0,0
2021-05-01,SWE,Selangor,38,33,5
2021-05-01,SWE,W.P. Labuan,0,0,0
2021-05-01,SWZ,Johor,0,0,0
2021-05-01,SWZ,Kedah,0,0,0
2021-05-01,SWZ,Pulau Pinang,0,0,0
2021-05-01,SWZ,Sabah,0,0,0
2021-05-01,SWZ,Selangor,0,0,0
2021-05-01,SYC,Johor,0,0,0
2021-05-01,SYC,Kedah,0,0,0
2021-05-01,SYC,Pulau Pinang,0,0,0
2021-05-01,SYC,Sabah,0,0,0
2021-05-01,SYC,Sarawak,0,0,0
2021-05-01,SYC,Selangor,12,6,6
2021-05-01,SYR,Johor,0,0,0
2021-05-01,SYR,Kedah,0,0,0
2021-05-01,SYR,Kelantan,0,0,0
2021-05-01,SYR,Pahang,0,0,0
2021-05-01,SYR,Perlis,0,0,0
2021-05-01,SYR,Pulau Pinang,0,0,0
2021-05-01,SYR,Sabah,0,0,0
2021-05-01,SYR,Sarawak,0,0,0
2021-05-01,SYR,Selangor,29,19,10
2021-05-01,SYR,W.P. Labuan,0,0,0
2021-05-01,TCA,Perlis,0,0,0
2021-05-01,TCD,Johor,0,0,0
2021-05-01,TCD,Kedah,0,0,0
2021-05-01,TCD,Perlis,0,0,0
2021-05-01,TCD,Selangor,3,3,0
2021-05-01,TGO,Johor,0,0,0
2021-05-01,TGO,Perak,0,0,0
2021-05-01,TGO,Pulau Pinang,0,0,0
2021-05-01,TGO,Selangor,1,1,0
2021-05-01,THA,Johor,6,6,0
2021-05-01,THA,Kedah,18417,18374,43
2021-05-01,THA,Kelantan,1,1,0
2021-05-01,THA,Melaka,0,0,0
2021-05-01,THA,Negeri Sembilan,0,0,0
2021-05-01,THA,Pahang,0,0,0
2021-05-01,THA,Perak,1,0,1
2021-05-01,THA,Perlis,8612,8377,235
2021-05-01,THA,Pulau Pinang,37,32,5
2021-05-01,THA,Sabah,0,0,0
2021-05-01,THA,Sarawak,12,11,1
2021-05-01,THA,Selangor,211,93,118
2021-05-01,THA,Terengganu,0,0,0
2021-05-01,THA,W.P. Labuan,1,0,1
2021-05-01,TJK,Johor,0,0,0
2021-05-01,TJK,Kedah,0,0,0
2021-05-01,TJK,Perlis,0,0,0
2021-05-01,TJK,Pulau Pinang,0,0,0
2021-05-01,TJK,Sabah,0,0,0
2021-05-01,TJK,Selangor,0,0,0
2021-05-01,TKL,Selangor,0,0,0
2021-05-01,TKM,Johor,0,0,0
2021-05-01,TKM,Kedah,0,0,0
2021-05-01,TKM,Kelantan,0,0,0
2021-05-01,TKM,Perlis,0,0,0
2021-05-01,TKM,Pulau Pinang,0,0,0
2021-05-01,TKM,Sabah,0,0,0
2021-05-01,TKM,Sarawak,0,0,0
2021-05-01,TKM,Selangor,0,0,0
2021-05-01,TLS,Johor,0,0,0
2021-05-01,TLS,Kedah,0,0,0
2021-05-01,TLS,Perlis,0,0,0
2021-05-01,TLS,Pulau Pinang,0,0,0
2021-05-01,TLS,Sabah,0,0,0
2021-05-01,TLS,Sarawak,0,0,0
2021-05-01,TLS,Selangor,1,1,0
2021-05-01,TON,Johor,0,0,0
2021-05-01,TON,Pulau Pinang,0,0,0
2021-05-01,TON,Sarawak,0,0,0
2021-05-01,TON,Selangor,0,0,0
2021-05-01,TTO,Johor,0,0,0
2021-05-01,TTO,Kedah,0,0,0
2021-05-01,TTO,Pahang,0,0,0
2021-05-01,TTO,Pulau Pinang,0,0,0
2021-05-01,TTO,Sabah,0,0,0
2021-05-01,TTO,Sarawak,0,0,0
2021-05-01,TTO,Selangor,1,1,0
2021-05-01,TUN,Johor,0,0,0
2021-05-01,TUN,Kedah,0,0,0
2021-05-01,TUN,Kelantan,0,0,0
2021-05-01,TUN,Melaka,0,0,0
2021-05-01,TUN,Perak,0,0,0
2021-05-01,TUN,Perlis,0,0,0
2021-05-01,TUN,Pulau Pinang,0,0,0
2021-05-01,TUN,Sabah,0,0,0
2021-05-01,TUN,Sarawak,0,0,0
2021-05-01,TUN,Selangor,9,7,2
2021-05-01,TUN,W.P. Labuan,0,0,0
2021-05-01,TUR,Johor,0,0,0
2021-05-01,TUR,Kedah,0,0,0
2021-05-01,TUR,Kelantan,0,0,0
2021-05-01,TUR,Melaka,0,0,0
2021-05-01,TUR,Negeri Sembilan,0,0,0
2021-05-01,TUR,Pahang,0,0,0
2021-05-01,TUR,Perak,0,0,0
2021-05-01,TUR,Perlis,0,0,0
2021-05-01,TUR,Pulau Pinang,0,0,0
2021-05-01,TUR,Sabah,0,0,0
2021-05-01,TUR,Sarawak,0,0,0
2021-05-01,TUR,Selangor,15,13,2
2021-05-01,TUR,W.P. Labuan,0,0,0
2021-05-01,TUV,Selangor,0,0,0
2021-05-01,TWN,Johor,1,0,1
2021-05-01,TWN,Kedah,0,0,0
2021-05-01,TWN,Kelantan,0,0,0
2021-05-01,TWN,Melaka,0,0,0
2021-05-01,TWN,Negeri Sembilan,0,0,0
2021-05-01,TWN,Pahang,0,0,0
2021-05-01,TWN,Perak,0,0,0
2021-05-01,TWN,Perlis,0,0,0
2021-05-01,TWN,Pulau Pinang,10,8,2
2021-05-01,TWN,Sabah,0,0,0
2021-05-01,TWN,Sarawak,0,0,0
2021-05-01,TWN,Selangor,66,48,18
2021-05-01,TWN,W.P. Labuan,0,0,0
2021-05-01,TZA,Johor,0,0,0
2021-05-01,TZA,Kedah,0,0,0
2021-05-01,TZA,Perak,0,0,0
2021-05-01,TZA,Perlis,0,0,0
2021-05-01,TZA,Pulau Pinang,0,0,0
2021-05-01,TZA,Sabah,0,0,0
2021-05-01,TZA,Sarawak,0,0,0
2021-05-01,TZA,Selangor,16,8,8
2021-05-01,UGA,Johor,0,0,0
2021-05-01,UGA,Kedah,0,0,0
2021-05-01,UGA,Perak,0,0,0
2021-05-01,UGA,Perlis,0,0,0
2021-05-01,UGA,Pulau Pinang,0,0,0
2021-05-01,UGA,Sabah,0,0,0
2021-05-01,UGA,Sarawak,0,0,0
2021-05-01,UGA,Selangor,4,1,3
2021-05-01,UKR,Johor,2,2,0
2021-05-01,UKR,Kedah,0,0,0
2021-05-01,UKR,Kelantan,0,0,0
2021-05-01,UKR,Melaka,0,0,0
2021-05-01,UKR,Negeri Sembilan,0,0,0
2021-05-01,UKR,Pahang,0,0,0
2021-05-01,UKR,Perak,0,0,0
2021-05-01,UKR,Perlis,0,0,0
2021-05-01,UKR,Pulau Pinang,0,0,0
2021-05-01,UKR,Sabah,0,0,0
2021-05-01,UKR,Sarawak,0,0,0
2021-05-01,UKR,Selangor,61,57,4
2021-05-01,UKR,W.P. Labuan,0,0,0
2021-05-01,URY,Johor,0,0,0
2021-05-01,URY,Kedah,0,0,0
2021-05-01,URY,Kelantan,0,0,0
2021-05-01,URY,Perak,0,0,0
2021-05-01,URY,Perlis,0,0,0
2021-05-01,URY,Pulau Pinang,0,0,0
2021-05-01,URY,Sabah,0,0,0
2021-05-01,URY,Sarawak,0,0,0
2021-05-01,URY,Selangor,0,0,0
2021-05-01,URY,W.P. Labuan,0,0,0
2021-05-01,USA,Johor,0,0,0
2021-05-01,USA,Kedah,0,0,0
2021-05-01,USA,Kelantan,0,0,0
2021-05-01,USA,Melaka,0,0,0
2021-05-01,USA,Negeri Sembilan,0,0,0
2021-05-01,USA,Pahang,0,0,0
2021-05-01,USA,Perak,0,0,0
2021-05-01,USA,Perlis,0,0,0
2021-05-01,USA,Pulau Pinang,6,4,2
2021-05-01,USA,Sabah,0,0,0
2021-05-01,USA,Sarawak,1,1,0
2021-05-01,USA,Selangor,152,103,49
2021-05-01,USA,Terengganu,0,0,0
2021-05-01,USA,W.P. Labuan,0,0,0
2021-05-01,UZB,Johor,0,0,0
2021-05-01,UZB,Kedah,0,0,0
2021-05-01,UZB,Kelantan,0,0,0
2021-05-01,UZB,Perak,0,0,0
2021-05-01,UZB,Perlis,0,0,0
2021-05-01,UZB,Pulau Pinang,0,0,0
2021-05-01,UZB,Sabah,0,0,0
2021-05-01,UZB,Sarawak,0,0,0
2021-05-01,UZB,Selangor,15,14,1
2021-05-01,VAT,Johor,0,0,0
2021-05-01,VAT,Sarawak,0,0,0
2021-05-01,VAT,Selangor,0,0,0
2021-05-01,VCT,Johor,0,0,0
2021-05-01,VCT,Kedah,0,0,0
2021-05-01,VCT,Pulau Pinang,0,0,0
2021-05-01,VCT,Sarawak,0,0,0
2021-05-01,VCT,Selangor,0,0,0
2021-05-01,VEN,Johor,0,0,0
2021-05-01,VEN,Kedah,0,0,0
2021-05-01,VEN,Kelantan,0,0,0
2021-05-01,VEN,Melaka,0,0,0
2021-05-01,VEN,Perak,0,0,0
2021-05-01,VEN,Perlis,0,0,0
2021-05-01,VEN,Pulau Pinang,0,0,0
2021-05-01,VEN,Sabah,0,0,0
2021-05-01,VEN,Sarawak,0,0,0
2021-05-01,VEN,Selangor,4,4,0
2021-05-01,VEN,W.P. Labuan,0,0,0
2021-05-01,VNM,Johor,0,0,0
2021-05-01,VNM,Kedah,0,0,0
2021-05-01,VNM,Kelantan,0,0,0
2021-05-01,VNM,Melaka,0,0,0
2021-05-01,VNM,Negeri Sembilan,0,0,0
2021-05-01,VNM,Pahang,0,0,0
2021-05-01,VNM,Perak,0,0,0
2021-05-01,VNM,Perlis,0,0,0
2021-05-01,VNM,Pulau Pinang,2,1,1
2021-05-01,VNM,Sabah,0,0,0
2021-05-01,VNM,Sarawak,0,0,0
2021-05-01,VNM,Selangor,107,43,64
2021-05-01,VNM,Terengganu,0,0,0
2021-05-01,VNM,W.P. Labuan,0,0,0
2021-05-01,VUT,Johor,0,0,0
2021-05-01,VUT,Kedah,0,0,0
2021-05-01,VUT,Pulau Pinang,0,0,0
2021-05-01,VUT,Sabah,0,0,0
2021-05-01,VUT,Sarawak,0,0,0
2021-05-01,VUT,Selangor,0,0,0
2021-05-01,WSM,Johor,0,0,0
2021-05-01,WSM,Sarawak,0,0,0
2021-05-01,WSM,Selangor,0,0,0
2021-05-01,XXX,Johor,2,2,0
2021-05-01,XXX,Kedah,0,0,0
2021-05-01,XXX,Kelantan,0,0,0
2021-05-01,XXX,Melaka,0,0,0
2021-05-01,XXX,Pahang,0,0,0
2021-05-01,XXX,Perak,0,0,0
2021-05-01,XXX,Perlis,0,0,0
2021-05-01,XXX,Pulau Pinang,0,0,0
2021-05-01,XXX,Sabah,0,0,0
2021-05-01,XXX,Sarawak,0,0,0
2021-05-01,XXX,Selangor,6,6,0
2021-05-01,XXX,W.P. Labuan,0,0,0
2021-05-01,YEM,Johor,0,0,0
2021-05-01,YEM,Kedah,0,0,0
2021-05-01,YEM,Kelantan,0,0,0
2021-05-01,YEM,Melaka,0,0,0
2021-05-01,YEM,Pahang,0,0,0
2021-05-01,YEM,Perak,0,0,0
2021-05-01,YEM,Perlis,0,0,0
2021-05-01,YEM,Pulau Pinang,0,0,0
2021-05-01,YEM,Sabah,0,0,0
2021-05-01,YEM,Sarawak,0,0,0
2021-05-01,YEM,Selangor,52,38,14
2021-05-01,YEM,W.P. Labuan,0,0,0
2021-05-01,ZAF,Johor,0,0,0
2021-05-01,ZAF,Kedah,0,0,0
2021-05-01,ZAF,Kelantan,0,0,0
2021-05-01,ZAF,Melaka,0,0,0
2021-05-01,ZAF,Pahang,0,0,0
2021-05-01,ZAF,Perak,0,0,0
2021-05-01,ZAF,Perlis,0,0,0
2021-05-01,ZAF,Pulau Pinang,0,0,0
2021-05-01,ZAF,Sabah,0,0,0
2021-05-01,ZAF,Sarawak,0,0,0
2021-05-01,ZAF,Selangor,33,25,8
2021-05-01,ZAF,Terengganu,0,0,0
2021-05-01,ZAF,W.P. Labuan,0,0,0
2021-05-01,ZAR,Selangor,0,0,0
2021-05-01,ZMB,Johor,0,0,0
2021-05-01,ZMB,Kedah,0,0,0
2021-05-01,ZMB,Perak,0,0,0
2021-05-01,ZMB,Perlis,0,0,0
2021-05-01,ZMB,Pulau Pinang,0,0,0
2021-05-01,ZMB,Sabah,0,0,0
2021-05-01,ZMB,Sarawak,0,0,0
2021-05-01,ZMB,Selangor,11,4,7
2021-05-01,ZWE,Johor,0,0,0
2021-05-01,ZWE,Kedah,0,0,0
2021-05-01,ZWE,Kelantan,0,0,0
2021-05-01,ZWE,Perak,0,0,0
2021-05-01,ZWE,Perlis,0,0,0
2021-05-01,ZWE,Pulau Pinang,0,0,0
2021-05-01,ZWE,Sabah,0,0,0
2021-05-01,ZWE,Sarawak,0,0,0
2021-05-01,ZWE,Selangor,11,8,3
2021-06-01,ABW,Kedah,0,0,0
2021-06-01,ABW,Pulau Pinang,0,0,0
2021-06-01,AFG,Johor,0,0,0
2021-06-01,AFG,Kedah,0,0,0
2021-06-01,AFG,Perlis,0,0,0
2021-06-01,AFG,Pulau Pinang,0,0,0
2021-06-01,AFG,Sarawak,0,0,0
2021-06-01,AFG,Selangor,6,3,3
2021-06-01,AGO,Johor,0,0,0
2021-06-01,AGO,Kedah,0,0,0
2021-06-01,AGO,Sabah,0,0,0
2021-06-01,AGO,Selangor,0,0,0
2021-06-01,AIA,Selangor,0,0,0
2021-06-01,ALB,Johor,0,0,0
2021-06-01,ALB,Kedah,0,0,0
2021-06-01,ALB,Perak,0,0,0
2021-06-01,ALB,Perlis,0,0,0
2021-06-01,ALB,Pulau Pinang,0,0,0
2021-06-01,ALB,Sabah,0,0,0
2021-06-01,ALB,Sarawak,0,0,0
2021-06-01,ALB,Selangor,1,0,1
2021-06-01,AND,Johor,0,0,0
2021-06-01,AND,Kedah,0,0,0
2021-06-01,AND,Perlis,0,0,0
2021-06-01,AND,Pulau Pinang,0,0,0
2021-06-01,AND,Selangor,0,0,0
2021-06-01,ANT,Selangor,0,0,0
2021-06-01,ARE,Johor,0,0,0
2021-06-01,ARE,Kedah,0,0,0
2021-06-01,ARE,Kelantan,0,0,0
2021-06-01,ARE,Perak,0,0,0
2021-06-01,ARE,Perlis,0,0,0
2021-06-01,ARE,Pulau Pinang,0,0,0
2021-06-01,ARE,Sabah,0,0,0
2021-06-01,ARE,Sarawak,0,0,0
2021-06-01,ARE,Selangor,1,0,1
2021-06-01,ARG,Johor,0,0,0
2021-06-01,ARG,Kedah,0,0,0
2021-06-01,ARG,Kelantan,0,0,0
2021-06-01,ARG,Melaka,0,0,0
2021-06-01,ARG,Perak,0,0,0
2021-06-01,ARG,Perlis,0,0,0
2021-06-01,ARG,Pulau Pinang,0,0,0
2021-06-01,ARG,Sabah,0,0,0
2021-06-01,ARG,Sarawak,0,0,0
2021-06-01,ARG,Selangor,7,4,3
2021-06-01,ARG,W.P. Labuan,0,0,0
2021-06-01,ARM,Johor,0,0,0
2021-06-01,ARM,Kedah,0,0,0
2021-06-01,ARM,Kelantan,0,0,0
2021-06-01,ARM,Perak,0,0,0
2021-06-01,ARM,Perlis,0,0,0
2021-06-01,ARM,Pulau Pinang,0,0,0
2021-06-01,ARM,Sabah,0,0,0
2021-06-01,ARM,Sarawak,0,0,0
2021-06-01,ARM,Selangor,0,0,0
2021-06-01,ATA,Selangor,0,0,0
2021-06-01,ATG,Johor,0,0,0
2021-06-01,ATG,Kedah,0,0,0
2021-06-01,ATG,Pulau Pinang,0,0,0
2021-06-01,ATG,Sarawak,0,0,0
2021-06-01,ATG,Selangor,0,0,0
2021-06-01,AUS,Johor,2,1,1
2021-06-01,AUS,Kedah,0,0,0
2021-06-01,AUS,Kelantan,0,0,0
2021-06-01,AUS,Melaka,0,0,0
2021-06-01,AUS,Negeri Sembilan,0,0,0
2021-06-01,AUS,Pahang,0,0,0
2021-06-01,AUS,Perak,0,0,0
2021-06-01,AUS,Perlis,0,0,0
2021-06-01,AUS,Pulau Pinang,6,3,3
2021-06-01,AUS,Sabah,0,0,0
2021-06-01,AUS,Sarawak,1,1,0
2021-06-01,AUS,Selangor,46,37,9
2021-06-01,AUS,Terengganu,0,0,0
2021-06-01,AUS,W.P. Labuan,0,0,0
2021-06-01,AUT,Johor,0,0,0
2021-06-01,AUT,Kedah,0,0,0
2021-06-01,AUT,Kelantan,0,0,0
2021-06-01,AUT,Melaka,0,0,0
2021-06-01,AUT,Negeri Sembilan,0,0,0
2021-06-01,AUT,Pahang,0,0,0
2021-06-01,AUT,Perak,0,0,0
2021-06-01,AUT,Perlis,0,0,0
2021-06-01,AUT,Pulau Pinang,0,0,0
2021-06-01,AUT,Sabah,0,0,0
2021-06-01,AUT,Sarawak,0,0,0
2021-06-01,AUT,Selangor,8,8,0
2021-06-01,AUT,Terengganu,0,0,0
2021-06-01,AUT,W.P. Labuan,0,0,0
2021-06-01,AZE,Johor,0,0,0
2021-06-01,AZE,Kedah,0,0,0
2021-06-01,AZE,Kelantan,0,0,0
2021-06-01,AZE,Melaka,0,0,0
2021-06-01,AZE,Perlis,0,0,0
2021-06-01,AZE,Pulau Pinang,0,0,0
2021-06-01,AZE,Sabah,0,0,0
2021-06-01,AZE,Sarawak,0,0,0
2021-06-01,AZE,Selangor,1,1,0
2021-06-01,AZE,W.P. Labuan,0,0,0
2021-06-01,BDI,Pulau Pinang,0,0,0
2021-06-01,BDI,Sarawak,0,0,0
2021-06-01,BDI,Selangor,0,0,0
2021-06-01,BEL,Johor,0,0,0
2021-06-01,BEL,Kedah,0,0,0
2021-06-01,BEL,Kelantan,0,0,0
2021-06-01,BEL,Melaka,0,0,0
2021-06-01,BEL,Negeri Sembilan,0,0,0
2021-06-01,BEL,Pahang,0,0,0
2021-06-01,BEL,Perak,0,0,0
2021-06-01,BEL,Perlis,0,0,0
2021-06-01,BEL,Pulau Pinang,0,0,0
2021-06-01,BEL,Sabah,0,0,0
2021-06-01,BEL,Sarawak,0,0,0
2021-06-01,BEL,Selangor,5,3,2
2021-06-01,BEL,W.P. Labuan,0,0,0
2021-06-01,BEN,Johor,0,0,0
2021-06-01,BEN,Kedah,0,0,0
2021-06-01,BEN,Perak,0,0,0
2021-06-01,BEN,Pulau Pinang,0,0,0
2021-06-01,BEN,Sabah,0,0,0
2021-06-01,BEN,Sarawak,0,0,0
2021-06-01,BEN,Selangor,0,0,0
2021-06-01,BFA,Perak,0,0,0
2021-06-01,BFA,Pulau Pinang,0,0,0
2021-06-01,BFA,Selangor,0,0,0
2021-06-01,BGD,Johor,0,0,0
2021-06-01,BGD,Kedah,0,0,0
2021-06-01,BGD,Kelantan,0,0,0
2021-06-01,BGD,Melaka,0,0,0
2021-06-01,BGD,Negeri Sembilan,0,0,0
2021-06-01,BGD,Pahang,0,0,0
2021-06-01,BGD,Perak,0,0,0
2021-06-01,BGD,Perlis,0,0,0
2021-06-01,BGD,Pulau Pinang,0,0,0
2021-06-01,BGD,Sabah,0,0,0
2021-06-01,BGD,Sarawak,0,0,0
2021-06-01,BGD,Selangor,3,1,2
2021-06-01,BGD,W.P. Labuan,0,0,0
2021-06-01,BGR,Johor,0,0,0
2021-06-01,BGR,Kedah,0,0,0
2021-06-01,BGR,Kelantan,0,0,0
2021-06-01,BGR,Pahang,0,0,0
2021-06-01,BGR,Perak,0,0,0
2021-06-01,BGR,Perlis,0,0,0
2021-06-01,BGR,Pulau Pinang,0,0,0
2021-06-01,BGR,Sabah,0,0,0
2021-06-01,BGR,Sarawak,0,0,0
2021-06-01,BGR,Selangor,8,8,0
2021-06-01,BGR,W.P. Labuan,0,0,0
2021-06-01,BHR,Johor,0,0,0
2021-06-01,BHR,Kedah,0,0,0
2021-06-01,BHR,Kelantan,0,0,0
2021-06-01,BHR,Perlis,0,0,0
2021-06-01,BHR,Pulau Pinang,0,0,0
2021-06-01,BHR,Sabah,0,0,0
2021-06-01,BHR,Sarawak,0,0,0
2021-06-01,BHR,Selangor,1,1,0
2021-06-01,BHS,Johor,0,0,0
2021-06-01,BHS,Kedah,0,0,0
2021-06-01,BHS,Perak,0,0,0
2021-06-01,BHS,Sabah,0,0,0
2021-06-01,BHS,Sarawak,0,0,0
2021-06-01,BHS,Selangor,0,0,0
2021-06-01,BIH,Johor,0,0,0
2021-06-01,BIH,Kedah,0,0,0
2021-06-01,BIH,Perlis,0,0,0
2021-06-01,BIH,Pulau Pinang,0,0,0
2021-06-01,BIH,Sabah,0,0,0
2021-06-01,BIH,Sarawak,0,0,0
2021-06-01,BIH,Selangor,2,1,1
2021-06-01,BLR,Johor,0,0,0
2021-06-01,BLR,Kedah,0,0,0
2021-06-01,BLR,Kelantan,0,0,0
2021-06-01,BLR,Pahang,0,0,0
2021-06-01,BLR,Perak,0,0,0
2021-06-01,BLR,Perlis,0,0,0
2021-06-01,BLR,Pulau Pinang,0,0,0
2021-06-01,BLR,Sabah,0,0,0
2021-06-01,BLR,Sarawak,0,0,0
2021-06-01,BLR,Selangor,0,0,0
2021-06-01,BLR,W.P. Labuan,0,0,0
2021-06-01,BLZ,Johor,0,0,0
2021-06-01,BLZ,Pulau Pinang,0,0,0
2021-06-01,BLZ,Sarawak,0,0,0
2021-06-01,BLZ,Selangor,0,0,0
2021-06-01,BMU,Selangor,0,0,0
2021-06-01,BOL,Johor,0,0,0
2021-06-01,BOL,Kedah,0,0,0
2021-06-01,BOL,Melaka,0,0,0
2021-06-01,BOL,Perak,0,0,0
2021-06-01,BOL,Perlis,0,0,0
2021-06-01,BOL,Pulau Pinang,0,0,0
2021-06-01,BOL,Sabah,0,0,0
2021-06-01,BOL,Sarawak,0,0,0
2021-06-01,BOL,Selangor,0,0,0
2021-06-01,BRA,Johor,0,0,0
2021-06-01,BRA,Kedah,0,0,0
2021-06-01,BRA,Kelantan,0,0,0
2021-06-01,BRA,Melaka,0,0,0
2021-06-01,BRA,Pahang,0,0,0
2021-06-01,BRA,Perak,0,0,0
2021-06-01,BRA,Perlis,0,0,0
2021-06-01,BRA,Pulau Pinang,0,0,0
2021-06-01,BRA,Sabah,0,0,0
2021-06-01,BRA,Sarawak,0,0,0
2021-06-01,BRA,Selangor,15,12,3
2021-06-01,BRA,W.P. Labuan,0,0,0
2021-06-01,BRB,Johor,0,0,0
2021-06-01,BRB,Kedah,0,0,0
2021-06-01,BRB,Perlis,0,0,0
2021-06-01,BRB,Pulau Pinang,0,0,0
2021-06-01,BRB,Selangor,0,0,0
2021-06-01,BRN,Johor,0,0,0
2021-06-01,BRN,Kedah,0,0,0
2021-06-01,BRN,Kelantan,0,0,0
2021-06-01,BRN,Melaka,0,0,0
2021-06-01,BRN,Pahang,0,0,0
2021-06-01,BRN,Perak,0,0,0
2021-06-01,BRN,Perlis,0,0,0
2021-06-01,BRN,Pulau Pinang,0,0,0
2021-06-01,BRN,Sabah,0,0,0
2021-06-01,BRN,Sarawak,308,306,2
2021-06-01,BRN,Selangor,8,2,6
2021-06-01,BRN,W.P. Labuan,0,0,0
2021-06-01,BTN,Johor,0,0,0
2021-06-01,BTN,Kedah,0,0,0
2021-06-01,BTN,Perak,0,0,0
2021-06-01,BTN,Perlis,0,0,0
2021-06-01,BTN,Pulau Pinang,0,0,0
2021-06-01,BTN,Sabah,0,0,0
2021-06-01,BTN,Sarawak,0,0,0
2021-06-01,BTN,Selangor,0,0,0
2021-06-01,BWA,Johor,0,0,0
2021-06-01,BWA,Kedah,0,0,0
2021-06-01,BWA,Perlis,0,0,0
2021-06-01,BWA,Pulau Pinang,0,0,0
2021-06-01,BWA,Sabah,0,0,0
2021-06-01,BWA,Sarawak,0,0,0
2021-06-01,BWA,Selangor,0,0,0
2021-06-01,CAF,Kedah,0,0,0
2021-06-01,CAF,Selangor,0,0,0
2021-06-01,CAN,Johor,0,0,0
2021-06-01,CAN,Kedah,0,0,0
2021-06-01,CAN,Kelantan,0,0,0
2021-06-01,CAN,Melaka,0,0,0
2021-06-01,CAN,Negeri Sembilan,0,0,0
2021-06-01,CAN,Pahang,0,0,0
2021-06-01,CAN,Perak,0,0,0
2021-06-01,CAN,Perlis,0,0,0
2021-06-01,CAN,Pulau Pinang,0,0,0
2021-06-01,CAN,Sabah,0,0,0
2021-06-01,CAN,Sarawak,0,0,0
2021-06-01,CAN,Selangor,29,19,10
2021-06-01,CAN,Terengganu,0,0,0
2021-06-01,CAN,W.P. Labuan,0,0,0
2021-06-01,CCK,Selangor,0,0,0
2021-06-01,CHE,Johor,0,0,0
2021-06-01,CHE,Kedah,0,0,0
2021-06-01,CHE,Kelantan,0,0,0
2021-06-01,CHE,Melaka,0,0,0
2021-06-01,CHE,Negeri Sembilan,0,0,0
2021-06-01,CHE,Pahang,0,0,0
2021-06-01,CHE,Perak,0,0,0
2021-06-01,CHE,Perlis,0,0,0
2021-06-01,CHE,Pulau Pinang,0,0,0
2021-06-01,CHE,Sabah,0,0,0
2021-06-01,CHE,Sarawak,0,0,0
2021-06-01,CHE,Selangor,12,9,3
2021-06-01,CHE,W.P. Labuan,0,0,0
2021-06-01,CHL,Johor,0,0,0
2021-06-01,CHL,Kedah,0,0,0
2021-06-01,CHL,Kelantan,0,0,0
2021-06-01,CHL,Melaka,0,0,0
2021-06-01,CHL,Pahang,0,0,0
2021-06-01,CHL,Perak,0,0,0
2021-06-01,CHL,Perlis,0,0,0
2021-06-01,CHL,Pulau Pinang,0,0,0
2021-06-01,CHL,Sabah,0,0,0
2021-06-01,CHL,Sarawak,0,0,0
2021-06-01,CHL,Selangor,0,0,0
2021-06-01,CHN,Johor,6,5,1
2021-06-01,CHN,Kedah,0,0,0
2021-06-01,CHN,Kelantan,0,0,0
2021-06-01,CHN,Melaka,0,0,0
2021-06-01,CHN,Pahang,0,0,0
2021-06-01,CHN,Perak,0,0,0
2021-06-01,CHN,Perlis,0,0,0
2021-06-01,CHN,Pulau Pinang,2,1,1
2021-06-01,CHN,Sabah,0,0,0
2021-06-01,CHN,Sarawak,77,67,10
2021-06-01,CHN,Selangor,727,622,105
2021-06-01,CHN,Terengganu,0,0,0
2021-06-01,CHN,W.P. Labuan,0,0,0
2021-06-01,CIV,Johor,0,0,0
2021-06-01,CIV,Kedah,0,0,0
2021-06-01,CIV,Pulau Pinang,0,0,0
2021-06-01,CIV,Sabah,0,0,0
2021-06-01,CIV,Sarawak,0,0,0
2021-06-01,CIV,Selangor,1,0,1
2021-06-01,CMR,Johor,0,0,0
2021-06-01,CMR,Kedah,0,0,0
2021-06-01,CMR,Pulau Pinang,0,0,0
2021-06-01,CMR,Sabah,0,0,0
2021-06-01,CMR,Sarawak,0,0,0
2021-06-01,CMR,Selangor,0,0,0
2021-06-01,COD,Johor,0,0,0
2021-06-01,COD,Pulau Pinang,0,0,0
2021-06-01,COD,Sarawak,0,0,0
2021-06-01,COD,Selangor,0,0,0
2021-06-01,COG,Johor,0,0,0
2021-06-01,COG,Kedah,0,0,0
2021-06-01,COG,Selangor,0,0,0
2021-06-01,COK,Selangor,0,0,0
2021-06-01,COL,Johor,0,0,0
2021-06-01,COL,Kedah,0,0,0
2021-06-01,COL,Perak,0,0,0
2021-06-01,COL,Pulau Pinang,0,0,0
2021-06-01,COL,Sabah,0,0,0
2021-06-01,COL,Sarawak,0,0,0
2021-06-01,COL,Selangor,1,1,0
2021-06-01,COL,W.P. Labuan,0,0,0
2021-06-01,COM,Johor,0,0,0
2021-06-01,COM,Kedah,0,0,0
2021-06-01,COM,Selangor,0,0,0
2021-06-01,CPV,Johor,0,0,0
2021-06-01,CPV,Kedah,0,0,0
2021-06-01,CPV,Pulau Pinang,0,0,0
2021-06-01,CPV,Sabah,0,0,0
2021-06-01,CPV,Selangor,0,0,0
2021-06-01,CRI,Johor,0,0,0
2021-06-01,CRI,Kedah,0,0,0
2021-06-01,CRI,Perak,0,0,0
2021-06-01,CRI,Perlis,0,0,0
2021-06-01,CRI,Pulau Pinang,0,0,0
2021-06-01,CRI,Sabah,0,0,0
2021-06-01,CRI,Sarawak,0,0,0
2021-06-01,CRI,Selangor,1,1,0
2021-06-01,CUB,Johor,0,0,0
2021-06-01,CUB,Kedah,0,0,0
2021-06-01,CUB,Perlis,0,0,0
2021-06-01,CUB,Pulau Pinang,0,0,0
2021-06-01,CUB,Sabah,0,0,0
2021-06-01,CUB,Sarawak,0,0,0
2021-06-01,CUB,Selangor,0,0,0
2021-06-01,CYP,Johor,0,0,0
2021-06-01,CYP,Kedah,0,0,0
2021-06-01,CYP,Perak,0,0,0
2021-06-01,CYP,Perlis,0,0,0
2021-06-01,CYP,Pulau Pinang,0,0,0
2021-06-01,CYP,Sabah,0,0,0
2021-06-01,CYP,Sarawak,0,0,0
2021-06-01,CYP,Selangor,0,0,0
2021-06-01,CZE,Johor,0,0,0
2021-06-01,CZE,Kedah,0,0,0
2021-06-01,CZE,Kelantan,0,0,0
2021-06-01,CZE,Melaka,0,0,0
2021-06-01,CZE,Negeri Sembilan,0,0,0
2021-06-01,CZE,Perak,0,0,0
2021-06-01,CZE,Perlis,0,0,0
2021-06-01,CZE,Pulau Pinang,0,0,0
2021-06-01,CZE,Sabah,0,0,0
2021-06-01,CZE,Sarawak,0,0,0
2021-06-01,CZE,Selangor,2,2,0
2021-06-01,CZE,W.P. Labuan,0,0,0
2021-06-01,DEU,Johor,0,0,0
2021-06-01,DEU,Kedah,0,0,0
2021-06-01,DEU,Kelantan,0,0,0
2021-06-01,DEU,Melaka,0,0,0
2021-06-01,DEU,Negeri Sembilan,0,0,0
2021-06-01,DEU,Pahang,0,0,0
2021-06-01,DEU,Perak,0,0,0
2021-06-01,DEU,Perlis,0,0,0
2021-06-01,DEU,Pulau Pinang,1,1,0
2021-06-01,DEU,Sabah,0,0,0
2021-06-01,DEU,Sarawak,0,0,0
2021-06-01,DEU,Selangor,50,45,5
2021-06-01,DEU,Terengganu,0,0,0
2021-06-01,DEU,W.P. Labuan,0,0,0
2021-06-01,DJI,Johor,0,0,0
2021-06-01,DJI,Selangor,1,0,1
2021-06-01,DMA,Johor,0,0,0
2021-06-01,DMA,Kedah,0,0,0
2021-06-01,DMA,Pulau Pinang,0,0,0
2021-06-01,DMA,Sabah,0,0,0
2021-06-01,DMA,Sarawak,0,0,0
2021-06-01,DMA,Selangor,0,0,0
2021-06-01,DMA,W.P. Labuan,0,0,0
2021-06-01,DNK,Johor,0,0,0
2021-06-01,DNK,Kedah,0,0,0
2021-06-01,DNK,Kelantan,0,0,0
2021-06-01,DNK,Melaka,0,0,0
2021-06-01,DNK,Negeri Sembilan,0,0,0
2021-06-01,DNK,Pahang,0,0,0
2021-06-01,DNK,Perak,0,0,0
2021-06-01,DNK,Perlis,0,0,0
2021-06-01,DNK,Pulau Pinang,0,0,0
2021-06-01,DNK,Sabah,0,0,0
2021-06-01,DNK,Sarawak,0,0,0
2021-06-01,DNK,Selangor,10,9,1
2021-06-01,DNK,W.P. Labuan,0,0,0
2021-06-01,DOM,Johor,0,0,0
2021-06-01,DOM,Kedah,0,0,0
2021-06-01,DOM,Perak,0,0,0
2021-06-01,DOM,Perlis,0,0,0
2021-06-01,DOM,Pulau Pinang,0,0,0
2021-06-01,DOM,Sabah,0,0,0
2021-06-01,DOM,Sarawak,0,0,0
2021-06-01,DOM,Selangor,0,0,0
2021-06-01,DZA,Johor,0,0,0
2021-06-01,DZA,Kedah,0,0,0
2021-06-01,DZA,Kelantan,0,0,0
2021-06-01,DZA,Melaka,0,0,0
2021-06-01,DZA,Perak,0,0,0
2021-06-01,DZA,Perlis,0,0,0
2021-06-01,DZA,Pulau Pinang,0,0,0
2021-06-01,DZA,Sabah,0,0,0
2021-06-01,DZA,Sarawak,0,0,0
2021-06-01,DZA,Selangor,11,7,4
2021-06-01,DZA,W.P. Labuan,0,0,0
2021-06-01,ECU,Johor,0,0,0
2021-06-01,ECU,Kedah,0,0,0
2021-06-01,ECU,Perak,0,0,0
2021-06-01,ECU,Perlis,0,0,0
2021-06-01,ECU,Pulau Pinang,0,0,0
2021-06-01,ECU,Sabah,0,0,0
2021-06-01,ECU,Sarawak,0,0,0
2021-06-01,ECU,Selangor,0,0,0
2021-06-01,EGY,Johor,0,0,0
2021-06-01,EGY,Kedah,0,0,0
2021-06-01,EGY,Kelantan,0,0,0
2021-06-01,EGY,Melaka,0,0,0
2021-06-01,EGY,Pahang,0,0,0
2021-06-01,EGY,Perak,0,0,0
2021-06-01,EGY,Perlis,0,0,0
2021-06-01,EGY,Pulau Pinang,0,0,0
2021-06-01,EGY,Sabah,0,0,0
2021-06-01,EGY,Sarawak,0,0,0
2021-06-01,EGY,Selangor,50,36,14
2021-06-01,EGY,Terengganu,0,0,0
2021-06-01,EGY,W.P. Labuan,0,0,0
2021-06-01,ERI,Johor,0,0,0
2021-06-01,ERI,Pulau Pinang,0,0,0
2021-06-01,ERI,Sabah,0,0,0
2021-06-01,ERI,Selangor,0,0,0
2021-06-01,ESP,Johor,0,0,0
2021-06-01,ESP,Kedah,0,0,0
2021-06-01,ESP,Kelantan,0,0,0
2021-06-01,ESP,Melaka,0,0,0
2021-06-01,ESP,Negeri Sembilan,0,0,0
2021-06-01,ESP,Pahang,0,0,0
2021-06-01,ESP,Perak,0,0,0
2021-06-01,ESP,Perlis,0,0,0
2021-06-01,ESP,Pulau Pinang,0,0,0
2021-06-01,ESP,Sabah,0,0,0
2021-06-01,ESP,Sarawak,0,0,0
2021-06-01,ESP,Selangor,14,12,2
2021-06-01,ESP,W.P. Labuan,0,0,0
2021-06-01,EST,Johor,0,0,0
2021-06-01,EST,Kedah,0,0,0
2021-06-01,EST,Kelantan,0,0,0
2021-06-01,EST,Pahang,0,0,0
2021-06-01,EST,Perak,0,0,0
2021-06-01,EST,Perlis,0,0,0
2021-06-01,EST,Pulau Pinang,0,0,0
2021-06-01,EST,Sabah,0,0,0
2021-06-01,EST,Sarawak,0,0,0
2021-06-01,EST,Selangor,1,1,0
2021-06-01,EST,W.P. Labuan,0,0,0
2021-06-01,ETH,Johor,0,0,0
2021-06-01,ETH,Kedah,0,0,0
2021-06-01,ETH,Pulau Pinang,0,0,0
2021-06-01,ETH,Sarawak,0,0,0
2021-06-01,ETH,Selangor,4,2,2
2021-06-01,FIN,Johor,0,0,0
2021-06-01,FIN,Kedah,0,0,0
2021-06-01,FIN,Kelantan,0,0,0
2021-06-01,FIN,Melaka,0,0,0
2021-06-01,FIN,Negeri Sembilan,0,0,0
2021-06-01,FIN,Pahang,0,0,0
2021-06-01,FIN,Perak,0,0,0
2021-06-01,FIN,Perlis,0,0,0
2021-06-01,FIN,Pulau Pinang,0,0,0
2021-06-01,FIN,Sabah,0,0,0
2021-06-01,FIN,Sarawak,0,0,0
2021-06-01,FIN,Selangor,7,5,2
2021-06-01,FIN,W.P. Labuan,0,0,0
2021-06-01,FJI,Johor,0,0,0
2021-06-01,FJI,Kedah,0,0,0
2021-06-01,FJI,Kelantan,0,0,0
2021-06-01,FJI,Perak,0,0,0
2021-06-01,FJI,Perlis,0,0,0
2021-06-01,FJI,Pulau Pinang,0,0,0
2021-06-01,FJI,Sabah,0,0,0
2021-06-01,FJI,Sarawak,0,0,0
2021-06-01,FJI,Selangor,0,0,0
2021-06-01,FRA,Johor,0,0,0
2021-06-01,FRA,Kedah,0,0,0
2021-06-01,FRA,Kelantan,0,0,0
2021-06-01,FRA,Melaka,0,0,0
2021-06-01,FRA,Negeri Sembilan,0,0,0
2021-06-01,FRA,Pahang,0,0,0
2021-06-01,FRA,Perak,0,0,0
2021-06-01,FRA,Perlis,0,0,0
2021-06-01,FRA,Pulau Pinang,0,0,0
2021-06-01,FRA,Sabah,0,0,0
2021-06-01,FRA,Sarawak,0,0,0
2021-06-01,FRA,Selangor,50,41,9
2021-06-01,FRA,Terengganu,0,0,0
2021-06-01,FRA,W.P. Labuan,0,0,0
2021-06-01,FSM,Johor,0,0,0
2021-06-01,FSM,Pulau Pinang,0,0,0
2021-06-01,FSM,Selangor,0,0,0
2021-06-01,GAB,Johor,0,0,0
2021-06-01,GAB,Pulau Pinang,0,0,0
2021-06-01,GAB,Sarawak,0,0,0
2021-06-01,GAB,Selangor,0,0,0
2021-06-01,GBR,Johor,3,3,0
2021-06-01,GBR,Kedah,2,1,1
2021-06-01,GBR,Kelantan,0,0,0
2021-06-01,GBR,Melaka,0,0,0
2021-06-01,GBR,Negeri Sembilan,0,0,0
2021-06-01,GBR,Pahang,0,0,0
2021-06-01,GBR,Perak,0,0,0
2021-06-01,GBR,Perlis,0,0,0
2021-06-01,GBR,Pulau Pinang,0,0,0
2021-06-01,GBR,Sabah,0,0,0
2021-06-01,GBR,Sarawak,2,2,0
2021-06-01,GBR,Selangor,142,112,30
2021-06-01,GBR,Terengganu,0,0,0
2021-06-01,GBR,W.P. Labuan,0,0,0
2021-06-01,GEO,Johor,0,0,0
2021-06-01,GEO,Kedah,0,0,0
2021-06-01,GEO,Melaka,0,0,0
2021-06-01,GEO,Perak,0,0,0
2021-06-01,GEO,Perlis,0,0,0
2021-06-01,GEO,Pulau Pinang,0,0,0
2021-06-01,GEO,Sabah,0,0,0
2021-06-01,GEO,Sarawak,0,0,0
2021-06-01,GEO,Selangor,5,5,0
2021-06-01,GHA,Johor,0,0,0
2021-06-01,GHA,Kedah,0,0,0
2021-06-01,GHA,Kelantan,0,0,0
2021-06-01,GHA,Pulau Pinang,0,0,0
2021-06-01,GHA,Sabah,0,0,0
2021-06-01,GHA,Sarawak,0,0,0
2021-06-01,GHA,Selangor,7,6,1
2021-06-01,GIB,Johor,0,0,0
2021-06-01,GIB,Sarawak,0,0,0
2021-06-01,GIN,Johor,0,0,0
2021-06-01,GIN,Kedah,0,0,0
2021-06-01,GIN,Kelantan,0,0,0
2021-06-01,GIN,Perlis,0,0,0
2021-06-01,GIN,Pulau Pinang,0,0,0
2021-06-01,GIN,Sabah,0,0,0
2021-06-01,GIN,Sarawak,0,0,0
2021-06-01,GIN,Selangor,5,4,1
2021-06-01,GLP,Selangor,0,0,0
2021-06-01,GMB,Johor,0,0,0
2021-06-01,GMB,Kedah,0,0,0
2021-06-01,GMB,Kelantan,0,0,0
2021-06-01,GMB,Pulau Pinang,0,0,0
2021-06-01,GMB,Sabah,0,0,0
2021-06-01,GMB,Sarawak,0,0,0
2021-06-01,GMB,Selangor,1,1,0
2021-06-01,GNB,Johor,0,0,0
2021-06-01,GNB,Selangor,0,0,0
2021-06-01,GNQ,Johor,0,0,0
2021-06-01,GNQ,Selangor,1,0,1
2021-06-01,GRC,Johor,0,0,0
2021-06-01,GRC,Kedah,0,0,0
2021-06-01,GRC,Kelantan,0,0,0
2021-06-01,GRC,Melaka,0,0,0
2021-06-01,GRC,Negeri Sembilan,0,0,0
2021-06-01,GRC,Pahang,0,0,0
2021-06-01,GRC,Perak,0,0,0
2021-06-01,GRC,Perlis,0,0,0
2021-06-01,GRC,Pulau Pinang,0,0,0
2021-06-01,GRC,Sabah,0,0,0
2021-06-01,GRC,Sarawak,0,0,0
2021-06-01,GRC,Selangor,5,4,1
2021-06-01,GRD,Johor,0,0,0
2021-06-01,GRD,Kedah,0,0,0
2021-06-01,GRD,Pulau Pinang,0,0,0
2021-06-01,GRD,Sabah,0,0,0
2021-06-01,GRD,Sarawak,0,0,0
2021-06-01,GRD,Selangor,1,1,0
2021-06-01,GRL,Johor,0,0,0
2021-06-01,GRL,Selangor,0,0,0
2021-06-01,GTM,Johor,0,0,0
2021-06-01,GTM,Kedah,0,0,0
2021-06-01,GTM,Pahang,0,0,0
2021-06-01,GTM,Perak,0,0,0
2021-06-01,GTM,Pulau Pinang,0,0,0
2021-06-01,GTM,Sabah,0,0,0
2021-06-01,GTM,Sarawak,0,0,0
2021-06-01,GTM,Selangor,1,1,0
2021-06-01,GTM,W.P. Labuan,0,0,0
2021-06-01,GUY,Johor,0,0,0
2021-06-01,GUY,Kedah,0,0,0
2021-06-01,GUY,Pulau Pinang,0,0,0
2021-06-01,GUY,Sarawak,0,0,0
2021-06-01,GUY,Selangor,0,0,0
2021-06-01,HKG,Johor,0,0,0
2021-06-01,HKG,Kedah,0,0,0
2021-06-01,HKG,Kelantan,0,0,0
2021-06-01,HKG,Pahang,0,0,0
2021-06-01,HKG,Perak,0,0,0
2021-06-01,HKG,Perlis,0,0,0
2021-06-01,HKG,Pulau Pinang,0,0,0
2021-06-01,HKG,Sabah,0,0,0
2021-06-01,HKG,Sarawak,0,0,0
2021-06-01,HKG,Selangor,0,0,0
2021-06-01,HKG,Terengganu,0,0,0
2021-06-01,HMD,Johor,0,0,0
2021-06-01,HND,Johor,0,0,0
2021-06-01,HND,Kedah,0,0,0
2021-06-01,HND,Perak,0,0,0
2021-06-01,HND,Pulau Pinang,0,0,0
2021-06-01,HND,Sabah,0,0,0
2021-06-01,HND,Sarawak,0,0,0
2021-06-01,HND,Selangor,2,2,0
2021-06-01,HRV,Johor,0,0,0
2021-06-01,HRV,Kedah,0,0,0
2021-06-01,HRV,Kelantan,0,0,0
2021-06-01,HRV,Melaka,0,0,0
2021-06-01,HRV,Pahang,0,0,0
2021-06-01,HRV,Perak,0,0,0
2021-06-01,HRV,Perlis,0,0,0
2021-06-01,HRV,Pulau Pinang,0,0,0
2021-06-01,HRV,Sabah,0,0,0
2021-06-01,HRV,Sarawak,0,0,0
2021-06-01,HRV,Selangor,21,21,0
2021-06-01,HTI,Johor,0,0,0
2021-06-01,HTI,Kedah,0,0,0
2021-06-01,HTI,Kelantan,0,0,0
2021-06-01,HTI,Perak,0,0,0
2021-06-01,HTI,Pulau Pinang,0,0,0
2021-06-01,HTI,Sabah,0,0,0
2021-06-01,HTI,Selangor,0,0,0
2021-06-01,HUN,Johor,0,0,0
2021-06-01,HUN,Kedah,0,0,0
2021-06-01,HUN,Kelantan,0,0,0
2021-06-01,HUN,Pahang,0,0,0
2021-06-01,HUN,Perak,0,0,0
2021-06-01,HUN,Perlis,0,0,0
2021-06-01,HUN,Pulau Pinang,0,0,0
2021-06-01,HUN,Sabah,0,0,0
2021-06-01,HUN,Sarawak,0,0,0
2021-06-01,HUN,Selangor,4,3,1
2021-06-01,HUN,W.P. Labuan,0,0,0
2021-06-01,IDN,Johor,39,33,6
2021-06-01,IDN,Kedah,4,4,0
2021-06-01,IDN,Kelantan,0,0,0
2021-06-01,IDN,Melaka,0,0,0
2021-06-01,IDN,Negeri Sembilan,0,0,0
2021-06-01,IDN,Pahang,0,0,0
2021-06-01,IDN,Perak,0,0,0
2021-06-01,IDN,Perlis,2,2,0
2021-06-01,IDN,Pulau Pinang,7,5,2
2021-06-01,IDN,Sabah,1,1,0
2021-06-01,IDN,Sarawak,334,330,4
2021-06-01,IDN,Selangor,518,377,141
2021-06-01,IDN,Terengganu,0,0,0
2021-06-01,IDN,W.P. Labuan,0,0,0
2021-06-01,IND,Johor,0,0,0
2021-06-01,IND,Kedah,0,0,0
2021-06-01,IND,Kelantan,0,0,0
2021-06-01,IND,Melaka,0,0,0
2021-06-01,IND,Negeri Sembilan,0,0,0
2021-06-01,IND,Pahang,0,0,0
2021-06-01,IND,Perak,0,0,0
2021-06-01,IND,Perlis,0,0,0
2021-06-01,IND,Pulau Pinang,0,0,0
2021-06-01,IND,Sabah,0,0,0
2021-06-01,IND,Sarawak,0,0,0
2021-06-01,IND,Selangor,29,19,10
2021-06-01,IND,Terengganu,0,0,0
2021-06-01,IND,W.P. Labuan,0,0,0
2021-06-01,IOT,Pulau Pinang,0,0,0
2021-06-01,IOT,Selangor,0,0,0
2021-06-01,IRL,Johor,0,0,0
2021-06-01,IRL,Kedah,0,0,0
2021-06-01,IRL,Kelantan,0,0,0
2021-06-01,IRL,Negeri Sembilan,0,0,0
2021-06-01,IRL,Pahang,0,0,0
2021-06-01,IRL,Perak,0,0,0
2021-06-01,IRL,Perlis,0,0,0
2021-06-01,IRL,Pulau Pinang,0,0,0
2021-06-01,IRL,Sabah,0,0,0
2021-06-01,IRL,Sarawak,0,0,0
2021-06-01,IRL,Selangor,6,4,2
2021-06-01,IRL,Terengganu,0,0,0
2021-06-01,IRL,W.P. Labuan,0,0,0
2021-06-01,IRN,Johor,0,0,0
2021-06-01,IRN,Kedah,0,0,0
2021-06-01,IRN,Kelantan,0,0,0
2021-06-01,IRN,Perak,0,0,0
2021-06-01,IRN,Perlis,0,0,0
2021-06-01,IRN,Pulau Pinang,0,0,0
2021-06-01,IRN,Sabah,0,0,0
2021-06-01,IRN,Sarawak,0,0,0
2021-06-01,IRN,Selangor,15,10,5
2021-06-01,IRN,W.P. Labuan,0,0,0
2021-06-01,IRQ,Johor,0,0,0
2021-06-01,IRQ,Kedah,0,0,0
2021-06-01,IRQ,Kelantan,0,0,0
2021-06-01,IRQ,Melaka,0,0,0
2021-06-01,IRQ,Pahang,0,0,0
2021-06-01,IRQ,Perak,0,0,0
2021-06-01,IRQ,Perlis,0,0,0
2021-06-01,IRQ,Pulau Pinang,0,0,0
2021-06-01,IRQ,Sabah,0,0,0
2021-06-01,IRQ,Sarawak,0,0,0
2021-06-01,IRQ,Selangor,25,15,10
2021-06-01,ISL,Johor,0,0,0
2021-06-01,ISL,Kedah,0,0,0
2021-06-01,ISL,Kelantan,0,0,0
2021-06-01,ISL,Perak,0,0,0
2021-06-01,ISL,Perlis,0,0,0
2021-06-01,ISL,Pulau Pinang,0,0,0
2021-06-01,ISL,Sabah,0,0,0
2021-06-01,ISL,Sarawak,0,0,0
2021-06-01,ISL,Selangor,0,0,0
2021-06-01,ISL,W.P. Labuan,0,0,0
2021-06-01,ISR,Pulau Pinang,0,0,0
2021-06-01,ITA,Johor,0,0,0
2021-06-01,ITA,Kedah,0,0,0
2021-06-01,ITA,Kelantan,0,0,0
2021-06-01,ITA,Melaka,0,0,0
2021-06-01,ITA,Negeri Sembilan,0,0,0
2021-06-01,ITA,Pahang,0,0,0
2021-06-01,ITA,Perak,0,0,0
2021-06-01,ITA,Perlis,0,0,0
2021-06-01,ITA,Pulau Pinang,0,0,0
2021-06-01,ITA,Sabah,0,0,0
2021-06-01,ITA,Sarawak,0,0,0
2021-06-01,ITA,Selangor,31,29,2
2021-06-01,ITA,W.P. Labuan,0,0,0
2021-06-01,JAM,Johor,0,0,0
2021-06-01,JAM,Kedah,0,0,0
2021-06-01,JAM,Perak,0,0,0
2021-06-01,JAM,Pulau Pinang,0,0,0
2021-06-01,JAM,Sabah,0,0,0
2021-06-01,JAM,Sarawak,0,0,0
2021-06-01,JAM,Selangor,0,0,0
2021-06-01,JAM,W.P. Labuan,0,0,0
2021-06-01,JOR,Johor,0,0,0
2021-06-01,JOR,Kedah,0,0,0
2021-06-01,JOR,Kelantan,0,0,0
2021-06-01,JOR,Melaka,0,0,0
2021-06-01,JOR,Perlis,0,0,0
2021-06-01,JOR,Pulau Pinang,0,0,0
2021-06-01,JOR,Sabah,0,0,0
2021-06-01,JOR,Sarawak,0,0,0
2021-06-01,JOR,Selangor,13,11,2
2021-06-01,JOR,W.P. Labuan,0,0,0
2021-06-01,JPN,Johor,0,0,0
2021-06-01,JPN,Kedah,0,0,0
2021-06-01,JPN,Kelantan,0,0,0
2021-06-01,JPN,Melaka,0,0,0
2021-06-01,JPN,Negeri Sembilan,0,0,0
2021-06-01,JPN,Pahang,0,0,0
2021-06-01,JPN,Perak,0,0,0
2021-06-01,JPN,Perlis,0,0,0
2021-06-01,JPN,Pulau Pinang,13,12,1
2021-06-01,JPN,Sabah,0,0,0
2021-06-01,JPN,Sarawak,2,1,1
2021-06-01,JPN,Selangor,297,195,102
2021-06-01,JPN,W.P. Labuan,0,0,0
2021-06-01,KAZ,Johor,0,0,0
2021-06-01,KAZ,Kedah,0,0,0
2021-06-01,KAZ,Kelantan,0,0,0
2021-06-01,KAZ,Melaka,0,0,0
2021-06-01,KAZ,Perak,0,0,0
2021-06-01,KAZ,Perlis,0,0,0
2021-06-01,KAZ,Pulau Pinang,0,0,0
2021-06-01,KAZ,Sabah,0,0,0
2021-06-01,KAZ,Sarawak,0,0,0
2021-06-01,KAZ,Selangor,28,21,7
2021-06-01,KAZ,W.P. Labuan,0,0,0
2021-06-01,KEN,Johor,0,0,0
2021-06-01,KEN,Kedah,0,0,0
2021-06-01,KEN,Kelantan,0,0,0
2021-06-01,KEN,Perak,0,0,0
2021-06-01,KEN,Perlis,0,0,0
2021-06-01,KEN,Pulau Pinang,0,0,0
2021-06-01,KEN,Sabah,0,0,0
2021-06-01,KEN,Sarawak,0,0,0
2021-06-01,KEN,Selangor,6,4,2
2021-06-01,KGZ,Johor,0,0,0
2021-06-01,KGZ,Kedah,0,0,0
2021-06-01,KGZ,Kelantan,0,0,0
2021-06-01,KGZ,Perak,0,0,0
2021-06-01,KGZ,Perlis,0,0,0
2021-06-01,KGZ,Pulau Pinang,0,0,0
2021-06-01,KGZ,Sabah,0,0,0
2021-06-01,KGZ,Sarawak,0,0,0
2021-06-01,KGZ,Selangor,3,2,1
2021-06-01,KHM,Johor,0,0,0
2021-06-01,KHM,Kedah,0,0,0
2021-06-01,KHM,Kelantan,0,0,0
2021-06-01,KHM,Melaka,0,0,0
2021-06-01,KHM,Negeri Sembilan,0,0,0
2021-06-01,KHM,Pahang,0,0,0
2021-06-01,KHM,Perak,0,0,0
2021-06-01,KHM,Perlis,0,0,0
2021-06-01,KHM,Pulau Pinang,0,0,0
2021-06-01,KHM,Sabah,0,0,0
2021-06-01,KHM,Sarawak,0,0,0
2021-06-01,KHM,Selangor,9,9,0
2021-06-01,KHM,W.P. Labuan,0,0,0
2021-06-01,KIR,Johor,0,0,0
2021-06-01,KIR,Sabah,0,0,0
2021-06-01,KIR,Selangor,5,5,0
2021-06-01,KNA,Johor,0,0,0
2021-06-01,KNA,Kedah,0,0,0
2021-06-01,KNA,Perlis,0,0,0
2021-06-01,KNA,Pulau Pinang,0,0,0
2021-06-01,KNA,Sabah,0,0,0
2021-06-01,KNA,Selangor,0,0,0
2021-06-01,KNA,W.P. Labuan,0,0,0
2021-06-01,KOR,Johor,0,0,0
2021-06-01,KOR,Kedah,0,0,0
2021-06-01,KOR,Kelantan,0,0,0
2021-06-01,KOR,Melaka,0,0,0
2021-06-01,KOR,Negeri Sembilan,0,0,0
2021-06-01,KOR,Pahang,0,0,0
2021-06-01,KOR,Perak,0,0,0
2021-06-01,KOR,Perlis,0,0,0
2021-06-01,KOR,Pulau Pinang,0,0,0
2021-06-01,KOR,Sabah,0,0,0
2021-06-01,KOR,Sarawak,15,12,3
2021-06-01,KOR,Selangor,199,151,48
2021-06-01,KOR,Terengganu,0,0,0
2021-06-01,KOR,W.P. Labuan,0,0,0
2021-06-01,KWT,Johor,0,0,0
2021-06-01,KWT,Kedah,0,0,0
2021-06-01,KWT,Kelantan,0,0,0
2021-06-01,KWT,Perak,0,0,0
2021-06-01,KWT,Perlis,0,0,0
2021-06-01,KWT,Pulau Pinang,0,0,0
2021-06-01,KWT,Sabah,0,0,0
2021-06-01,KWT,Sarawak,0,0,0
2021-06-01,KWT,Selangor,2,2,0
2021-06-01,KWT,W.P. Labuan,0,0,0
2021-06-01,LAO,Johor,0,0,0
2021-06-01,LAO,Kedah,0,0,0
2021-06-01,LAO,Kelantan,0,0,0
2021-06-01,LAO,Melaka,0,0,0
2021-06-01,LAO,Perak,0,0,0
2021-06-01,LAO,Perlis,0,0,0
2021-06-01,LAO,Pulau Pinang,0,0,0
2021-06-01,LAO,Sabah,0,0,0
2021-06-01,LAO,Sarawak,0,0,0
2021-06-01,LAO,Selangor,86,85,1
2021-06-01,LAO,W.P. Labuan,0,0,0
2021-06-01,LBN,Johor,0,0,0
2021-06-01,LBN,Kedah,0,0,0
2021-06-01,LBN,Kelantan,0,0,0
2021-06-01,LBN,Pahang,0,0,0
2021-06-01,LBN,Perak,0,0,0
2021-06-01,LBN,Perlis,0,0,0
2021-06-01,LBN,Pulau Pinang,0,0,0
2021-06-01,LBN,Sabah,0,0,0
2021-06-01,LBN,Sarawak,0,0,0
2021-06-01,LBN,Selangor,4,2,2
2021-06-01,LBN,W.P. Labuan,0,0,0
2021-06-01,LBR,Johor,0,0,0
2021-06-01,LBR,Kedah,0,0,0
2021-06-01,LBR,Sabah,0,0,0
2021-06-01,LBR,Sarawak,0,0,0
2021-06-01,LBR,Selangor,0,0,0
2021-06-01,LBY,Johor,0,0,0
2021-06-01,LBY,Kedah,0,0,0
2021-06-01,LBY,Perlis,0,0,0
2021-06-01,LBY,Pulau Pinang,0,0,0
2021-06-01,LBY,Sabah,0,0,0
2021-06-01,LBY,Sarawak,0,0,0
2021-06-01,LBY,Selangor,26,18,8
2021-06-01,LCA,Johor,0,0,0
2021-06-01,LCA,Kedah,0,0,0
2021-06-01,LCA,Pulau Pinang,0,0,0
2021-06-01,LCA,Sarawak,0,0,0
2021-06-01,LCA,Selangor,0,0,0
2021-06-01,LIE,Johor,0,0,0
2021-06-01,LIE,Kedah,0,0,0
2021-06-01,LIE,Perlis,0,0,0
2021-06-01,LIE,Pulau Pinang,0,0,0
2021-06-01,LIE,Sabah,0,0,0
2021-06-01,LIE,Sarawak,0,0,0
2021-06-01,LIE,Selangor,0,0,0
2021-06-01,LKA,Johor,0,0,0
2021-06-01,LKA,Kedah,0,0,0
2021-06-01,LKA,Kelantan,0,0,0
2021-06-01,LKA,Melaka,0,0,0
2021-06-01,LKA,Pahang,0,0,0
2021-06-01,LKA,Perak,0,0,0
2021-06-01,LKA,Perlis,0,0,0
2021-06-01,LKA,Pulau Pinang,0,0,0
2021-06-01,LKA,Sabah,0,0,0
2021-06-01,LKA,Sarawak,0,0,0
2021-06-01,LKA,Selangor,3,2,1
2021-06-01,LKA,W.P. Labuan,0,0,0
2021-06-01,LSO,Johor,0,0,0
2021-06-01,LSO,Kedah,0,0,0
2021-06-01,LSO,Pulau Pinang,0,0,0
2021-06-01,LSO,Sarawak,0,0,0
2021-06-01,LSO,Selangor,0,0,0
2021-06-01,LTU,Johor,0,0,0
2021-06-01,LTU,Kedah,0,0,0
2021-06-01,LTU,Kelantan,0,0,0
2021-06-01,LTU,Pahang,0,0,0
2021-06-01,LTU,Perak,0,0,0
2021-06-01,LTU,Perlis,0,0,0
2021-06-01,LTU,Pulau Pinang,0,0,0
2021-06-01,LTU,Sabah,0,0,0
2021-06-01,LTU,Sarawak,0,0,0
2021-06-01,LTU,Selangor,1,0,1
2021-06-01,LTU,W.P. Labuan,0,0,0
2021-06-01,LUX,Johor,0,0,0
2021-06-01,LUX,Kedah,0,0,0
2021-06-01,LUX,Kelantan,0,0,0
2021-06-01,LUX,Perak,0,0,0
2021-06-01,LUX,Perlis,0,0,0
2021-06-01,LUX,Pulau Pinang,0,0,0
2021-06-01,LUX,Sabah,0,0,0
2021-06-01,LUX,Sarawak,0,0,0
2021-06-01,LUX,Selangor,0,0,0
2021-06-01,LVA,Johor,0,0,0
2021-06-01,LVA,Kedah,0,0,0
2021-06-01,LVA,Kelantan,0,0,0
2021-06-01,LVA,Pahang,0,0,0
2021-06-01,LVA,Perak,0,0,0
2021-06-01,LVA,Perlis,0,0,0
2021-06-01,LVA,Pulau Pinang,0,0,0
2021-06-01,LVA,Sabah,0,0,0
2021-06-01,LVA,Sarawak,0,0,0
2021-06-01,LVA,Selangor,2,2,0
2021-06-01,LVA,W.P. Labuan,0,0,0
2021-06-01,MAC,Johor,0,0,0
2021-06-01,MAC,Pahang,0,0,0
2021-06-01,MAC,Perak,0,0,0
2021-06-01,MAC,Selangor,0,0,0
2021-06-01,MAC,W.P. Labuan,0,0,0
2021-06-01,MAR,Johor,0,0,0
2021-06-01,MAR,Kedah,0,0,0
2021-06-01,MAR,Kelantan,0,0,0
2021-06-01,MAR,Melaka,0,0,0
2021-06-01,MAR,Pahang,0,0,0
2021-06-01,MAR,Perak,0,0,0
2021-06-01,MAR,Perlis,0,0,0
2021-06-01,MAR,Pulau Pinang,0,0,0
2021-06-01,MAR,Sabah,0,0,0
2021-06-01,MAR,Sarawak,0,0,0
2021-06-01,MAR,Selangor,6,3,3
2021-06-01,MAR,W.P. Labuan,0,0,0
2021-06-01,MCO,Johor,0,0,0
2021-06-01,MCO,Kedah,0,0,0
2021-06-01,MCO,Sabah,0,0,0
2021-06-01,MCO,Selangor,0,0,0
2021-06-01,MDA,Johor,0,0,0
2021-06-01,MDA,Kedah,0,0,0
2021-06-01,MDA,Kelantan,0,0,0
2021-06-01,MDA,Negeri Sembilan,0,0,0
2021-06-01,MDA,Perlis,0,0,0
2021-06-01,MDA,Pulau Pinang,0,0,0
2021-06-01,MDA,Sabah,0,0,0
2021-06-01,MDA,Sarawak,0,0,0
2021-06-01,MDA,Selangor,0,0,0
2021-06-01,MDG,Johor,0,0,0
2021-06-01,MDG,Kedah,0,0,0
2021-06-01,MDG,Perak,0,0,0
2021-06-01,MDG,Perlis,0,0,0
2021-06-01,MDG,Pulau Pinang,0,0,0
2021-06-01,MDG,Sabah,0,0,0
2021-06-01,MDG,Sarawak,0,0,0
2021-06-01,MDG,Selangor,0,0,0
2021-06-01,MDV,Johor,0,0,0
2021-06-01,MDV,Kedah,0,0,0
2021-06-01,MDV,Kelantan,0,0,0
2021-06-01,MDV,Perak,0,0,0
2021-06-01,MDV,Perlis,0,0,0
2021-06-01,MDV,Pulau Pinang,0,0,0
2021-06-01,MDV,Sabah,0,0,0
2021-06-01,MDV,Sarawak,0,0,0
2021-06-01,MDV,Selangor,24,12,12
2021-06-01,MEX,Johor,0,0,0
2021-06-01,MEX,Kedah,0,0,0
2021-06-01,MEX,Kelantan,0,0,0
2021-06-01,MEX,Pahang,0,0,0
2021-06-01,MEX,Perak,0,0,0
2021-06-01,MEX,Perlis,0,0,0
2021-06-01,MEX,Pulau Pinang,0,0,0
2021-06-01,MEX,Sabah,0,0,0
2021-06-01,MEX,Sarawak,0,0,0
2021-06-01,MEX,Selangor,10,8,2
2021-06-01,MEX,W.P. Labuan,0,0,0
2021-06-01,MHL,Johor,0,0,0
2021-06-01,MHL,Kedah,0,0,0
2021-06-01,MHL,Perak,0,0,0
2021-06-01,MHL,Pulau Pinang,0,0,0
2021-06-01,MHL,Sabah,0,0,0
2021-06-01,MHL,Selangor,0,0,0
2021-06-01,MKD,Johor,0,0,0
2021-06-01,MKD,Kedah,0,0,0
2021-06-01,MKD,Perak,0,0,0
2021-06-01,MKD,Pulau Pinang,0,0,0
2021-06-01,MKD,Sabah,0,0,0
2021-06-01,MKD,Sarawak,0,0,0
2021-06-01,MKD,Selangor,0,0,0
2021-06-01,MLI,Johor,0,0,0
2021-06-01,MLI,Sabah,0,0,0
2021-06-01,MLI,Selangor,0,0,0
2021-06-01,MLT,Johor,0,0,0
2021-06-01,MLT,Kedah,0,0,0
2021-06-01,MLT,Kelantan,0,0,0
2021-06-01,MLT,Perak,0,0,0
2021-06-01,MLT,Perlis,0,0,0
2021-06-01,MLT,Pulau Pinang,0,0,0
2021-06-01,MLT,Sabah,0,0,0
2021-06-01,MLT,Sarawak,0,0,0
2021-06-01,MLT,Selangor,1,1,0
2021-06-01,MLT,W.P. Labuan,0,0,0
2021-06-01,MMR,Johor,2,2,0
2021-06-01,MMR,Kedah,0,0,0
2021-06-01,MMR,Kelantan,0,0,0
2021-06-01,MMR,Negeri Sembilan,0,0,0
2021-06-01,MMR,Pahang,0,0,0
2021-06-01,MMR,Perak,0,0,0
2021-06-01,MMR,Perlis,0,0,0
2021-06-01,MMR,Pulau Pinang,1,0,1
2021-06-01,MMR,Sabah,0,0,0
2021-06-01,MMR,Sarawak,0,0,0
2021-06-01,MMR,Selangor,77,65,12
2021-06-01,MMR,Terengganu,0,0,0
2021-06-01,MMR,W.P. Labuan,0,0,0
2021-06-01,MNE,Johor,0,0,0
2021-06-01,MNE,Kedah,0,0,0
2021-06-01,MNE,Pulau Pinang,0,0,0
2021-06-01,MNE,Sabah,0,0,0
2021-06-01,MNE,Sarawak,0,0,0
2021-06-01,MNE,Selangor,3,3,0
2021-06-01,MNG,Johor,0,0,0
2021-06-01,MNG,Kedah,0,0,0
2021-06-01,MNG,Kelantan,0,0,0
2021-06-01,MNG,Perak,0,0,0
2021-06-01,MNG,Perlis,0,0,0
2021-06-01,MNG,Pulau Pinang,0,0,0
2021-06-01,MNG,Sabah,0,0,0
2021-06-01,MNG,Sarawak,0,0,0
2021-06-01,MNG,Selangor,1,0,1
2021-06-01,MNP,Selangor,0,0,0
2021-06-01,MOZ,Johor,0,0,0
2021-06-01,MOZ,Kedah,0,0,0
2021-06-01,MOZ,Perak,0,0,0
2021-06-01,MOZ,Pulau Pinang,0,0,0
2021-06-01,MOZ,Sabah,0,0,0
2021-06-01,MOZ,Sarawak,0,0,0
2021-06-01,MOZ,Selangor,6,3,3
2021-06-01,MRT,Johor,0,0,0
2021-06-01,MRT,Kedah,0,0,0
2021-06-01,MRT,Pulau Pinang,0,0,0
2021-06-01,MRT,Sabah,0,0,0
2021-06-01,MRT,Sarawak,0,0,0
2021-06-01,MRT,Selangor,0,0,0
2021-06-01,MUS,Johor,0,0,0
2021-06-01,MUS,Kedah,0,0,0
2021-06-01,MUS,Kelantan,0,0,0
2021-06-01,MUS,Pahang,0,0,0
2021-06-01,MUS,Perak,0,0,0
2021-06-01,MUS,Perlis,0,0,0
2021-06-01,MUS,Pulau Pinang,0,0,0
2021-06-01,MUS,Sabah,0,0,0
2021-06-01,MUS,Sarawak,0,0,0
2021-06-01,MUS,Selangor,7,3,4
2021-06-01,MWI,Johor,0,0,0
2021-06-01,MWI,Pulau Pinang,0,0,0
2021-06-01,MWI,Sabah,0,0,0
2021-06-01,MWI,Sarawak,0,0,0
2021-06-01,MWI,Selangor,1,0,1
2021-06-01,MYT,Selangor,0,0,0
2021-06-01,NAM,Johor,0,0,0
2021-06-01,NAM,Kedah,0,0,0
2021-06-01,NAM,Perak,0,0,0
2021-06-01,NAM,Perlis,0,0,0
2021-06-01,NAM,Pulau Pinang,0,0,0
2021-06-01,NAM,Sabah,0,0,0
2021-06-01,NAM,Sarawak,0,0,0
2021-06-01,NAM,Selangor,2,1,1
2021-06-01,NCL,Selangor,0,0,0
2021-06-01,NER,Johor,0,0,0
2021-06-01,NER,Sabah,0,0,0
2021-06-01,NER,Selangor,0,0,0
2021-06-01,NGA,Johor,0,0,0
2021-06-01,NGA,Kedah,0,0,0
2021-06-01,NGA,Perlis,0,0,0
2021-06-01,NGA,Pulau Pinang,0,0,0
2021-06-01,NGA,Sabah,0,0,0
2021-06-01,NGA,Sarawak,0,0,0
2021-06-01,NGA,Selangor,93,81,12
2021-06-01,NIC,Johor,0,0,0
2021-06-01,NIC,Kedah,0,0,0
2021-06-01,NIC,Pulau Pinang,0,0,0
2021-06-01,NIC,Sabah,0,0,0
2021-06-01,NIC,Selangor,0,0,0
2021-06-01,NLD,Johor,0,0,0
2021-06-01,NLD,Kedah,0,0,0
2021-06-01,NLD,Kelantan,0,0,0
2021-06-01,NLD,Melaka,0,0,0
2021-06-01,NLD,Negeri Sembilan,0,0,0
2021-06-01,NLD,Pahang,0,0,0
2021-06-01,NLD,Perak,0,0,0
2021-06-01,NLD,Perlis,0,0,0
2021-06-01,NLD,Pulau Pinang,2,2,0
2021-06-01,NLD,Sabah,0,0,0
2021-06-01,NLD,Sarawak,0,0,0
2021-06-01,NLD,Selangor,24,20,4
2021-06-01,NLD,Terengganu,0,0,0
2021-06-01,NLD,W.P. Labuan,0,0,0
2021-06-01,NOR,Johor,0,0,0
2021-06-01,NOR,Kedah,0,0,0
2021-06-01,NOR,Kelantan,0,0,0
2021-06-01,NOR,Melaka,0,0,0
2021-06-01,NOR,Pahang,0,0,0
2021-06-01,NOR,Perak,0,0,0
2021-06-01,NOR,Perlis,0,0,0
2021-06-01,NOR,Pulau Pinang,0,0,0
2021-06-01,NOR,Sabah,0,0,0
2021-06-01,NOR,Sarawak,0,0,0
2021-06-01,NOR,Selangor,8,8,0
2021-06-01,NOR,W.P. Labuan,0,0,0
2021-06-01,NPL,Johor,0,0,0
2021-06-01,NPL,Kedah,0,0,0
2021-06-01,NPL,Pahang,0,0,0
2021-06-01,NPL,Perak,0,0,0
2021-06-01,NPL,Perlis,0,0,0
2021-06-01,NPL,Pulau Pinang,0,0,0
2021-06-01,NPL,Sabah,0,0,0
2021-06-01,NPL,Sarawak,0,0,0
2021-06-01,NPL,Selangor,1,1,0
2021-06-01,NPL,W.P. Labuan,0,0,0
2021-06-01,NRU,Johor,0,0,0
2021-06-01,NRU,Pulau Pinang,0,0,0
2021-06-01,NRU,Selangor,0,0,0
2021-06-01,NZL,Johor,0,0,0
2021-06-01,NZL,Kedah,0,0,0
2021-06-01,NZL,Kelantan,0,0,0
2021-06-01,NZL,Melaka,0,0,0
2021-06-01,NZL,Negeri Sembilan,0,0,0
2021-06-01,NZL,Pahang,0,0,0
2021-06-01,NZL,Perak,0,0,0
2021-06-01,NZL,Perlis,0,0,0
2021-06-01,NZL,Pulau Pinang,0,0,0
2021-06-01,NZL,Sabah,0,0,0
2021-06-01,NZL,Sarawak,0,0,0
2021-06-01,NZL,Selangor,20,11,9
2021-06-01,NZL,Terengganu,0,0,0
2021-06-01,NZL,W.P. Labuan,0,0,0
2021-06-01,OMN,Johor,0,0,0
2021-06-01,OMN,Kedah,0,0,0
2021-06-01,OMN,Kelantan,0,0,0
2021-06-01,OMN,Melaka,0,0,0
2021-06-01,OMN,Perak,0,0,0
2021-06-01,OMN,Perlis,0,0,0
2021-06-01,OMN,Pulau Pinang,0,0,0
2021-06-01,OMN,Sabah,0,0,0
2021-06-01,OMN,Sarawak,0,0,0
2021-06-01,OMN,Selangor,0,0,0
2021-06-01,PAK,Johor,2,2,0
2021-06-01,PAK,Kedah,0,0,0
2021-06-01,PAK,Kelantan,0,0,0
2021-06-01,PAK,Melaka,0,0,0
2021-06-01,PAK,Negeri Sembilan,0,0,0
2021-06-01,PAK,Pahang,0,0,0
2021-06-01,PAK,Perak,0,0,0
2021-06-01,PAK,Perlis,0,0,0
2021-06-01,PAK,Pulau Pinang,0,0,0
2021-06-01,PAK,Sabah,1,1,0
2021-06-01,PAK,Sarawak,0,0,0
2021-06-01,PAK,Selangor,14,8,6
2021-06-01,PAK,W.P. Labuan,0,0,0
2021-06-01,PAN,Johor,0,0,0
2021-06-01,PAN,Kedah,0,0,0
2021-06-01,PAN,Perak,0,0,0
2021-06-01,PAN,Perlis,0,0,0
2021-06-01,PAN,Pulau Pinang,0,0,0
2021-06-01,PAN,Sabah,0,0,0
2021-06-01,PAN,Sarawak,0,0,0
2021-06-01,PAN,Selangor,0,0,0
2021-06-01,PER,Johor,0,0,0
2021-06-01,PER,Kedah,0,0,0
2021-06-01,PER,Kelantan,0,0,0
2021-06-01,PER,Pahang,0,0,0
2021-06-01,PER,Perak,0,0,0
2021-06-01,PER,Perlis,0,0,0
2021-06-01,PER,Pulau Pinang,0,0,0
2021-06-01,PER,Sabah,0,0,0
2021-06-01,PER,Sarawak,0,0,0
2021-06-01,PER,Selangor,0,0,0
2021-06-01,PER,W.P. Labuan,0,0,0
2021-06-01,PHL,Johor,7,6,1
2021-06-01,PHL,Kedah,0,0,0
2021-06-01,PHL,Kelantan,0,0,0
2021-06-01,PHL,Melaka,0,0,0
2021-06-01,PHL,Negeri Sembilan,0,0,0
2021-06-01,PHL,Pahang,0,0,0
2021-06-01,PHL,Perak,0,0,0
2021-06-01,PHL,Perlis,0,0,0
2021-06-01,PHL,Pulau Pinang,3,2,1
2021-06-01,PHL,Sabah,2,0,2
2021-06-01,PHL,Sarawak,52,51,1
2021-06-01,PHL,Selangor,337,274,63
2021-06-01,PHL,Terengganu,0,0,0
2021-06-01,PHL,W.P. Labuan,0,0,0
2021-06-01,PLW,Johor,0,0,0
2021-06-01,PLW,Pulau Pinang,0,0,0
2021-06-01,PLW,Selangor,0,0,0
2021-06-01,PNG,Johor,0,0,0
2021-06-01,PNG,Kedah,0,0,0
2021-06-01,PNG,Kelantan,0,0,0
2021-06-01,PNG,Perak,0,0,0
2021-06-01,PNG,Pulau Pinang,0,0,0
2021-06-01,PNG,Sabah,0,0,0
2021-06-01,PNG,Sarawak,0,0,0
2021-06-01,PNG,Selangor,3,2,1
2021-06-01,POL,Johor,0,0,0
2021-06-01,POL,Kedah,0,0,0
2021-06-01,POL,Kelantan,0,0,0
2021-06-01,POL,Melaka,0,0,0
2021-06-01,POL,Negeri Sembilan,0,0,0
2021-06-01,POL,Pahang,0,0,0
2021-06-01,POL,Perak,0,0,0
2021-06-01,POL,Perlis,0,0,0
2021-06-01,POL,Pulau Pinang,0,0,0
2021-06-01,POL,Sabah,0,0,0
2021-06-01,POL,Sarawak,0,0,0
2021-06-01,POL,Selangor,14,11,3
2021-06-01,POL,Terengganu,0,0,0
2021-06-01,POL,W.P. Labuan,0,0,0
2021-06-01,PRK,Selangor,0,0,0
2021-06-01,PRT,Johor,0,0,0
2021-06-01,PRT,Kedah,0,0,0
2021-06-01,PRT,Kelantan,0,0,0
2021-06-01,PRT,Melaka,0,0,0
2021-06-01,PRT,Pahang,0,0,0
2021-06-01,PRT,Perak,0,0,0
2021-06-01,PRT,Perlis,0,0,0
2021-06-01,PRT,Pulau Pinang,0,0,0
2021-06-01,PRT,Sabah,0,0,0
2021-06-01,PRT,Sarawak,0,0,0
2021-06-01,PRT,Selangor,7,4,3
2021-06-01,PRT,W.P. Labuan,0,0,0
2021-06-01,PRY,Johor,0,0,0
2021-06-01,PRY,Kedah,0,0,0
2021-06-01,PRY,Perak,0,0,0
2021-06-01,PRY,Perlis,0,0,0
2021-06-01,PRY,Pulau Pinang,0,0,0
2021-06-01,PRY,Sabah,0,0,0
2021-06-01,PRY,Sarawak,0,0,0
2021-06-01,PRY,Selangor,0,0,0
2021-06-01,PSE,Johor,0,0,0
2021-06-01,PSE,Kedah,0,0,0
2021-06-01,PSE,Kelantan,0,0,0
2021-06-01,PSE,Melaka,0,0,0
2021-06-01,PSE,Perak,0,0,0
2021-06-01,PSE,Perlis,0,0,0
2021-06-01,PSE,Pulau Pinang,0,0,0
2021-06-01,PSE,Sabah,0,0,0
2021-06-01,PSE,Sarawak,0,0,0
2021-06-01,PSE,Selangor,9,9,0
2021-06-01,QAT,Johor,0,0,0
2021-06-01,QAT,Kedah,0,0,0
2021-06-01,QAT,Perlis,0,0,0
2021-06-01,QAT,Pulau Pinang,0,0,0
2021-06-01,QAT,Sabah,0,0,0
2021-06-01,QAT,Sarawak,0,0,0
2021-06-01,QAT,Selangor,0,0,0
2021-06-01,REU,Johor,0,0,0
2021-06-01,REU,Sarawak,0,0,0
2021-06-01,ROU,Johor,0,0,0
2021-06-01,ROU,Kedah,0,0,0
2021-06-01,ROU,Kelantan,0,0,0
2021-06-01,ROU,Negeri Sembilan,0,0,0
2021-06-01,ROU,Pahang,0,0,0
2021-06-01,ROU,Perak,0,0,0
2021-06-01,ROU,Perlis,0,0,0
2021-06-01,ROU,Pulau Pinang,0,0,0
2021-06-01,ROU,Sabah,0,0,0
2021-06-01,ROU,Sarawak,0,0,0
2021-06-01,ROU,Selangor,17,16,1
2021-06-01,ROU,W.P. Labuan,0,0,0
2021-06-01,RUS,Johor,0,0,0
2021-06-01,RUS,Kedah,0,0,0
2021-06-01,RUS,Kelantan,0,0,0
2021-06-01,RUS,Melaka,0,0,0
2021-06-01,RUS,Negeri Sembilan,0,0,0
2021-06-01,RUS,Pahang,0,0,0
2021-06-01,RUS,Perak,0,0,0
2021-06-01,RUS,Perlis,0,0,0
2021-06-01,RUS,Pulau Pinang,0,0,0
2021-06-01,RUS,Sabah,0,0,0
2021-06-01,RUS,Sarawak,0,0,0
2021-06-01,RUS,Selangor,77,67,10
2021-06-01,RUS,W.P. Labuan,0,0,0
2021-06-01,RWA,Johor,0,0,0
2021-06-01,RWA,Kedah,0,0,0
2021-06-01,RWA,Pulau Pinang,0,0,0
2021-06-01,RWA,Selangor,0,0,0
2021-06-01,SAU,Johor,0,0,0
2021-06-01,SAU,Kedah,0,0,0
2021-06-01,SAU,Kelantan,0,0,0
2021-06-01,SAU,Melaka,0,0,0
2021-06-01,SAU,Perak,0,0,0
2021-06-01,SAU,Perlis,0,0,0
2021-06-01,SAU,Pulau Pinang,0,0,0
2021-06-01,SAU,Sabah,0,0,0
2021-06-01,SAU,Sarawak,0,0,0
2021-06-01,SAU,Selangor,47,33,14
2021-06-01,SAU,W.P. Labuan,0,0,0
2021-06-01,SDN,Johor,0,0,0
2021-06-01,SDN,Kedah,0,0,0
2021-06-01,SDN,Kelantan,0,0,0
2021-06-01,SDN,Perlis,0,0,0
2021-06-01,SDN,Pulau Pinang,0,0,0
2021-06-01,SDN,Sabah,0,0,0
2021-06-01,SDN,Sarawak,0,0,0
2021-06-01,SDN,Selangor,30,23,7
2021-06-01,SDN,W.P. Labuan,0,0,0
2021-06-01,SEN,Johor,0,0,0
2021-06-01,SEN,Kedah,0,0,0
2021-06-01,SEN,Kelantan,0,0,0
2021-06-01,SEN,Perak,0,0,0
2021-06-01,SEN,Perlis,0,0,0
2021-06-01,SEN,Pulau Pinang,0,0,0
2021-06-01,SEN,Sabah,0,0,0
2021-06-01,SEN,Sarawak,0,0,0
2021-06-01,SEN,Selangor,3,1,2
2021-06-01,SGP,Johor,72,61,11
2021-06-01,SGP,Kedah,1,1,0
2021-06-01,SGP,Kelantan,0,0,0
2021-06-01,SGP,Melaka,0,0,0
2021-06-01,SGP,Negeri Sembilan,0,0,0
2021-06-01,SGP,Pahang,0,0,0
2021-06-01,SGP,Perak,1,1,0
2021-06-01,SGP,Perlis,1,1,0
2021-06-01,SGP,Pulau Pinang,5,1,4
2021-06-01,SGP,Sabah,0,0,0
2021-06-01,SGP,Sarawak,5,4,1
2021-06-01,SGP,Selangor,82,54,28
2021-06-01,SGP,Terengganu,0,0,0
2021-06-01,SGP,W.P. Labuan,0,0,0
2021-06-01,SGS,Johor,0,0,0
2021-06-01,SGS,Sabah,0,0,0
2021-06-01,SGS,Selangor,0,0,0
2021-06-01,SHN,Sarawak,0,0,0
2021-06-01,SLB,Johor,0,0,0
2021-06-01,SLB,Perlis,0,0,0
2021-06-01,SLB,Pulau Pinang,0,0,0
2021-06-01,SLB,Sabah,0,0,0
2021-06-01,SLB,Sarawak,0,0,0
2021-06-01,SLB,Selangor,0,0,0
2021-06-01,SLB,W.P. Labuan,0,0,0
2021-06-01,SLE,Johor,0,0,0
2021-06-01,SLE,Kedah,0,0,0
2021-06-01,SLE,Perak,0,0,0
2021-06-01,SLE,Pulau Pinang,0,0,0
2021-06-01,SLE,Sabah,0,0,0
2021-06-01,SLE,Selangor,0,0,0
2021-06-01,SLV,Johor,0,0,0
2021-06-01,SLV,Kedah,0,0,0
2021-06-01,SLV,Perak,0,0,0
2021-06-01,SLV,Perlis,0,0,0
2021-06-01,SLV,Pulau Pinang,0,0,0
2021-06-01,SLV,Sabah,0,0,0
2021-06-01,SLV,Selangor,1,0,1
2021-06-01,SLV,W.P. Labuan,0,0,0
2021-06-01,SMR,Johor,0,0,0
2021-06-01,SMR,Selangor,0,0,0
2021-06-01,SOM,Johor,0,0,0
2021-06-01,SOM,Kedah,0,0,0
2021-06-01,SOM,Kelantan,0,0,0
2021-06-01,SOM,Perlis,0,0,0
2021-06-01,SOM,Sabah,0,0,0
2021-06-01,SOM,Sarawak,0,0,0
2021-06-01,SOM,Selangor,9,5,4
2021-06-01,SRB,Johor,0,0,0
2021-06-01,SRB,Kedah,0,0,0
2021-06-01,SRB,Kelantan,0,0,0
2021-06-01,SRB,Pahang,0,0,0
2021-06-01,SRB,Perak,0,0,0
2021-06-01,SRB,Perlis,0,0,0
2021-06-01,SRB,Pulau Pinang,0,0,0
2021-06-01,SRB,Sabah,0,0,0
2021-06-01,SRB,Sarawak,0,0,0
2021-06-01,SRB,Selangor,0,0,0
2021-06-01,SSD,Johor,0,0,0
2021-06-01,SSD,Kedah,0,0,0
2021-06-01,SSD,Sarawak,0,0,0
2021-06-01,SSD,Selangor,2,1,1
2021-06-01,SSD,W.P. Labuan,0,0,0
2021-06-01,STP,Selangor,0,0,0
2021-06-01,SUR,Johor,0,0,0
2021-06-01,SUR,Kedah,0,0,0
2021-06-01,SUR,Kelantan,0,0,0
2021-06-01,SUR,Perak,0,0,0
2021-06-01,SUR,Perlis,0,0,0
2021-06-01,SUR,Pulau Pinang,0,0,0
2021-06-01,SUR,Sabah,0,0,0
2021-06-01,SUR,Sarawak,0,0,0
2021-06-01,SUR,Selangor,0,0,0
2021-06-01,SVK,Johor,0,0,0
2021-06-01,SVK,Kedah,0,0,0
2021-06-01,SVK,Kelantan,0,0,0
2021-06-01,SVK,Negeri Sembilan,0,0,0
2021-06-01,SVK,Pahang,0,0,0
2021-06-01,SVK,Perak,0,0,0
2021-06-01,SVK,Perlis,0,0,0
2021-06-01,SVK,Pulau Pinang,0,0,0
2021-06-01,SVK,Sabah,0,0,0
2021-06-01,SVK,Sarawak,0,0,0
2021-06-01,SVK,Selangor,0,0,0
2021-06-01,SVK,W.P. Labuan,0,0,0
2021-06-01,SVN,Johor,0,0,0
2021-06-01,SVN,Kedah,0,0,0
2021-06-01,SVN,Kelantan,0,0,0
2021-06-01,SVN,Perak,0,0,0
2021-06-01,SVN,Perlis,0,0,0
2021-06-01,SVN,Pulau Pinang,0,0,0
2021-06-01,SVN,Sabah,0,0,0
2021-06-01,SVN,Sarawak,0,0,0
2021-06-01,SVN,Selangor,2,2,0
2021-06-01,SVN,W.P. Labuan,0,0,0
2021-06-01,SWE,Johor,0,0,0
2021-06-01,SWE,Kedah,0,0,0
2021-06-01,SWE,Kelantan,0,0,0
2021-06-01,SWE,Melaka,0,0,0
2021-06-01,SWE,Negeri Sembilan,0,0,0
2021-06-01,SWE,Pahang,0,0,0
2021-06-01,SWE,Perak,0,0,0
2021-06-01,SWE,Perlis,0,0,0
2021-06-01,SWE,Pulau Pinang,0,0,0
2021-06-01,SWE,Sabah,0,0,0
2021-06-01,SWE,Sarawak,0,0,0
2021-06-01,SWE,Selangor,11,10,1
2021-06-01,SWE,W.P. Labuan,0,0,0
2021-06-01,SWZ,Johor,0,0,0
2021-06-01,SWZ,Kedah,0,0,0
2021-06-01,SWZ,Pulau Pinang,0,0,0
2021-06-01,SWZ,Sabah,0,0,0
2021-06-01,SWZ,Selangor,0,0,0
2021-06-01,SYC,Johor,0,0,0
2021-06-01,SYC,Kedah,0,0,0
2021-06-01,SYC,Pulau Pinang,0,0,0
2021-06-01,SYC,Sabah,0,0,0
2021-06-01,SYC,Sarawak,0,0,0
2021-06-01,SYC,Selangor,1,1,0
2021-06-01,SYR,Johor,0,0,0
2021-06-01,SYR,Kedah,0,0,0
2021-06-01,SYR,Kelantan,0,0,0
2021-06-01,SYR,Pahang,0,0,0
2021-06-01,SYR,Perlis,0,0,0
2021-06-01,SYR,Pulau Pinang,0,0,0
2021-06-01,SYR,Sabah,0,0,0
2021-06-01,SYR,Sarawak,1,1,0
2021-06-01,SYR,Selangor,14,10,4
2021-06-01,SYR,W.P. Labuan,0,0,0
2021-06-01,TCA,Perlis,0,0,0
2021-06-01,TCD,Johor,0,0,0
2021-06-01,TCD,Kedah,0,0,0
2021-06-01,TCD,Perlis,0,0,0
2021-06-01,TCD,Selangor,0,0,0
2021-06-01,TGO,Johor,0,0,0
2021-06-01,TGO,Perak,0,0,0
2021-06-01,TGO,Pulau Pinang,0,0,0
2021-06-01,TGO,Selangor,0,0,0
2021-06-01,THA,Johor,0,0,0
2021-06-01,THA,Kedah,16884,16840,44
2021-06-01,THA,Kelantan,1,0,1
2021-06-01,THA,Melaka,0,0,0
2021-06-01,THA,Negeri Sembilan,0,0,0
2021-06-01,THA,Pahang,0,0,0
2021-06-01,THA,Perak,0,0,0
2021-06-01,THA,Perlis,7245,7161,84
2021-06-01,THA,Pulau Pinang,282,280,2
2021-06-01,THA,Sabah,0,0,0
2021-06-01,THA,Sarawak,13,12,1
2021-06-01,THA,Selangor,197,127,70
2021-06-01,THA,Terengganu,0,0,0
2021-06-01,THA,W.P. Labuan,0,0,0
2021-06-01,TJK,Johor,0,0,0
2021-06-01,TJK,Kedah,0,0,0
2021-06-01,TJK,Perlis,0,0,0
2021-06-01,TJK,Pulau Pinang,0,0,0
2021-06-01,TJK,Sabah,0,0,0
2021-06-01,TJK,Selangor,2,2,0
2021-06-01,TKL,Selangor,0,0,0
2021-06-01,TKM,Johor,0,0,0
2021-06-01,TKM,Kedah,0,0,0
2021-06-01,TKM,Kelantan,0,0,0
2021-06-01,TKM,Perlis,0,0,0
2021-06-01,TKM,Pulau Pinang,0,0,0
2021-06-01,TKM,Sabah,0,0,0
2021-06-01,TKM,Sarawak,0,0,0
2021-06-01,TKM,Selangor,3,3,0
2021-06-01,TLS,Johor,0,0,0
2021-06-01,TLS,Kedah,0,0,0
2021-06-01,TLS,Perlis,0,0,0
2021-06-01,TLS,Pulau Pinang,0,0,0
2021-06-01,TLS,Sabah,0,0,0
2021-06-01,TLS,Sarawak,0,0,0
2021-06-01,TLS,Selangor,2,0,2
2021-06-01,TON,Johor,0,0,0
2021-06-01,TON,Pulau Pinang,0,0,0
2021-06-01,TON,Sarawak,0,0,0
2021-06-01,TON,Selangor,0,0,0
2021-06-01,TTO,Johor,0,0,0
2021-06-01,TTO,Kedah,0,0,0
2021-06-01,TTO,Pahang,0,0,0
2021-06-01,TTO,Pulau Pinang,0,0,0
2021-06-01,TTO,Sabah,0,0,0
2021-06-01,TTO,Sarawak,0,0,0
2021-06-01,TTO,Selangor,1,0,1
2021-06-01,TUN,Johor,0,0,0
2021-06-01,TUN,Kedah,0,0,0
2021-06-01,TUN,Kelantan,0,0,0
2021-06-01,TUN,Melaka,0,0,0
2021-06-01,TUN,Perak,0,0,0
2021-06-01,TUN,Perlis,0,0,0
2021-06-01,TUN,Pulau Pinang,0,0,0
2021-06-01,TUN,Sabah,0,0,0
2021-06-01,TUN,Sarawak,0,0,0
2021-06-01,TUN,Selangor,1,1,0
2021-06-01,TUN,W.P. Labuan,0,0,0
2021-06-01,TUR,Johor,0,0,0
2021-06-01,TUR,Kedah,0,0,0
2021-06-01,TUR,Kelantan,0,0,0
2021-06-01,TUR,Melaka,0,0,0
2021-06-01,TUR,Negeri Sembilan,0,0,0
2021-06-01,TUR,Pahang,0,0,0
2021-06-01,TUR,Perak,0,0,0
2021-06-01,TUR,Perlis,0,0,0
2021-06-01,TUR,Pulau Pinang,0,0,0
2021-06-01,TUR,Sabah,0,0,0
2021-06-01,TUR,Sarawak,0,0,0
2021-06-01,TUR,Selangor,26,22,4
2021-06-01,TUR,W.P. Labuan,0,0,0
2021-06-01,TUV,Selangor,0,0,0
2021-06-01,TWN,Johor,0,0,0
2021-06-01,TWN,Kedah,0,0,0
2021-06-01,TWN,Kelantan,0,0,0
2021-06-01,TWN,Melaka,0,0,0
2021-06-01,TWN,Negeri Sembilan,0,0,0
2021-06-01,TWN,Pahang,0,0,0
2021-06-01,TWN,Perak,0,0,0
2021-06-01,TWN,Perlis,0,0,0
2021-06-01,TWN,Pulau Pinang,15,10,5
2021-06-01,TWN,Sabah,0,0,0
2021-06-01,TWN,Sarawak,1,1,0
2021-06-01,TWN,Selangor,30,18,12
2021-06-01,TWN,W.P. Labuan,0,0,0
2021-06-01,TZA,Johor,0,0,0
2021-06-01,TZA,Kedah,0,0,0
2021-06-01,TZA,Perak,0,0,0
2021-06-01,TZA,Perlis,0,0,0
2021-06-01,TZA,Pulau Pinang,0,0,0
2021-06-01,TZA,Sabah,0,0,0
2021-06-01,TZA,Sarawak,0,0,0
2021-06-01,TZA,Selangor,6,5,1
2021-06-01,UGA,Johor,0,0,0
2021-06-01,UGA,Kedah,0,0,0
2021-06-01,UGA,Perak,0,0,0
2021-06-01,UGA,Perlis,0,0,0
2021-06-01,UGA,Pulau Pinang,0,0,0
2021-06-01,UGA,Sabah,0,0,0
2021-06-01,UGA,Sarawak,0,0,0
2021-06-01,UGA,Selangor,5,0,5
2021-06-01,UKR,Johor,0,0,0
2021-06-01,UKR,Kedah,0,0,0
2021-06-01,UKR,Kelantan,0,0,0
2021-06-01,UKR,Melaka,0,0,0
2021-06-01,UKR,Negeri Sembilan,0,0,0
2021-06-01,UKR,Pahang,0,0,0
2021-06-01,UKR,Perak,0,0,0
2021-06-01,UKR,Perlis,0,0,0
2021-06-01,UKR,Pulau Pinang,0,0,0
2021-06-01,UKR,Sabah,0,0,0
2021-06-01,UKR,Sarawak,0,0,0
2021-06-01,UKR,Selangor,50,49,1
2021-06-01,UKR,W.P. Labuan,0,0,0
2021-06-01,URY,Johor,0,0,0
2021-06-01,URY,Kedah,0,0,0
2021-06-01,URY,Kelantan,0,0,0
2021-06-01,URY,Perak,0,0,0
2021-06-01,URY,Perlis,0,0,0
2021-06-01,URY,Pulau Pinang,0,0,0
2021-06-01,URY,Sabah,0,0,0
2021-06-01,URY,Sarawak,0,0,0
2021-06-01,URY,Selangor,0,0,0
2021-06-01,URY,W.P. Labuan,0,0,0
2021-06-01,USA,Johor,0,0,0
2021-06-01,USA,Kedah,0,0,0
2021-06-01,USA,Kelantan,0,0,0
2021-06-01,USA,Melaka,0,0,0
2021-06-01,USA,Negeri Sembilan,0,0,0
2021-06-01,USA,Pahang,0,0,0
2021-06-01,USA,Perak,0,0,0
2021-06-01,USA,Perlis,0,0,0
2021-06-01,USA,Pulau Pinang,7,5,2
2021-06-01,USA,Sabah,0,0,0
2021-06-01,USA,Sarawak,0,0,0
2021-06-01,USA,Selangor,152,96,56
2021-06-01,USA,Terengganu,0,0,0
2021-06-01,USA,W.P. Labuan,0,0,0
2021-06-01,UZB,Johor,0,0,0
2021-06-01,UZB,Kedah,0,0,0
2021-06-01,UZB,Kelantan,0,0,0
2021-06-01,UZB,Perak,0,0,0
2021-06-01,UZB,Perlis,0,0,0
2021-06-01,UZB,Pulau Pinang,0,0,0
2021-06-01,UZB,Sabah,0,0,0
2021-06-01,UZB,Sarawak,0,0,0
2021-06-01,UZB,Selangor,8,3,5
2021-06-01,VAT,Johor,0,0,0
2021-06-01,VAT,Sarawak,0,0,0
2021-06-01,VAT,Selangor,1,1,0
2021-06-01,VCT,Johor,0,0,0
2021-06-01,VCT,Kedah,0,0,0
2021-06-01,VCT,Pulau Pinang,0,0,0
2021-06-01,VCT,Sarawak,0,0,0
2021-06-01,VCT,Selangor,0,0,0
2021-06-01,VEN,Johor,0,0,0
2021-06-01,VEN,Kedah,0,0,0
2021-06-01,VEN,Kelantan,0,0,0
2021-06-01,VEN,Melaka,0,0,0
2021-06-01,VEN,Perak,0,0,0
2021-06-01,VEN,Perlis,0,0,0
2021-06-01,VEN,Pulau Pinang,0,0,0
2021-06-01,VEN,Sabah,0,0,0
2021-06-01,VEN,Sarawak,0,0,0
2021-06-01,VEN,Selangor,0,0,0
2021-06-01,VEN,W.P. Labuan,0,0,0
2021-06-01,VNM,Johor,0,0,0
2021-06-01,VNM,Kedah,0,0,0
2021-06-01,VNM,Kelantan,0,0,0
2021-06-01,VNM,Melaka,0,0,0
2021-06-01,VNM,Negeri Sembilan,0,0,0
2021-06-01,VNM,Pahang,0,0,0
2021-06-01,VNM,Perak,0,0,0
2021-06-01,VNM,Perlis,0,0,0
2021-06-01,VNM,Pulau Pinang,2,0,2
2021-06-01,VNM,Sabah,0,0,0
2021-06-01,VNM,Sarawak,0,0,0
2021-06-01,VNM,Selangor,63,23,40
2021-06-01,VNM,Terengganu,0,0,0
2021-06-01,VNM,W.P. Labuan,0,0,0
2021-06-01,VUT,Johor,0,0,0
2021-06-01,VUT,Kedah,0,0,0
2021-06-01,VUT,Pulau Pinang,0,0,0
2021-06-01,VUT,Sabah,0,0,0
2021-06-01,VUT,Sarawak,0,0,0
2021-06-01,VUT,Selangor,0,0,0
2021-06-01,WSM,Johor,0,0,0
2021-06-01,WSM,Sarawak,0,0,0
2021-06-01,WSM,Selangor,0,0,0
2021-06-01,XXX,Johor,0,0,0
2021-06-01,XXX,Kedah,0,0,0
2021-06-01,XXX,Kelantan,0,0,0
2021-06-01,XXX,Melaka,0,0,0
2021-06-01,XXX,Pahang,0,0,0
2021-06-01,XXX,Perak,0,0,0
2021-06-01,XXX,Perlis,0,0,0
2021-06-01,XXX,Pulau Pinang,0,0,0
2021-06-01,XXX,Sabah,0,0,0
2021-06-01,XXX,Sarawak,0,0,0
2021-06-01,XXX,Selangor,6,5,1
2021-06-01,XXX,W.P. Labuan,0,0,0
2021-06-01,YEM,Johor,0,0,0
2021-06-01,YEM,Kedah,0,0,0
2021-06-01,YEM,Kelantan,0,0,0
2021-06-01,YEM,Melaka,0,0,0
2021-06-01,YEM,Pahang,0,0,0
2021-06-01,YEM,Perak,0,0,0
2021-06-01,YEM,Perlis,0,0,0
2021-06-01,YEM,Pulau Pinang,0,0,0
2021-06-01,YEM,Sabah,0,0,0
2021-06-01,YEM,Sarawak,0,0,0
2021-06-01,YEM,Selangor,38,35,3
2021-06-01,YEM,W.P. Labuan,0,0,0
2021-06-01,ZAF,Johor,1,1,0
2021-06-01,ZAF,Kedah,0,0,0
2021-06-01,ZAF,Kelantan,0,0,0
2021-06-01,ZAF,Melaka,0,0,0
2021-06-01,ZAF,Pahang,0,0,0
2021-06-01,ZAF,Perak,0,0,0
2021-06-01,ZAF,Perlis,0,0,0
2021-06-01,ZAF,Pulau Pinang,0,0,0
2021-06-01,ZAF,Sabah,0,0,0
2021-06-01,ZAF,Sarawak,0,0,0
2021-06-01,ZAF,Selangor,23,14,9
2021-06-01,ZAF,Terengganu,0,0,0
2021-06-01,ZAF,W.P. Labuan,0,0,0
2021-06-01,ZAR,Selangor,0,0,0
2021-06-01,ZMB,Johor,0,0,0
2021-06-01,ZMB,Kedah,0,0,0
2021-06-01,ZMB,Perak,0,0,0
2021-06-01,ZMB,Perlis,0,0,0
2021-06-01,ZMB,Pulau Pinang,0,0,0
2021-06-01,ZMB,Sabah,0,0,0
2021-06-01,ZMB,Sarawak,0,0,0
2021-06-01,ZMB,Selangor,4,2,2
2021-06-01,ZWE,Johor,0,0,0
2021-06-01,ZWE,Kedah,0,0,0
2021-06-01,ZWE,Kelantan,0,0,0
2021-06-01,ZWE,Perak,0,0,0
2021-06-01,ZWE,Perlis,0,0,0
2021-06-01,ZWE,Pulau Pinang,1,1,0
2021-06-01,ZWE,Sabah,0,0,0
2021-06-01,ZWE,Sarawak,0,0,0
2021-06-01,ZWE,Selangor,2,1,1
2021-07-01,ABW,Kedah,0,0,0
2021-07-01,ABW,Pulau Pinang,0,0,0
2021-07-01,AFG,Johor,0,0,0
2021-07-01,AFG,Kedah,0,0,0
2021-07-01,AFG,Perlis,0,0,0
2021-07-01,AFG,Pulau Pinang,0,0,0
2021-07-01,AFG,Sarawak,0,0,0
2021-07-01,AFG,Selangor,10,7,3
2021-07-01,AGO,Johor,0,0,0
2021-07-01,AGO,Kedah,0,0,0
2021-07-01,AGO,Sabah,0,0,0
2021-07-01,AGO,Selangor,0,0,0
2021-07-01,AIA,Selangor,0,0,0
2021-07-01,ALB,Johor,0,0,0
2021-07-01,ALB,Kedah,0,0,0
2021-07-01,ALB,Perak,0,0,0
2021-07-01,ALB,Perlis,0,0,0
2021-07-01,ALB,Pulau Pinang,0,0,0
2021-07-01,ALB,Sabah,0,0,0
2021-07-01,ALB,Sarawak,0,0,0
2021-07-01,ALB,Selangor,0,0,0
2021-07-01,AND,Johor,0,0,0
2021-07-01,AND,Kedah,0,0,0
2021-07-01,AND,Perlis,0,0,0
2021-07-01,AND,Pulau Pinang,0,0,0
2021-07-01,AND,Selangor,0,0,0
2021-07-01,ANT,Selangor,1,0,1
2021-07-01,ARE,Johor,0,0,0
2021-07-01,ARE,Kedah,0,0,0
2021-07-01,ARE,Kelantan,0,0,0
2021-07-01,ARE,Perak,0,0,0
2021-07-01,ARE,Perlis,0,0,0
2021-07-01,ARE,Pulau Pinang,0,0,0
2021-07-01,ARE,Sabah,0,0,0
2021-07-01,ARE,Sarawak,0,0,0
2021-07-01,ARE,Selangor,1,1,0
2021-07-01,ARG,Johor,2,2,0
2021-07-01,ARG,Kedah,0,0,0
2021-07-01,ARG,Kelantan,0,0,0
2021-07-01,ARG,Melaka,0,0,0
2021-07-01,ARG,Perak,0,0,0
2021-07-01,ARG,Perlis,0,0,0
2021-07-01,ARG,Pulau Pinang,0,0,0
2021-07-01,ARG,Sabah,0,0,0
2021-07-01,ARG,Sarawak,0,0,0
2021-07-01,ARG,Selangor,8,6,2
2021-07-01,ARG,W.P. Labuan,0,0,0
2021-07-01,ARM,Johor,0,0,0
2021-07-01,ARM,Kedah,0,0,0
2021-07-01,ARM,Kelantan,0,0,0
2021-07-01,ARM,Perak,0,0,0
2021-07-01,ARM,Perlis,0,0,0
2021-07-01,ARM,Pulau Pinang,0,0,0
2021-07-01,ARM,Sabah,0,0,0
2021-07-01,ARM,Sarawak,0,0,0
2021-07-01,ARM,Selangor,3,2,1
2021-07-01,ATA,Selangor,0,0,0
2021-07-01,ATG,Johor,0,0,0
2021-07-01,ATG,Kedah,0,0,0
2021-07-01,ATG,Pulau Pinang,0,0,0
2021-07-01,ATG,Sarawak,0,0,0
2021-07-01,ATG,Selangor,0,0,0
2021-07-01,AUS,Johor,2,2,0
2021-07-01,AUS,Kedah,3,1,2
2021-07-01,AUS,Kelantan,0,0,0
2021-07-01,AUS,Melaka,0,0,0
2021-07-01,AUS,Negeri Sembilan,0,0,0
2021-07-01,AUS,Pahang,0,0,0
2021-07-01,AUS,Perak,0,0,0
2021-07-01,AUS,Perlis,0,0,0
2021-07-01,AUS,Pulau Pinang,1,0,1
2021-07-01,AUS,Sabah,1,1,0
2021-07-01,AUS,Sarawak,1,0,1
2021-07-01,AUS,Selangor,91,51,40
2021-07-01,AUS,Terengganu,0,0,0
2021-07-01,AUS,W.P. Labuan,0,0,0
2021-07-01,AUT,Johor,0,0,0
2021-07-01,AUT,Kedah,0,0,0
2021-07-01,AUT,Kelantan,0,0,0
2021-07-01,AUT,Melaka,0,0,0
2021-07-01,AUT,Negeri Sembilan,0,0,0
2021-07-01,AUT,Pahang,0,0,0
2021-07-01,AUT,Perak,0,0,0
2021-07-01,AUT,Perlis,0,0,0
2021-07-01,AUT,Pulau Pinang,0,0,0
2021-07-01,AUT,Sabah,0,0,0
2021-07-01,AUT,Sarawak,0,0,0
2021-07-01,AUT,Selangor,12,8,4
2021-07-01,AUT,Terengganu,0,0,0
2021-07-01,AUT,W.P. Labuan,0,0,0
2021-07-01,AZE,Johor,0,0,0
2021-07-01,AZE,Kedah,0,0,0
2021-07-01,AZE,Kelantan,0,0,0
2021-07-01,AZE,Melaka,0,0,0
2021-07-01,AZE,Perlis,0,0,0
2021-07-01,AZE,Pulau Pinang,0,0,0
2021-07-01,AZE,Sabah,0,0,0
2021-07-01,AZE,Sarawak,0,0,0
2021-07-01,AZE,Selangor,5,3,2
2021-07-01,AZE,W.P. Labuan,0,0,0
2021-07-01,BDI,Pulau Pinang,0,0,0
2021-07-01,BDI,Sarawak,0,0,0
2021-07-01,BDI,Selangor,1,0,1
2021-07-01,BEL,Johor,0,0,0
2021-07-01,BEL,Kedah,0,0,0
2021-07-01,BEL,Kelantan,0,0,0
2021-07-01,BEL,Melaka,0,0,0
2021-07-01,BEL,Negeri Sembilan,0,0,0
2021-07-01,BEL,Pahang,0,0,0
2021-07-01,BEL,Perak,0,0,0
2021-07-01,BEL,Perlis,0,0,0
2021-07-01,BEL,Pulau Pinang,1,1,0
2021-07-01,BEL,Sabah,0,0,0
2021-07-01,BEL,Sarawak,0,0,0
2021-07-01,BEL,Selangor,16,12,4
2021-07-01,BEL,W.P. Labuan,0,0,0
2021-07-01,BEN,Johor,0,0,0
2021-07-01,BEN,Kedah,0,0,0
2021-07-01,BEN,Perak,0,0,0
2021-07-01,BEN,Pulau Pinang,0,0,0
2021-07-01,BEN,Sabah,0,0,0
2021-07-01,BEN,Sarawak,0,0,0
2021-07-01,BEN,Selangor,0,0,0
2021-07-01,BFA,Perak,0,0,0
2021-07-01,BFA,Pulau Pinang,0,0,0
2021-07-01,BFA,Selangor,0,0,0
2021-07-01,BGD,Johor,0,0,0
2021-07-01,BGD,Kedah,0,0,0
2021-07-01,BGD,Kelantan,0,0,0
2021-07-01,BGD,Melaka,0,0,0
2021-07-01,BGD,Negeri Sembilan,0,0,0
2021-07-01,BGD,Pahang,0,0,0
2021-07-01,BGD,Perak,0,0,0
2021-07-01,BGD,Perlis,0,0,0
2021-07-01,BGD,Pulau Pinang,0,0,0
2021-07-01,BGD,Sabah,0,0,0
2021-07-01,BGD,Sarawak,0,0,0
2021-07-01,BGD,Selangor,10,8,2
2021-07-01,BGD,W.P. Labuan,0,0,0
2021-07-01,BGR,Johor,0,0,0
2021-07-01,BGR,Kedah,0,0,0
2021-07-01,BGR,Kelantan,0,0,0
2021-07-01,BGR,Pahang,0,0,0
2021-07-01,BGR,Perak,0,0,0
2021-07-01,BGR,Perlis,0,0,0
2021-07-01,BGR,Pulau Pinang,0,0,0
2021-07-01,BGR,Sabah,0,0,0
2021-07-01,BGR,Sarawak,0,0,0
2021-07-01,BGR,Selangor,2,2,0
2021-07-01,BGR,W.P. Labuan,0,0,0
2021-07-01,BHR,Johor,0,0,0
2021-07-01,BHR,Kedah,0,0,0
2021-07-01,BHR,Kelantan,0,0,0
2021-07-01,BHR,Perlis,0,0,0
2021-07-01,BHR,Pulau Pinang,0,0,0
2021-07-01,BHR,Sabah,0,0,0
2021-07-01,BHR,Sarawak,0,0,0
2021-07-01,BHR,Selangor,1,1,0
2021-07-01,BHS,Johor,0,0,0
2021-07-01,BHS,Kedah,0,0,0
2021-07-01,BHS,Perak,0,0,0
2021-07-01,BHS,Sabah,0,0,0
2021-07-01,BHS,Sarawak,0,0,0
2021-07-01,BHS,Selangor,0,0,0
2021-07-01,BIH,Johor,0,0,0
2021-07-01,BIH,Kedah,0,0,0
2021-07-01,BIH,Perlis,0,0,0
2021-07-01,BIH,Pulau Pinang,0,0,0
2021-07-01,BIH,Sabah,0,0,0
2021-07-01,BIH,Sarawak,0,0,0
2021-07-01,BIH,Selangor,1,1,0
2021-07-01,BLR,Johor,0,0,0
2021-07-01,BLR,Kedah,0,0,0
2021-07-01,BLR,Kelantan,0,0,0
2021-07-01,BLR,Pahang,0,0,0
2021-07-01,BLR,Perak,0,0,0
2021-07-01,BLR,Perlis,0,0,0
2021-07-01,BLR,Pulau Pinang,0,0,0
2021-07-01,BLR,Sabah,0,0,0
2021-07-01,BLR,Sarawak,0,0,0
2021-07-01,BLR,Selangor,1,1,0
2021-07-01,BLR,W.P. Labuan,0,0,0
2021-07-01,BLZ,Johor,0,0,0
2021-07-01,BLZ,Pulau Pinang,0,0,0
2021-07-01,BLZ,Sarawak,0,0,0
2021-07-01,BLZ,Selangor,0,0,0
2021-07-01,BMU,Selangor,0,0,0
2021-07-01,BOL,Johor,0,0,0
2021-07-01,BOL,Kedah,0,0,0
2021-07-01,BOL,Melaka,0,0,0
2021-07-01,BOL,Perak,0,0,0
2021-07-01,BOL,Perlis,0,0,0
2021-07-01,BOL,Pulau Pinang,0,0,0
2021-07-01,BOL,Sabah,0,0,0
2021-07-01,BOL,Sarawak,0,0,0
2021-07-01,BOL,Selangor,1,0,1
2021-07-01,BRA,Johor,2,2,0
2021-07-01,BRA,Kedah,0,0,0
2021-07-01,BRA,Kelantan,0,0,0
2021-07-01,BRA,Melaka,0,0,0
2021-07-01,BRA,Pahang,0,0,0
2021-07-01,BRA,Perak,0,0,0
2021-07-01,BRA,Perlis,0,0,0
2021-07-01,BRA,Pulau Pinang,0,0,0
2021-07-01,BRA,Sabah,0,0,0
2021-07-01,BRA,Sarawak,0,0,0
2021-07-01,BRA,Selangor,19,11,8
2021-07-01,BRA,W.P. Labuan,0,0,0
2021-07-01,BRB,Johor,0,0,0
2021-07-01,BRB,Kedah,0,0,0
2021-07-01,BRB,Perlis,0,0,0
2021-07-01,BRB,Pulau Pinang,0,0,0
2021-07-01,BRB,Selangor,0,0,0
2021-07-01,BRN,Johor,0,0,0
2021-07-01,BRN,Kedah,0,0,0
2021-07-01,BRN,Kelantan,0,0,0
2021-07-01,BRN,Melaka,0,0,0
2021-07-01,BRN,Pahang,0,0,0
2021-07-01,BRN,Perak,0,0,0
2021-07-01,BRN,Perlis,0,0,0
2021-07-01,BRN,Pulau Pinang,0,0,0
2021-07-01,BRN,Sabah,0,0,0
2021-07-01,BRN,Sarawak,405,398,7
2021-07-01,BRN,Selangor,16,9,7
2021-07-01,BRN,W.P. Labuan,0,0,0
2021-07-01,BTN,Johor,0,0,0
2021-07-01,BTN,Kedah,0,0,0
2021-07-01,BTN,Perak,0,0,0
2021-07-01,BTN,Perlis,0,0,0
2021-07-01,BTN,Pulau Pinang,0,0,0
2021-07-01,BTN,Sabah,0,0,0
2021-07-01,BTN,Sarawak,0,0,0
2021-07-01,BTN,Selangor,0,0,0
2021-07-01,BWA,Johor,0,0,0
2021-07-01,BWA,Kedah,0,0,0
2021-07-01,BWA,Perlis,0,0,0
2021-07-01,BWA,Pulau Pinang,0,0,0
2021-07-01,BWA,Sabah,0,0,0
2021-07-01,BWA,Sarawak,0,0,0
2021-07-01,BWA,Selangor,0,0,0
2021-07-01,CAF,Kedah,0,0,0
2021-07-01,CAF,Selangor,0,0,0
2021-07-01,CAN,Johor,0,0,0
2021-07-01,CAN,Kedah,0,0,0
2021-07-01,CAN,Kelantan,0,0,0
2021-07-01,CAN,Melaka,0,0,0
2021-07-01,CAN,Negeri Sembilan,0,0,0
2021-07-01,CAN,Pahang,0,0,0
2021-07-01,CAN,Perak,0,0,0
2021-07-01,CAN,Perlis,0,0,0
2021-07-01,CAN,Pulau Pinang,0,0,0
2021-07-01,CAN,Sabah,0,0,0
2021-07-01,CAN,Sarawak,0,0,0
2021-07-01,CAN,Selangor,81,47,34
2021-07-01,CAN,Terengganu,0,0,0
2021-07-01,CAN,W.P. Labuan,0,0,0
2021-07-01,CCK,Selangor,0,0,0
2021-07-01,CHE,Johor,0,0,0
2021-07-01,CHE,Kedah,0,0,0
2021-07-01,CHE,Kelantan,0,0,0
2021-07-01,CHE,Melaka,0,0,0
2021-07-01,CHE,Negeri Sembilan,0,0,0
2021-07-01,CHE,Pahang,0,0,0
2021-07-01,CHE,Perak,0,0,0
2021-07-01,CHE,Perlis,0,0,0
2021-07-01,CHE,Pulau Pinang,0,0,0
2021-07-01,CHE,Sabah,0,0,0
2021-07-01,CHE,Sarawak,0,0,0
2021-07-01,CHE,Selangor,10,6,4
2021-07-01,CHE,W.P. Labuan,0,0,0
2021-07-01,CHL,Johor,0,0,0
2021-07-01,CHL,Kedah,0,0,0
2021-07-01,CHL,Kelantan,0,0,0
2021-07-01,CHL,Melaka,0,0,0
2021-07-01,CHL,Pahang,0,0,0
2021-07-01,CHL,Perak,0,0,0
2021-07-01,CHL,Perlis,0,0,0
2021-07-01,CHL,Pulau Pinang,0,0,0
2021-07-01,CHL,Sabah,0,0,0
2021-07-01,CHL,Sarawak,0,0,0
2021-07-01,CHL,Selangor,1,1,0
2021-07-01,CHN,Johor,2,2,0
2021-07-01,CHN,Kedah,1,1,0
2021-07-01,CHN,Kelantan,0,0,0
2021-07-01,CHN,Melaka,0,0,0
2021-07-01,CHN,Pahang,0,0,0
2021-07-01,CHN,Perak,0,0,0
2021-07-01,CHN,Perlis,0,0,0
2021-07-01,CHN,Pulau Pinang,1,1,0
2021-07-01,CHN,Sabah,2,2,0
2021-07-01,CHN,Sarawak,145,145,0
2021-07-01,CHN,Selangor,722,580,142
2021-07-01,CHN,Terengganu,0,0,0
2021-07-01,CHN,W.P. Labuan,0,0,0
2021-07-01,CIV,Johor,0,0,0
2021-07-01,CIV,Kedah,0,0,0
2021-07-01,CIV,Pulau Pinang,0,0,0
2021-07-01,CIV,Sabah,0,0,0
2021-07-01,CIV,Sarawak,0,0,0
2021-07-01,CIV,Selangor,3,3,0
2021-07-01,CMR,Johor,0,0,0
2021-07-01,CMR,Kedah,0,0,0
2021-07-01,CMR,Pulau Pinang,0,0,0
2021-07-01,CMR,Sabah,0,0,0
2021-07-01,CMR,Sarawak,0,0,0
2021-07-01,CMR,Selangor,2,1,1
2021-07-01,COD,Johor,0,0,0
2021-07-01,COD,Pulau Pinang,0,0,0
2021-07-01,COD,Sarawak,0,0,0
2021-07-01,COD,Selangor,1,1,0
2021-07-01,COG,Johor,0,0,0
2021-07-01,COG,Kedah,0,0,0
2021-07-01,COG,Selangor,0,0,0
2021-07-01,COK,Selangor,0,0,0
2021-07-01,COL,Johor,0,0,0
2021-07-01,COL,Kedah,0,0,0
2021-07-01,COL,Perak,0,0,0
2021-07-01,COL,Pulau Pinang,0,0,0
2021-07-01,COL,Sabah,0,0,0
2021-07-01,COL,Sarawak,0,0,0
2021-07-01,COL,Selangor,5,2,3
2021-07-01,COL,W.P. Labuan,0,0,0
2021-07-01,COM,Johor,0,0,0
2021-07-01,COM,Kedah,0,0,0
2021-07-01,COM,Selangor,0,0,0
2021-07-01,CPV,Johor,0,0,0
2021-07-01,CPV,Kedah,0,0,0
2021-07-01,CPV,Pulau Pinang,0,0,0
2021-07-01,CPV,Sabah,0,0,0
2021-07-01,CPV,Selangor,0,0,0
2021-07-01,CRI,Johor,0,0,0
2021-07-01,CRI,Kedah,0,0,0
2021-07-01,CRI,Perak,0,0,0
2021-07-01,CRI,Perlis,0,0,0
2021-07-01,CRI,Pulau Pinang,0,0,0
2021-07-01,CRI,Sabah,0,0,0
2021-07-01,CRI,Sarawak,0,0,0
2021-07-01,CRI,Selangor,3,1,2
2021-07-01,CUB,Johor,0,0,0
2021-07-01,CUB,Kedah,0,0,0
2021-07-01,CUB,Perlis,0,0,0
2021-07-01,CUB,Pulau Pinang,0,0,0
2021-07-01,CUB,Sabah,0,0,0
2021-07-01,CUB,Sarawak,0,0,0
2021-07-01,CUB,Selangor,0,0,0
2021-07-01,CYP,Johor,0,0,0
2021-07-01,CYP,Kedah,0,0,0
2021-07-01,CYP,Perak,0,0,0
2021-07-01,CYP,Perlis,0,0,0
2021-07-01,CYP,Pulau Pinang,0,0,0
2021-07-01,CYP,Sabah,0,0,0
2021-07-01,CYP,Sarawak,0,0,0
2021-07-01,CYP,Selangor,0,0,0
2021-07-01,CZE,Johor,0,0,0
2021-07-01,CZE,Kedah,0,0,0
2021-07-01,CZE,Kelantan,0,0,0
2021-07-01,CZE,Melaka,0,0,0
2021-07-01,CZE,Negeri Sembilan,0,0,0
2021-07-01,CZE,Perak,0,0,0
2021-07-01,CZE,Perlis,0,0,0
2021-07-01,CZE,Pulau Pinang,0,0,0
2021-07-01,CZE,Sabah,0,0,0
2021-07-01,CZE,Sarawak,0,0,0
2021-07-01,CZE,Selangor,4,2,2
2021-07-01,CZE,W.P. Labuan,0,0,0
2021-07-01,DEU,Johor,0,0,0
2021-07-01,DEU,Kedah,0,0,0
2021-07-01,DEU,Kelantan,0,0,0
2021-07-01,DEU,Melaka,0,0,0
2021-07-01,DEU,Negeri Sembilan,0,0,0
2021-07-01,DEU,Pahang,0,0,0
2021-07-01,DEU,Perak,0,0,0
2021-07-01,DEU,Perlis,0,0,0
2021-07-01,DEU,Pulau Pinang,2,2,0
2021-07-01,DEU,Sabah,1,1,0
2021-07-01,DEU,Sarawak,1,1,0
2021-07-01,DEU,Selangor,78,47,31
2021-07-01,DEU,Terengganu,0,0,0
2021-07-01,DEU,W.P. Labuan,0,0,0
2021-07-01,DJI,Johor,0,0,0
2021-07-01,DJI,Selangor,1,1,0
2021-07-01,DMA,Johor,0,0,0
2021-07-01,DMA,Kedah,0,0,0
2021-07-01,DMA,Pulau Pinang,0,0,0
2021-07-01,DMA,Sabah,0,0,0
2021-07-01,DMA,Sarawak,0,0,0
2021-07-01,DMA,Selangor,0,0,0
2021-07-01,DMA,W.P. Labuan,0,0,0
2021-07-01,DNK,Johor,0,0,0
2021-07-01,DNK,Kedah,0,0,0
2021-07-01,DNK,Kelantan,0,0,0
2021-07-01,DNK,Melaka,0,0,0
2021-07-01,DNK,Negeri Sembilan,0,0,0
2021-07-01,DNK,Pahang,0,0,0
2021-07-01,DNK,Perak,0,0,0
2021-07-01,DNK,Perlis,0,0,0
2021-07-01,DNK,Pulau Pinang,0,0,0
2021-07-01,DNK,Sabah,0,0,0
2021-07-01,DNK,Sarawak,0,0,0
2021-07-01,DNK,Selangor,14,10,4
2021-07-01,DNK,W.P. Labuan,0,0,0
2021-07-01,DOM,Johor,0,0,0
2021-07-01,DOM,Kedah,0,0,0
2021-07-01,DOM,Perak,0,0,0
2021-07-01,DOM,Perlis,0,0,0
2021-07-01,DOM,Pulau Pinang,0,0,0
2021-07-01,DOM,Sabah,0,0,0
2021-07-01,DOM,Sarawak,0,0,0
2021-07-01,DOM,Selangor,0,0,0
2021-07-01,DZA,Johor,0,0,0
2021-07-01,DZA,Kedah,0,0,0
2021-07-01,DZA,Kelantan,0,0,0
2021-07-01,DZA,Melaka,0,0,0
2021-07-01,DZA,Perak,0,0,0
2021-07-01,DZA,Perlis,0,0,0
2021-07-01,DZA,Pulau Pinang,0,0,0
2021-07-01,DZA,Sabah,0,0,0
2021-07-01,DZA,Sarawak,0,0,0
2021-07-01,DZA,Selangor,3,1,2
2021-07-01,DZA,W.P. Labuan,0,0,0
2021-07-01,ECU,Johor,0,0,0
2021-07-01,ECU,Kedah,0,0,0
2021-07-01,ECU,Perak,0,0,0
2021-07-01,ECU,Perlis,0,0,0
2021-07-01,ECU,Pulau Pinang,0,0,0
2021-07-01,ECU,Sabah,0,0,0
2021-07-01,ECU,Sarawak,0,0,0
2021-07-01,ECU,Selangor,0,0,0
2021-07-01,EGY,Johor,0,0,0
2021-07-01,EGY,Kedah,0,0,0
2021-07-01,EGY,Kelantan,0,0,0
2021-07-01,EGY,Melaka,0,0,0
2021-07-01,EGY,Pahang,0,0,0
2021-07-01,EGY,Perak,0,0,0
2021-07-01,EGY,Perlis,0,0,0
2021-07-01,EGY,Pulau Pinang,0,0,0
2021-07-01,EGY,Sabah,0,0,0
2021-07-01,EGY,Sarawak,0,0,0
2021-07-01,EGY,Selangor,52,39,13
2021-07-01,EGY,Terengganu,0,0,0
2021-07-01,EGY,W.P. Labuan,0,0,0
2021-07-01,ERI,Johor,0,0,0
2021-07-01,ERI,Pulau Pinang,0,0,0
2021-07-01,ERI,Sabah,0,0,0
2021-07-01,ERI,Selangor,0,0,0
2021-07-01,ESP,Johor,2,2,0
2021-07-01,ESP,Kedah,0,0,0
2021-07-01,ESP,Kelantan,0,0,0
2021-07-01,ESP,Melaka,0,0,0
2021-07-01,ESP,Negeri Sembilan,0,0,0
2021-07-01,ESP,Pahang,0,0,0
2021-07-01,ESP,Perak,0,0,0
2021-07-01,ESP,Perlis,0,0,0
2021-07-01,ESP,Pulau Pinang,0,0,0
2021-07-01,ESP,Sabah,0,0,0
2021-07-01,ESP,Sarawak,0,0,0
2021-07-01,ESP,Selangor,30,20,10
2021-07-01,ESP,W.P. Labuan,0,0,0
2021-07-01,EST,Johor,0,0,0
2021-07-01,EST,Kedah,0,0,0
2021-07-01,EST,Kelantan,0,0,0
2021-07-01,EST,Pahang,0,0,0
2021-07-01,EST,Perak,0,0,0
2021-07-01,EST,Perlis,0,0,0
2021-07-01,EST,Pulau Pinang,0,0,0
2021-07-01,EST,Sabah,0,0,0
2021-07-01,EST,Sarawak,0,0,0
2021-07-01,EST,Selangor,0,0,0
2021-07-01,EST,W.P. Labuan,0,0,0
2021-07-01,ETH,Johor,0,0,0
2021-07-01,ETH,Kedah,0,0,0
2021-07-01,ETH,Pulau Pinang,0,0,0
2021-07-01,ETH,Sarawak,1,0,1
2021-07-01,ETH,Selangor,2,1,1
2021-07-01,FIN,Johor,0,0,0
2021-07-01,FIN,Kedah,0,0,0
2021-07-01,FIN,Kelantan,0,0,0
2021-07-01,FIN,Melaka,0,0,0
2021-07-01,FIN,Negeri Sembilan,0,0,0
2021-07-01,FIN,Pahang,0,0,0
2021-07-01,FIN,Perak,0,0,0
2021-07-01,FIN,Perlis,0,0,0
2021-07-01,FIN,Pulau Pinang,0,0,0
2021-07-01,FIN,Sabah,0,0,0
2021-07-01,FIN,Sarawak,0,0,0
2021-07-01,FIN,Selangor,16,13,3
2021-07-01,FIN,W.P. Labuan,0,0,0
2021-07-01,FJI,Johor,0,0,0
2021-07-01,FJI,Kedah,0,0,0
2021-07-01,FJI,Kelantan,0,0,0
2021-07-01,FJI,Perak,0,0,0
2021-07-01,FJI,Perlis,0,0,0
2021-07-01,FJI,Pulau Pinang,0,0,0
2021-07-01,FJI,Sabah,0,0,0
2021-07-01,FJI,Sarawak,0,0,0
2021-07-01,FJI,Selangor,0,0,0
2021-07-01,FRA,Johor,0,0,0
2021-07-01,FRA,Kedah,0,0,0
2021-07-01,FRA,Kelantan,0,0,0
2021-07-01,FRA,Melaka,0,0,0
2021-07-01,FRA,Negeri Sembilan,0,0,0
2021-07-01,FRA,Pahang,0,0,0
2021-07-01,FRA,Perak,0,0,0
2021-07-01,FRA,Perlis,0,0,0
2021-07-01,FRA,Pulau Pinang,1,1,0
2021-07-01,FRA,Sabah,0,0,0
2021-07-01,FRA,Sarawak,2,2,0
2021-07-01,FRA,Selangor,99,72,27
2021-07-01,FRA,Terengganu,0,0,0
2021-07-01,FRA,W.P. Labuan,0,0,0
2021-07-01,FSM,Johor,0,0,0
2021-07-01,FSM,Pulau Pinang,0,0,0
2021-07-01,FSM,Selangor,0,0,0
2021-07-01,GAB,Johor,0,0,0
2021-07-01,GAB,Pulau Pinang,0,0,0
2021-07-01,GAB,Sarawak,0,0,0
2021-07-01,GAB,Selangor,0,0,0
2021-07-01,GBR,Johor,1,1,0
2021-07-01,GBR,Kedah,0,0,0
2021-07-01,GBR,Kelantan,0,0,0
2021-07-01,GBR,Melaka,0,0,0
2021-07-01,GBR,Negeri Sembilan,0,0,0
2021-07-01,GBR,Pahang,0,0,0
2021-07-01,GBR,Perak,0,0,0
2021-07-01,GBR,Perlis,0,0,0
2021-07-01,GBR,Pulau Pinang,7,4,3
2021-07-01,GBR,Sabah,0,0,0
2021-07-01,GBR,Sarawak,2,1,1
2021-07-01,GBR,Selangor,386,249,137
2021-07-01,GBR,Terengganu,0,0,0
2021-07-01,GBR,W.P. Labuan,0,0,0
2021-07-01,GEO,Johor,0,0,0
2021-07-01,GEO,Kedah,0,0,0
2021-07-01,GEO,Melaka,0,0,0
2021-07-01,GEO,Perak,0,0,0
2021-07-01,GEO,Perlis,0,0,0
2021-07-01,GEO,Pulau Pinang,0,0,0
2021-07-01,GEO,Sabah,0,0,0
2021-07-01,GEO,Sarawak,0,0,0
2021-07-01,GEO,Selangor,2,2,0
2021-07-01,GHA,Johor,0,0,0
2021-07-01,GHA,Kedah,0,0,0
2021-07-01,GHA,Kelantan,0,0,0
2021-07-01,GHA,Pulau Pinang,0,0,0
2021-07-01,GHA,Sabah,0,0,0
2021-07-01,GHA,Sarawak,0,0,0
2021-07-01,GHA,Selangor,2,2,0
2021-07-01,GIB,Johor,0,0,0
2021-07-01,GIB,Sarawak,0,0,0
2021-07-01,GIN,Johor,0,0,0
2021-07-01,GIN,Kedah,0,0,0
2021-07-01,GIN,Kelantan,0,0,0
2021-07-01,GIN,Perlis,0,0,0
2021-07-01,GIN,Pulau Pinang,0,0,0
2021-07-01,GIN,Sabah,0,0,0
2021-07-01,GIN,Sarawak,0,0,0
2021-07-01,GIN,Selangor,1,1,0
2021-07-01,GLP,Selangor,0,0,0
2021-07-01,GMB,Johor,0,0,0
2021-07-01,GMB,Kedah,0,0,0
2021-07-01,GMB,Kelantan,0,0,0
2021-07-01,GMB,Pulau Pinang,0,0,0
2021-07-01,GMB,Sabah,0,0,0
2021-07-01,GMB,Sarawak,0,0,0
2021-07-01,GMB,Selangor,0,0,0
2021-07-01,GNB,Johor,0,0,0
2021-07-01,GNB,Selangor,0,0,0
2021-07-01,GNQ,Johor,0,0,0
2021-07-01,GNQ,Selangor,0,0,0
2021-07-01,GRC,Johor,1,1,0
2021-07-01,GRC,Kedah,0,0,0
2021-07-01,GRC,Kelantan,0,0,0
2021-07-01,GRC,Melaka,0,0,0
2021-07-01,GRC,Negeri Sembilan,0,0,0
2021-07-01,GRC,Pahang,0,0,0
2021-07-01,GRC,Perak,0,0,0
2021-07-01,GRC,Perlis,0,0,0
2021-07-01,GRC,Pulau Pinang,0,0,0
2021-07-01,GRC,Sabah,0,0,0
2021-07-01,GRC,Sarawak,0,0,0
2021-07-01,GRC,Selangor,11,10,1
2021-07-01,GRD,Johor,0,0,0
2021-07-01,GRD,Kedah,0,0,0
2021-07-01,GRD,Pulau Pinang,0,0,0
2021-07-01,GRD,Sabah,0,0,0
2021-07-01,GRD,Sarawak,0,0,0
2021-07-01,GRD,Selangor,0,0,0
2021-07-01,GRL,Johor,0,0,0
2021-07-01,GRL,Selangor,0,0,0
2021-07-01,GTM,Johor,0,0,0
2021-07-01,GTM,Kedah,0,0,0
2021-07-01,GTM,Pahang,0,0,0
2021-07-01,GTM,Perak,0,0,0
2021-07-01,GTM,Pulau Pinang,0,0,0
2021-07-01,GTM,Sabah,0,0,0
2021-07-01,GTM,Sarawak,0,0,0
2021-07-01,GTM,Selangor,0,0,0
2021-07-01,GTM,W.P. Labuan,0,0,0
2021-07-01,GUY,Johor,0,0,0
2021-07-01,GUY,Kedah,0,0,0
2021-07-01,GUY,Pulau Pinang,0,0,0
2021-07-01,GUY,Sarawak,0,0,0
2021-07-01,GUY,Selangor,0,0,0
2021-07-01,HKG,Johor,0,0,0
2021-07-01,HKG,Kedah,0,0,0
2021-07-01,HKG,Kelantan,0,0,0
2021-07-01,HKG,Pahang,0,0,0
2021-07-01,HKG,Perak,0,0,0
2021-07-01,HKG,Perlis,0,0,0
2021-07-01,HKG,Pulau Pinang,2,1,1
2021-07-01,HKG,Sabah,0,0,0
2021-07-01,HKG,Sarawak,0,0,0
2021-07-01,HKG,Selangor,0,0,0
2021-07-01,HKG,Terengganu,0,0,0
2021-07-01,HMD,Johor,0,0,0
2021-07-01,HND,Johor,0,0,0
2021-07-01,HND,Kedah,0,0,0
2021-07-01,HND,Perak,0,0,0
2021-07-01,HND,Pulau Pinang,0,0,0
2021-07-01,HND,Sabah,0,0,0
2021-07-01,HND,Sarawak,0,0,0
2021-07-01,HND,Selangor,0,0,0
2021-07-01,HRV,Johor,0,0,0
2021-07-01,HRV,Kedah,0,0,0
2021-07-01,HRV,Kelantan,0,0,0
2021-07-01,HRV,Melaka,0,0,0
2021-07-01,HRV,Pahang,0,0,0
2021-07-01,HRV,Perak,0,0,0
2021-07-01,HRV,Perlis,0,0,0
2021-07-01,HRV,Pulau Pinang,0,0,0
2021-07-01,HRV,Sabah,0,0,0
2021-07-01,HRV,Sarawak,0,0,0
2021-07-01,HRV,Selangor,13,13,0
2021-07-01,HTI,Johor,0,0,0
2021-07-01,HTI,Kedah,0,0,0
2021-07-01,HTI,Kelantan,0,0,0
2021-07-01,HTI,Perak,0,0,0
2021-07-01,HTI,Pulau Pinang,0,0,0
2021-07-01,HTI,Sabah,0,0,0
2021-07-01,HTI,Selangor,0,0,0
2021-07-01,HUN,Johor,0,0,0
2021-07-01,HUN,Kedah,0,0,0
2021-07-01,HUN,Kelantan,0,0,0
2021-07-01,HUN,Pahang,0,0,0
2021-07-01,HUN,Perak,0,0,0
2021-07-01,HUN,Perlis,0,0,0
2021-07-01,HUN,Pulau Pinang,0,0,0
2021-07-01,HUN,Sabah,0,0,0
2021-07-01,HUN,Sarawak,0,0,0
2021-07-01,HUN,Selangor,4,3,1
2021-07-01,HUN,W.P. Labuan,0,0,0
2021-07-01,IDN,Johor,59,49,10
2021-07-01,IDN,Kedah,8,8,0
2021-07-01,IDN,Kelantan,0,0,0
2021-07-01,IDN,Melaka,2,1,1
2021-07-01,IDN,Negeri Sembilan,0,0,0
2021-07-01,IDN,Pahang,0,0,0
2021-07-01,IDN,Perak,0,0,0
2021-07-01,IDN,Perlis,3,3,0
2021-07-01,IDN,Pulau Pinang,32,7,25
2021-07-01,IDN,Sabah,0,0,0
2021-07-01,IDN,Sarawak,347,343,4
2021-07-01,IDN,Selangor,669,548,121
2021-07-01,IDN,Terengganu,0,0,0
2021-07-01,IDN,W.P. Labuan,6,6,0
2021-07-01,IND,Johor,1,1,0
2021-07-01,IND,Kedah,0,0,0
2021-07-01,IND,Kelantan,0,0,0
2021-07-01,IND,Melaka,0,0,0
2021-07-01,IND,Negeri Sembilan,0,0,0
2021-07-01,IND,Pahang,0,0,0
2021-07-01,IND,Perak,0,0,0
2021-07-01,IND,Perlis,0,0,0
2021-07-01,IND,Pulau Pinang,0,0,0
2021-07-01,IND,Sabah,0,0,0
2021-07-01,IND,Sarawak,0,0,0
2021-07-01,IND,Selangor,47,25,22
2021-07-01,IND,Terengganu,0,0,0
2021-07-01,IND,W.P. Labuan,0,0,0
2021-07-01,IOT,Pulau Pinang,0,0,0
2021-07-01,IOT,Selangor,0,0,0
2021-07-01,IRL,Johor,0,0,0
2021-07-01,IRL,Kedah,0,0,0
2021-07-01,IRL,Kelantan,0,0,0
2021-07-01,IRL,Negeri Sembilan,0,0,0
2021-07-01,IRL,Pahang,0,0,0
2021-07-01,IRL,Perak,0,0,0
2021-07-01,IRL,Perlis,0,0,0
2021-07-01,IRL,Pulau Pinang,0,0,0
2021-07-01,IRL,Sabah,0,0,0
2021-07-01,IRL,Sarawak,0,0,0
2021-07-01,IRL,Selangor,20,12,8
2021-07-01,IRL,Terengganu,0,0,0
2021-07-01,IRL,W.P. Labuan,0,0,0
2021-07-01,IRN,Johor,0,0,0
2021-07-01,IRN,Kedah,0,0,0
2021-07-01,IRN,Kelantan,0,0,0
2021-07-01,IRN,Perak,0,0,0
2021-07-01,IRN,Perlis,0,0,0
2021-07-01,IRN,Pulau Pinang,0,0,0
2021-07-01,IRN,Sabah,0,0,0
2021-07-01,IRN,Sarawak,0,0,0
2021-07-01,IRN,Selangor,23,14,9
2021-07-01,IRN,W.P. Labuan,0,0,0
2021-07-01,IRQ,Johor,0,0,0
2021-07-01,IRQ,Kedah,0,0,0
2021-07-01,IRQ,Kelantan,0,0,0
2021-07-01,IRQ,Melaka,0,0,0
2021-07-01,IRQ,Pahang,0,0,0
2021-07-01,IRQ,Perak,0,0,0
2021-07-01,IRQ,Perlis,0,0,0
2021-07-01,IRQ,Pulau Pinang,0,0,0
2021-07-01,IRQ,Sabah,0,0,0
2021-07-01,IRQ,Sarawak,0,0,0
2021-07-01,IRQ,Selangor,16,12,4
2021-07-01,ISL,Johor,0,0,0
2021-07-01,ISL,Kedah,0,0,0
2021-07-01,ISL,Kelantan,0,0,0
2021-07-01,ISL,Perak,0,0,0
2021-07-01,ISL,Perlis,0,0,0
2021-07-01,ISL,Pulau Pinang,0,0,0
2021-07-01,ISL,Sabah,0,0,0
2021-07-01,ISL,Sarawak,0,0,0
2021-07-01,ISL,Selangor,0,0,0
2021-07-01,ISL,W.P. Labuan,0,0,0
2021-07-01,ISR,Pulau Pinang,0,0,0
2021-07-01,ITA,Johor,0,0,0
2021-07-01,ITA,Kedah,0,0,0
2021-07-01,ITA,Kelantan,0,0,0
2021-07-01,ITA,Melaka,0,0,0
2021-07-01,ITA,Negeri Sembilan,0,0,0
2021-07-01,ITA,Pahang,0,0,0
2021-07-01,ITA,Perak,0,0,0
2021-07-01,ITA,Perlis,0,0,0
2021-07-01,ITA,Pulau Pinang,0,0,0
2021-07-01,ITA,Sabah,0,0,0
2021-07-01,ITA,Sarawak,0,0,0
2021-07-01,ITA,Selangor,29,25,4
2021-07-01,ITA,W.P. Labuan,0,0,0
2021-07-01,JAM,Johor,0,0,0
2021-07-01,JAM,Kedah,0,0,0
2021-07-01,JAM,Perak,0,0,0
2021-07-01,JAM,Pulau Pinang,0,0,0
2021-07-01,JAM,Sabah,0,0,0
2021-07-01,JAM,Sarawak,0,0,0
2021-07-01,JAM,Selangor,0,0,0
2021-07-01,JAM,W.P. Labuan,0,0,0
2021-07-01,JOR,Johor,0,0,0
2021-07-01,JOR,Kedah,0,0,0
2021-07-01,JOR,Kelantan,0,0,0
2021-07-01,JOR,Melaka,0,0,0
2021-07-01,JOR,Perlis,0,0,0
2021-07-01,JOR,Pulau Pinang,0,0,0
2021-07-01,JOR,Sabah,0,0,0
2021-07-01,JOR,Sarawak,0,0,0
2021-07-01,JOR,Selangor,8,7,1
2021-07-01,JOR,W.P. Labuan,0,0,0
2021-07-01,JPN,Johor,0,0,0
2021-07-01,JPN,Kedah,0,0,0
2021-07-01,JPN,Kelantan,0,0,0
2021-07-01,JPN,Melaka,0,0,0
2021-07-01,JPN,Negeri Sembilan,0,0,0
2021-07-01,JPN,Pahang,0,0,0
2021-07-01,JPN,Perak,0,0,0
2021-07-01,JPN,Perlis,0,0,0
2021-07-01,JPN,Pulau Pinang,16,8,8
2021-07-01,JPN,Sabah,0,0,0
2021-07-01,JPN,Sarawak,8,8,0
2021-07-01,JPN,Selangor,281,159,122
2021-07-01,JPN,W.P. Labuan,0,0,0
2021-07-01,KAZ,Johor,0,0,0
2021-07-01,KAZ,Kedah,0,0,0
2021-07-01,KAZ,Kelantan,0,0,0
2021-07-01,KAZ,Melaka,0,0,0
2021-07-01,KAZ,Perak,0,0,0
2021-07-01,KAZ,Perlis,0,0,0
2021-07-01,KAZ,Pulau Pinang,0,0,0
2021-07-01,KAZ,Sabah,0,0,0
2021-07-01,KAZ,Sarawak,0,0,0
2021-07-01,KAZ,Selangor,7,5,2
2021-07-01,KAZ,W.P. Labuan,0,0,0
2021-07-01,KEN,Johor,0,0,0
2021-07-01,KEN,Kedah,0,0,0
2021-07-01,KEN,Kelantan,0,0,0
2021-07-01,KEN,Perak,0,0,0
2021-07-01,KEN,Perlis,0,0,0
2021-07-01,KEN,Pulau Pinang,0,0,0
2021-07-01,KEN,Sabah,0,0,0
2021-07-01,KEN,Sarawak,0,0,0
2021-07-01,KEN,Selangor,8,3,5
2021-07-01,KGZ,Johor,0,0,0
2021-07-01,KGZ,Kedah,0,0,0
2021-07-01,KGZ,Kelantan,0,0,0
2021-07-01,KGZ,Perak,0,0,0
2021-07-01,KGZ,Perlis,0,0,0
2021-07-01,KGZ,Pulau Pinang,0,0,0
2021-07-01,KGZ,Sabah,0,0,0
2021-07-01,KGZ,Sarawak,0,0,0
2021-07-01,KGZ,Selangor,6,2,4
2021-07-01,KHM,Johor,0,0,0
2021-07-01,KHM,Kedah,0,0,0
2021-07-01,KHM,Kelantan,0,0,0
2021-07-01,KHM,Melaka,0,0,0
2021-07-01,KHM,Negeri Sembilan,0,0,0
2021-07-01,KHM,Pahang,0,0,0
2021-07-01,KHM,Perak,0,0,0
2021-07-01,KHM,Perlis,0,0,0
2021-07-01,KHM,Pulau Pinang,0,0,0
2021-07-01,KHM,Sabah,0,0,0
2021-07-01,KHM,Sarawak,0,0,0
2021-07-01,KHM,Selangor,118,115,3
2021-07-01,KHM,W.P. Labuan,0,0,0
2021-07-01,KIR,Johor,0,0,0
2021-07-01,KIR,Sabah,0,0,0
2021-07-01,KIR,Selangor,4,4,0
2021-07-01,KNA,Johor,0,0,0
2021-07-01,KNA,Kedah,0,0,0
2021-07-01,KNA,Perlis,0,0,0
2021-07-01,KNA,Pulau Pinang,0,0,0
2021-07-01,KNA,Sabah,0,0,0
2021-07-01,KNA,Selangor,0,0,0
2021-07-01,KNA,W.P. Labuan,0,0,0
2021-07-01,KOR,Johor,1,1,0
2021-07-01,KOR,Kedah,0,0,0
2021-07-01,KOR,Kelantan,0,0,0
2021-07-01,KOR,Melaka,0,0,0
2021-07-01,KOR,Negeri Sembilan,0,0,0
2021-07-01,KOR,Pahang,0,0,0
2021-07-01,KOR,Perak,0,0,0
2021-07-01,KOR,Perlis,0,0,0
2021-07-01,KOR,Pulau Pinang,9,5,4
2021-07-01,KOR,Sabah,0,0,0
2021-07-01,KOR,Sarawak,13,8,5
2021-07-01,KOR,Selangor,259,180,79
2021-07-01,KOR,Terengganu,0,0,0
2021-07-01,KOR,W.P. Labuan,0,0,0
2021-07-01,KWT,Johor,0,0,0
2021-07-01,KWT,Kedah,0,0,0
2021-07-01,KWT,Kelantan,0,0,0
2021-07-01,KWT,Perak,0,0,0
2021-07-01,KWT,Perlis,0,0,0
2021-07-01,KWT,Pulau Pinang,0,0,0
2021-07-01,KWT,Sabah,0,0,0
2021-07-01,KWT,Sarawak,0,0,0
2021-07-01,KWT,Selangor,8,3,5
2021-07-01,KWT,W.P. Labuan,0,0,0
2021-07-01,LAO,Johor,0,0,0
2021-07-01,LAO,Kedah,0,0,0
2021-07-01,LAO,Kelantan,0,0,0
2021-07-01,LAO,Melaka,0,0,0
2021-07-01,LAO,Perak,0,0,0
2021-07-01,LAO,Perlis,0,0,0
2021-07-01,LAO,Pulau Pinang,0,0,0
2021-07-01,LAO,Sabah,0,0,0
2021-07-01,LAO,Sarawak,0,0,0
2021-07-01,LAO,Selangor,96,95,1
2021-07-01,LAO,W.P. Labuan,0,0,0
2021-07-01,LBN,Johor,0,0,0
2021-07-01,LBN,Kedah,0,0,0
2021-07-01,LBN,Kelantan,0,0,0
2021-07-01,LBN,Pahang,0,0,0
2021-07-01,LBN,Perak,0,0,0
2021-07-01,LBN,Perlis,0,0,0
2021-07-01,LBN,Pulau Pinang,0,0,0
2021-07-01,LBN,Sabah,0,0,0
2021-07-01,LBN,Sarawak,0,0,0
2021-07-01,LBN,Selangor,2,2,0
2021-07-01,LBN,W.P. Labuan,0,0,0
2021-07-01,LBR,Johor,0,0,0
2021-07-01,LBR,Kedah,0,0,0
2021-07-01,LBR,Sabah,0,0,0
2021-07-01,LBR,Sarawak,0,0,0
2021-07-01,LBR,Selangor,1,0,1
2021-07-01,LBY,Johor,0,0,0
2021-07-01,LBY,Kedah,0,0,0
2021-07-01,LBY,Perlis,0,0,0
2021-07-01,LBY,Pulau Pinang,0,0,0
2021-07-01,LBY,Sabah,0,0,0
2021-07-01,LBY,Sarawak,0,0,0
2021-07-01,LBY,Selangor,14,13,1
2021-07-01,LCA,Johor,0,0,0
2021-07-01,LCA,Kedah,0,0,0
2021-07-01,LCA,Pulau Pinang,0,0,0
2021-07-01,LCA,Sarawak,0,0,0
2021-07-01,LCA,Selangor,0,0,0
2021-07-01,LIE,Johor,0,0,0
2021-07-01,LIE,Kedah,0,0,0
2021-07-01,LIE,Perlis,0,0,0
2021-07-01,LIE,Pulau Pinang,0,0,0
2021-07-01,LIE,Sabah,0,0,0
2021-07-01,LIE,Sarawak,0,0,0
2021-07-01,LIE,Selangor,0,0,0
2021-07-01,LKA,Johor,0,0,0
2021-07-01,LKA,Kedah,0,0,0
2021-07-01,LKA,Kelantan,0,0,0
2021-07-01,LKA,Melaka,0,0,0
2021-07-01,LKA,Pahang,0,0,0
2021-07-01,LKA,Perak,0,0,0
2021-07-01,LKA,Perlis,0,0,0
2021-07-01,LKA,Pulau Pinang,0,0,0
2021-07-01,LKA,Sabah,0,0,0
2021-07-01,LKA,Sarawak,0,0,0
2021-07-01,LKA,Selangor,8,4,4
2021-07-01,LKA,W.P. Labuan,0,0,0
2021-07-01,LSO,Johor,0,0,0
2021-07-01,LSO,Kedah,0,0,0
2021-07-01,LSO,Pulau Pinang,0,0,0
2021-07-01,LSO,Sarawak,0,0,0
2021-07-01,LSO,Selangor,0,0,0
2021-07-01,LTU,Johor,0,0,0
2021-07-01,LTU,Kedah,0,0,0
2021-07-01,LTU,Kelantan,0,0,0
2021-07-01,LTU,Pahang,0,0,0
2021-07-01,LTU,Perak,0,0,0
2021-07-01,LTU,Perlis,0,0,0
2021-07-01,LTU,Pulau Pinang,0,0,0
2021-07-01,LTU,Sabah,0,0,0
2021-07-01,LTU,Sarawak,0,0,0
2021-07-01,LTU,Selangor,1,1,0
2021-07-01,LTU,W.P. Labuan,0,0,0
2021-07-01,LUX,Johor,0,0,0
2021-07-01,LUX,Kedah,0,0,0
2021-07-01,LUX,Kelantan,0,0,0
2021-07-01,LUX,Perak,0,0,0
2021-07-01,LUX,Perlis,0,0,0
2021-07-01,LUX,Pulau Pinang,0,0,0
2021-07-01,LUX,Sabah,0,0,0
2021-07-01,LUX,Sarawak,0,0,0
2021-07-01,LUX,Selangor,0,0,0
2021-07-01,LVA,Johor,0,0,0
2021-07-01,LVA,Kedah,0,0,0
2021-07-01,LVA,Kelantan,0,0,0
2021-07-01,LVA,Pahang,0,0,0
2021-07-01,LVA,Perak,0,0,0
2021-07-01,LVA,Perlis,0,0,0
2021-07-01,LVA,Pulau Pinang,0,0,0
2021-07-01,LVA,Sabah,0,0,0
2021-07-01,LVA,Sarawak,0,0,0
2021-07-01,LVA,Selangor,0,0,0
2021-07-01,LVA,W.P. Labuan,0,0,0
2021-07-01,MAC,Johor,0,0,0
2021-07-01,MAC,Pahang,0,0,0
2021-07-01,MAC,Perak,0,0,0
2021-07-01,MAC,Selangor,0,0,0
2021-07-01,MAC,W.P. Labuan,0,0,0
2021-07-01,MAR,Johor,0,0,0
2021-07-01,MAR,Kedah,0,0,0
2021-07-01,MAR,Kelantan,0,0,0
2021-07-01,MAR,Melaka,0,0,0
2021-07-01,MAR,Pahang,0,0,0
2021-07-01,MAR,Perak,0,0,0
2021-07-01,MAR,Perlis,0,0,0
2021-07-01,MAR,Pulau Pinang,0,0,0
2021-07-01,MAR,Sabah,0,0,0
2021-07-01,MAR,Sarawak,0,0,0
2021-07-01,MAR,Selangor,0,0,0
2021-07-01,MAR,W.P. Labuan,0,0,0
2021-07-01,MCO,Johor,0,0,0
2021-07-01,MCO,Kedah,0,0,0
2021-07-01,MCO,Sabah,0,0,0
2021-07-01,MCO,Selangor,0,0,0
2021-07-01,MDA,Johor,0,0,0
2021-07-01,MDA,Kedah,0,0,0
2021-07-01,MDA,Kelantan,0,0,0
2021-07-01,MDA,Negeri Sembilan,0,0,0
2021-07-01,MDA,Perlis,0,0,0
2021-07-01,MDA,Pulau Pinang,0,0,0
2021-07-01,MDA,Sabah,0,0,0
2021-07-01,MDA,Sarawak,0,0,0
2021-07-01,MDA,Selangor,0,0,0
2021-07-01,MDG,Johor,0,0,0
2021-07-01,MDG,Kedah,0,0,0
2021-07-01,MDG,Perak,0,0,0
2021-07-01,MDG,Perlis,0,0,0
2021-07-01,MDG,Pulau Pinang,0,0,0
2021-07-01,MDG,Sabah,0,0,0
2021-07-01,MDG,Sarawak,0,0,0
2021-07-01,MDG,Selangor,0,0,0
2021-07-01,MDV,Johor,0,0,0
2021-07-01,MDV,Kedah,0,0,0
2021-07-01,MDV,Kelantan,0,0,0
2021-07-01,MDV,Perak,0,0,0
2021-07-01,MDV,Perlis,0,0,0
2021-07-01,MDV,Pulau Pinang,0,0,0
2021-07-01,MDV,Sabah,0,0,0
2021-07-01,MDV,Sarawak,0,0,0
2021-07-01,MDV,Selangor,24,8,16
2021-07-01,MEX,Johor,0,0,0
2021-07-01,MEX,Kedah,0,0,0
2021-07-01,MEX,Kelantan,0,0,0
2021-07-01,MEX,Pahang,0,0,0
2021-07-01,MEX,Perak,0,0,0
2021-07-01,MEX,Perlis,0,0,0
2021-07-01,MEX,Pulau Pinang,0,0,0
2021-07-01,MEX,Sabah,0,0,0
2021-07-01,MEX,Sarawak,0,0,0
2021-07-01,MEX,Selangor,13,9,4
2021-07-01,MEX,W.P. Labuan,0,0,0
2021-07-01,MHL,Johor,0,0,0
2021-07-01,MHL,Kedah,0,0,0
2021-07-01,MHL,Perak,0,0,0
2021-07-01,MHL,Pulau Pinang,0,0,0
2021-07-01,MHL,Sabah,0,0,0
2021-07-01,MHL,Selangor,0,0,0
2021-07-01,MKD,Johor,0,0,0
2021-07-01,MKD,Kedah,0,0,0
2021-07-01,MKD,Perak,0,0,0
2021-07-01,MKD,Pulau Pinang,0,0,0
2021-07-01,MKD,Sabah,0,0,0
2021-07-01,MKD,Sarawak,0,0,0
2021-07-01,MKD,Selangor,0,0,0
2021-07-01,MLI,Johor,0,0,0
2021-07-01,MLI,Sabah,0,0,0
2021-07-01,MLI,Selangor,0,0,0
2021-07-01,MLT,Johor,0,0,0
2021-07-01,MLT,Kedah,0,0,0
2021-07-01,MLT,Kelantan,0,0,0
2021-07-01,MLT,Perak,0,0,0
2021-07-01,MLT,Perlis,0,0,0
2021-07-01,MLT,Pulau Pinang,0,0,0
2021-07-01,MLT,Sabah,0,0,0
2021-07-01,MLT,Sarawak,0,0,0
2021-07-01,MLT,Selangor,0,0,0
2021-07-01,MLT,W.P. Labuan,0,0,0
2021-07-01,MMR,Johor,0,0,0
2021-07-01,MMR,Kedah,0,0,0
2021-07-01,MMR,Kelantan,0,0,0
2021-07-01,MMR,Negeri Sembilan,0,0,0
2021-07-01,MMR,Pahang,0,0,0
2021-07-01,MMR,Perak,0,0,0
2021-07-01,MMR,Perlis,0,0,0
2021-07-01,MMR,Pulau Pinang,0,0,0
2021-07-01,MMR,Sabah,0,0,0
2021-07-01,MMR,Sarawak,0,0,0
2021-07-01,MMR,Selangor,112,105,7
2021-07-01,MMR,Terengganu,0,0,0
2021-07-01,MMR,W.P. Labuan,0,0,0
2021-07-01,MNE,Johor,0,0,0
2021-07-01,MNE,Kedah,0,0,0
2021-07-01,MNE,Pulau Pinang,0,0,0
2021-07-01,MNE,Sabah,0,0,0
2021-07-01,MNE,Sarawak,0,0,0
2021-07-01,MNE,Selangor,5,4,1
2021-07-01,MNG,Johor,0,0,0
2021-07-01,MNG,Kedah,0,0,0
2021-07-01,MNG,Kelantan,0,0,0
2021-07-01,MNG,Perak,0,0,0
2021-07-01,MNG,Perlis,0,0,0
2021-07-01,MNG,Pulau Pinang,0,0,0
2021-07-01,MNG,Sabah,0,0,0
2021-07-01,MNG,Sarawak,0,0,0
2021-07-01,MNG,Selangor,0,0,0
2021-07-01,MNP,Selangor,0,0,0
2021-07-01,MOZ,Johor,0,0,0
2021-07-01,MOZ,Kedah,0,0,0
2021-07-01,MOZ,Perak,0,0,0
2021-07-01,MOZ,Pulau Pinang,0,0,0
2021-07-01,MOZ,Sabah,0,0,0
2021-07-01,MOZ,Sarawak,0,0,0
2021-07-01,MOZ,Selangor,0,0,0
2021-07-01,MRT,Johor,0,0,0
2021-07-01,MRT,Kedah,0,0,0
2021-07-01,MRT,Pulau Pinang,0,0,0
2021-07-01,MRT,Sabah,0,0,0
2021-07-01,MRT,Sarawak,0,0,0
2021-07-01,MRT,Selangor,1,1,0
2021-07-01,MUS,Johor,0,0,0
2021-07-01,MUS,Kedah,0,0,0
2021-07-01,MUS,Kelantan,0,0,0
2021-07-01,MUS,Pahang,0,0,0
2021-07-01,MUS,Perak,0,0,0
2021-07-01,MUS,Perlis,0,0,0
2021-07-01,MUS,Pulau Pinang,0,0,0
2021-07-01,MUS,Sabah,0,0,0
2021-07-01,MUS,Sarawak,0,0,0
2021-07-01,MUS,Selangor,5,4,1
2021-07-01,MWI,Johor,0,0,0
2021-07-01,MWI,Pulau Pinang,0,0,0
2021-07-01,MWI,Sabah,0,0,0
2021-07-01,MWI,Sarawak,0,0,0
2021-07-01,MWI,Selangor,1,1,0
2021-07-01,MYT,Selangor,0,0,0
2021-07-01,NAM,Johor,0,0,0
2021-07-01,NAM,Kedah,0,0,0
2021-07-01,NAM,Perak,0,0,0
2021-07-01,NAM,Perlis,0,0,0
2021-07-01,NAM,Pulau Pinang,0,0,0
2021-07-01,NAM,Sabah,0,0,0
2021-07-01,NAM,Sarawak,0,0,0
2021-07-01,NAM,Selangor,0,0,0
2021-07-01,NCL,Selangor,0,0,0
2021-07-01,NER,Johor,0,0,0
2021-07-01,NER,Sabah,0,0,0
2021-07-01,NER,Selangor,0,0,0
2021-07-01,NGA,Johor,0,0,0
2021-07-01,NGA,Kedah,0,0,0
2021-07-01,NGA,Perlis,0,0,0
2021-07-01,NGA,Pulau Pinang,0,0,0
2021-07-01,NGA,Sabah,0,0,0
2021-07-01,NGA,Sarawak,0,0,0
2021-07-01,NGA,Selangor,65,58,7
2021-07-01,NIC,Johor,0,0,0
2021-07-01,NIC,Kedah,0,0,0
2021-07-01,NIC,Pulau Pinang,0,0,0
2021-07-01,NIC,Sabah,0,0,0
2021-07-01,NIC,Selangor,3,1,2
2021-07-01,NLD,Johor,0,0,0
2021-07-01,NLD,Kedah,0,0,0
2021-07-01,NLD,Kelantan,0,0,0
2021-07-01,NLD,Melaka,0,0,0
2021-07-01,NLD,Negeri Sembilan,0,0,0
2021-07-01,NLD,Pahang,0,0,0
2021-07-01,NLD,Perak,0,0,0
2021-07-01,NLD,Perlis,0,0,0
2021-07-01,NLD,Pulau Pinang,2,1,1
2021-07-01,NLD,Sabah,0,0,0
2021-07-01,NLD,Sarawak,1,1,0
2021-07-01,NLD,Selangor,54,36,18
2021-07-01,NLD,Terengganu,0,0,0
2021-07-01,NLD,W.P. Labuan,0,0,0
2021-07-01,NOR,Johor,0,0,0
2021-07-01,NOR,Kedah,0,0,0
2021-07-01,NOR,Kelantan,0,0,0
2021-07-01,NOR,Melaka,0,0,0
2021-07-01,NOR,Pahang,0,0,0
2021-07-01,NOR,Perak,0,0,0
2021-07-01,NOR,Perlis,0,0,0
2021-07-01,NOR,Pulau Pinang,0,0,0
2021-07-01,NOR,Sabah,0,0,0
2021-07-01,NOR,Sarawak,0,0,0
2021-07-01,NOR,Selangor,13,9,4
2021-07-01,NOR,W.P. Labuan,0,0,0
2021-07-01,NPL,Johor,0,0,0
2021-07-01,NPL,Kedah,0,0,0
2021-07-01,NPL,Pahang,0,0,0
2021-07-01,NPL,Perak,0,0,0
2021-07-01,NPL,Perlis,0,0,0
2021-07-01,NPL,Pulau Pinang,0,0,0
2021-07-01,NPL,Sabah,0,0,0
2021-07-01,NPL,Sarawak,0,0,0
2021-07-01,NPL,Selangor,1,1,0
2021-07-01,NPL,W.P. Labuan,0,0,0
2021-07-01,NRU,Johor,0,0,0
2021-07-01,NRU,Pulau Pinang,0,0,0
2021-07-01,NRU,Selangor,0,0,0
2021-07-01,NZL,Johor,0,0,0
2021-07-01,NZL,Kedah,0,0,0
2021-07-01,NZL,Kelantan,0,0,0
2021-07-01,NZL,Melaka,0,0,0
2021-07-01,NZL,Negeri Sembilan,0,0,0
2021-07-01,NZL,Pahang,0,0,0
2021-07-01,NZL,Perak,0,0,0
2021-07-01,NZL,Perlis,0,0,0
2021-07-01,NZL,Pulau Pinang,2,2,0
2021-07-01,NZL,Sabah,0,0,0
2021-07-01,NZL,Sarawak,0,0,0
2021-07-01,NZL,Selangor,23,17,6
2021-07-01,NZL,Terengganu,0,0,0
2021-07-01,NZL,W.P. Labuan,0,0,0
2021-07-01,OMN,Johor,0,0,0
2021-07-01,OMN,Kedah,0,0,0
2021-07-01,OMN,Kelantan,0,0,0
2021-07-01,OMN,Melaka,0,0,0
2021-07-01,OMN,Perak,0,0,0
2021-07-01,OMN,Perlis,0,0,0
2021-07-01,OMN,Pulau Pinang,0,0,0
2021-07-01,OMN,Sabah,0,0,0
2021-07-01,OMN,Sarawak,0,0,0
2021-07-01,OMN,Selangor,9,8,1
2021-07-01,PAK,Johor,0,0,0
2021-07-01,PAK,Kedah,0,0,0
2021-07-01,PAK,Kelantan,0,0,0
2021-07-01,PAK,Melaka,0,0,0
2021-07-01,PAK,Negeri Sembilan,0,0,0
2021-07-01,PAK,Pahang,0,0,0
2021-07-01,PAK,Perak,0,0,0
2021-07-01,PAK,Perlis,0,0,0
2021-07-01,PAK,Pulau Pinang,0,0,0
2021-07-01,PAK,Sabah,0,0,0
2021-07-01,PAK,Sarawak,0,0,0
2021-07-01,PAK,Selangor,6,5,1
2021-07-01,PAK,W.P. Labuan,0,0,0
2021-07-01,PAN,Johor,0,0,0
2021-07-01,PAN,Kedah,0,0,0
2021-07-01,PAN,Perak,0,0,0
2021-07-01,PAN,Perlis,0,0,0
2021-07-01,PAN,Pulau Pinang,0,0,0
2021-07-01,PAN,Sabah,0,0,0
2021-07-01,PAN,Sarawak,0,0,0
2021-07-01,PAN,Selangor,5,4,1
2021-07-01,PER,Johor,0,0,0
2021-07-01,PER,Kedah,0,0,0
2021-07-01,PER,Kelantan,0,0,0
2021-07-01,PER,Pahang,0,0,0
2021-07-01,PER,Perak,0,0,0
2021-07-01,PER,Perlis,0,0,0
2021-07-01,PER,Pulau Pinang,0,0,0
2021-07-01,PER,Sabah,0,0,0
2021-07-01,PER,Sarawak,0,0,0
2021-07-01,PER,Selangor,1,1,0
2021-07-01,PER,W.P. Labuan,0,0,0
2021-07-01,PHL,Johor,6,4,2
2021-07-01,PHL,Kedah,0,0,0
2021-07-01,PHL,Kelantan,0,0,0
2021-07-01,PHL,Melaka,0,0,0
2021-07-01,PHL,Negeri Sembilan,0,0,0
2021-07-01,PHL,Pahang,0,0,0
2021-07-01,PHL,Perak,0,0,0
2021-07-01,PHL,Perlis,0,0,0
2021-07-01,PHL,Pulau Pinang,5,2,3
2021-07-01,PHL,Sabah,1,1,0
2021-07-01,PHL,Sarawak,35,35,0
2021-07-01,PHL,Selangor,634,508,126
2021-07-01,PHL,Terengganu,0,0,0
2021-07-01,PHL,W.P. Labuan,9,9,0
2021-07-01,PLW,Johor,0,0,0
2021-07-01,PLW,Pulau Pinang,0,0,0
2021-07-01,PLW,Selangor,0,0,0
2021-07-01,PNG,Johor,0,0,0
2021-07-01,PNG,Kedah,0,0,0
2021-07-01,PNG,Kelantan,0,0,0
2021-07-01,PNG,Perak,0,0,0
2021-07-01,PNG,Pulau Pinang,0,0,0
2021-07-01,PNG,Sabah,0,0,0
2021-07-01,PNG,Sarawak,0,0,0
2021-07-01,PNG,Selangor,0,0,0
2021-07-01,POL,Johor,0,0,0
2021-07-01,POL,Kedah,0,0,0
2021-07-01,POL,Kelantan,0,0,0
2021-07-01,POL,Melaka,0,0,0
2021-07-01,POL,Negeri Sembilan,0,0,0
2021-07-01,POL,Pahang,0,0,0
2021-07-01,POL,Perak,0,0,0
2021-07-01,POL,Perlis,0,0,0
2021-07-01,POL,Pulau Pinang,0,0,0
2021-07-01,POL,Sabah,0,0,0
2021-07-01,POL,Sarawak,0,0,0
2021-07-01,POL,Selangor,25,21,4
2021-07-01,POL,Terengganu,0,0,0
2021-07-01,POL,W.P. Labuan,0,0,0
2021-07-01,PRK,Selangor,0,0,0
2021-07-01,PRT,Johor,0,0,0
2021-07-01,PRT,Kedah,0,0,0
2021-07-01,PRT,Kelantan,0,0,0
2021-07-01,PRT,Melaka,0,0,0
2021-07-01,PRT,Pahang,0,0,0
2021-07-01,PRT,Perak,0,0,0
2021-07-01,PRT,Perlis,0,0,0
2021-07-01,PRT,Pulau Pinang,0,0,0
2021-07-01,PRT,Sabah,0,0,0
2021-07-01,PRT,Sarawak,0,0,0
2021-07-01,PRT,Selangor,9,5,4
2021-07-01,PRT,W.P. Labuan,0,0,0
2021-07-01,PRY,Johor,0,0,0
2021-07-01,PRY,Kedah,0,0,0
2021-07-01,PRY,Perak,0,0,0
2021-07-01,PRY,Perlis,0,0,0
2021-07-01,PRY,Pulau Pinang,0,0,0
2021-07-01,PRY,Sabah,0,0,0
2021-07-01,PRY,Sarawak,0,0,0
2021-07-01,PRY,Selangor,0,0,0
2021-07-01,PSE,Johor,0,0,0
2021-07-01,PSE,Kedah,0,0,0
2021-07-01,PSE,Kelantan,0,0,0
2021-07-01,PSE,Melaka,0,0,0
2021-07-01,PSE,Perak,0,0,0
2021-07-01,PSE,Perlis,0,0,0
2021-07-01,PSE,Pulau Pinang,0,0,0
2021-07-01,PSE,Sabah,0,0,0
2021-07-01,PSE,Sarawak,0,0,0
2021-07-01,PSE,Selangor,2,2,0
2021-07-01,QAT,Johor,0,0,0
2021-07-01,QAT,Kedah,0,0,0
2021-07-01,QAT,Perlis,0,0,0
2021-07-01,QAT,Pulau Pinang,0,0,0
2021-07-01,QAT,Sabah,0,0,0
2021-07-01,QAT,Sarawak,0,0,0
2021-07-01,QAT,Selangor,0,0,0
2021-07-01,REU,Johor,0,0,0
2021-07-01,REU,Sarawak,0,0,0
2021-07-01,ROU,Johor,1,1,0
2021-07-01,ROU,Kedah,0,0,0
2021-07-01,ROU,Kelantan,0,0,0
2021-07-01,ROU,Negeri Sembilan,0,0,0
2021-07-01,ROU,Pahang,0,0,0
2021-07-01,ROU,Perak,0,0,0
2021-07-01,ROU,Perlis,0,0,0
2021-07-01,ROU,Pulau Pinang,0,0,0
2021-07-01,ROU,Sabah,0,0,0
2021-07-01,ROU,Sarawak,0,0,0
2021-07-01,ROU,Selangor,12,8,4
2021-07-01,ROU,W.P. Labuan,0,0,0
2021-07-01,RUS,Johor,1,1,0
2021-07-01,RUS,Kedah,3,1,2
2021-07-01,RUS,Kelantan,0,0,0
2021-07-01,RUS,Melaka,0,0,0
2021-07-01,RUS,Negeri Sembilan,0,0,0
2021-07-01,RUS,Pahang,0,0,0
2021-07-01,RUS,Perak,0,0,0
2021-07-01,RUS,Perlis,0,0,0
2021-07-01,RUS,Pulau Pinang,0,0,0
2021-07-01,RUS,Sabah,0,0,0
2021-07-01,RUS,Sarawak,0,0,0
2021-07-01,RUS,Selangor,65,50,15
2021-07-01,RUS,W.P. Labuan,0,0,0
2021-07-01,RWA,Johor,0,0,0
2021-07-01,RWA,Kedah,0,0,0
2021-07-01,RWA,Pulau Pinang,0,0,0
2021-07-01,RWA,Selangor,1,0,1
2021-07-01,SAU,Johor,0,0,0
2021-07-01,SAU,Kedah,0,0,0
2021-07-01,SAU,Kelantan,0,0,0
2021-07-01,SAU,Melaka,0,0,0
2021-07-01,SAU,Perak,0,0,0
2021-07-01,SAU,Perlis,0,0,0
2021-07-01,SAU,Pulau Pinang,0,0,0
2021-07-01,SAU,Sabah,0,0,0
2021-07-01,SAU,Sarawak,0,0,0
2021-07-01,SAU,Selangor,51,27,24
2021-07-01,SAU,W.P. Labuan,0,0,0
2021-07-01,SDN,Johor,0,0,0
2021-07-01,SDN,Kedah,0,0,0
2021-07-01,SDN,Kelantan,0,0,0
2021-07-01,SDN,Perlis,0,0,0
2021-07-01,SDN,Pulau Pinang,0,0,0
2021-07-01,SDN,Sabah,0,0,0
2021-07-01,SDN,Sarawak,0,0,0
2021-07-01,SDN,Selangor,23,17,6
2021-07-01,SDN,W.P. Labuan,0,0,0
2021-07-01,SEN,Johor,0,0,0
2021-07-01,SEN,Kedah,0,0,0
2021-07-01,SEN,Kelantan,0,0,0
2021-07-01,SEN,Perak,0,0,0
2021-07-01,SEN,Perlis,0,0,0
2021-07-01,SEN,Pulau Pinang,0,0,0
2021-07-01,SEN,Sabah,0,0,0
2021-07-01,SEN,Sarawak,0,0,0
2021-07-01,SEN,Selangor,9,4,5
2021-07-01,SGP,Johor,101,81,20
2021-07-01,SGP,Kedah,2,2,0
2021-07-01,SGP,Kelantan,0,0,0
2021-07-01,SGP,Melaka,0,0,0
2021-07-01,SGP,Negeri Sembilan,0,0,0
2021-07-01,SGP,Pahang,0,0,0
2021-07-01,SGP,Perak,0,0,0
2021-07-01,SGP,Perlis,2,2,0
2021-07-01,SGP,Pulau Pinang,19,12,7
2021-07-01,SGP,Sabah,0,0,0
2021-07-01,SGP,Sarawak,3,1,2
2021-07-01,SGP,Selangor,68,38,30
2021-07-01,SGP,Terengganu,0,0,0
2021-07-01,SGP,W.P. Labuan,0,0,0
2021-07-01,SGS,Johor,0,0,0
2021-07-01,SGS,Sabah,0,0,0
2021-07-01,SGS,Selangor,0,0,0
2021-07-01,SHN,Sarawak,0,0,0
2021-07-01,SLB,Johor,0,0,0
2021-07-01,SLB,Perlis,0,0,0
2021-07-01,SLB,Pulau Pinang,0,0,0
2021-07-01,SLB,Sabah,0,0,0
2021-07-01,SLB,Sarawak,0,0,0
2021-07-01,SLB,Selangor,0,0,0
2021-07-01,SLB,W.P. Labuan,0,0,0
2021-07-01,SLE,Johor,0,0,0
2021-07-01,SLE,Kedah,0,0,0
2021-07-01,SLE,Perak,0,0,0
2021-07-01,SLE,Pulau Pinang,0,0,0
2021-07-01,SLE,Sabah,0,0,0
2021-07-01,SLE,Selangor,3,3,0
2021-07-01,SLV,Johor,0,0,0
2021-07-01,SLV,Kedah,0,0,0
2021-07-01,SLV,Perak,0,0,0
2021-07-01,SLV,Perlis,0,0,0
2021-07-01,SLV,Pulau Pinang,0,0,0
2021-07-01,SLV,Sabah,0,0,0
2021-07-01,SLV,Selangor,0,0,0
2021-07-01,SLV,W.P. Labuan,0,0,0
2021-07-01,SMR,Johor,0,0,0
2021-07-01,SMR,Selangor,0,0,0
2021-07-01,SOM,Johor,0,0,0
2021-07-01,SOM,Kedah,0,0,0
2021-07-01,SOM,Kelantan,0,0,0
2021-07-01,SOM,Perlis,0,0,0
2021-07-01,SOM,Sabah,0,0,0
2021-07-01,SOM,Sarawak,0,0,0
2021-07-01,SOM,Selangor,10,9,1
2021-07-01,SRB,Johor,0,0,0
2021-07-01,SRB,Kedah,0,0,0
2021-07-01,SRB,Kelantan,0,0,0
2021-07-01,SRB,Pahang,0,0,0
2021-07-01,SRB,Perak,0,0,0
2021-07-01,SRB,Perlis,0,0,0
2021-07-01,SRB,Pulau Pinang,0,0,0
2021-07-01,SRB,Sabah,0,0,0
2021-07-01,SRB,Sarawak,0,0,0
2021-07-01,SRB,Selangor,1,0,1
2021-07-01,SSD,Johor,0,0,0
2021-07-01,SSD,Kedah,0,0,0
2021-07-01,SSD,Sarawak,0,0,0
2021-07-01,SSD,Selangor,2,2,0
2021-07-01,SSD,W.P. Labuan,0,0,0
2021-07-01,STP,Selangor,0,0,0
2021-07-01,SUR,Johor,0,0,0
2021-07-01,SUR,Kedah,0,0,0
2021-07-01,SUR,Kelantan,0,0,0
2021-07-01,SUR,Perak,0,0,0
2021-07-01,SUR,Perlis,0,0,0
2021-07-01,SUR,Pulau Pinang,0,0,0
2021-07-01,SUR,Sabah,0,0,0
2021-07-01,SUR,Sarawak,0,0,0
2021-07-01,SUR,Selangor,0,0,0
2021-07-01,SVK,Johor,0,0,0
2021-07-01,SVK,Kedah,0,0,0
2021-07-01,SVK,Kelantan,0,0,0
2021-07-01,SVK,Negeri Sembilan,0,0,0
2021-07-01,SVK,Pahang,0,0,0
2021-07-01,SVK,Perak,0,0,0
2021-07-01,SVK,Perlis,0,0,0
2021-07-01,SVK,Pulau Pinang,0,0,0
2021-07-01,SVK,Sabah,0,0,0
2021-07-01,SVK,Sarawak,0,0,0
2021-07-01,SVK,Selangor,2,2,0
2021-07-01,SVK,W.P. Labuan,0,0,0
2021-07-01,SVN,Johor,0,0,0
2021-07-01,SVN,Kedah,0,0,0
2021-07-01,SVN,Kelantan,0,0,0
2021-07-01,SVN,Perak,0,0,0
2021-07-01,SVN,Perlis,0,0,0
2021-07-01,SVN,Pulau Pinang,0,0,0
2021-07-01,SVN,Sabah,0,0,0
2021-07-01,SVN,Sarawak,0,0,0
2021-07-01,SVN,Selangor,0,0,0
2021-07-01,SVN,W.P. Labuan,0,0,0
2021-07-01,SWE,Johor,0,0,0
2021-07-01,SWE,Kedah,0,0,0
2021-07-01,SWE,Kelantan,0,0,0
2021-07-01,SWE,Melaka,0,0,0
2021-07-01,SWE,Negeri Sembilan,0,0,0
2021-07-01,SWE,Pahang,0,0,0
2021-07-01,SWE,Perak,0,0,0
2021-07-01,SWE,Perlis,0,0,0
2021-07-01,SWE,Pulau Pinang,0,0,0
2021-07-01,SWE,Sabah,0,0,0
2021-07-01,SWE,Sarawak,0,0,0
2021-07-01,SWE,Selangor,27,24,3
2021-07-01,SWE,W.P. Labuan,0,0,0
2021-07-01,SWZ,Johor,0,0,0
2021-07-01,SWZ,Kedah,0,0,0
2021-07-01,SWZ,Pulau Pinang,0,0,0
2021-07-01,SWZ,Sabah,0,0,0
2021-07-01,SWZ,Selangor,1,1,0
2021-07-01,SYC,Johor,1,1,0
2021-07-01,SYC,Kedah,0,0,0
2021-07-01,SYC,Pulau Pinang,0,0,0
2021-07-01,SYC,Sabah,0,0,0
2021-07-01,SYC,Sarawak,0,0,0
2021-07-01,SYC,Selangor,2,1,1
2021-07-01,SYR,Johor,0,0,0
2021-07-01,SYR,Kedah,0,0,0
2021-07-01,SYR,Kelantan,0,0,0
2021-07-01,SYR,Pahang,0,0,0
2021-07-01,SYR,Perlis,0,0,0
2021-07-01,SYR,Pulau Pinang,0,0,0
2021-07-01,SYR,Sabah,0,0,0
2021-07-01,SYR,Sarawak,0,0,0
2021-07-01,SYR,Selangor,20,12,8
2021-07-01,SYR,W.P. Labuan,0,0,0
2021-07-01,TCA,Perlis,0,0,0
2021-07-01,TCD,Johor,0,0,0
2021-07-01,TCD,Kedah,0,0,0
2021-07-01,TCD,Perlis,0,0,0
2021-07-01,TCD,Selangor,0,0,0
2021-07-01,TGO,Johor,0,0,0
2021-07-01,TGO,Perak,0,0,0
2021-07-01,TGO,Pulau Pinang,0,0,0
2021-07-01,TGO,Selangor,1,1,0
2021-07-01,THA,Johor,9,9,0
2021-07-01,THA,Kedah,17464,17428,36
2021-07-01,THA,Kelantan,3,1,2
2021-07-01,THA,Melaka,0,0,0
2021-07-01,THA,Negeri Sembilan,0,0,0
2021-07-01,THA,Pahang,0,0,0
2021-07-01,THA,Perak,0,0,0
2021-07-01,THA,Perlis,6956,6874,82
2021-07-01,THA,Pulau Pinang,33,28,5
2021-07-01,THA,Sabah,0,0,0
2021-07-01,THA,Sarawak,9,9,0
2021-07-01,THA,Selangor,154,83,71
2021-07-01,THA,Terengganu,0,0,0
2021-07-01,THA,W.P. Labuan,0,0,0
2021-07-01,TJK,Johor,0,0,0
2021-07-01,TJK,Kedah,0,0,0
2021-07-01,TJK,Perlis,0,0,0
2021-07-01,TJK,Pulau Pinang,0,0,0
2021-07-01,TJK,Sabah,0,0,0
2021-07-01,TJK,Selangor,9,5,4
2021-07-01,TKL,Selangor,0,0,0
2021-07-01,TKM,Johor,0,0,0
2021-07-01,TKM,Kedah,0,0,0
2021-07-01,TKM,Kelantan,0,0,0
2021-07-01,TKM,Perlis,0,0,0
2021-07-01,TKM,Pulau Pinang,0,0,0
2021-07-01,TKM,Sabah,0,0,0
2021-07-01,TKM,Sarawak,0,0,0
2021-07-01,TKM,Selangor,1,1,0
2021-07-01,TLS,Johor,0,0,0
2021-07-01,TLS,Kedah,0,0,0
2021-07-01,TLS,Perlis,0,0,0
2021-07-01,TLS,Pulau Pinang,0,0,0
2021-07-01,TLS,Sabah,0,0,0
2021-07-01,TLS,Sarawak,0,0,0
2021-07-01,TLS,Selangor,4,3,1
2021-07-01,TON,Johor,0,0,0
2021-07-01,TON,Pulau Pinang,0,0,0
2021-07-01,TON,Sarawak,0,0,0
2021-07-01,TON,Selangor,0,0,0
2021-07-01,TTO,Johor,0,0,0
2021-07-01,TTO,Kedah,0,0,0
2021-07-01,TTO,Pahang,0,0,0
2021-07-01,TTO,Pulau Pinang,0,0,0
2021-07-01,TTO,Sabah,0,0,0
2021-07-01,TTO,Sarawak,0,0,0
2021-07-01,TTO,Selangor,2,0,2
2021-07-01,TUN,Johor,0,0,0
2021-07-01,TUN,Kedah,0,0,0
2021-07-01,TUN,Kelantan,0,0,0
2021-07-01,TUN,Melaka,0,0,0
2021-07-01,TUN,Perak,0,0,0
2021-07-01,TUN,Perlis,0,0,0
2021-07-01,TUN,Pulau Pinang,0,0,0
2021-07-01,TUN,Sabah,0,0,0
2021-07-01,TUN,Sarawak,0,0,0
2021-07-01,TUN,Selangor,1,1,0
2021-07-01,TUN,W.P. Labuan,0,0,0
2021-07-01,TUR,Johor,0,0,0
2021-07-01,TUR,Kedah,0,0,0
2021-07-01,TUR,Kelantan,0,0,0
2021-07-01,TUR,Melaka,0,0,0
2021-07-01,TUR,Negeri Sembilan,0,0,0
2021-07-01,TUR,Pahang,0,0,0
2021-07-01,TUR,Perak,0,0,0
2021-07-01,TUR,Perlis,0,0,0
2021-07-01,TUR,Pulau Pinang,0,0,0
2021-07-01,TUR,Sabah,0,0,0
2021-07-01,TUR,Sarawak,0,0,0
2021-07-01,TUR,Selangor,34,23,11
2021-07-01,TUR,W.P. Labuan,0,0,0
2021-07-01,TUV,Selangor,0,0,0
2021-07-01,TWN,Johor,0,0,0
2021-07-01,TWN,Kedah,0,0,0
2021-07-01,TWN,Kelantan,0,0,0
2021-07-01,TWN,Melaka,0,0,0
2021-07-01,TWN,Negeri Sembilan,0,0,0
2021-07-01,TWN,Pahang,0,0,0
2021-07-01,TWN,Perak,0,0,0
2021-07-01,TWN,Perlis,0,0,0
2021-07-01,TWN,Pulau Pinang,15,10,5
2021-07-01,TWN,Sabah,0,0,0
2021-07-01,TWN,Sarawak,0,0,0
2021-07-01,TWN,Selangor,47,23,24
2021-07-01,TWN,W.P. Labuan,0,0,0
2021-07-01,TZA,Johor,0,0,0
2021-07-01,TZA,Kedah,0,0,0
2021-07-01,TZA,Perak,0,0,0
2021-07-01,TZA,Perlis,0,0,0
2021-07-01,TZA,Pulau Pinang,0,0,0
2021-07-01,TZA,Sabah,0,0,0
2021-07-01,TZA,Sarawak,0,0,0
2021-07-01,TZA,Selangor,7,4,3
2021-07-01,UGA,Johor,0,0,0
2021-07-01,UGA,Kedah,0,0,0
2021-07-01,UGA,Perak,0,0,0
2021-07-01,UGA,Perlis,0,0,0
2021-07-01,UGA,Pulau Pinang,0,0,0
2021-07-01,UGA,Sabah,0,0,0
2021-07-01,UGA,Sarawak,0,0,0
2021-07-01,UGA,Selangor,1,1,0
2021-07-01,UKR,Johor,2,2,0
2021-07-01,UKR,Kedah,0,0,0
2021-07-01,UKR,Kelantan,0,0,0
2021-07-01,UKR,Melaka,0,0,0
2021-07-01,UKR,Negeri Sembilan,0,0,0
2021-07-01,UKR,Pahang,0,0,0
2021-07-01,UKR,Perak,0,0,0
2021-07-01,UKR,Perlis,0,0,0
2021-07-01,UKR,Pulau Pinang,0,0,0
2021-07-01,UKR,Sabah,0,0,0
2021-07-01,UKR,Sarawak,0,0,0
2021-07-01,UKR,Selangor,30,27,3
2021-07-01,UKR,W.P. Labuan,0,0,0
2021-07-01,URY,Johor,0,0,0
2021-07-01,URY,Kedah,0,0,0
2021-07-01,URY,Kelantan,0,0,0
2021-07-01,URY,Perak,0,0,0
2021-07-01,URY,Perlis,0,0,0
2021-07-01,URY,Pulau Pinang,0,0,0
2021-07-01,URY,Sabah,0,0,0
2021-07-01,URY,Sarawak,0,0,0
2021-07-01,URY,Selangor,0,0,0
2021-07-01,URY,W.P. Labuan,0,0,0
2021-07-01,USA,Johor,1,1,0
2021-07-01,USA,Kedah,0,0,0
2021-07-01,USA,Kelantan,0,0,0
2021-07-01,USA,Melaka,0,0,0
2021-07-01,USA,Negeri Sembilan,0,0,0
2021-07-01,USA,Pahang,0,0,0
2021-07-01,USA,Perak,1,0,1
2021-07-01,USA,Perlis,0,0,0
2021-07-01,USA,Pulau Pinang,14,8,6
2021-07-01,USA,Sabah,0,0,0
2021-07-01,USA,Sarawak,1,1,0
2021-07-01,USA,Selangor,444,224,220
2021-07-01,USA,Terengganu,0,0,0
2021-07-01,USA,W.P. Labuan,0,0,0
2021-07-01,UZB,Johor,0,0,0
2021-07-01,UZB,Kedah,0,0,0
2021-07-01,UZB,Kelantan,0,0,0
2021-07-01,UZB,Perak,0,0,0
2021-07-01,UZB,Perlis,0,0,0
2021-07-01,UZB,Pulau Pinang,0,0,0
2021-07-01,UZB,Sabah,0,0,0
2021-07-01,UZB,Sarawak,0,0,0
2021-07-01,UZB,Selangor,4,3,1
2021-07-01,VAT,Johor,0,0,0
2021-07-01,VAT,Sarawak,0,0,0
2021-07-01,VAT,Selangor,1,1,0
2021-07-01,VCT,Johor,0,0,0
2021-07-01,VCT,Kedah,0,0,0
2021-07-01,VCT,Pulau Pinang,0,0,0
2021-07-01,VCT,Sarawak,0,0,0
2021-07-01,VCT,Selangor,0,0,0
2021-07-01,VEN,Johor,0,0,0
2021-07-01,VEN,Kedah,0,0,0
2021-07-01,VEN,Kelantan,0,0,0
2021-07-01,VEN,Melaka,0,0,0
2021-07-01,VEN,Perak,0,0,0
2021-07-01,VEN,Perlis,0,0,0
2021-07-01,VEN,Pulau Pinang,0,0,0
2021-07-01,VEN,Sabah,0,0,0
2021-07-01,VEN,Sarawak,0,0,0
2021-07-01,VEN,Selangor,4,4,0
2021-07-01,VEN,W.P. Labuan,0,0,0
2021-07-01,VNM,Johor,2,0,2
2021-07-01,VNM,Kedah,0,0,0
2021-07-01,VNM,Kelantan,0,0,0
2021-07-01,VNM,Melaka,0,0,0
2021-07-01,VNM,Negeri Sembilan,0,0,0
2021-07-01,VNM,Pahang,0,0,0
2021-07-01,VNM,Perak,0,0,0
2021-07-01,VNM,Perlis,0,0,0
2021-07-01,VNM,Pulau Pinang,0,0,0
2021-07-01,VNM,Sabah,0,0,0
2021-07-01,VNM,Sarawak,1,0,1
2021-07-01,VNM,Selangor,51,19,32
2021-07-01,VNM,Terengganu,0,0,0
2021-07-01,VNM,W.P. Labuan,0,0,0
2021-07-01,VUT,Johor,0,0,0
2021-07-01,VUT,Kedah,0,0,0
2021-07-01,VUT,Pulau Pinang,0,0,0
2021-07-01,VUT,Sabah,0,0,0
2021-07-01,VUT,Sarawak,0,0,0
2021-07-01,VUT,Selangor,0,0,0
2021-07-01,WSM,Johor,0,0,0
2021-07-01,WSM,Sarawak,0,0,0
2021-07-01,WSM,Selangor,0,0,0
2021-07-01,XXX,Johor,0,0,0
2021-07-01,XXX,Kedah,0,0,0
2021-07-01,XXX,Kelantan,0,0,0
2021-07-01,XXX,Melaka,0,0,0
2021-07-01,XXX,Pahang,0,0,0
2021-07-01,XXX,Perak,0,0,0
2021-07-01,XXX,Perlis,0,0,0
2021-07-01,XXX,Pulau Pinang,0,0,0
2021-07-01,XXX,Sabah,0,0,0
2021-07-01,XXX,Sarawak,0,0,0
2021-07-01,XXX,Selangor,9,7,2
2021-07-01,XXX,W.P. Labuan,0,0,0
2021-07-01,YEM,Johor,0,0,0
2021-07-01,YEM,Kedah,0,0,0
2021-07-01,YEM,Kelantan,0,0,0
2021-07-01,YEM,Melaka,0,0,0
2021-07-01,YEM,Pahang,0,0,0
2021-07-01,YEM,Perak,0,0,0
2021-07-01,YEM,Perlis,0,0,0
2021-07-01,YEM,Pulau Pinang,0,0,0
2021-07-01,YEM,Sabah,0,0,0
2021-07-01,YEM,Sarawak,0,0,0
2021-07-01,YEM,Selangor,19,14,5
2021-07-01,YEM,W.P. Labuan,0,0,0
2021-07-01,ZAF,Johor,0,0,0
2021-07-01,ZAF,Kedah,0,0,0
2021-07-01,ZAF,Kelantan,0,0,0
2021-07-01,ZAF,Melaka,0,0,0
2021-07-01,ZAF,Pahang,0,0,0
2021-07-01,ZAF,Perak,0,0,0
2021-07-01,ZAF,Perlis,0,0,0
2021-07-01,ZAF,Pulau Pinang,0,0,0
2021-07-01,ZAF,Sabah,0,0,0
2021-07-01,ZAF,Sarawak,1,0,1
2021-07-01,ZAF,Selangor,23,14,9
2021-07-01,ZAF,Terengganu,0,0,0
2021-07-01,ZAF,W.P. Labuan,0,0,0
2021-07-01,ZAR,Selangor,0,0,0
2021-07-01,ZMB,Johor,0,0,0
2021-07-01,ZMB,Kedah,0,0,0
2021-07-01,ZMB,Perak,0,0,0
2021-07-01,ZMB,Perlis,0,0,0
2021-07-01,ZMB,Pulau Pinang,0,0,0
2021-07-01,ZMB,Sabah,0,0,0
2021-07-01,ZMB,Sarawak,0,0,0
2021-07-01,ZMB,Selangor,1,1,0
2021-07-01,ZWE,Johor,0,0,0
2021-07-01,ZWE,Kedah,0,0,0
2021-07-01,ZWE,Kelantan,0,0,0
2021-07-01,ZWE,Perak,0,0,0
2021-07-01,ZWE,Perlis,0,0,0
2021-07-01,ZWE,Pulau Pinang,0,0,0
2021-07-01,ZWE,Sabah,0,0,0
2021-07-01,ZWE,Sarawak,0,0,0
2021-07-01,ZWE,Selangor,3,1,2
2021-08-01,ABW,Kedah,0,0,0
2021-08-01,ABW,Pulau Pinang,0,0,0
2021-08-01,AFG,Johor,0,0,0
2021-08-01,AFG,Kedah,0,0,0
2021-08-01,AFG,Perlis,0,0,0
2021-08-01,AFG,Pulau Pinang,0,0,0
2021-08-01,AFG,Sarawak,0,0,0
2021-08-01,AFG,Selangor,15,12,3
2021-08-01,AGO,Johor,0,0,0
2021-08-01,AGO,Kedah,0,0,0
2021-08-01,AGO,Sabah,0,0,0
2021-08-01,AGO,Selangor,4,3,1
2021-08-01,AIA,Selangor,0,0,0
2021-08-01,ALB,Johor,0,0,0
2021-08-01,ALB,Kedah,0,0,0
2021-08-01,ALB,Perak,0,0,0
2021-08-01,ALB,Perlis,0,0,0
2021-08-01,ALB,Pulau Pinang,0,0,0
2021-08-01,ALB,Sabah,0,0,0
2021-08-01,ALB,Sarawak,0,0,0
2021-08-01,ALB,Selangor,0,0,0
2021-08-01,AND,Johor,0,0,0
2021-08-01,AND,Kedah,0,0,0
2021-08-01,AND,Perlis,0,0,0
2021-08-01,AND,Pulau Pinang,0,0,0
2021-08-01,AND,Selangor,0,0,0
2021-08-01,ANT,Selangor,0,0,0
2021-08-01,ARE,Johor,0,0,0
2021-08-01,ARE,Kedah,0,0,0
2021-08-01,ARE,Kelantan,0,0,0
2021-08-01,ARE,Perak,0,0,0
2021-08-01,ARE,Perlis,0,0,0
2021-08-01,ARE,Pulau Pinang,0,0,0
2021-08-01,ARE,Sabah,0,0,0
2021-08-01,ARE,Sarawak,0,0,0
2021-08-01,ARE,Selangor,1,1,0
2021-08-01,ARG,Johor,0,0,0
2021-08-01,ARG,Kedah,0,0,0
2021-08-01,ARG,Kelantan,0,0,0
2021-08-01,ARG,Melaka,0,0,0
2021-08-01,ARG,Perak,0,0,0
2021-08-01,ARG,Perlis,0,0,0
2021-08-01,ARG,Pulau Pinang,0,0,0
2021-08-01,ARG,Sabah,0,0,0
2021-08-01,ARG,Sarawak,0,0,0
2021-08-01,ARG,Selangor,19,13,6
2021-08-01,ARG,W.P. Labuan,0,0,0
2021-08-01,ARM,Johor,0,0,0
2021-08-01,ARM,Kedah,0,0,0
2021-08-01,ARM,Kelantan,0,0,0
2021-08-01,ARM,Perak,0,0,0
2021-08-01,ARM,Perlis,0,0,0
2021-08-01,ARM,Pulau Pinang,0,0,0
2021-08-01,ARM,Sabah,0,0,0
2021-08-01,ARM,Sarawak,0,0,0
2021-08-01,ARM,Selangor,0,0,0
2021-08-01,ATA,Selangor,0,0,0
2021-08-01,ATG,Johor,0,0,0
2021-08-01,ATG,Kedah,0,0,0
2021-08-01,ATG,Pulau Pinang,0,0,0
2021-08-01,ATG,Sarawak,0,0,0
2021-08-01,ATG,Selangor,0,0,0
2021-08-01,AUS,Johor,0,0,0
2021-08-01,AUS,Kedah,0,0,0
2021-08-01,AUS,Kelantan,0,0,0
2021-08-01,AUS,Melaka,0,0,0
2021-08-01,AUS,Negeri Sembilan,0,0,0
2021-08-01,AUS,Pahang,0,0,0
2021-08-01,AUS,Perak,0,0,0
2021-08-01,AUS,Perlis,0,0,0
2021-08-01,AUS,Pulau Pinang,10,5,5
2021-08-01,AUS,Sabah,0,0,0
2021-08-01,AUS,Sarawak,0,0,0
2021-08-01,AUS,Selangor,137,73,64
2021-08-01,AUS,Terengganu,0,0,0
2021-08-01,AUS,W.P. Labuan,0,0,0
2021-08-01,AUT,Johor,0,0,0
2021-08-01,AUT,Kedah,0,0,0
2021-08-01,AUT,Kelantan,0,0,0
2021-08-01,AUT,Melaka,0,0,0
2021-08-01,AUT,Negeri Sembilan,0,0,0
2021-08-01,AUT,Pahang,0,0,0
2021-08-01,AUT,Perak,0,0,0
2021-08-01,AUT,Perlis,0,0,0
2021-08-01,AUT,Pulau Pinang,0,0,0
2021-08-01,AUT,Sabah,0,0,0
2021-08-01,AUT,Sarawak,0,0,0
2021-08-01,AUT,Selangor,29,19,10
2021-08-01,AUT,Terengganu,0,0,0
2021-08-01,AUT,W.P. Labuan,0,0,0
2021-08-01,AZE,Johor,0,0,0
2021-08-01,AZE,Kedah,0,0,0
2021-08-01,AZE,Kelantan,0,0,0
2021-08-01,AZE,Melaka,0,0,0
2021-08-01,AZE,Perlis,0,0,0
2021-08-01,AZE,Pulau Pinang,0,0,0
2021-08-01,AZE,Sabah,0,0,0
2021-08-01,AZE,Sarawak,0,0,0
2021-08-01,AZE,Selangor,11,5,6
2021-08-01,AZE,W.P. Labuan,0,0,0
2021-08-01,BDI,Pulau Pinang,0,0,0
2021-08-01,BDI,Sarawak,0,0,0
2021-08-01,BDI,Selangor,2,1,1
2021-08-01,BEL,Johor,0,0,0
2021-08-01,BEL,Kedah,0,0,0
2021-08-01,BEL,Kelantan,0,0,0
2021-08-01,BEL,Melaka,0,0,0
2021-08-01,BEL,Negeri Sembilan,0,0,0
2021-08-01,BEL,Pahang,0,0,0
2021-08-01,BEL,Perak,0,0,0
2021-08-01,BEL,Perlis,0,0,0
2021-08-01,BEL,Pulau Pinang,0,0,0
2021-08-01,BEL,Sabah,0,0,0
2021-08-01,BEL,Sarawak,0,0,0
2021-08-01,BEL,Selangor,20,12,8
2021-08-01,BEL,W.P. Labuan,0,0,0
2021-08-01,BEN,Johor,0,0,0
2021-08-01,BEN,Kedah,0,0,0
2021-08-01,BEN,Perak,0,0,0
2021-08-01,BEN,Pulau Pinang,0,0,0
2021-08-01,BEN,Sabah,0,0,0
2021-08-01,BEN,Sarawak,0,0,0
2021-08-01,BEN,Selangor,0,0,0
2021-08-01,BFA,Perak,0,0,0
2021-08-01,BFA,Pulau Pinang,0,0,0
2021-08-01,BFA,Selangor,0,0,0
2021-08-01,BGD,Johor,0,0,0
2021-08-01,BGD,Kedah,0,0,0
2021-08-01,BGD,Kelantan,0,0,0
2021-08-01,BGD,Melaka,0,0,0
2021-08-01,BGD,Negeri Sembilan,0,0,0
2021-08-01,BGD,Pahang,0,0,0
2021-08-01,BGD,Perak,0,0,0
2021-08-01,BGD,Perlis,0,0,0
2021-08-01,BGD,Pulau Pinang,0,0,0
2021-08-01,BGD,Sabah,0,0,0
2021-08-01,BGD,Sarawak,0,0,0
2021-08-01,BGD,Selangor,16,10,6
2021-08-01,BGD,W.P. Labuan,0,0,0
2021-08-01,BGR,Johor,0,0,0
2021-08-01,BGR,Kedah,0,0,0
2021-08-01,BGR,Kelantan,0,0,0
2021-08-01,BGR,Pahang,0,0,0
2021-08-01,BGR,Perak,0,0,0
2021-08-01,BGR,Perlis,0,0,0
2021-08-01,BGR,Pulau Pinang,0,0,0
2021-08-01,BGR,Sabah,0,0,0
2021-08-01,BGR,Sarawak,0,0,0
2021-08-01,BGR,Selangor,14,13,1
2021-08-01,BGR,W.P. Labuan,0,0,0
2021-08-01,BHR,Johor,0,0,0
2021-08-01,BHR,Kedah,0,0,0
2021-08-01,BHR,Kelantan,0,0,0
2021-08-01,BHR,Perlis,0,0,0
2021-08-01,BHR,Pulau Pinang,0,0,0
2021-08-01,BHR,Sabah,0,0,0
2021-08-01,BHR,Sarawak,0,0,0
2021-08-01,BHR,Selangor,0,0,0
2021-08-01,BHS,Johor,0,0,0
2021-08-01,BHS,Kedah,0,0,0
2021-08-01,BHS,Perak,0,0,0
2021-08-01,BHS,Sabah,0,0,0
2021-08-01,BHS,Sarawak,0,0,0
2021-08-01,BHS,Selangor,0,0,0
2021-08-01,BIH,Johor,0,0,0
2021-08-01,BIH,Kedah,0,0,0
2021-08-01,BIH,Perlis,0,0,0
2021-08-01,BIH,Pulau Pinang,0,0,0
2021-08-01,BIH,Sabah,0,0,0
2021-08-01,BIH,Sarawak,0,0,0
2021-08-01,BIH,Selangor,12,6,6
2021-08-01,BLR,Johor,0,0,0
2021-08-01,BLR,Kedah,0,0,0
2021-08-01,BLR,Kelantan,0,0,0
2021-08-01,BLR,Pahang,0,0,0
2021-08-01,BLR,Perak,0,0,0
2021-08-01,BLR,Perlis,0,0,0
2021-08-01,BLR,Pulau Pinang,0,0,0
2021-08-01,BLR,Sabah,0,0,0
2021-08-01,BLR,Sarawak,0,0,0
2021-08-01,BLR,Selangor,0,0,0
2021-08-01,BLR,W.P. Labuan,0,0,0
2021-08-01,BLZ,Johor,0,0,0
2021-08-01,BLZ,Pulau Pinang,0,0,0
2021-08-01,BLZ,Sarawak,0,0,0
2021-08-01,BLZ,Selangor,4,1,3
2021-08-01,BMU,Selangor,0,0,0
2021-08-01,BOL,Johor,0,0,0
2021-08-01,BOL,Kedah,0,0,0
2021-08-01,BOL,Melaka,0,0,0
2021-08-01,BOL,Perak,0,0,0
2021-08-01,BOL,Perlis,0,0,0
2021-08-01,BOL,Pulau Pinang,0,0,0
2021-08-01,BOL,Sabah,0,0,0
2021-08-01,BOL,Sarawak,0,0,0
2021-08-01,BOL,Selangor,0,0,0
2021-08-01,BRA,Johor,0,0,0
2021-08-01,BRA,Kedah,0,0,0
2021-08-01,BRA,Kelantan,0,0,0
2021-08-01,BRA,Melaka,0,0,0
2021-08-01,BRA,Pahang,0,0,0
2021-08-01,BRA,Perak,0,0,0
2021-08-01,BRA,Perlis,0,0,0
2021-08-01,BRA,Pulau Pinang,0,0,0
2021-08-01,BRA,Sabah,2,2,0
2021-08-01,BRA,Sarawak,0,0,0
2021-08-01,BRA,Selangor,18,11,7
2021-08-01,BRA,W.P. Labuan,0,0,0
2021-08-01,BRB,Johor,0,0,0
2021-08-01,BRB,Kedah,0,0,0
2021-08-01,BRB,Perlis,0,0,0
2021-08-01,BRB,Pulau Pinang,0,0,0
2021-08-01,BRB,Selangor,1,0,1
2021-08-01,BRN,Johor,0,0,0
2021-08-01,BRN,Kedah,0,0,0
2021-08-01,BRN,Kelantan,0,0,0
2021-08-01,BRN,Melaka,0,0,0
2021-08-01,BRN,Pahang,0,0,0
2021-08-01,BRN,Perak,0,0,0
2021-08-01,BRN,Perlis,0,0,0
2021-08-01,BRN,Pulau Pinang,0,0,0
2021-08-01,BRN,Sabah,0,0,0
2021-08-01,BRN,Sarawak,297,294,3
2021-08-01,BRN,Selangor,12,3,9
2021-08-01,BRN,W.P. Labuan,0,0,0
2021-08-01,BTN,Johor,0,0,0
2021-08-01,BTN,Kedah,0,0,0
2021-08-01,BTN,Perak,0,0,0
2021-08-01,BTN,Perlis,0,0,0
2021-08-01,BTN,Pulau Pinang,0,0,0
2021-08-01,BTN,Sabah,0,0,0
2021-08-01,BTN,Sarawak,0,0,0
2021-08-01,BTN,Selangor,1,1,0
2021-08-01,BWA,Johor,0,0,0
2021-08-01,BWA,Kedah,0,0,0
2021-08-01,BWA,Perlis,0,0,0
2021-08-01,BWA,Pulau Pinang,0,0,0
2021-08-01,BWA,Sabah,0,0,0
2021-08-01,BWA,Sarawak,0,0,0
2021-08-01,BWA,Selangor,2,2,0
2021-08-01,CAF,Kedah,0,0,0
2021-08-01,CAF,Selangor,0,0,0
2021-08-01,CAN,Johor,0,0,0
2021-08-01,CAN,Kedah,0,0,0
2021-08-01,CAN,Kelantan,0,0,0
2021-08-01,CAN,Melaka,0,0,0
2021-08-01,CAN,Negeri Sembilan,0,0,0
2021-08-01,CAN,Pahang,0,0,0
2021-08-01,CAN,Perak,0,0,0
2021-08-01,CAN,Perlis,0,0,0
2021-08-01,CAN,Pulau Pinang,1,0,1
2021-08-01,CAN,Sabah,0,0,0
2021-08-01,CAN,Sarawak,0,0,0
2021-08-01,CAN,Selangor,79,42,37
2021-08-01,CAN,Terengganu,0,0,0
2021-08-01,CAN,W.P. Labuan,0,0,0
2021-08-01,CCK,Selangor,0,0,0
2021-08-01,CHE,Johor,0,0,0
2021-08-01,CHE,Kedah,0,0,0
2021-08-01,CHE,Kelantan,0,0,0
2021-08-01,CHE,Melaka,0,0,0
2021-08-01,CHE,Negeri Sembilan,0,0,0
2021-08-01,CHE,Pahang,0,0,0
2021-08-01,CHE,Perak,0,0,0
2021-08-01,CHE,Perlis,0,0,0
2021-08-01,CHE,Pulau Pinang,0,0,0
2021-08-01,CHE,Sabah,0,0,0
2021-08-01,CHE,Sarawak,0,0,0
2021-08-01,CHE,Selangor,19,16,3
2021-08-01,CHE,W.P. Labuan,0,0,0
2021-08-01,CHL,Johor,0,0,0
2021-08-01,CHL,Kedah,0,0,0
2021-08-01,CHL,Kelantan,0,0,0
2021-08-01,CHL,Melaka,0,0,0
2021-08-01,CHL,Pahang,0,0,0
2021-08-01,CHL,Perak,0,0,0
2021-08-01,CHL,Perlis,0,0,0
2021-08-01,CHL,Pulau Pinang,0,0,0
2021-08-01,CHL,Sabah,0,0,0
2021-08-01,CHL,Sarawak,0,0,0
2021-08-01,CHL,Selangor,4,2,2
2021-08-01,CHN,Johor,1,1,0
2021-08-01,CHN,Kedah,0,0,0
2021-08-01,CHN,Kelantan,0,0,0
2021-08-01,CHN,Melaka,0,0,0
2021-08-01,CHN,Pahang,0,0,0
2021-08-01,CHN,Perak,0,0,0
2021-08-01,CHN,Perlis,0,0,0
2021-08-01,CHN,Pulau Pinang,1,1,0
2021-08-01,CHN,Sabah,0,0,0
2021-08-01,CHN,Sarawak,99,94,5
2021-08-01,CHN,Selangor,705,594,111
2021-08-01,CHN,Terengganu,0,0,0
2021-08-01,CHN,W.P. Labuan,0,0,0
2021-08-01,CIV,Johor,0,0,0
2021-08-01,CIV,Kedah,0,0,0
2021-08-01,CIV,Pulau Pinang,0,0,0
2021-08-01,CIV,Sabah,0,0,0
2021-08-01,CIV,Sarawak,0,0,0
2021-08-01,CIV,Selangor,0,0,0
2021-08-01,CMR,Johor,0,0,0
2021-08-01,CMR,Kedah,0,0,0
2021-08-01,CMR,Pulau Pinang,0,0,0
2021-08-01,CMR,Sabah,0,0,0
2021-08-01,CMR,Sarawak,0,0,0
2021-08-01,CMR,Selangor,3,2,1
2021-08-01,COD,Johor,0,0,0
2021-08-01,COD,Pulau Pinang,0,0,0
2021-08-01,COD,Sarawak,0,0,0
2021-08-01,COD,Selangor,1,1,0
2021-08-01,COG,Johor,0,0,0
2021-08-01,COG,Kedah,0,0,0
2021-08-01,COG,Selangor,0,0,0
2021-08-01,COK,Selangor,0,0,0
2021-08-01,COL,Johor,0,0,0
2021-08-01,COL,Kedah,0,0,0
2021-08-01,COL,Perak,0,0,0
2021-08-01,COL,Pulau Pinang,0,0,0
2021-08-01,COL,Sabah,0,0,0
2021-08-01,COL,Sarawak,0,0,0
2021-08-01,COL,Selangor,7,4,3
2021-08-01,COL,W.P. Labuan,0,0,0
2021-08-01,COM,Johor,0,0,0
2021-08-01,COM,Kedah,0,0,0
2021-08-01,COM,Selangor,0,0,0
2021-08-01,CPV,Johor,0,0,0
2021-08-01,CPV,Kedah,0,0,0
2021-08-01,CPV,Pulau Pinang,0,0,0
2021-08-01,CPV,Sabah,0,0,0
2021-08-01,CPV,Selangor,0,0,0
2021-08-01,CRI,Johor,0,0,0
2021-08-01,CRI,Kedah,0,0,0
2021-08-01,CRI,Perak,0,0,0
2021-08-01,CRI,Perlis,0,0,0
2021-08-01,CRI,Pulau Pinang,0,0,0
2021-08-01,CRI,Sabah,0,0,0
2021-08-01,CRI,Sarawak,0,0,0
2021-08-01,CRI,Selangor,0,0,0
2021-08-01,CUB,Johor,0,0,0
2021-08-01,CUB,Kedah,0,0,0
2021-08-01,CUB,Perlis,0,0,0
2021-08-01,CUB,Pulau Pinang,0,0,0
2021-08-01,CUB,Sabah,0,0,0
2021-08-01,CUB,Sarawak,0,0,0
2021-08-01,CUB,Selangor,0,0,0
2021-08-01,CYP,Johor,0,0,0
2021-08-01,CYP,Kedah,0,0,0
2021-08-01,CYP,Perak,0,0,0
2021-08-01,CYP,Perlis,0,0,0
2021-08-01,CYP,Pulau Pinang,0,0,0
2021-08-01,CYP,Sabah,0,0,0
2021-08-01,CYP,Sarawak,0,0,0
2021-08-01,CYP,Selangor,0,0,0
2021-08-01,CZE,Johor,0,0,0
2021-08-01,CZE,Kedah,0,0,0
2021-08-01,CZE,Kelantan,0,0,0
2021-08-01,CZE,Melaka,0,0,0
2021-08-01,CZE,Negeri Sembilan,0,0,0
2021-08-01,CZE,Perak,0,0,0
2021-08-01,CZE,Perlis,0,0,0
2021-08-01,CZE,Pulau Pinang,0,0,0
2021-08-01,CZE,Sabah,0,0,0
2021-08-01,CZE,Sarawak,0,0,0
2021-08-01,CZE,Selangor,8,4,4
2021-08-01,CZE,W.P. Labuan,0,0,0
2021-08-01,DEU,Johor,0,0,0
2021-08-01,DEU,Kedah,0,0,0
2021-08-01,DEU,Kelantan,0,0,0
2021-08-01,DEU,Melaka,0,0,0
2021-08-01,DEU,Negeri Sembilan,0,0,0
2021-08-01,DEU,Pahang,0,0,0
2021-08-01,DEU,Perak,0,0,0
2021-08-01,DEU,Perlis,0,0,0
2021-08-01,DEU,Pulau Pinang,6,3,3
2021-08-01,DEU,Sabah,0,0,0
2021-08-01,DEU,Sarawak,3,3,0
2021-08-01,DEU,Selangor,109,71,38
2021-08-01,DEU,Terengganu,0,0,0
2021-08-01,DEU,W.P. Labuan,0,0,0
2021-08-01,DJI,Johor,0,0,0
2021-08-01,DJI,Selangor,2,0,2
2021-08-01,DMA,Johor,0,0,0
2021-08-01,DMA,Kedah,0,0,0
2021-08-01,DMA,Pulau Pinang,0,0,0
2021-08-01,DMA,Sabah,0,0,0
2021-08-01,DMA,Sarawak,0,0,0
2021-08-01,DMA,Selangor,4,3,1
2021-08-01,DMA,W.P. Labuan,0,0,0
2021-08-01,DNK,Johor,0,0,0
2021-08-01,DNK,Kedah,0,0,0
2021-08-01,DNK,Kelantan,0,0,0
2021-08-01,DNK,Melaka,0,0,0
2021-08-01,DNK,Negeri Sembilan,0,0,0
2021-08-01,DNK,Pahang,0,0,0
2021-08-01,DNK,Perak,0,0,0
2021-08-01,DNK,Perlis,0,0,0
2021-08-01,DNK,Pulau Pinang,0,0,0
2021-08-01,DNK,Sabah,0,0,0
2021-08-01,DNK,Sarawak,0,0,0
2021-08-01,DNK,Selangor,35,25,10
2021-08-01,DNK,W.P. Labuan,0,0,0
2021-08-01,DOM,Johor,0,0,0
2021-08-01,DOM,Kedah,0,0,0
2021-08-01,DOM,Perak,0,0,0
2021-08-01,DOM,Perlis,0,0,0
2021-08-01,DOM,Pulau Pinang,0,0,0
2021-08-01,DOM,Sabah,0,0,0
2021-08-01,DOM,Sarawak,0,0,0
2021-08-01,DOM,Selangor,0,0,0
2021-08-01,DZA,Johor,0,0,0
2021-08-01,DZA,Kedah,0,0,0
2021-08-01,DZA,Kelantan,0,0,0
2021-08-01,DZA,Melaka,0,0,0
2021-08-01,DZA,Perak,0,0,0
2021-08-01,DZA,Perlis,0,0,0
2021-08-01,DZA,Pulau Pinang,0,0,0
2021-08-01,DZA,Sabah,0,0,0
2021-08-01,DZA,Sarawak,0,0,0
2021-08-01,DZA,Selangor,12,5,7
2021-08-01,DZA,W.P. Labuan,0,0,0
2021-08-01,ECU,Johor,0,0,0
2021-08-01,ECU,Kedah,0,0,0
2021-08-01,ECU,Perak,0,0,0
2021-08-01,ECU,Perlis,0,0,0
2021-08-01,ECU,Pulau Pinang,0,0,0
2021-08-01,ECU,Sabah,0,0,0
2021-08-01,ECU,Sarawak,0,0,0
2021-08-01,ECU,Selangor,1,0,1
2021-08-01,EGY,Johor,0,0,0
2021-08-01,EGY,Kedah,0,0,0
2021-08-01,EGY,Kelantan,0,0,0
2021-08-01,EGY,Melaka,0,0,0
2021-08-01,EGY,Pahang,0,0,0
2021-08-01,EGY,Perak,0,0,0
2021-08-01,EGY,Perlis,0,0,0
2021-08-01,EGY,Pulau Pinang,0,0,0
2021-08-01,EGY,Sabah,0,0,0
2021-08-01,EGY,Sarawak,0,0,0
2021-08-01,EGY,Selangor,81,61,20
2021-08-01,EGY,Terengganu,0,0,0
2021-08-01,EGY,W.P. Labuan,0,0,0
2021-08-01,ERI,Johor,0,0,0
2021-08-01,ERI,Pulau Pinang,0,0,0
2021-08-01,ERI,Sabah,0,0,0
2021-08-01,ERI,Selangor,0,0,0
2021-08-01,ESP,Johor,0,0,0
2021-08-01,ESP,Kedah,0,0,0
2021-08-01,ESP,Kelantan,0,0,0
2021-08-01,ESP,Melaka,0,0,0
2021-08-01,ESP,Negeri Sembilan,0,0,0
2021-08-01,ESP,Pahang,0,0,0
2021-08-01,ESP,Perak,0,0,0
2021-08-01,ESP,Perlis,0,0,0
2021-08-01,ESP,Pulau Pinang,0,0,0
2021-08-01,ESP,Sabah,0,0,0
2021-08-01,ESP,Sarawak,0,0,0
2021-08-01,ESP,Selangor,75,45,30
2021-08-01,ESP,W.P. Labuan,0,0,0
2021-08-01,EST,Johor,0,0,0
2021-08-01,EST,Kedah,0,0,0
2021-08-01,EST,Kelantan,0,0,0
2021-08-01,EST,Pahang,0,0,0
2021-08-01,EST,Perak,0,0,0
2021-08-01,EST,Perlis,0,0,0
2021-08-01,EST,Pulau Pinang,0,0,0
2021-08-01,EST,Sabah,0,0,0
2021-08-01,EST,Sarawak,0,0,0
2021-08-01,EST,Selangor,0,0,0
2021-08-01,EST,W.P. Labuan,0,0,0
2021-08-01,ETH,Johor,0,0,0
2021-08-01,ETH,Kedah,0,0,0
2021-08-01,ETH,Pulau Pinang,0,0,0
2021-08-01,ETH,Sarawak,0,0,0
2021-08-01,ETH,Selangor,1,1,0
2021-08-01,FIN,Johor,0,0,0
2021-08-01,FIN,Kedah,0,0,0
2021-08-01,FIN,Kelantan,0,0,0
2021-08-01,FIN,Melaka,0,0,0
2021-08-01,FIN,Negeri Sembilan,0,0,0
2021-08-01,FIN,Pahang,0,0,0
2021-08-01,FIN,Perak,0,0,0
2021-08-01,FIN,Perlis,0,0,0
2021-08-01,FIN,Pulau Pinang,0,0,0
2021-08-01,FIN,Sabah,0,0,0
2021-08-01,FIN,Sarawak,0,0,0
2021-08-01,FIN,Selangor,16,12,4
2021-08-01,FIN,W.P. Labuan,0,0,0
2021-08-01,FJI,Johor,0,0,0
2021-08-01,FJI,Kedah,0,0,0
2021-08-01,FJI,Kelantan,0,0,0
2021-08-01,FJI,Perak,0,0,0
2021-08-01,FJI,Perlis,0,0,0
2021-08-01,FJI,Pulau Pinang,0,0,0
2021-08-01,FJI,Sabah,0,0,0
2021-08-01,FJI,Sarawak,0,0,0
2021-08-01,FJI,Selangor,0,0,0
2021-08-01,FRA,Johor,0,0,0
2021-08-01,FRA,Kedah,0,0,0
2021-08-01,FRA,Kelantan,0,0,0
2021-08-01,FRA,Melaka,0,0,0
2021-08-01,FRA,Negeri Sembilan,0,0,0
2021-08-01,FRA,Pahang,0,0,0
2021-08-01,FRA,Perak,0,0,0
2021-08-01,FRA,Perlis,0,0,0
2021-08-01,FRA,Pulau Pinang,5,4,1
2021-08-01,FRA,Sabah,0,0,0
2021-08-01,FRA,Sarawak,1,1,0
2021-08-01,FRA,Selangor,417,243,174
2021-08-01,FRA,Terengganu,0,0,0
2021-08-01,FRA,W.P. Labuan,0,0,0
2021-08-01,FSM,Johor,0,0,0
2021-08-01,FSM,Pulau Pinang,0,0,0
2021-08-01,FSM,Selangor,0,0,0
2021-08-01,GAB,Johor,0,0,0
2021-08-01,GAB,Pulau Pinang,0,0,0
2021-08-01,GAB,Sarawak,0,0,0
2021-08-01,GAB,Selangor,0,0,0
2021-08-01,GBR,Johor,2,2,0
2021-08-01,GBR,Kedah,0,0,0
2021-08-01,GBR,Kelantan,0,0,0
2021-08-01,GBR,Melaka,0,0,0
2021-08-01,GBR,Negeri Sembilan,0,0,0
2021-08-01,GBR,Pahang,0,0,0
2021-08-01,GBR,Perak,0,0,0
2021-08-01,GBR,Perlis,0,0,0
2021-08-01,GBR,Pulau Pinang,26,9,17
2021-08-01,GBR,Sabah,0,0,0
2021-08-01,GBR,Sarawak,7,6,1
2021-08-01,GBR,Selangor,627,364,263
2021-08-01,GBR,Terengganu,0,0,0
2021-08-01,GBR,W.P. Labuan,0,0,0
2021-08-01,GEO,Johor,0,0,0
2021-08-01,GEO,Kedah,0,0,0
2021-08-01,GEO,Melaka,0,0,0
2021-08-01,GEO,Perak,0,0,0
2021-08-01,GEO,Perlis,0,0,0
2021-08-01,GEO,Pulau Pinang,0,0,0
2021-08-01,GEO,Sabah,0,0,0
2021-08-01,GEO,Sarawak,0,0,0
2021-08-01,GEO,Selangor,9,9,0
2021-08-01,GHA,Johor,0,0,0
2021-08-01,GHA,Kedah,0,0,0
2021-08-01,GHA,Kelantan,0,0,0
2021-08-01,GHA,Pulau Pinang,0,0,0
2021-08-01,GHA,Sabah,0,0,0
2021-08-01,GHA,Sarawak,0,0,0
2021-08-01,GHA,Selangor,10,5,5
2021-08-01,GIB,Johor,0,0,0
2021-08-01,GIB,Sarawak,0,0,0
2021-08-01,GIN,Johor,0,0,0
2021-08-01,GIN,Kedah,0,0,0
2021-08-01,GIN,Kelantan,0,0,0
2021-08-01,GIN,Perlis,0,0,0
2021-08-01,GIN,Pulau Pinang,0,0,0
2021-08-01,GIN,Sabah,0,0,0
2021-08-01,GIN,Sarawak,0,0,0
2021-08-01,GIN,Selangor,4,3,1
2021-08-01,GLP,Selangor,0,0,0
2021-08-01,GMB,Johor,0,0,0
2021-08-01,GMB,Kedah,0,0,0
2021-08-01,GMB,Kelantan,0,0,0
2021-08-01,GMB,Pulau Pinang,0,0,0
2021-08-01,GMB,Sabah,0,0,0
2021-08-01,GMB,Sarawak,0,0,0
2021-08-01,GMB,Selangor,0,0,0
2021-08-01,GNB,Johor,0,0,0
2021-08-01,GNB,Selangor,0,0,0
2021-08-01,GNQ,Johor,0,0,0
2021-08-01,GNQ,Selangor,0,0,0
2021-08-01,GRC,Johor,0,0,0
2021-08-01,GRC,Kedah,0,0,0
2021-08-01,GRC,Kelantan,0,0,0
2021-08-01,GRC,Melaka,0,0,0
2021-08-01,GRC,Negeri Sembilan,0,0,0
2021-08-01,GRC,Pahang,0,0,0
2021-08-01,GRC,Perak,0,0,0
2021-08-01,GRC,Perlis,0,0,0
2021-08-01,GRC,Pulau Pinang,0,0,0
2021-08-01,GRC,Sabah,0,0,0
2021-08-01,GRC,Sarawak,0,0,0
2021-08-01,GRC,Selangor,10,7,3
2021-08-01,GRD,Johor,0,0,0
2021-08-01,GRD,Kedah,0,0,0
2021-08-01,GRD,Pulau Pinang,0,0,0
2021-08-01,GRD,Sabah,0,0,0
2021-08-01,GRD,Sarawak,0,0,0
2021-08-01,GRD,Selangor,0,0,0
2021-08-01,GRL,Johor,0,0,0
2021-08-01,GRL,Selangor,0,0,0
2021-08-01,GTM,Johor,0,0,0
2021-08-01,GTM,Kedah,0,0,0
2021-08-01,GTM,Pahang,0,0,0
2021-08-01,GTM,Perak,0,0,0
2021-08-01,GTM,Pulau Pinang,0,0,0
2021-08-01,GTM,Sabah,0,0,0
2021-08-01,GTM,Sarawak,0,0,0
2021-08-01,GTM,Selangor,0,0,0
2021-08-01,GTM,W.P. Labuan,0,0,0
2021-08-01,GUY,Johor,0,0,0
2021-08-01,GUY,Kedah,0,0,0
2021-08-01,GUY,Pulau Pinang,0,0,0
2021-08-01,GUY,Sarawak,0,0,0
2021-08-01,GUY,Selangor,0,0,0
2021-08-01,HKG,Johor,0,0,0
2021-08-01,HKG,Kedah,0,0,0
2021-08-01,HKG,Kelantan,0,0,0
2021-08-01,HKG,Pahang,0,0,0
2021-08-01,HKG,Perak,0,0,0
2021-08-01,HKG,Perlis,0,0,0
2021-08-01,HKG,Pulau Pinang,3,1,2
2021-08-01,HKG,Sabah,0,0,0
2021-08-01,HKG,Sarawak,0,0,0
2021-08-01,HKG,Selangor,0,0,0
2021-08-01,HKG,Terengganu,0,0,0
2021-08-01,HMD,Johor,0,0,0
2021-08-01,HND,Johor,0,0,0
2021-08-01,HND,Kedah,0,0,0
2021-08-01,HND,Perak,0,0,0
2021-08-01,HND,Pulau Pinang,0,0,0
2021-08-01,HND,Sabah,0,0,0
2021-08-01,HND,Sarawak,0,0,0
2021-08-01,HND,Selangor,2,1,1
2021-08-01,HRV,Johor,0,0,0
2021-08-01,HRV,Kedah,0,0,0
2021-08-01,HRV,Kelantan,0,0,0
2021-08-01,HRV,Melaka,0,0,0
2021-08-01,HRV,Pahang,0,0,0
2021-08-01,HRV,Perak,0,0,0
2021-08-01,HRV,Perlis,0,0,0
2021-08-01,HRV,Pulau Pinang,0,0,0
2021-08-01,HRV,Sabah,2,2,0
2021-08-01,HRV,Sarawak,0,0,0
2021-08-01,HRV,Selangor,23,22,1
2021-08-01,HTI,Johor,0,0,0
2021-08-01,HTI,Kedah,0,0,0
2021-08-01,HTI,Kelantan,0,0,0
2021-08-01,HTI,Perak,0,0,0
2021-08-01,HTI,Pulau Pinang,0,0,0
2021-08-01,HTI,Sabah,0,0,0
2021-08-01,HTI,Selangor,0,0,0
2021-08-01,HUN,Johor,0,0,0
2021-08-01,HUN,Kedah,0,0,0
2021-08-01,HUN,Kelantan,0,0,0
2021-08-01,HUN,Pahang,0,0,0
2021-08-01,HUN,Perak,0,0,0
2021-08-01,HUN,Perlis,0,0,0
2021-08-01,HUN,Pulau Pinang,2,0,2
2021-08-01,HUN,Sabah,0,0,0
2021-08-01,HUN,Sarawak,0,0,0
2021-08-01,HUN,Selangor,8,7,1
2021-08-01,HUN,W.P. Labuan,0,0,0
2021-08-01,IDN,Johor,61,49,12
2021-08-01,IDN,Kedah,5,5,0
2021-08-01,IDN,Kelantan,0,0,0
2021-08-01,IDN,Melaka,0,0,0
2021-08-01,IDN,Negeri Sembilan,0,0,0
2021-08-01,IDN,Pahang,0,0,0
2021-08-01,IDN,Perak,0,0,0
2021-08-01,IDN,Perlis,7,7,0
2021-08-01,IDN,Pulau Pinang,1,1,0
2021-08-01,IDN,Sabah,2,0,2
2021-08-01,IDN,Sarawak,206,200,6
2021-08-01,IDN,Selangor,601,409,192
2021-08-01,IDN,Terengganu,0,0,0
2021-08-01,IDN,W.P. Labuan,2,2,0
2021-08-01,IND,Johor,17,17,0
2021-08-01,IND,Kedah,0,0,0
2021-08-01,IND,Kelantan,0,0,0
2021-08-01,IND,Melaka,0,0,0
2021-08-01,IND,Negeri Sembilan,0,0,0
2021-08-01,IND,Pahang,0,0,0
2021-08-01,IND,Perak,0,0,0
2021-08-01,IND,Perlis,0,0,0
2021-08-01,IND,Pulau Pinang,1,1,0
2021-08-01,IND,Sabah,0,0,0
2021-08-01,IND,Sarawak,0,0,0
2021-08-01,IND,Selangor,50,33,17
2021-08-01,IND,Terengganu,0,0,0
2021-08-01,IND,W.P. Labuan,0,0,0
2021-08-01,IOT,Pulau Pinang,0,0,0
2021-08-01,IOT,Selangor,0,0,0
2021-08-01,IRL,Johor,0,0,0
2021-08-01,IRL,Kedah,0,0,0
2021-08-01,IRL,Kelantan,0,0,0
2021-08-01,IRL,Negeri Sembilan,0,0,0
2021-08-01,IRL,Pahang,0,0,0
2021-08-01,IRL,Perak,0,0,0
2021-08-01,IRL,Perlis,0,0,0
2021-08-01,IRL,Pulau Pinang,0,0,0
2021-08-01,IRL,Sabah,0,0,0
2021-08-01,IRL,Sarawak,0,0,0
2021-08-01,IRL,Selangor,29,18,11
2021-08-01,IRL,Terengganu,0,0,0
2021-08-01,IRL,W.P. Labuan,0,0,0
2021-08-01,IRN,Johor,0,0,0
2021-08-01,IRN,Kedah,0,0,0
2021-08-01,IRN,Kelantan,0,0,0
2021-08-01,IRN,Perak,0,0,0
2021-08-01,IRN,Perlis,0,0,0
2021-08-01,IRN,Pulau Pinang,1,0,1
2021-08-01,IRN,Sabah,0,0,0
2021-08-01,IRN,Sarawak,0,0,0
2021-08-01,IRN,Selangor,45,33,12
2021-08-01,IRN,W.P. Labuan,0,0,0
2021-08-01,IRQ,Johor,0,0,0
2021-08-01,IRQ,Kedah,0,0,0
2021-08-01,IRQ,Kelantan,0,0,0
2021-08-01,IRQ,Melaka,0,0,0
2021-08-01,IRQ,Pahang,0,0,0
2021-08-01,IRQ,Perak,0,0,0
2021-08-01,IRQ,Perlis,0,0,0
2021-08-01,IRQ,Pulau Pinang,0,0,0
2021-08-01,IRQ,Sabah,0,0,0
2021-08-01,IRQ,Sarawak,0,0,0
2021-08-01,IRQ,Selangor,29,15,14
2021-08-01,ISL,Johor,0,0,0
2021-08-01,ISL,Kedah,0,0,0
2021-08-01,ISL,Kelantan,0,0,0
2021-08-01,ISL,Perak,0,0,0
2021-08-01,ISL,Perlis,0,0,0
2021-08-01,ISL,Pulau Pinang,0,0,0
2021-08-01,ISL,Sabah,0,0,0
2021-08-01,ISL,Sarawak,0,0,0
2021-08-01,ISL,Selangor,0,0,0
2021-08-01,ISL,W.P. Labuan,0,0,0
2021-08-01,ISR,Pulau Pinang,0,0,0
2021-08-01,ITA,Johor,0,0,0
2021-08-01,ITA,Kedah,0,0,0
2021-08-01,ITA,Kelantan,0,0,0
2021-08-01,ITA,Melaka,0,0,0
2021-08-01,ITA,Negeri Sembilan,0,0,0
2021-08-01,ITA,Pahang,0,0,0
2021-08-01,ITA,Perak,0,0,0
2021-08-01,ITA,Perlis,0,0,0
2021-08-01,ITA,Pulau Pinang,1,1,0
2021-08-01,ITA,Sabah,0,0,0
2021-08-01,ITA,Sarawak,1,1,0
2021-08-01,ITA,Selangor,65,43,22
2021-08-01,ITA,W.P. Labuan,0,0,0
2021-08-01,JAM,Johor,0,0,0
2021-08-01,JAM,Kedah,0,0,0
2021-08-01,JAM,Perak,0,0,0
2021-08-01,JAM,Pulau Pinang,0,0,0
2021-08-01,JAM,Sabah,0,0,0
2021-08-01,JAM,Sarawak,0,0,0
2021-08-01,JAM,Selangor,0,0,0
2021-08-01,JAM,W.P. Labuan,0,0,0
2021-08-01,JOR,Johor,0,0,0
2021-08-01,JOR,Kedah,0,0,0
2021-08-01,JOR,Kelantan,0,0,0
2021-08-01,JOR,Melaka,0,0,0
2021-08-01,JOR,Perlis,0,0,0
2021-08-01,JOR,Pulau Pinang,0,0,0
2021-08-01,JOR,Sabah,0,0,0
2021-08-01,JOR,Sarawak,0,0,0
2021-08-01,JOR,Selangor,24,15,9
2021-08-01,JOR,W.P. Labuan,0,0,0
2021-08-01,JPN,Johor,1,1,0
2021-08-01,JPN,Kedah,0,0,0
2021-08-01,JPN,Kelantan,0,0,0
2021-08-01,JPN,Melaka,0,0,0
2021-08-01,JPN,Negeri Sembilan,0,0,0
2021-08-01,JPN,Pahang,0,0,0
2021-08-01,JPN,Perak,1,1,0
2021-08-01,JPN,Perlis,0,0,0
2021-08-01,JPN,Pulau Pinang,22,16,6
2021-08-01,JPN,Sabah,0,0,0
2021-08-01,JPN,Sarawak,1,1,0
2021-08-01,JPN,Selangor,360,226,134
2021-08-01,JPN,W.P. Labuan,0,0,0
2021-08-01,KAZ,Johor,0,0,0
2021-08-01,KAZ,Kedah,0,0,0
2021-08-01,KAZ,Kelantan,0,0,0
2021-08-01,KAZ,Melaka,0,0,0
2021-08-01,KAZ,Perak,0,0,0
2021-08-01,KAZ,Perlis,0,0,0
2021-08-01,KAZ,Pulau Pinang,0,0,0
2021-08-01,KAZ,Sabah,0,0,0
2021-08-01,KAZ,Sarawak,0,0,0
2021-08-01,KAZ,Selangor,21,17,4
2021-08-01,KAZ,W.P. Labuan,0,0,0
2021-08-01,KEN,Johor,0,0,0
2021-08-01,KEN,Kedah,0,0,0
2021-08-01,KEN,Kelantan,0,0,0
2021-08-01,KEN,Perak,0,0,0
2021-08-01,KEN,Perlis,0,0,0
2021-08-01,KEN,Pulau Pinang,0,0,0
2021-08-01,KEN,Sabah,0,0,0
2021-08-01,KEN,Sarawak,0,0,0
2021-08-01,KEN,Selangor,8,4,4
2021-08-01,KGZ,Johor,0,0,0
2021-08-01,KGZ,Kedah,0,0,0
2021-08-01,KGZ,Kelantan,0,0,0
2021-08-01,KGZ,Perak,0,0,0
2021-08-01,KGZ,Perlis,0,0,0
2021-08-01,KGZ,Pulau Pinang,0,0,0
2021-08-01,KGZ,Sabah,0,0,0
2021-08-01,KGZ,Sarawak,0,0,0
2021-08-01,KGZ,Selangor,8,8,0
2021-08-01,KHM,Johor,0,0,0
2021-08-01,KHM,Kedah,0,0,0
2021-08-01,KHM,Kelantan,0,0,0
2021-08-01,KHM,Melaka,0,0,0
2021-08-01,KHM,Negeri Sembilan,0,0,0
2021-08-01,KHM,Pahang,0,0,0
2021-08-01,KHM,Perak,0,0,0
2021-08-01,KHM,Perlis,0,0,0
2021-08-01,KHM,Pulau Pinang,1,0,1
2021-08-01,KHM,Sabah,0,0,0
2021-08-01,KHM,Sarawak,0,0,0
2021-08-01,KHM,Selangor,63,61,2
2021-08-01,KHM,W.P. Labuan,0,0,0
2021-08-01,KIR,Johor,0,0,0
2021-08-01,KIR,Sabah,0,0,0
2021-08-01,KIR,Selangor,0,0,0
2021-08-01,KNA,Johor,0,0,0
2021-08-01,KNA,Kedah,0,0,0
2021-08-01,KNA,Perlis,0,0,0
2021-08-01,KNA,Pulau Pinang,0,0,0
2021-08-01,KNA,Sabah,0,0,0
2021-08-01,KNA,Selangor,0,0,0
2021-08-01,KNA,W.P. Labuan,0,0,0
2021-08-01,KOR,Johor,0,0,0
2021-08-01,KOR,Kedah,0,0,0
2021-08-01,KOR,Kelantan,0,0,0
2021-08-01,KOR,Melaka,0,0,0
2021-08-01,KOR,Negeri Sembilan,0,0,0
2021-08-01,KOR,Pahang,0,0,0
2021-08-01,KOR,Perak,0,0,0
2021-08-01,KOR,Perlis,0,0,0
2021-08-01,KOR,Pulau Pinang,12,6,6
2021-08-01,KOR,Sabah,0,0,0
2021-08-01,KOR,Sarawak,28,28,0
2021-08-01,KOR,Selangor,332,187,145
2021-08-01,KOR,Terengganu,0,0,0
2021-08-01,KOR,W.P. Labuan,0,0,0
2021-08-01,KWT,Johor,0,0,0
2021-08-01,KWT,Kedah,0,0,0
2021-08-01,KWT,Kelantan,0,0,0
2021-08-01,KWT,Perak,0,0,0
2021-08-01,KWT,Perlis,0,0,0
2021-08-01,KWT,Pulau Pinang,0,0,0
2021-08-01,KWT,Sabah,0,0,0
2021-08-01,KWT,Sarawak,0,0,0
2021-08-01,KWT,Selangor,10,8,2
2021-08-01,KWT,W.P. Labuan,0,0,0
2021-08-01,LAO,Johor,0,0,0
2021-08-01,LAO,Kedah,0,0,0
2021-08-01,LAO,Kelantan,0,0,0
2021-08-01,LAO,Melaka,0,0,0
2021-08-01,LAO,Perak,0,0,0
2021-08-01,LAO,Perlis,0,0,0
2021-08-01,LAO,Pulau Pinang,0,0,0
2021-08-01,LAO,Sabah,0,0,0
2021-08-01,LAO,Sarawak,0,0,0
2021-08-01,LAO,Selangor,202,202,0
2021-08-01,LAO,W.P. Labuan,0,0,0
2021-08-01,LBN,Johor,0,0,0
2021-08-01,LBN,Kedah,0,0,0
2021-08-01,LBN,Kelantan,0,0,0
2021-08-01,LBN,Pahang,0,0,0
2021-08-01,LBN,Perak,0,0,0
2021-08-01,LBN,Perlis,0,0,0
2021-08-01,LBN,Pulau Pinang,0,0,0
2021-08-01,LBN,Sabah,0,0,0
2021-08-01,LBN,Sarawak,0,0,0
2021-08-01,LBN,Selangor,1,1,0
2021-08-01,LBN,W.P. Labuan,0,0,0
2021-08-01,LBR,Johor,0,0,0
2021-08-01,LBR,Kedah,0,0,0
2021-08-01,LBR,Sabah,0,0,0
2021-08-01,LBR,Sarawak,0,0,0
2021-08-01,LBR,Selangor,1,1,0
2021-08-01,LBY,Johor,0,0,0
2021-08-01,LBY,Kedah,0,0,0
2021-08-01,LBY,Perlis,0,0,0
2021-08-01,LBY,Pulau Pinang,0,0,0
2021-08-01,LBY,Sabah,0,0,0
2021-08-01,LBY,Sarawak,0,0,0
2021-08-01,LBY,Selangor,28,23,5
2021-08-01,LCA,Johor,0,0,0
2021-08-01,LCA,Kedah,0,0,0
2021-08-01,LCA,Pulau Pinang,0,0,0
2021-08-01,LCA,Sarawak,0,0,0
2021-08-01,LCA,Selangor,0,0,0
2021-08-01,LIE,Johor,0,0,0
2021-08-01,LIE,Kedah,0,0,0
2021-08-01,LIE,Perlis,0,0,0
2021-08-01,LIE,Pulau Pinang,0,0,0
2021-08-01,LIE,Sabah,0,0,0
2021-08-01,LIE,Sarawak,0,0,0
2021-08-01,LIE,Selangor,0,0,0
2021-08-01,LKA,Johor,0,0,0
2021-08-01,LKA,Kedah,0,0,0
2021-08-01,LKA,Kelantan,0,0,0
2021-08-01,LKA,Melaka,0,0,0
2021-08-01,LKA,Pahang,0,0,0
2021-08-01,LKA,Perak,0,0,0
2021-08-01,LKA,Perlis,0,0,0
2021-08-01,LKA,Pulau Pinang,0,0,0
2021-08-01,LKA,Sabah,0,0,0
2021-08-01,LKA,Sarawak,0,0,0
2021-08-01,LKA,Selangor,5,4,1
2021-08-01,LKA,W.P. Labuan,0,0,0
2021-08-01,LSO,Johor,0,0,0
2021-08-01,LSO,Kedah,0,0,0
2021-08-01,LSO,Pulau Pinang,0,0,0
2021-08-01,LSO,Sarawak,0,0,0
2021-08-01,LSO,Selangor,0,0,0
2021-08-01,LTU,Johor,0,0,0
2021-08-01,LTU,Kedah,0,0,0
2021-08-01,LTU,Kelantan,0,0,0
2021-08-01,LTU,Pahang,0,0,0
2021-08-01,LTU,Perak,0,0,0
2021-08-01,LTU,Perlis,0,0,0
2021-08-01,LTU,Pulau Pinang,0,0,0
2021-08-01,LTU,Sabah,0,0,0
2021-08-01,LTU,Sarawak,0,0,0
2021-08-01,LTU,Selangor,5,5,0
2021-08-01,LTU,W.P. Labuan,0,0,0
2021-08-01,LUX,Johor,0,0,0
2021-08-01,LUX,Kedah,0,0,0
2021-08-01,LUX,Kelantan,0,0,0
2021-08-01,LUX,Perak,0,0,0
2021-08-01,LUX,Perlis,0,0,0
2021-08-01,LUX,Pulau Pinang,0,0,0
2021-08-01,LUX,Sabah,0,0,0
2021-08-01,LUX,Sarawak,0,0,0
2021-08-01,LUX,Selangor,0,0,0
2021-08-01,LVA,Johor,0,0,0
2021-08-01,LVA,Kedah,0,0,0
2021-08-01,LVA,Kelantan,0,0,0
2021-08-01,LVA,Pahang,0,0,0
2021-08-01,LVA,Perak,0,0,0
2021-08-01,LVA,Perlis,0,0,0
2021-08-01,LVA,Pulau Pinang,0,0,0
2021-08-01,LVA,Sabah,0,0,0
2021-08-01,LVA,Sarawak,0,0,0
2021-08-01,LVA,Selangor,6,5,1
2021-08-01,LVA,W.P. Labuan,0,0,0
2021-08-01,MAC,Johor,0,0,0
2021-08-01,MAC,Pahang,0,0,0
2021-08-01,MAC,Perak,0,0,0
2021-08-01,MAC,Selangor,0,0,0
2021-08-01,MAC,W.P. Labuan,0,0,0
2021-08-01,MAR,Johor,0,0,0
2021-08-01,MAR,Kedah,0,0,0
2021-08-01,MAR,Kelantan,0,0,0
2021-08-01,MAR,Melaka,0,0,0
2021-08-01,MAR,Pahang,0,0,0
2021-08-01,MAR,Perak,0,0,0
2021-08-01,MAR,Perlis,0,0,0
2021-08-01,MAR,Pulau Pinang,0,0,0
2021-08-01,MAR,Sabah,0,0,0
2021-08-01,MAR,Sarawak,0,0,0
2021-08-01,MAR,Selangor,10,5,5
2021-08-01,MAR,W.P. Labuan,0,0,0
2021-08-01,MCO,Johor,0,0,0
2021-08-01,MCO,Kedah,0,0,0
2021-08-01,MCO,Sabah,0,0,0
2021-08-01,MCO,Selangor,3,0,3
2021-08-01,MDA,Johor,0,0,0
2021-08-01,MDA,Kedah,0,0,0
2021-08-01,MDA,Kelantan,0,0,0
2021-08-01,MDA,Negeri Sembilan,0,0,0
2021-08-01,MDA,Perlis,0,0,0
2021-08-01,MDA,Pulau Pinang,0,0,0
2021-08-01,MDA,Sabah,0,0,0
2021-08-01,MDA,Sarawak,0,0,0
2021-08-01,MDA,Selangor,0,0,0
2021-08-01,MDG,Johor,0,0,0
2021-08-01,MDG,Kedah,0,0,0
2021-08-01,MDG,Perak,0,0,0
2021-08-01,MDG,Perlis,0,0,0
2021-08-01,MDG,Pulau Pinang,0,0,0
2021-08-01,MDG,Sabah,0,0,0
2021-08-01,MDG,Sarawak,0,0,0
2021-08-01,MDG,Selangor,1,1,0
2021-08-01,MDV,Johor,0,0,0
2021-08-01,MDV,Kedah,0,0,0
2021-08-01,MDV,Kelantan,0,0,0
2021-08-01,MDV,Perak,0,0,0
2021-08-01,MDV,Perlis,0,0,0
2021-08-01,MDV,Pulau Pinang,1,1,0
2021-08-01,MDV,Sabah,0,0,0
2021-08-01,MDV,Sarawak,0,0,0
2021-08-01,MDV,Selangor,56,29,27
2021-08-01,MEX,Johor,0,0,0
2021-08-01,MEX,Kedah,0,0,0
2021-08-01,MEX,Kelantan,0,0,0
2021-08-01,MEX,Pahang,0,0,0
2021-08-01,MEX,Perak,0,0,0
2021-08-01,MEX,Perlis,0,0,0
2021-08-01,MEX,Pulau Pinang,0,0,0
2021-08-01,MEX,Sabah,0,0,0
2021-08-01,MEX,Sarawak,0,0,0
2021-08-01,MEX,Selangor,14,10,4
2021-08-01,MEX,W.P. Labuan,0,0,0
2021-08-01,MHL,Johor,0,0,0
2021-08-01,MHL,Kedah,0,0,0
2021-08-01,MHL,Perak,0,0,0
2021-08-01,MHL,Pulau Pinang,0,0,0
2021-08-01,MHL,Sabah,0,0,0
2021-08-01,MHL,Selangor,0,0,0
2021-08-01,MKD,Johor,0,0,0
2021-08-01,MKD,Kedah,0,0,0
2021-08-01,MKD,Perak,0,0,0
2021-08-01,MKD,Pulau Pinang,0,0,0
2021-08-01,MKD,Sabah,0,0,0
2021-08-01,MKD,Sarawak,0,0,0
2021-08-01,MKD,Selangor,1,0,1
2021-08-01,MLI,Johor,0,0,0
2021-08-01,MLI,Sabah,0,0,0
2021-08-01,MLI,Selangor,0,0,0
2021-08-01,MLT,Johor,0,0,0
2021-08-01,MLT,Kedah,0,0,0
2021-08-01,MLT,Kelantan,0,0,0
2021-08-01,MLT,Perak,0,0,0
2021-08-01,MLT,Perlis,0,0,0
2021-08-01,MLT,Pulau Pinang,0,0,0
2021-08-01,MLT,Sabah,0,0,0
2021-08-01,MLT,Sarawak,0,0,0
2021-08-01,MLT,Selangor,0,0,0
2021-08-01,MLT,W.P. Labuan,0,0,0
2021-08-01,MMR,Johor,0,0,0
2021-08-01,MMR,Kedah,0,0,0
2021-08-01,MMR,Kelantan,0,0,0
2021-08-01,MMR,Negeri Sembilan,0,0,0
2021-08-01,MMR,Pahang,0,0,0
2021-08-01,MMR,Perak,0,0,0
2021-08-01,MMR,Perlis,0,0,0
2021-08-01,MMR,Pulau Pinang,0,0,0
2021-08-01,MMR,Sabah,0,0,0
2021-08-01,MMR,Sarawak,0,0,0
2021-08-01,MMR,Selangor,59,55,4
2021-08-01,MMR,Terengganu,0,0,0
2021-08-01,MMR,W.P. Labuan,0,0,0
2021-08-01,MNE,Johor,0,0,0
2021-08-01,MNE,Kedah,0,0,0
2021-08-01,MNE,Pulau Pinang,0,0,0
2021-08-01,MNE,Sabah,0,0,0
2021-08-01,MNE,Sarawak,0,0,0
2021-08-01,MNE,Selangor,5,5,0
2021-08-01,MNG,Johor,0,0,0
2021-08-01,MNG,Kedah,0,0,0
2021-08-01,MNG,Kelantan,0,0,0
2021-08-01,MNG,Perak,0,0,0
2021-08-01,MNG,Perlis,0,0,0
2021-08-01,MNG,Pulau Pinang,0,0,0
2021-08-01,MNG,Sabah,0,0,0
2021-08-01,MNG,Sarawak,0,0,0
2021-08-01,MNG,Selangor,1,0,1
2021-08-01,MNP,Selangor,0,0,0
2021-08-01,MOZ,Johor,0,0,0
2021-08-01,MOZ,Kedah,0,0,0
2021-08-01,MOZ,Perak,0,0,0
2021-08-01,MOZ,Pulau Pinang,0,0,0
2021-08-01,MOZ,Sabah,0,0,0
2021-08-01,MOZ,Sarawak,0,0,0
2021-08-01,MOZ,Selangor,8,6,2
2021-08-01,MRT,Johor,0,0,0
2021-08-01,MRT,Kedah,0,0,0
2021-08-01,MRT,Pulau Pinang,0,0,0
2021-08-01,MRT,Sabah,0,0,0
2021-08-01,MRT,Sarawak,0,0,0
2021-08-01,MRT,Selangor,0,0,0
2021-08-01,MUS,Johor,0,0,0
2021-08-01,MUS,Kedah,0,0,0
2021-08-01,MUS,Kelantan,0,0,0
2021-08-01,MUS,Pahang,0,0,0
2021-08-01,MUS,Perak,0,0,0
2021-08-01,MUS,Perlis,0,0,0
2021-08-01,MUS,Pulau Pinang,0,0,0
2021-08-01,MUS,Sabah,0,0,0
2021-08-01,MUS,Sarawak,0,0,0
2021-08-01,MUS,Selangor,6,1,5
2021-08-01,MWI,Johor,0,0,0
2021-08-01,MWI,Pulau Pinang,0,0,0
2021-08-01,MWI,Sabah,0,0,0
2021-08-01,MWI,Sarawak,0,0,0
2021-08-01,MWI,Selangor,4,3,1
2021-08-01,MYT,Selangor,0,0,0
2021-08-01,NAM,Johor,0,0,0
2021-08-01,NAM,Kedah,0,0,0
2021-08-01,NAM,Perak,0,0,0
2021-08-01,NAM,Perlis,0,0,0
2021-08-01,NAM,Pulau Pinang,0,0,0
2021-08-01,NAM,Sabah,0,0,0
2021-08-01,NAM,Sarawak,0,0,0
2021-08-01,NAM,Selangor,0,0,0
2021-08-01,NCL,Selangor,0,0,0
2021-08-01,NER,Johor,0,0,0
2021-08-01,NER,Sabah,0,0,0
2021-08-01,NER,Selangor,0,0,0
2021-08-01,NGA,Johor,0,0,0
2021-08-01,NGA,Kedah,0,0,0
2021-08-01,NGA,Perlis,0,0,0
2021-08-01,NGA,Pulau Pinang,0,0,0
2021-08-01,NGA,Sabah,0,0,0
2021-08-01,NGA,Sarawak,1,1,0
2021-08-01,NGA,Selangor,88,80,8
2021-08-01,NIC,Johor,0,0,0
2021-08-01,NIC,Kedah,0,0,0
2021-08-01,NIC,Pulau Pinang,0,0,0
2021-08-01,NIC,Sabah,0,0,0
2021-08-01,NIC,Selangor,0,0,0
2021-08-01,NLD,Johor,0,0,0
2021-08-01,NLD,Kedah,0,0,0
2021-08-01,NLD,Kelantan,0,0,0
2021-08-01,NLD,Melaka,0,0,0
2021-08-01,NLD,Negeri Sembilan,0,0,0
2021-08-01,NLD,Pahang,0,0,0
2021-08-01,NLD,Perak,0,0,0
2021-08-01,NLD,Perlis,0,0,0
2021-08-01,NLD,Pulau Pinang,0,0,0
2021-08-01,NLD,Sabah,0,0,0
2021-08-01,NLD,Sarawak,0,0,0
2021-08-01,NLD,Selangor,91,61,30
2021-08-01,NLD,Terengganu,0,0,0
2021-08-01,NLD,W.P. Labuan,0,0,0
2021-08-01,NOR,Johor,0,0,0
2021-08-01,NOR,Kedah,0,0,0
2021-08-01,NOR,Kelantan,0,0,0
2021-08-01,NOR,Melaka,0,0,0
2021-08-01,NOR,Pahang,0,0,0
2021-08-01,NOR,Perak,0,0,0
2021-08-01,NOR,Perlis,0,0,0
2021-08-01,NOR,Pulau Pinang,0,0,0
2021-08-01,NOR,Sabah,0,0,0
2021-08-01,NOR,Sarawak,1,1,0
2021-08-01,NOR,Selangor,23,19,4
2021-08-01,NOR,W.P. Labuan,0,0,0
2021-08-01,NPL,Johor,0,0,0
2021-08-01,NPL,Kedah,0,0,0
2021-08-01,NPL,Pahang,0,0,0
2021-08-01,NPL,Perak,0,0,0
2021-08-01,NPL,Perlis,0,0,0
2021-08-01,NPL,Pulau Pinang,0,0,0
2021-08-01,NPL,Sabah,0,0,0
2021-08-01,NPL,Sarawak,0,0,0
2021-08-01,NPL,Selangor,0,0,0
2021-08-01,NPL,W.P. Labuan,0,0,0
2021-08-01,NRU,Johor,0,0,0
2021-08-01,NRU,Pulau Pinang,0,0,0
2021-08-01,NRU,Selangor,0,0,0
2021-08-01,NZL,Johor,0,0,0
2021-08-01,NZL,Kedah,0,0,0
2021-08-01,NZL,Kelantan,0,0,0
2021-08-01,NZL,Melaka,0,0,0
2021-08-01,NZL,Negeri Sembilan,0,0,0
2021-08-01,NZL,Pahang,0,0,0
2021-08-01,NZL,Perak,0,0,0
2021-08-01,NZL,Perlis,0,0,0
2021-08-01,NZL,Pulau Pinang,0,0,0
2021-08-01,NZL,Sabah,0,0,0
2021-08-01,NZL,Sarawak,0,0,0
2021-08-01,NZL,Selangor,21,10,11
2021-08-01,NZL,Terengganu,0,0,0
2021-08-01,NZL,W.P. Labuan,0,0,0
2021-08-01,OMN,Johor,0,0,0
2021-08-01,OMN,Kedah,0,0,0
2021-08-01,OMN,Kelantan,0,0,0
2021-08-01,OMN,Melaka,0,0,0
2021-08-01,OMN,Perak,0,0,0
2021-08-01,OMN,Perlis,0,0,0
2021-08-01,OMN,Pulau Pinang,0,0,0
2021-08-01,OMN,Sabah,0,0,0
2021-08-01,OMN,Sarawak,0,0,0
2021-08-01,OMN,Selangor,18,15,3
2021-08-01,PAK,Johor,2,2,0
2021-08-01,PAK,Kedah,0,0,0
2021-08-01,PAK,Kelantan,0,0,0
2021-08-01,PAK,Melaka,0,0,0
2021-08-01,PAK,Negeri Sembilan,0,0,0
2021-08-01,PAK,Pahang,0,0,0
2021-08-01,PAK,Perak,0,0,0
2021-08-01,PAK,Perlis,0,0,0
2021-08-01,PAK,Pulau Pinang,0,0,0
2021-08-01,PAK,Sabah,0,0,0
2021-08-01,PAK,Sarawak,0,0,0
2021-08-01,PAK,Selangor,29,22,7
2021-08-01,PAK,W.P. Labuan,0,0,0
2021-08-01,PAN,Johor,0,0,0
2021-08-01,PAN,Kedah,0,0,0
2021-08-01,PAN,Perak,0,0,0
2021-08-01,PAN,Perlis,0,0,0
2021-08-01,PAN,Pulau Pinang,0,0,0
2021-08-01,PAN,Sabah,0,0,0
2021-08-01,PAN,Sarawak,0,0,0
2021-08-01,PAN,Selangor,2,1,1
2021-08-01,PER,Johor,0,0,0
2021-08-01,PER,Kedah,0,0,0
2021-08-01,PER,Kelantan,0,0,0
2021-08-01,PER,Pahang,0,0,0
2021-08-01,PER,Perak,0,0,0
2021-08-01,PER,Perlis,0,0,0
2021-08-01,PER,Pulau Pinang,0,0,0
2021-08-01,PER,Sabah,0,0,0
2021-08-01,PER,Sarawak,0,0,0
2021-08-01,PER,Selangor,4,2,2
2021-08-01,PER,W.P. Labuan,0,0,0
2021-08-01,PHL,Johor,2,1,1
2021-08-01,PHL,Kedah,0,0,0
2021-08-01,PHL,Kelantan,0,0,0
2021-08-01,PHL,Melaka,0,0,0
2021-08-01,PHL,Negeri Sembilan,0,0,0
2021-08-01,PHL,Pahang,0,0,0
2021-08-01,PHL,Perak,0,0,0
2021-08-01,PHL,Perlis,0,0,0
2021-08-01,PHL,Pulau Pinang,6,2,4
2021-08-01,PHL,Sabah,1,1,0
2021-08-01,PHL,Sarawak,40,37,3
2021-08-01,PHL,Selangor,361,290,71
2021-08-01,PHL,Terengganu,0,0,0
2021-08-01,PHL,W.P. Labuan,7,7,0
2021-08-01,PLW,Johor,0,0,0
2021-08-01,PLW,Pulau Pinang,0,0,0
2021-08-01,PLW,Selangor,0,0,0
2021-08-01,PNG,Johor,0,0,0
2021-08-01,PNG,Kedah,0,0,0
2021-08-01,PNG,Kelantan,0,0,0
2021-08-01,PNG,Perak,0,0,0
2021-08-01,PNG,Pulau Pinang,0,0,0
2021-08-01,PNG,Sabah,0,0,0
2021-08-01,PNG,Sarawak,0,0,0
2021-08-01,PNG,Selangor,0,0,0
2021-08-01,POL,Johor,0,0,0
2021-08-01,POL,Kedah,0,0,0
2021-08-01,POL,Kelantan,0,0,0
2021-08-01,POL,Melaka,0,0,0
2021-08-01,POL,Negeri Sembilan,0,0,0
2021-08-01,POL,Pahang,0,0,0
2021-08-01,POL,Perak,0,0,0
2021-08-01,POL,Perlis,0,0,0
2021-08-01,POL,Pulau Pinang,0,0,0
2021-08-01,POL,Sabah,0,0,0
2021-08-01,POL,Sarawak,0,0,0
2021-08-01,POL,Selangor,37,32,5
2021-08-01,POL,Terengganu,0,0,0
2021-08-01,POL,W.P. Labuan,0,0,0
2021-08-01,PRK,Selangor,0,0,0
2021-08-01,PRT,Johor,0,0,0
2021-08-01,PRT,Kedah,0,0,0
2021-08-01,PRT,Kelantan,0,0,0
2021-08-01,PRT,Melaka,0,0,0
2021-08-01,PRT,Pahang,0,0,0
2021-08-01,PRT,Perak,0,0,0
2021-08-01,PRT,Perlis,0,0,0
2021-08-01,PRT,Pulau Pinang,0,0,0
2021-08-01,PRT,Sabah,0,0,0
2021-08-01,PRT,Sarawak,0,0,0
2021-08-01,PRT,Selangor,18,5,13
2021-08-01,PRT,W.P. Labuan,0,0,0
2021-08-01,PRY,Johor,0,0,0
2021-08-01,PRY,Kedah,0,0,0
2021-08-01,PRY,Perak,0,0,0
2021-08-01,PRY,Perlis,0,0,0
2021-08-01,PRY,Pulau Pinang,0,0,0
2021-08-01,PRY,Sabah,0,0,0
2021-08-01,PRY,Sarawak,0,0,0
2021-08-01,PRY,Selangor,0,0,0
2021-08-01,PSE,Johor,0,0,0
2021-08-01,PSE,Kedah,0,0,0
2021-08-01,PSE,Kelantan,0,0,0
2021-08-01,PSE,Melaka,0,0,0
2021-08-01,PSE,Perak,0,0,0
2021-08-01,PSE,Perlis,0,0,0
2021-08-01,PSE,Pulau Pinang,0,0,0
2021-08-01,PSE,Sabah,0,0,0
2021-08-01,PSE,Sarawak,0,0,0
2021-08-01,PSE,Selangor,14,9,5
2021-08-01,QAT,Johor,0,0,0
2021-08-01,QAT,Kedah,0,0,0
2021-08-01,QAT,Perlis,0,0,0
2021-08-01,QAT,Pulau Pinang,0,0,0
2021-08-01,QAT,Sabah,0,0,0
2021-08-01,QAT,Sarawak,0,0,0
2021-08-01,QAT,Selangor,19,12,7
2021-08-01,REU,Johor,0,0,0
2021-08-01,REU,Sarawak,0,0,0
2021-08-01,ROU,Johor,0,0,0
2021-08-01,ROU,Kedah,0,0,0
2021-08-01,ROU,Kelantan,0,0,0
2021-08-01,ROU,Negeri Sembilan,0,0,0
2021-08-01,ROU,Pahang,0,0,0
2021-08-01,ROU,Perak,0,0,0
2021-08-01,ROU,Perlis,0,0,0
2021-08-01,ROU,Pulau Pinang,0,0,0
2021-08-01,ROU,Sabah,0,0,0
2021-08-01,ROU,Sarawak,1,1,0
2021-08-01,ROU,Selangor,25,19,6
2021-08-01,ROU,W.P. Labuan,0,0,0
2021-08-01,RUS,Johor,6,6,0
2021-08-01,RUS,Kedah,0,0,0
2021-08-01,RUS,Kelantan,0,0,0
2021-08-01,RUS,Melaka,0,0,0
2021-08-01,RUS,Negeri Sembilan,0,0,0
2021-08-01,RUS,Pahang,0,0,0
2021-08-01,RUS,Perak,0,0,0
2021-08-01,RUS,Perlis,0,0,0
2021-08-01,RUS,Pulau Pinang,0,0,0
2021-08-01,RUS,Sabah,0,0,0
2021-08-01,RUS,Sarawak,0,0,0
2021-08-01,RUS,Selangor,85,63,22
2021-08-01,RUS,W.P. Labuan,0,0,0
2021-08-01,RWA,Johor,0,0,0
2021-08-01,RWA,Kedah,0,0,0
2021-08-01,RWA,Pulau Pinang,0,0,0
2021-08-01,RWA,Selangor,2,1,1
2021-08-01,SAU,Johor,0,0,0
2021-08-01,SAU,Kedah,0,0,0
2021-08-01,SAU,Kelantan,0,0,0
2021-08-01,SAU,Melaka,0,0,0
2021-08-01,SAU,Perak,0,0,0
2021-08-01,SAU,Perlis,0,0,0
2021-08-01,SAU,Pulau Pinang,0,0,0
2021-08-01,SAU,Sabah,0,0,0
2021-08-01,SAU,Sarawak,0,0,0
2021-08-01,SAU,Selangor,123,75,48
2021-08-01,SAU,W.P. Labuan,0,0,0
2021-08-01,SDN,Johor,0,0,0
2021-08-01,SDN,Kedah,0,0,0
2021-08-01,SDN,Kelantan,0,0,0
2021-08-01,SDN,Perlis,0,0,0
2021-08-01,SDN,Pulau Pinang,0,0,0
2021-08-01,SDN,Sabah,0,0,0
2021-08-01,SDN,Sarawak,0,0,0
2021-08-01,SDN,Selangor,33,22,11
2021-08-01,SDN,W.P. Labuan,0,0,0
2021-08-01,SEN,Johor,0,0,0
2021-08-01,SEN,Kedah,0,0,0
2021-08-01,SEN,Kelantan,0,0,0
2021-08-01,SEN,Perak,0,0,0
2021-08-01,SEN,Perlis,0,0,0
2021-08-01,SEN,Pulau Pinang,0,0,0
2021-08-01,SEN,Sabah,0,0,0
2021-08-01,SEN,Sarawak,0,0,0
2021-08-01,SEN,Selangor,15,11,4
2021-08-01,SGP,Johor,81,63,18
2021-08-01,SGP,Kedah,3,3,0
2021-08-01,SGP,Kelantan,0,0,0
2021-08-01,SGP,Melaka,0,0,0
2021-08-01,SGP,Negeri Sembilan,0,0,0
2021-08-01,SGP,Pahang,0,0,0
2021-08-01,SGP,Perak,1,0,1
2021-08-01,SGP,Perlis,0,0,0
2021-08-01,SGP,Pulau Pinang,12,6,6
2021-08-01,SGP,Sabah,0,0,0
2021-08-01,SGP,Sarawak,4,4,0
2021-08-01,SGP,Selangor,107,75,32
2021-08-01,SGP,Terengganu,0,0,0
2021-08-01,SGP,W.P. Labuan,0,0,0
2021-08-01,SGS,Johor,0,0,0
2021-08-01,SGS,Sabah,0,0,0
2021-08-01,SGS,Selangor,0,0,0
2021-08-01,SHN,Sarawak,0,0,0
2021-08-01,SLB,Johor,0,0,0
2021-08-01,SLB,Perlis,0,0,0
2021-08-01,SLB,Pulau Pinang,0,0,0
2021-08-01,SLB,Sabah,0,0,0
2021-08-01,SLB,Sarawak,0,0,0
2021-08-01,SLB,Selangor,0,0,0
2021-08-01,SLB,W.P. Labuan,0,0,0
2021-08-01,SLE,Johor,0,0,0
2021-08-01,SLE,Kedah,0,0,0
2021-08-01,SLE,Perak,0,0,0
2021-08-01,SLE,Pulau Pinang,0,0,0
2021-08-01,SLE,Sabah,0,0,0
2021-08-01,SLE,Selangor,0,0,0
2021-08-01,SLV,Johor,0,0,0
2021-08-01,SLV,Kedah,0,0,0
2021-08-01,SLV,Perak,0,0,0
2021-08-01,SLV,Perlis,0,0,0
2021-08-01,SLV,Pulau Pinang,0,0,0
2021-08-01,SLV,Sabah,0,0,0
2021-08-01,SLV,Selangor,0,0,0
2021-08-01,SLV,W.P. Labuan,0,0,0
2021-08-01,SMR,Johor,0,0,0
2021-08-01,SMR,Selangor,0,0,0
2021-08-01,SOM,Johor,0,0,0
2021-08-01,SOM,Kedah,0,0,0
2021-08-01,SOM,Kelantan,0,0,0
2021-08-01,SOM,Perlis,0,0,0
2021-08-01,SOM,Sabah,0,0,0
2021-08-01,SOM,Sarawak,0,0,0
2021-08-01,SOM,Selangor,19,9,10
2021-08-01,SRB,Johor,0,0,0
2021-08-01,SRB,Kedah,0,0,0
2021-08-01,SRB,Kelantan,0,0,0
2021-08-01,SRB,Pahang,0,0,0
2021-08-01,SRB,Perak,0,0,0
2021-08-01,SRB,Perlis,0,0,0
2021-08-01,SRB,Pulau Pinang,0,0,0
2021-08-01,SRB,Sabah,0,0,0
2021-08-01,SRB,Sarawak,0,0,0
2021-08-01,SRB,Selangor,6,3,3
2021-08-01,SSD,Johor,0,0,0
2021-08-01,SSD,Kedah,0,0,0
2021-08-01,SSD,Sarawak,0,0,0
2021-08-01,SSD,Selangor,3,3,0
2021-08-01,SSD,W.P. Labuan,0,0,0
2021-08-01,STP,Selangor,0,0,0
2021-08-01,SUR,Johor,0,0,0
2021-08-01,SUR,Kedah,0,0,0
2021-08-01,SUR,Kelantan,0,0,0
2021-08-01,SUR,Perak,0,0,0
2021-08-01,SUR,Perlis,0,0,0
2021-08-01,SUR,Pulau Pinang,0,0,0
2021-08-01,SUR,Sabah,0,0,0
2021-08-01,SUR,Sarawak,0,0,0
2021-08-01,SUR,Selangor,0,0,0
2021-08-01,SVK,Johor,0,0,0
2021-08-01,SVK,Kedah,0,0,0
2021-08-01,SVK,Kelantan,0,0,0
2021-08-01,SVK,Negeri Sembilan,0,0,0
2021-08-01,SVK,Pahang,0,0,0
2021-08-01,SVK,Perak,0,0,0
2021-08-01,SVK,Perlis,0,0,0
2021-08-01,SVK,Pulau Pinang,0,0,0
2021-08-01,SVK,Sabah,0,0,0
2021-08-01,SVK,Sarawak,0,0,0
2021-08-01,SVK,Selangor,11,6,5
2021-08-01,SVK,W.P. Labuan,0,0,0
2021-08-01,SVN,Johor,0,0,0
2021-08-01,SVN,Kedah,0,0,0
2021-08-01,SVN,Kelantan,0,0,0
2021-08-01,SVN,Perak,0,0,0
2021-08-01,SVN,Perlis,0,0,0
2021-08-01,SVN,Pulau Pinang,0,0,0
2021-08-01,SVN,Sabah,0,0,0
2021-08-01,SVN,Sarawak,0,0,0
2021-08-01,SVN,Selangor,2,1,1
2021-08-01,SVN,W.P. Labuan,0,0,0
2021-08-01,SWE,Johor,0,0,0
2021-08-01,SWE,Kedah,0,0,0
2021-08-01,SWE,Kelantan,0,0,0
2021-08-01,SWE,Melaka,0,0,0
2021-08-01,SWE,Negeri Sembilan,0,0,0
2021-08-01,SWE,Pahang,0,0,0
2021-08-01,SWE,Perak,0,0,0
2021-08-01,SWE,Perlis,0,0,0
2021-08-01,SWE,Pulau Pinang,0,0,0
2021-08-01,SWE,Sabah,0,0,0
2021-08-01,SWE,Sarawak,0,0,0
2021-08-01,SWE,Selangor,35,26,9
2021-08-01,SWE,W.P. Labuan,0,0,0
2021-08-01,SWZ,Johor,0,0,0
2021-08-01,SWZ,Kedah,0,0,0
2021-08-01,SWZ,Pulau Pinang,0,0,0
2021-08-01,SWZ,Sabah,0,0,0
2021-08-01,SWZ,Selangor,0,0,0
2021-08-01,SYC,Johor,0,0,0
2021-08-01,SYC,Kedah,0,0,0
2021-08-01,SYC,Pulau Pinang,0,0,0
2021-08-01,SYC,Sabah,0,0,0
2021-08-01,SYC,Sarawak,0,0,0
2021-08-01,SYC,Selangor,4,3,1
2021-08-01,SYR,Johor,0,0,0
2021-08-01,SYR,Kedah,0,0,0
2021-08-01,SYR,Kelantan,0,0,0
2021-08-01,SYR,Pahang,0,0,0
2021-08-01,SYR,Perlis,0,0,0
2021-08-01,SYR,Pulau Pinang,0,0,0
2021-08-01,SYR,Sabah,0,0,0
2021-08-01,SYR,Sarawak,0,0,0
2021-08-01,SYR,Selangor,22,15,7
2021-08-01,SYR,W.P. Labuan,0,0,0
2021-08-01,TCA,Perlis,0,0,0
2021-08-01,TCD,Johor,0,0,0
2021-08-01,TCD,Kedah,0,0,0
2021-08-01,TCD,Perlis,0,0,0
2021-08-01,TCD,Selangor,2,1,1
2021-08-01,TGO,Johor,0,0,0
2021-08-01,TGO,Perak,0,0,0
2021-08-01,TGO,Pulau Pinang,0,0,0
2021-08-01,TGO,Selangor,0,0,0
2021-08-01,THA,Johor,12,12,0
2021-08-01,THA,Kedah,16335,16295,40
2021-08-01,THA,Kelantan,0,0,0
2021-08-01,THA,Melaka,0,0,0
2021-08-01,THA,Negeri Sembilan,0,0,0
2021-08-01,THA,Pahang,0,0,0
2021-08-01,THA,Perak,0,0,0
2021-08-01,THA,Perlis,7375,7314,61
2021-08-01,THA,Pulau Pinang,126,124,2
2021-08-01,THA,Sabah,0,0,0
2021-08-01,THA,Sarawak,10,9,1
2021-08-01,THA,Selangor,196,144,52
2021-08-01,THA,Terengganu,0,0,0
2021-08-01,THA,W.P. Labuan,0,0,0
2021-08-01,TJK,Johor,0,0,0
2021-08-01,TJK,Kedah,0,0,0
2021-08-01,TJK,Perlis,0,0,0
2021-08-01,TJK,Pulau Pinang,0,0,0
2021-08-01,TJK,Sabah,0,0,0
2021-08-01,TJK,Selangor,2,2,0
2021-08-01,TKL,Selangor,0,0,0
2021-08-01,TKM,Johor,0,0,0
2021-08-01,TKM,Kedah,0,0,0
2021-08-01,TKM,Kelantan,0,0,0
2021-08-01,TKM,Perlis,0,0,0
2021-08-01,TKM,Pulau Pinang,0,0,0
2021-08-01,TKM,Sabah,0,0,0
2021-08-01,TKM,Sarawak,0,0,0
2021-08-01,TKM,Selangor,2,1,1
2021-08-01,TLS,Johor,0,0,0
2021-08-01,TLS,Kedah,0,0,0
2021-08-01,TLS,Perlis,0,0,0
2021-08-01,TLS,Pulau Pinang,0,0,0
2021-08-01,TLS,Sabah,0,0,0
2021-08-01,TLS,Sarawak,0,0,0
2021-08-01,TLS,Selangor,1,0,1
2021-08-01,TON,Johor,0,0,0
2021-08-01,TON,Pulau Pinang,0,0,0
2021-08-01,TON,Sarawak,0,0,0
2021-08-01,TON,Selangor,0,0,0
2021-08-01,TTO,Johor,0,0,0
2021-08-01,TTO,Kedah,0,0,0
2021-08-01,TTO,Pahang,0,0,0
2021-08-01,TTO,Pulau Pinang,0,0,0
2021-08-01,TTO,Sabah,0,0,0
2021-08-01,TTO,Sarawak,0,0,0
2021-08-01,TTO,Selangor,0,0,0
2021-08-01,TUN,Johor,0,0,0
2021-08-01,TUN,Kedah,0,0,0
2021-08-01,TUN,Kelantan,0,0,0
2021-08-01,TUN,Melaka,0,0,0
2021-08-01,TUN,Perak,0,0,0
2021-08-01,TUN,Perlis,0,0,0
2021-08-01,TUN,Pulau Pinang,0,0,0
2021-08-01,TUN,Sabah,0,0,0
2021-08-01,TUN,Sarawak,0,0,0
2021-08-01,TUN,Selangor,2,1,1
2021-08-01,TUN,W.P. Labuan,0,0,0
2021-08-01,TUR,Johor,0,0,0
2021-08-01,TUR,Kedah,0,0,0
2021-08-01,TUR,Kelantan,0,0,0
2021-08-01,TUR,Melaka,0,0,0
2021-08-01,TUR,Negeri Sembilan,0,0,0
2021-08-01,TUR,Pahang,0,0,0
2021-08-01,TUR,Perak,0,0,0
2021-08-01,TUR,Perlis,0,0,0
2021-08-01,TUR,Pulau Pinang,0,0,0
2021-08-01,TUR,Sabah,0,0,0
2021-08-01,TUR,Sarawak,0,0,0
2021-08-01,TUR,Selangor,66,45,21
2021-08-01,TUR,W.P. Labuan,0,0,0
2021-08-01,TUV,Selangor,0,0,0
2021-08-01,TWN,Johor,0,0,0
2021-08-01,TWN,Kedah,0,0,0
2021-08-01,TWN,Kelantan,0,0,0
2021-08-01,TWN,Melaka,0,0,0
2021-08-01,TWN,Negeri Sembilan,0,0,0
2021-08-01,TWN,Pahang,0,0,0
2021-08-01,TWN,Perak,0,0,0
2021-08-01,TWN,Perlis,0,0,0
2021-08-01,TWN,Pulau Pinang,8,5,3
2021-08-01,TWN,Sabah,0,0,0
2021-08-01,TWN,Sarawak,1,1,0
2021-08-01,TWN,Selangor,73,55,18
2021-08-01,TWN,W.P. Labuan,0,0,0
2021-08-01,TZA,Johor,0,0,0
2021-08-01,TZA,Kedah,0,0,0
2021-08-01,TZA,Perak,0,0,0
2021-08-01,TZA,Perlis,0,0,0
2021-08-01,TZA,Pulau Pinang,0,0,0
2021-08-01,TZA,Sabah,0,0,0
2021-08-01,TZA,Sarawak,0,0,0
2021-08-01,TZA,Selangor,16,14,2
2021-08-01,UGA,Johor,0,0,0
2021-08-01,UGA,Kedah,0,0,0
2021-08-01,UGA,Perak,0,0,0
2021-08-01,UGA,Perlis,0,0,0
2021-08-01,UGA,Pulau Pinang,0,0,0
2021-08-01,UGA,Sabah,0,0,0
2021-08-01,UGA,Sarawak,0,0,0
2021-08-01,UGA,Selangor,2,1,1
2021-08-01,UKR,Johor,0,0,0
2021-08-01,UKR,Kedah,0,0,0
2021-08-01,UKR,Kelantan,0,0,0
2021-08-01,UKR,Melaka,0,0,0
2021-08-01,UKR,Negeri Sembilan,0,0,0
2021-08-01,UKR,Pahang,0,0,0
2021-08-01,UKR,Perak,0,0,0
2021-08-01,UKR,Perlis,0,0,0
2021-08-01,UKR,Pulau Pinang,0,0,0
2021-08-01,UKR,Sabah,0,0,0
2021-08-01,UKR,Sarawak,0,0,0
2021-08-01,UKR,Selangor,100,95,5
2021-08-01,UKR,W.P. Labuan,0,0,0
2021-08-01,URY,Johor,0,0,0
2021-08-01,URY,Kedah,0,0,0
2021-08-01,URY,Kelantan,0,0,0
2021-08-01,URY,Perak,0,0,0
2021-08-01,URY,Perlis,0,0,0
2021-08-01,URY,Pulau Pinang,0,0,0
2021-08-01,URY,Sabah,0,0,0
2021-08-01,URY,Sarawak,0,0,0
2021-08-01,URY,Selangor,0,0,0
2021-08-01,URY,W.P. Labuan,0,0,0
2021-08-01,USA,Johor,0,0,0
2021-08-01,USA,Kedah,0,0,0
2021-08-01,USA,Kelantan,0,0,0
2021-08-01,USA,Melaka,0,0,0
2021-08-01,USA,Negeri Sembilan,0,0,0
2021-08-01,USA,Pahang,0,0,0
2021-08-01,USA,Perak,0,0,0
2021-08-01,USA,Perlis,0,0,0
2021-08-01,USA,Pulau Pinang,11,8,3
2021-08-01,USA,Sabah,0,0,0
2021-08-01,USA,Sarawak,0,0,0
2021-08-01,USA,Selangor,262,156,106
2021-08-01,USA,Terengganu,0,0,0
2021-08-01,USA,W.P. Labuan,0,0,0
2021-08-01,UZB,Johor,0,0,0
2021-08-01,UZB,Kedah,0,0,0
2021-08-01,UZB,Kelantan,0,0,0
2021-08-01,UZB,Perak,0,0,0
2021-08-01,UZB,Perlis,0,0,0
2021-08-01,UZB,Pulau Pinang,0,0,0
2021-08-01,UZB,Sabah,0,0,0
2021-08-01,UZB,Sarawak,0,0,0
2021-08-01,UZB,Selangor,9,5,4
2021-08-01,VAT,Johor,0,0,0
2021-08-01,VAT,Sarawak,0,0,0
2021-08-01,VAT,Selangor,0,0,0
2021-08-01,VCT,Johor,0,0,0
2021-08-01,VCT,Kedah,0,0,0
2021-08-01,VCT,Pulau Pinang,0,0,0
2021-08-01,VCT,Sarawak,0,0,0
2021-08-01,VCT,Selangor,0,0,0
2021-08-01,VEN,Johor,0,0,0
2021-08-01,VEN,Kedah,0,0,0
2021-08-01,VEN,Kelantan,0,0,0
2021-08-01,VEN,Melaka,0,0,0
2021-08-01,VEN,Perak,0,0,0
2021-08-01,VEN,Perlis,0,0,0
2021-08-01,VEN,Pulau Pinang,0,0,0
2021-08-01,VEN,Sabah,0,0,0
2021-08-01,VEN,Sarawak,0,0,0
2021-08-01,VEN,Selangor,7,5,2
2021-08-01,VEN,W.P. Labuan,0,0,0
2021-08-01,VNM,Johor,0,0,0
2021-08-01,VNM,Kedah,0,0,0
2021-08-01,VNM,Kelantan,0,0,0
2021-08-01,VNM,Melaka,0,0,0
2021-08-01,VNM,Negeri Sembilan,0,0,0
2021-08-01,VNM,Pahang,0,0,0
2021-08-01,VNM,Perak,0,0,0
2021-08-01,VNM,Perlis,0,0,0
2021-08-01,VNM,Pulau Pinang,0,0,0
2021-08-01,VNM,Sabah,0,0,0
2021-08-01,VNM,Sarawak,0,0,0
2021-08-01,VNM,Selangor,35,22,13
2021-08-01,VNM,Terengganu,0,0,0
2021-08-01,VNM,W.P. Labuan,0,0,0
2021-08-01,VUT,Johor,0,0,0
2021-08-01,VUT,Kedah,0,0,0
2021-08-01,VUT,Pulau Pinang,0,0,0
2021-08-01,VUT,Sabah,0,0,0
2021-08-01,VUT,Sarawak,0,0,0
2021-08-01,VUT,Selangor,0,0,0
2021-08-01,WSM,Johor,0,0,0
2021-08-01,WSM,Sarawak,0,0,0
2021-08-01,WSM,Selangor,0,0,0
2021-08-01,XXX,Johor,0,0,0
2021-08-01,XXX,Kedah,0,0,0
2021-08-01,XXX,Kelantan,0,0,0
2021-08-01,XXX,Melaka,0,0,0
2021-08-01,XXX,Pahang,0,0,0
2021-08-01,XXX,Perak,1,0,1
2021-08-01,XXX,Perlis,0,0,0
2021-08-01,XXX,Pulau Pinang,0,0,0
2021-08-01,XXX,Sabah,0,0,0
2021-08-01,XXX,Sarawak,1,0,1
2021-08-01,XXX,Selangor,11,4,7
2021-08-01,XXX,W.P. Labuan,0,0,0
2021-08-01,YEM,Johor,0,0,0
2021-08-01,YEM,Kedah,0,0,0
2021-08-01,YEM,Kelantan,0,0,0
2021-08-01,YEM,Melaka,0,0,0
2021-08-01,YEM,Pahang,0,0,0
2021-08-01,YEM,Perak,0,0,0
2021-08-01,YEM,Perlis,0,0,0
2021-08-01,YEM,Pulau Pinang,0,0,0
2021-08-01,YEM,Sabah,0,0,0
2021-08-01,YEM,Sarawak,0,0,0
2021-08-01,YEM,Selangor,63,40,23
2021-08-01,YEM,W.P. Labuan,0,0,0
2021-08-01,ZAF,Johor,0,0,0
2021-08-01,ZAF,Kedah,0,0,0
2021-08-01,ZAF,Kelantan,0,0,0
2021-08-01,ZAF,Melaka,0,0,0
2021-08-01,ZAF,Pahang,0,0,0
2021-08-01,ZAF,Perak,0,0,0
2021-08-01,ZAF,Perlis,0,0,0
2021-08-01,ZAF,Pulau Pinang,0,0,0
2021-08-01,ZAF,Sabah,0,0,0
2021-08-01,ZAF,Sarawak,0,0,0
2021-08-01,ZAF,Selangor,30,20,10
2021-08-01,ZAF,Terengganu,0,0,0
2021-08-01,ZAF,W.P. Labuan,0,0,0
2021-08-01,ZAR,Selangor,0,0,0
2021-08-01,ZMB,Johor,0,0,0
2021-08-01,ZMB,Kedah,0,0,0
2021-08-01,ZMB,Perak,0,0,0
2021-08-01,ZMB,Perlis,0,0,0
2021-08-01,ZMB,Pulau Pinang,0,0,0
2021-08-01,ZMB,Sabah,0,0,0
2021-08-01,ZMB,Sarawak,0,0,0
2021-08-01,ZMB,Selangor,8,4,4
2021-08-01,ZWE,Johor,0,0,0
2021-08-01,ZWE,Kedah,0,0,0
2021-08-01,ZWE,Kelantan,0,0,0
2021-08-01,ZWE,Perak,0,0,0
2021-08-01,ZWE,Perlis,0,0,0
2021-08-01,ZWE,Pulau Pinang,0,0,0
2021-08-01,ZWE,Sabah,0,0,0
2021-08-01,ZWE,Sarawak,0,0,0
2021-08-01,ZWE,Selangor,15,4,11
2021-09-01,ABW,Kedah,0,0,0
2021-09-01,ABW,Pulau Pinang,0,0,0
2021-09-01,AFG,Johor,0,0,0
2021-09-01,AFG,Kedah,0,0,0
2021-09-01,AFG,Perlis,0,0,0
2021-09-01,AFG,Pulau Pinang,0,0,0
2021-09-01,AFG,Sarawak,0,0,0
2021-09-01,AFG,Selangor,8,4,4
2021-09-01,AGO,Johor,0,0,0
2021-09-01,AGO,Kedah,0,0,0
2021-09-01,AGO,Sabah,0,0,0
2021-09-01,AGO,Selangor,0,0,0
2021-09-01,AIA,Selangor,0,0,0
2021-09-01,ALB,Johor,0,0,0
2021-09-01,ALB,Kedah,0,0,0
2021-09-01,ALB,Perak,0,0,0
2021-09-01,ALB,Perlis,0,0,0
2021-09-01,ALB,Pulau Pinang,0,0,0
2021-09-01,ALB,Sabah,0,0,0
2021-09-01,ALB,Sarawak,0,0,0
2021-09-01,ALB,Selangor,2,1,1
2021-09-01,AND,Johor,0,0,0
2021-09-01,AND,Kedah,0,0,0
2021-09-01,AND,Perlis,0,0,0
2021-09-01,AND,Pulau Pinang,0,0,0
2021-09-01,AND,Selangor,0,0,0
2021-09-01,ANT,Selangor,0,0,0
2021-09-01,ARE,Johor,0,0,0
2021-09-01,ARE,Kedah,0,0,0
2021-09-01,ARE,Kelantan,0,0,0
2021-09-01,ARE,Perak,0,0,0
2021-09-01,ARE,Perlis,0,0,0
2021-09-01,ARE,Pulau Pinang,0,0,0
2021-09-01,ARE,Sabah,0,0,0
2021-09-01,ARE,Sarawak,43,43,0
2021-09-01,ARE,Selangor,2,1,1
2021-09-01,ARG,Johor,0,0,0
2021-09-01,ARG,Kedah,0,0,0
2021-09-01,ARG,Kelantan,0,0,0
2021-09-01,ARG,Melaka,0,0,0
2021-09-01,ARG,Perak,0,0,0
2021-09-01,ARG,Perlis,0,0,0
2021-09-01,ARG,Pulau Pinang,0,0,0
2021-09-01,ARG,Sabah,0,0,0
2021-09-01,ARG,Sarawak,0,0,0
2021-09-01,ARG,Selangor,4,1,3
2021-09-01,ARG,W.P. Labuan,0,0,0
2021-09-01,ARM,Johor,0,0,0
2021-09-01,ARM,Kedah,0,0,0
2021-09-01,ARM,Kelantan,0,0,0
2021-09-01,ARM,Perak,0,0,0
2021-09-01,ARM,Perlis,0,0,0
2021-09-01,ARM,Pulau Pinang,0,0,0
2021-09-01,ARM,Sabah,0,0,0
2021-09-01,ARM,Sarawak,0,0,0
2021-09-01,ARM,Selangor,0,0,0
2021-09-01,ATA,Selangor,0,0,0
2021-09-01,ATG,Johor,0,0,0
2021-09-01,ATG,Kedah,0,0,0
2021-09-01,ATG,Pulau Pinang,0,0,0
2021-09-01,ATG,Sarawak,0,0,0
2021-09-01,ATG,Selangor,0,0,0
2021-09-01,AUS,Johor,1,1,0
2021-09-01,AUS,Kedah,0,0,0
2021-09-01,AUS,Kelantan,0,0,0
2021-09-01,AUS,Melaka,0,0,0
2021-09-01,AUS,Negeri Sembilan,0,0,0
2021-09-01,AUS,Pahang,0,0,0
2021-09-01,AUS,Perak,0,0,0
2021-09-01,AUS,Perlis,0,0,0
2021-09-01,AUS,Pulau Pinang,4,3,1
2021-09-01,AUS,Sabah,0,0,0
2021-09-01,AUS,Sarawak,0,0,0
2021-09-01,AUS,Selangor,96,63,33
2021-09-01,AUS,Terengganu,0,0,0
2021-09-01,AUS,W.P. Labuan,0,0,0
2021-09-01,AUT,Johor,0,0,0
2021-09-01,AUT,Kedah,0,0,0
2021-09-01,AUT,Kelantan,1,1,0
2021-09-01,AUT,Melaka,0,0,0
2021-09-01,AUT,Negeri Sembilan,0,0,0
2021-09-01,AUT,Pahang,0,0,0
2021-09-01,AUT,Perak,0,0,0
2021-09-01,AUT,Perlis,0,0,0
2021-09-01,AUT,Pulau Pinang,1,0,1
2021-09-01,AUT,Sabah,0,0,0
2021-09-01,AUT,Sarawak,0,0,0
2021-09-01,AUT,Selangor,31,27,4
2021-09-01,AUT,Terengganu,0,0,0
2021-09-01,AUT,W.P. Labuan,0,0,0
2021-09-01,AZE,Johor,0,0,0
2021-09-01,AZE,Kedah,0,0,0
2021-09-01,AZE,Kelantan,0,0,0
2021-09-01,AZE,Melaka,0,0,0
2021-09-01,AZE,Perlis,0,0,0
2021-09-01,AZE,Pulau Pinang,0,0,0
2021-09-01,AZE,Sabah,0,0,0
2021-09-01,AZE,Sarawak,0,0,0
2021-09-01,AZE,Selangor,2,1,1
2021-09-01,AZE,W.P. Labuan,0,0,0
2021-09-01,BDI,Pulau Pinang,0,0,0
2021-09-01,BDI,Sarawak,0,0,0
2021-09-01,BDI,Selangor,0,0,0
2021-09-01,BEL,Johor,0,0,0
2021-09-01,BEL,Kedah,0,0,0
2021-09-01,BEL,Kelantan,0,0,0
2021-09-01,BEL,Melaka,0,0,0
2021-09-01,BEL,Negeri Sembilan,0,0,0
2021-09-01,BEL,Pahang,0,0,0
2021-09-01,BEL,Perak,0,0,0
2021-09-01,BEL,Perlis,0,0,0
2021-09-01,BEL,Pulau Pinang,2,1,1
2021-09-01,BEL,Sabah,0,0,0
2021-09-01,BEL,Sarawak,0,0,0
2021-09-01,BEL,Selangor,26,13,13
2021-09-01,BEL,W.P. Labuan,0,0,0
2021-09-01,BEN,Johor,0,0,0
2021-09-01,BEN,Kedah,0,0,0
2021-09-01,BEN,Perak,0,0,0
2021-09-01,BEN,Pulau Pinang,0,0,0
2021-09-01,BEN,Sabah,0,0,0
2021-09-01,BEN,Sarawak,0,0,0
2021-09-01,BEN,Selangor,0,0,0
2021-09-01,BFA,Perak,0,0,0
2021-09-01,BFA,Pulau Pinang,0,0,0
2021-09-01,BFA,Selangor,1,0,1
2021-09-01,BGD,Johor,2,2,0
2021-09-01,BGD,Kedah,0,0,0
2021-09-01,BGD,Kelantan,0,0,0
2021-09-01,BGD,Melaka,0,0,0
2021-09-01,BGD,Negeri Sembilan,0,0,0
2021-09-01,BGD,Pahang,0,0,0
2021-09-01,BGD,Perak,0,0,0
2021-09-01,BGD,Perlis,0,0,0
2021-09-01,BGD,Pulau Pinang,0,0,0
2021-09-01,BGD,Sabah,0,0,0
2021-09-01,BGD,Sarawak,1,1,0
2021-09-01,BGD,Selangor,31,22,9
2021-09-01,BGD,W.P. Labuan,0,0,0
2021-09-01,BGR,Johor,0,0,0
2021-09-01,BGR,Kedah,0,0,0
2021-09-01,BGR,Kelantan,0,0,0
2021-09-01,BGR,Pahang,0,0,0
2021-09-01,BGR,Perak,0,0,0
2021-09-01,BGR,Perlis,0,0,0
2021-09-01,BGR,Pulau Pinang,0,0,0
2021-09-01,BGR,Sabah,0,0,0
2021-09-01,BGR,Sarawak,0,0,0
2021-09-01,BGR,Selangor,9,7,2
2021-09-01,BGR,W.P. Labuan,0,0,0
2021-09-01,BHR,Johor,0,0,0
2021-09-01,BHR,Kedah,0,0,0
2021-09-01,BHR,Kelantan,0,0,0
2021-09-01,BHR,Perlis,0,0,0
2021-09-01,BHR,Pulau Pinang,0,0,0
2021-09-01,BHR,Sabah,0,0,0
2021-09-01,BHR,Sarawak,0,0,0
2021-09-01,BHR,Selangor,0,0,0
2021-09-01,BHS,Johor,0,0,0
2021-09-01,BHS,Kedah,0,0,0
2021-09-01,BHS,Perak,0,0,0
2021-09-01,BHS,Sabah,0,0,0
2021-09-01,BHS,Sarawak,0,0,0
2021-09-01,BHS,Selangor,0,0,0
2021-09-01,BIH,Johor,0,0,0
2021-09-01,BIH,Kedah,0,0,0
2021-09-01,BIH,Perlis,0,0,0
2021-09-01,BIH,Pulau Pinang,0,0,0
2021-09-01,BIH,Sabah,0,0,0
2021-09-01,BIH,Sarawak,0,0,0
2021-09-01,BIH,Selangor,4,2,2
2021-09-01,BLR,Johor,0,0,0
2021-09-01,BLR,Kedah,0,0,0
2021-09-01,BLR,Kelantan,0,0,0
2021-09-01,BLR,Pahang,0,0,0
2021-09-01,BLR,Perak,0,0,0
2021-09-01,BLR,Perlis,0,0,0
2021-09-01,BLR,Pulau Pinang,0,0,0
2021-09-01,BLR,Sabah,0,0,0
2021-09-01,BLR,Sarawak,0,0,0
2021-09-01,BLR,Selangor,2,1,1
2021-09-01,BLR,W.P. Labuan,0,0,0
2021-09-01,BLZ,Johor,0,0,0
2021-09-01,BLZ,Pulau Pinang,0,0,0
2021-09-01,BLZ,Sarawak,0,0,0
2021-09-01,BLZ,Selangor,0,0,0
2021-09-01,BMU,Selangor,0,0,0
2021-09-01,BOL,Johor,0,0,0
2021-09-01,BOL,Kedah,0,0,0
2021-09-01,BOL,Melaka,0,0,0
2021-09-01,BOL,Perak,0,0,0
2021-09-01,BOL,Perlis,0,0,0
2021-09-01,BOL,Pulau Pinang,0,0,0
2021-09-01,BOL,Sabah,0,0,0
2021-09-01,BOL,Sarawak,0,0,0
2021-09-01,BOL,Selangor,0,0,0
2021-09-01,BRA,Johor,0,0,0
2021-09-01,BRA,Kedah,0,0,0
2021-09-01,BRA,Kelantan,0,0,0
2021-09-01,BRA,Melaka,0,0,0
2021-09-01,BRA,Pahang,0,0,0
2021-09-01,BRA,Perak,0,0,0
2021-09-01,BRA,Perlis,0,0,0
2021-09-01,BRA,Pulau Pinang,0,0,0
2021-09-01,BRA,Sabah,0,0,0
2021-09-01,BRA,Sarawak,0,0,0
2021-09-01,BRA,Selangor,11,5,6
2021-09-01,BRA,W.P. Labuan,0,0,0
2021-09-01,BRB,Johor,0,0,0
2021-09-01,BRB,Kedah,0,0,0
2021-09-01,BRB,Perlis,0,0,0
2021-09-01,BRB,Pulau Pinang,0,0,0
2021-09-01,BRB,Selangor,1,1,0
2021-09-01,BRN,Johor,0,0,0
2021-09-01,BRN,Kedah,0,0,0
2021-09-01,BRN,Kelantan,0,0,0
2021-09-01,BRN,Melaka,0,0,0
2021-09-01,BRN,Pahang,0,0,0
2021-09-01,BRN,Perak,0,0,0
2021-09-01,BRN,Perlis,0,0,0
2021-09-01,BRN,Pulau Pinang,0,0,0
2021-09-01,BRN,Sabah,0,0,0
2021-09-01,BRN,Sarawak,234,234,0
2021-09-01,BRN,Selangor,38,32,6
2021-09-01,BRN,W.P. Labuan,0,0,0
2021-09-01,BTN,Johor,0,0,0
2021-09-01,BTN,Kedah,0,0,0
2021-09-01,BTN,Perak,0,0,0
2021-09-01,BTN,Perlis,0,0,0
2021-09-01,BTN,Pulau Pinang,0,0,0
2021-09-01,BTN,Sabah,0,0,0
2021-09-01,BTN,Sarawak,0,0,0
2021-09-01,BTN,Selangor,1,1,0
2021-09-01,BWA,Johor,0,0,0
2021-09-01,BWA,Kedah,0,0,0
2021-09-01,BWA,Perlis,0,0,0
2021-09-01,BWA,Pulau Pinang,0,0,0
2021-09-01,BWA,Sabah,0,0,0
2021-09-01,BWA,Sarawak,0,0,0
2021-09-01,BWA,Selangor,0,0,0
2021-09-01,CAF,Kedah,0,0,0
2021-09-01,CAF,Selangor,0,0,0
2021-09-01,CAN,Johor,0,0,0
2021-09-01,CAN,Kedah,0,0,0
2021-09-01,CAN,Kelantan,0,0,0
2021-09-01,CAN,Melaka,0,0,0
2021-09-01,CAN,Negeri Sembilan,0,0,0
2021-09-01,CAN,Pahang,0,0,0
2021-09-01,CAN,Perak,0,0,0
2021-09-01,CAN,Perlis,0,0,0
2021-09-01,CAN,Pulau Pinang,1,1,0
2021-09-01,CAN,Sabah,0,0,0
2021-09-01,CAN,Sarawak,0,0,0
2021-09-01,CAN,Selangor,58,45,13
2021-09-01,CAN,Terengganu,0,0,0
2021-09-01,CAN,W.P. Labuan,0,0,0
2021-09-01,CCK,Selangor,0,0,0
2021-09-01,CHE,Johor,0,0,0
2021-09-01,CHE,Kedah,0,0,0
2021-09-01,CHE,Kelantan,0,0,0
2021-09-01,CHE,Melaka,0,0,0
2021-09-01,CHE,Negeri Sembilan,0,0,0
2021-09-01,CHE,Pahang,0,0,0
2021-09-01,CHE,Perak,0,0,0
2021-09-01,CHE,Perlis,0,0,0
2021-09-01,CHE,Pulau Pinang,1,1,0
2021-09-01,CHE,Sabah,0,0,0
2021-09-01,CHE,Sarawak,0,0,0
2021-09-01,CHE,Selangor,22,16,6
2021-09-01,CHE,W.P. Labuan,0,0,0
2021-09-01,CHL,Johor,0,0,0
2021-09-01,CHL,Kedah,0,0,0
2021-09-01,CHL,Kelantan,0,0,0
2021-09-01,CHL,Melaka,0,0,0
2021-09-01,CHL,Pahang,0,0,0
2021-09-01,CHL,Perak,0,0,0
2021-09-01,CHL,Perlis,0,0,0
2021-09-01,CHL,Pulau Pinang,0,0,0
2021-09-01,CHL,Sabah,0,0,0
2021-09-01,CHL,Sarawak,0,0,0
2021-09-01,CHL,Selangor,1,1,0
2021-09-01,CHN,Johor,2,2,0
2021-09-01,CHN,Kedah,0,0,0
2021-09-01,CHN,Kelantan,0,0,0
2021-09-01,CHN,Melaka,0,0,0
2021-09-01,CHN,Pahang,0,0,0
2021-09-01,CHN,Perak,0,0,0
2021-09-01,CHN,Perlis,0,0,0
2021-09-01,CHN,Pulau Pinang,3,1,2
2021-09-01,CHN,Sabah,0,0,0
2021-09-01,CHN,Sarawak,144,133,11
2021-09-01,CHN,Selangor,935,753,182
2021-09-01,CHN,Terengganu,0,0,0
2021-09-01,CHN,W.P. Labuan,0,0,0
2021-09-01,CIV,Johor,0,0,0
2021-09-01,CIV,Kedah,0,0,0
2021-09-01,CIV,Pulau Pinang,0,0,0
2021-09-01,CIV,Sabah,0,0,0
2021-09-01,CIV,Sarawak,0,0,0
2021-09-01,CIV,Selangor,0,0,0
2021-09-01,CMR,Johor,0,0,0
2021-09-01,CMR,Kedah,0,0,0
2021-09-01,CMR,Pulau Pinang,0,0,0
2021-09-01,CMR,Sabah,0,0,0
2021-09-01,CMR,Sarawak,0,0,0
2021-09-01,CMR,Selangor,3,1,2
2021-09-01,COD,Johor,0,0,0
2021-09-01,COD,Pulau Pinang,0,0,0
2021-09-01,COD,Sarawak,0,0,0
2021-09-01,COD,Selangor,0,0,0
2021-09-01,COG,Johor,0,0,0
2021-09-01,COG,Kedah,0,0,0
2021-09-01,COG,Selangor,0,0,0
2021-09-01,COK,Selangor,0,0,0
2021-09-01,COL,Johor,0,0,0
2021-09-01,COL,Kedah,0,0,0
2021-09-01,COL,Perak,0,0,0
2021-09-01,COL,Pulau Pinang,0,0,0
2021-09-01,COL,Sabah,0,0,0
2021-09-01,COL,Sarawak,0,0,0
2021-09-01,COL,Selangor,9,5,4
2021-09-01,COL,W.P. Labuan,0,0,0
2021-09-01,COM,Johor,0,0,0
2021-09-01,COM,Kedah,0,0,0
2021-09-01,COM,Selangor,6,4,2
2021-09-01,CPV,Johor,0,0,0
2021-09-01,CPV,Kedah,0,0,0
2021-09-01,CPV,Pulau Pinang,0,0,0
2021-09-01,CPV,Sabah,0,0,0
2021-09-01,CPV,Selangor,0,0,0
2021-09-01,CRI,Johor,0,0,0
2021-09-01,CRI,Kedah,0,0,0
2021-09-01,CRI,Perak,0,0,0
2021-09-01,CRI,Perlis,0,0,0
2021-09-01,CRI,Pulau Pinang,0,0,0
2021-09-01,CRI,Sabah,0,0,0
2021-09-01,CRI,Sarawak,0,0,0
2021-09-01,CRI,Selangor,0,0,0
2021-09-01,CUB,Johor,0,0,0
2021-09-01,CUB,Kedah,0,0,0
2021-09-01,CUB,Perlis,0,0,0
2021-09-01,CUB,Pulau Pinang,0,0,0
2021-09-01,CUB,Sabah,0,0,0
2021-09-01,CUB,Sarawak,0,0,0
2021-09-01,CUB,Selangor,0,0,0
2021-09-01,CYP,Johor,0,0,0
2021-09-01,CYP,Kedah,0,0,0
2021-09-01,CYP,Perak,0,0,0
2021-09-01,CYP,Perlis,0,0,0
2021-09-01,CYP,Pulau Pinang,0,0,0
2021-09-01,CYP,Sabah,0,0,0
2021-09-01,CYP,Sarawak,0,0,0
2021-09-01,CYP,Selangor,0,0,0
2021-09-01,CZE,Johor,0,0,0
2021-09-01,CZE,Kedah,0,0,0
2021-09-01,CZE,Kelantan,0,0,0
2021-09-01,CZE,Melaka,0,0,0
2021-09-01,CZE,Negeri Sembilan,0,0,0
2021-09-01,CZE,Perak,0,0,0
2021-09-01,CZE,Perlis,0,0,0
2021-09-01,CZE,Pulau Pinang,0,0,0
2021-09-01,CZE,Sabah,0,0,0
2021-09-01,CZE,Sarawak,0,0,0
2021-09-01,CZE,Selangor,3,2,1
2021-09-01,CZE,W.P. Labuan,0,0,0
2021-09-01,DEU,Johor,2,2,0
2021-09-01,DEU,Kedah,0,0,0
2021-09-01,DEU,Kelantan,0,0,0
2021-09-01,DEU,Melaka,0,0,0
2021-09-01,DEU,Negeri Sembilan,0,0,0
2021-09-01,DEU,Pahang,0,0,0
2021-09-01,DEU,Perak,0,0,0
2021-09-01,DEU,Perlis,0,0,0
2021-09-01,DEU,Pulau Pinang,8,5,3
2021-09-01,DEU,Sabah,0,0,0
2021-09-01,DEU,Sarawak,1,1,0
2021-09-01,DEU,Selangor,148,110,38
2021-09-01,DEU,Terengganu,0,0,0
2021-09-01,DEU,W.P. Labuan,0,0,0
2021-09-01,DJI,Johor,0,0,0
2021-09-01,DJI,Selangor,1,1,0
2021-09-01,DMA,Johor,0,0,0
2021-09-01,DMA,Kedah,0,0,0
2021-09-01,DMA,Pulau Pinang,0,0,0
2021-09-01,DMA,Sabah,0,0,0
2021-09-01,DMA,Sarawak,0,0,0
2021-09-01,DMA,Selangor,0,0,0
2021-09-01,DMA,W.P. Labuan,0,0,0
2021-09-01,DNK,Johor,0,0,0
2021-09-01,DNK,Kedah,0,0,0
2021-09-01,DNK,Kelantan,0,0,0
2021-09-01,DNK,Melaka,0,0,0
2021-09-01,DNK,Negeri Sembilan,0,0,0
2021-09-01,DNK,Pahang,0,0,0
2021-09-01,DNK,Perak,0,0,0
2021-09-01,DNK,Perlis,0,0,0
2021-09-01,DNK,Pulau Pinang,3,2,1
2021-09-01,DNK,Sabah,0,0,0
2021-09-01,DNK,Sarawak,0,0,0
2021-09-01,DNK,Selangor,36,30,6
2021-09-01,DNK,W.P. Labuan,0,0,0
2021-09-01,DOM,Johor,0,0,0
2021-09-01,DOM,Kedah,0,0,0
2021-09-01,DOM,Perak,0,0,0
2021-09-01,DOM,Perlis,0,0,0
2021-09-01,DOM,Pulau Pinang,0,0,0
2021-09-01,DOM,Sabah,0,0,0
2021-09-01,DOM,Sarawak,0,0,0
2021-09-01,DOM,Selangor,0,0,0
2021-09-01,DZA,Johor,0,0,0
2021-09-01,DZA,Kedah,0,0,0
2021-09-01,DZA,Kelantan,0,0,0
2021-09-01,DZA,Melaka,0,0,0
2021-09-01,DZA,Perak,0,0,0
2021-09-01,DZA,Perlis,0,0,0
2021-09-01,DZA,Pulau Pinang,0,0,0
2021-09-01,DZA,Sabah,0,0,0
2021-09-01,DZA,Sarawak,0,0,0
2021-09-01,DZA,Selangor,26,12,14
2021-09-01,DZA,W.P. Labuan,0,0,0
2021-09-01,ECU,Johor,0,0,0
2021-09-01,ECU,Kedah,0,0,0
2021-09-01,ECU,Perak,0,0,0
2021-09-01,ECU,Perlis,0,0,0
2021-09-01,ECU,Pulau Pinang,0,0,0
2021-09-01,ECU,Sabah,0,0,0
2021-09-01,ECU,Sarawak,0,0,0
2021-09-01,ECU,Selangor,0,0,0
2021-09-01,EGY,Johor,0,0,0
2021-09-01,EGY,Kedah,0,0,0
2021-09-01,EGY,Kelantan,0,0,0
2021-09-01,EGY,Melaka,0,0,0
2021-09-01,EGY,Pahang,0,0,0
2021-09-01,EGY,Perak,0,0,0
2021-09-01,EGY,Perlis,0,0,0
2021-09-01,EGY,Pulau Pinang,0,0,0
2021-09-01,EGY,Sabah,0,0,0
2021-09-01,EGY,Sarawak,1,1,0
2021-09-01,EGY,Selangor,72,53,19
2021-09-01,EGY,Terengganu,0,0,0
2021-09-01,EGY,W.P. Labuan,0,0,0
2021-09-01,ERI,Johor,0,0,0
2021-09-01,ERI,Pulau Pinang,0,0,0
2021-09-01,ERI,Sabah,0,0,0
2021-09-01,ERI,Selangor,1,1,0
2021-09-01,ESP,Johor,0,0,0
2021-09-01,ESP,Kedah,0,0,0
2021-09-01,ESP,Kelantan,0,0,0
2021-09-01,ESP,Melaka,0,0,0
2021-09-01,ESP,Negeri Sembilan,0,0,0
2021-09-01,ESP,Pahang,0,0,0
2021-09-01,ESP,Perak,0,0,0
2021-09-01,ESP,Perlis,0,0,0
2021-09-01,ESP,Pulau Pinang,2,1,1
2021-09-01,ESP,Sabah,0,0,0
2021-09-01,ESP,Sarawak,0,0,0
2021-09-01,ESP,Selangor,41,31,10
2021-09-01,ESP,W.P. Labuan,0,0,0
2021-09-01,EST,Johor,0,0,0
2021-09-01,EST,Kedah,0,0,0
2021-09-01,EST,Kelantan,0,0,0
2021-09-01,EST,Pahang,0,0,0
2021-09-01,EST,Perak,0,0,0
2021-09-01,EST,Perlis,0,0,0
2021-09-01,EST,Pulau Pinang,0,0,0
2021-09-01,EST,Sabah,0,0,0
2021-09-01,EST,Sarawak,0,0,0
2021-09-01,EST,Selangor,4,1,3
2021-09-01,EST,W.P. Labuan,0,0,0
2021-09-01,ETH,Johor,1,1,0
2021-09-01,ETH,Kedah,0,0,0
2021-09-01,ETH,Pulau Pinang,0,0,0
2021-09-01,ETH,Sarawak,0,0,0
2021-09-01,ETH,Selangor,4,4,0
2021-09-01,FIN,Johor,0,0,0
2021-09-01,FIN,Kedah,0,0,0
2021-09-01,FIN,Kelantan,0,0,0
2021-09-01,FIN,Melaka,0,0,0
2021-09-01,FIN,Negeri Sembilan,0,0,0
2021-09-01,FIN,Pahang,0,0,0
2021-09-01,FIN,Perak,0,0,0
2021-09-01,FIN,Perlis,0,0,0
2021-09-01,FIN,Pulau Pinang,1,1,0
2021-09-01,FIN,Sabah,0,0,0
2021-09-01,FIN,Sarawak,0,0,0
2021-09-01,FIN,Selangor,23,19,4
2021-09-01,FIN,W.P. Labuan,0,0,0
2021-09-01,FJI,Johor,0,0,0
2021-09-01,FJI,Kedah,0,0,0
2021-09-01,FJI,Kelantan,0,0,0
2021-09-01,FJI,Perak,0,0,0
2021-09-01,FJI,Perlis,0,0,0
2021-09-01,FJI,Pulau Pinang,0,0,0
2021-09-01,FJI,Sabah,0,0,0
2021-09-01,FJI,Sarawak,0,0,0
2021-09-01,FJI,Selangor,0,0,0
2021-09-01,FRA,Johor,0,0,0
2021-09-01,FRA,Kedah,0,0,0
2021-09-01,FRA,Kelantan,0,0,0
2021-09-01,FRA,Melaka,0,0,0
2021-09-01,FRA,Negeri Sembilan,0,0,0
2021-09-01,FRA,Pahang,0,0,0
2021-09-01,FRA,Perak,0,0,0
2021-09-01,FRA,Perlis,0,0,0
2021-09-01,FRA,Pulau Pinang,5,3,2
2021-09-01,FRA,Sabah,0,0,0
2021-09-01,FRA,Sarawak,2,2,0
2021-09-01,FRA,Selangor,243,168,75
2021-09-01,FRA,Terengganu,0,0,0
2021-09-01,FRA,W.P. Labuan,0,0,0
2021-09-01,FSM,Johor,0,0,0
2021-09-01,FSM,Pulau Pinang,0,0,0
2021-09-01,FSM,Selangor,0,0,0
2021-09-01,GAB,Johor,0,0,0
2021-09-01,GAB,Pulau Pinang,0,0,0
2021-09-01,GAB,Sarawak,0,0,0
2021-09-01,GAB,Selangor,2,1,1
2021-09-01,GBR,Johor,2,1,1
2021-09-01,GBR,Kedah,0,0,0
2021-09-01,GBR,Kelantan,0,0,0
2021-09-01,GBR,Melaka,0,0,0
2021-09-01,GBR,Negeri Sembilan,0,0,0
2021-09-01,GBR,Pahang,0,0,0
2021-09-01,GBR,Perak,0,0,0
2021-09-01,GBR,Perlis,0,0,0
2021-09-01,GBR,Pulau Pinang,18,11,7
2021-09-01,GBR,Sabah,0,0,0
2021-09-01,GBR,Sarawak,1,1,0
2021-09-01,GBR,Selangor,348,271,77
2021-09-01,GBR,Terengganu,0,0,0
2021-09-01,GBR,W.P. Labuan,0,0,0
2021-09-01,GEO,Johor,0,0,0
2021-09-01,GEO,Kedah,0,0,0
2021-09-01,GEO,Melaka,0,0,0
2021-09-01,GEO,Perak,0,0,0
2021-09-01,GEO,Perlis,0,0,0
2021-09-01,GEO,Pulau Pinang,0,0,0
2021-09-01,GEO,Sabah,0,0,0
2021-09-01,GEO,Sarawak,0,0,0
2021-09-01,GEO,Selangor,3,3,0
2021-09-01,GHA,Johor,0,0,0
2021-09-01,GHA,Kedah,0,0,0
2021-09-01,GHA,Kelantan,0,0,0
2021-09-01,GHA,Pulau Pinang,0,0,0
2021-09-01,GHA,Sabah,0,0,0
2021-09-01,GHA,Sarawak,0,0,0
2021-09-01,GHA,Selangor,5,3,2
2021-09-01,GIB,Johor,0,0,0
2021-09-01,GIB,Sarawak,0,0,0
2021-09-01,GIN,Johor,0,0,0
2021-09-01,GIN,Kedah,0,0,0
2021-09-01,GIN,Kelantan,0,0,0
2021-09-01,GIN,Perlis,0,0,0
2021-09-01,GIN,Pulau Pinang,0,0,0
2021-09-01,GIN,Sabah,0,0,0
2021-09-01,GIN,Sarawak,0,0,0
2021-09-01,GIN,Selangor,11,6,5
2021-09-01,GLP,Selangor,0,0,0
2021-09-01,GMB,Johor,0,0,0
2021-09-01,GMB,Kedah,0,0,0
2021-09-01,GMB,Kelantan,0,0,0
2021-09-01,GMB,Pulau Pinang,0,0,0
2021-09-01,GMB,Sabah,0,0,0
2021-09-01,GMB,Sarawak,0,0,0
2021-09-01,GMB,Selangor,6,4,2
2021-09-01,GNB,Johor,0,0,0
2021-09-01,GNB,Selangor,0,0,0
2021-09-01,GNQ,Johor,0,0,0
2021-09-01,GNQ,Selangor,0,0,0
2021-09-01,GRC,Johor,0,0,0
2021-09-01,GRC,Kedah,0,0,0
2021-09-01,GRC,Kelantan,0,0,0
2021-09-01,GRC,Melaka,0,0,0
2021-09-01,GRC,Negeri Sembilan,0,0,0
2021-09-01,GRC,Pahang,0,0,0
2021-09-01,GRC,Perak,0,0,0
2021-09-01,GRC,Perlis,0,0,0
2021-09-01,GRC,Pulau Pinang,0,0,0
2021-09-01,GRC,Sabah,0,0,0
2021-09-01,GRC,Sarawak,0,0,0
2021-09-01,GRC,Selangor,13,12,1
2021-09-01,GRD,Johor,0,0,0
2021-09-01,GRD,Kedah,0,0,0
2021-09-01,GRD,Pulau Pinang,0,0,0
2021-09-01,GRD,Sabah,0,0,0
2021-09-01,GRD,Sarawak,0,0,0
2021-09-01,GRD,Selangor,0,0,0
2021-09-01,GRL,Johor,0,0,0
2021-09-01,GRL,Selangor,0,0,0
2021-09-01,GTM,Johor,0,0,0
2021-09-01,GTM,Kedah,0,0,0
2021-09-01,GTM,Pahang,0,0,0
2021-09-01,GTM,Perak,0,0,0
2021-09-01,GTM,Pulau Pinang,0,0,0
2021-09-01,GTM,Sabah,0,0,0
2021-09-01,GTM,Sarawak,0,0,0
2021-09-01,GTM,Selangor,0,0,0
2021-09-01,GTM,W.P. Labuan,0,0,0
2021-09-01,GUY,Johor,0,0,0
2021-09-01,GUY,Kedah,0,0,0
2021-09-01,GUY,Pulau Pinang,0,0,0
2021-09-01,GUY,Sarawak,0,0,0
2021-09-01,GUY,Selangor,0,0,0
2021-09-01,HKG,Johor,0,0,0
2021-09-01,HKG,Kedah,0,0,0
2021-09-01,HKG,Kelantan,0,0,0
2021-09-01,HKG,Pahang,0,0,0
2021-09-01,HKG,Perak,0,0,0
2021-09-01,HKG,Perlis,0,0,0
2021-09-01,HKG,Pulau Pinang,5,4,1
2021-09-01,HKG,Sabah,0,0,0
2021-09-01,HKG,Sarawak,6,4,2
2021-09-01,HKG,Selangor,0,0,0
2021-09-01,HKG,Terengganu,0,0,0
2021-09-01,HMD,Johor,0,0,0
2021-09-01,HND,Johor,0,0,0
2021-09-01,HND,Kedah,0,0,0
2021-09-01,HND,Perak,0,0,0
2021-09-01,HND,Pulau Pinang,0,0,0
2021-09-01,HND,Sabah,0,0,0
2021-09-01,HND,Sarawak,0,0,0
2021-09-01,HND,Selangor,0,0,0
2021-09-01,HRV,Johor,1,1,0
2021-09-01,HRV,Kedah,0,0,0
2021-09-01,HRV,Kelantan,0,0,0
2021-09-01,HRV,Melaka,0,0,0
2021-09-01,HRV,Pahang,0,0,0
2021-09-01,HRV,Perak,0,0,0
2021-09-01,HRV,Perlis,0,0,0
2021-09-01,HRV,Pulau Pinang,0,0,0
2021-09-01,HRV,Sabah,0,0,0
2021-09-01,HRV,Sarawak,0,0,0
2021-09-01,HRV,Selangor,21,17,4
2021-09-01,HTI,Johor,0,0,0
2021-09-01,HTI,Kedah,0,0,0
2021-09-01,HTI,Kelantan,0,0,0
2021-09-01,HTI,Perak,0,0,0
2021-09-01,HTI,Pulau Pinang,0,0,0
2021-09-01,HTI,Sabah,0,0,0
2021-09-01,HTI,Selangor,0,0,0
2021-09-01,HUN,Johor,0,0,0
2021-09-01,HUN,Kedah,0,0,0
2021-09-01,HUN,Kelantan,0,0,0
2021-09-01,HUN,Pahang,0,0,0
2021-09-01,HUN,Perak,0,0,0
2021-09-01,HUN,Perlis,0,0,0
2021-09-01,HUN,Pulau Pinang,0,0,0
2021-09-01,HUN,Sabah,0,0,0
2021-09-01,HUN,Sarawak,0,0,0
2021-09-01,HUN,Selangor,17,8,9
2021-09-01,HUN,W.P. Labuan,0,0,0
2021-09-01,IDN,Johor,64,50,14
2021-09-01,IDN,Kedah,7,7,0
2021-09-01,IDN,Kelantan,0,0,0
2021-09-01,IDN,Melaka,0,0,0
2021-09-01,IDN,Negeri Sembilan,0,0,0
2021-09-01,IDN,Pahang,0,0,0
2021-09-01,IDN,Perak,0,0,0
2021-09-01,IDN,Perlis,5,5,0
2021-09-01,IDN,Pulau Pinang,11,5,6
2021-09-01,IDN,Sabah,0,0,0
2021-09-01,IDN,Sarawak,136,131,5
2021-09-01,IDN,Selangor,972,608,364
2021-09-01,IDN,Terengganu,1,1,0
2021-09-01,IDN,W.P. Labuan,1,1,0
2021-09-01,IND,Johor,2,2,0
2021-09-01,IND,Kedah,0,0,0
2021-09-01,IND,Kelantan,0,0,0
2021-09-01,IND,Melaka,0,0,0
2021-09-01,IND,Negeri Sembilan,0,0,0
2021-09-01,IND,Pahang,0,0,0
2021-09-01,IND,Perak,0,0,0
2021-09-01,IND,Perlis,0,0,0
2021-09-01,IND,Pulau Pinang,0,0,0
2021-09-01,IND,Sabah,0,0,0
2021-09-01,IND,Sarawak,2,2,0
2021-09-01,IND,Selangor,180,131,49
2021-09-01,IND,Terengganu,0,0,0
2021-09-01,IND,W.P. Labuan,0,0,0
2021-09-01,IOT,Pulau Pinang,0,0,0
2021-09-01,IOT,Selangor,0,0,0
2021-09-01,IRL,Johor,0,0,0
2021-09-01,IRL,Kedah,0,0,0
2021-09-01,IRL,Kelantan,0,0,0
2021-09-01,IRL,Negeri Sembilan,0,0,0
2021-09-01,IRL,Pahang,0,0,0
2021-09-01,IRL,Perak,0,0,0
2021-09-01,IRL,Perlis,0,0,0
2021-09-01,IRL,Pulau Pinang,0,0,0
2021-09-01,IRL,Sabah,0,0,0
2021-09-01,IRL,Sarawak,0,0,0
2021-09-01,IRL,Selangor,15,10,5
2021-09-01,IRL,Terengganu,0,0,0
2021-09-01,IRL,W.P. Labuan,0,0,0
2021-09-01,IRN,Johor,0,0,0
2021-09-01,IRN,Kedah,0,0,0
2021-09-01,IRN,Kelantan,0,0,0
2021-09-01,IRN,Perak,0,0,0
2021-09-01,IRN,Perlis,0,0,0
2021-09-01,IRN,Pulau Pinang,0,0,0
2021-09-01,IRN,Sabah,0,0,0
2021-09-01,IRN,Sarawak,0,0,0
2021-09-01,IRN,Selangor,45,27,18
2021-09-01,IRN,W.P. Labuan,0,0,0
2021-09-01,IRQ,Johor,0,0,0
2021-09-01,IRQ,Kedah,0,0,0
2021-09-01,IRQ,Kelantan,0,0,0
2021-09-01,IRQ,Melaka,0,0,0
2021-09-01,IRQ,Pahang,0,0,0
2021-09-01,IRQ,Perak,0,0,0
2021-09-01,IRQ,Perlis,0,0,0
2021-09-01,IRQ,Pulau Pinang,0,0,0
2021-09-01,IRQ,Sabah,0,0,0
2021-09-01,IRQ,Sarawak,0,0,0
2021-09-01,IRQ,Selangor,47,35,12
2021-09-01,ISL,Johor,0,0,0
2021-09-01,ISL,Kedah,0,0,0
2021-09-01,ISL,Kelantan,0,0,0
2021-09-01,ISL,Perak,0,0,0
2021-09-01,ISL,Perlis,0,0,0
2021-09-01,ISL,Pulau Pinang,0,0,0
2021-09-01,ISL,Sabah,0,0,0
2021-09-01,ISL,Sarawak,0,0,0
2021-09-01,ISL,Selangor,1,1,0
2021-09-01,ISL,W.P. Labuan,0,0,0
2021-09-01,ISR,Pulau Pinang,0,0,0
2021-09-01,ITA,Johor,0,0,0
2021-09-01,ITA,Kedah,0,0,0
2021-09-01,ITA,Kelantan,0,0,0
2021-09-01,ITA,Melaka,0,0,0
2021-09-01,ITA,Negeri Sembilan,0,0,0
2021-09-01,ITA,Pahang,0,0,0
2021-09-01,ITA,Perak,0,0,0
2021-09-01,ITA,Perlis,0,0,0
2021-09-01,ITA,Pulau Pinang,2,2,0
2021-09-01,ITA,Sabah,0,0,0
2021-09-01,ITA,Sarawak,0,0,0
2021-09-01,ITA,Selangor,83,62,21
2021-09-01,ITA,W.P. Labuan,0,0,0
2021-09-01,JAM,Johor,0,0,0
2021-09-01,JAM,Kedah,0,0,0
2021-09-01,JAM,Perak,0,0,0
2021-09-01,JAM,Pulau Pinang,0,0,0
2021-09-01,JAM,Sabah,0,0,0
2021-09-01,JAM,Sarawak,0,0,0
2021-09-01,JAM,Selangor,1,1,0
2021-09-01,JAM,W.P. Labuan,0,0,0
2021-09-01,JOR,Johor,0,0,0
2021-09-01,JOR,Kedah,0,0,0
2021-09-01,JOR,Kelantan,0,0,0
2021-09-01,JOR,Melaka,0,0,0
2021-09-01,JOR,Perlis,0,0,0
2021-09-01,JOR,Pulau Pinang,0,0,0
2021-09-01,JOR,Sabah,0,0,0
2021-09-01,JOR,Sarawak,0,0,0
2021-09-01,JOR,Selangor,39,26,13
2021-09-01,JOR,W.P. Labuan,0,0,0
2021-09-01,JPN,Johor,0,0,0
2021-09-01,JPN,Kedah,0,0,0
2021-09-01,JPN,Kelantan,0,0,0
2021-09-01,JPN,Melaka,0,0,0
2021-09-01,JPN,Negeri Sembilan,0,0,0
2021-09-01,JPN,Pahang,0,0,0
2021-09-01,JPN,Perak,0,0,0
2021-09-01,JPN,Perlis,0,0,0
2021-09-01,JPN,Pulau Pinang,31,16,15
2021-09-01,JPN,Sabah,0,0,0
2021-09-01,JPN,Sarawak,2,2,0
2021-09-01,JPN,Selangor,637,428,209
2021-09-01,JPN,W.P. Labuan,0,0,0
2021-09-01,KAZ,Johor,0,0,0
2021-09-01,KAZ,Kedah,0,0,0
2021-09-01,KAZ,Kelantan,0,0,0
2021-09-01,KAZ,Melaka,0,0,0
2021-09-01,KAZ,Perak,0,0,0
2021-09-01,KAZ,Perlis,0,0,0
2021-09-01,KAZ,Pulau Pinang,0,0,0
2021-09-01,KAZ,Sabah,0,0,0
2021-09-01,KAZ,Sarawak,0,0,0
2021-09-01,KAZ,Selangor,36,15,21
2021-09-01,KAZ,W.P. Labuan,0,0,0
2021-09-01,KEN,Johor,0,0,0
2021-09-01,KEN,Kedah,0,0,0
2021-09-01,KEN,Kelantan,0,0,0
2021-09-01,KEN,Perak,0,0,0
2021-09-01,KEN,Perlis,0,0,0
2021-09-01,KEN,Pulau Pinang,0,0,0
2021-09-01,KEN,Sabah,0,0,0
2021-09-01,KEN,Sarawak,0,0,0
2021-09-01,KEN,Selangor,37,27,10
2021-09-01,KGZ,Johor,0,0,0
2021-09-01,KGZ,Kedah,0,0,0
2021-09-01,KGZ,Kelantan,0,0,0
2021-09-01,KGZ,Perak,0,0,0
2021-09-01,KGZ,Perlis,0,0,0
2021-09-01,KGZ,Pulau Pinang,0,0,0
2021-09-01,KGZ,Sabah,0,0,0
2021-09-01,KGZ,Sarawak,0,0,0
2021-09-01,KGZ,Selangor,0,0,0
2021-09-01,KHM,Johor,0,0,0
2021-09-01,KHM,Kedah,0,0,0
2021-09-01,KHM,Kelantan,0,0,0
2021-09-01,KHM,Melaka,0,0,0
2021-09-01,KHM,Negeri Sembilan,0,0,0
2021-09-01,KHM,Pahang,0,0,0
2021-09-01,KHM,Perak,0,0,0
2021-09-01,KHM,Perlis,0,0,0
2021-09-01,KHM,Pulau Pinang,1,0,1
2021-09-01,KHM,Sabah,0,0,0
2021-09-01,KHM,Sarawak,0,0,0
2021-09-01,KHM,Selangor,1,1,0
2021-09-01,KHM,W.P. Labuan,0,0,0
2021-09-01,KIR,Johor,0,0,0
2021-09-01,KIR,Sabah,0,0,0
2021-09-01,KIR,Selangor,0,0,0
2021-09-01,KNA,Johor,0,0,0
2021-09-01,KNA,Kedah,0,0,0
2021-09-01,KNA,Perlis,0,0,0
2021-09-01,KNA,Pulau Pinang,0,0,0
2021-09-01,KNA,Sabah,0,0,0
2021-09-01,KNA,Selangor,1,1,0
2021-09-01,KNA,W.P. Labuan,0,0,0
2021-09-01,KOR,Johor,0,0,0
2021-09-01,KOR,Kedah,0,0,0
2021-09-01,KOR,Kelantan,0,0,0
2021-09-01,KOR,Melaka,0,0,0
2021-09-01,KOR,Negeri Sembilan,0,0,0
2021-09-01,KOR,Pahang,0,0,0
2021-09-01,KOR,Perak,0,0,0
2021-09-01,KOR,Perlis,0,0,0
2021-09-01,KOR,Pulau Pinang,15,7,8
2021-09-01,KOR,Sabah,0,0,0
2021-09-01,KOR,Sarawak,49,48,1
2021-09-01,KOR,Selangor,323,194,129
2021-09-01,KOR,Terengganu,0,0,0
2021-09-01,KOR,W.P. Labuan,0,0,0
2021-09-01,KWT,Johor,0,0,0
2021-09-01,KWT,Kedah,0,0,0
2021-09-01,KWT,Kelantan,0,0,0
2021-09-01,KWT,Perak,0,0,0
2021-09-01,KWT,Perlis,0,0,0
2021-09-01,KWT,Pulau Pinang,0,0,0
2021-09-01,KWT,Sabah,0,0,0
2021-09-01,KWT,Sarawak,0,0,0
2021-09-01,KWT,Selangor,2,2,0
2021-09-01,KWT,W.P. Labuan,0,0,0
2021-09-01,LAO,Johor,0,0,0
2021-09-01,LAO,Kedah,0,0,0
2021-09-01,LAO,Kelantan,0,0,0
2021-09-01,LAO,Melaka,0,0,0
2021-09-01,LAO,Perak,0,0,0
2021-09-01,LAO,Perlis,0,0,0
2021-09-01,LAO,Pulau Pinang,0,0,0
2021-09-01,LAO,Sabah,0,0,0
2021-09-01,LAO,Sarawak,0,0,0
2021-09-01,LAO,Selangor,23,23,0
2021-09-01,LAO,W.P. Labuan,0,0,0
2021-09-01,LBN,Johor,0,0,0
2021-09-01,LBN,Kedah,0,0,0
2021-09-01,LBN,Kelantan,0,0,0
2021-09-01,LBN,Pahang,0,0,0
2021-09-01,LBN,Perak,0,0,0
2021-09-01,LBN,Perlis,0,0,0
2021-09-01,LBN,Pulau Pinang,0,0,0
2021-09-01,LBN,Sabah,0,0,0
2021-09-01,LBN,Sarawak,0,0,0
2021-09-01,LBN,Selangor,7,4,3
2021-09-01,LBN,W.P. Labuan,0,0,0
2021-09-01,LBR,Johor,0,0,0
2021-09-01,LBR,Kedah,0,0,0
2021-09-01,LBR,Sabah,0,0,0
2021-09-01,LBR,Sarawak,0,0,0
2021-09-01,LBR,Selangor,2,2,0
2021-09-01,LBY,Johor,0,0,0
2021-09-01,LBY,Kedah,0,0,0
2021-09-01,LBY,Perlis,0,0,0
2021-09-01,LBY,Pulau Pinang,0,0,0
2021-09-01,LBY,Sabah,0,0,0
2021-09-01,LBY,Sarawak,0,0,0
2021-09-01,LBY,Selangor,41,36,5
2021-09-01,LCA,Johor,0,0,0
2021-09-01,LCA,Kedah,0,0,0
2021-09-01,LCA,Pulau Pinang,0,0,0
2021-09-01,LCA,Sarawak,0,0,0
2021-09-01,LCA,Selangor,0,0,0
2021-09-01,LIE,Johor,0,0,0
2021-09-01,LIE,Kedah,0,0,0
2021-09-01,LIE,Perlis,0,0,0
2021-09-01,LIE,Pulau Pinang,0,0,0
2021-09-01,LIE,Sabah,0,0,0
2021-09-01,LIE,Sarawak,0,0,0
2021-09-01,LIE,Selangor,0,0,0
2021-09-01,LKA,Johor,0,0,0
2021-09-01,LKA,Kedah,0,0,0
2021-09-01,LKA,Kelantan,0,0,0
2021-09-01,LKA,Melaka,0,0,0
2021-09-01,LKA,Pahang,0,0,0
2021-09-01,LKA,Perak,0,0,0
2021-09-01,LKA,Perlis,0,0,0
2021-09-01,LKA,Pulau Pinang,0,0,0
2021-09-01,LKA,Sabah,0,0,0
2021-09-01,LKA,Sarawak,0,0,0
2021-09-01,LKA,Selangor,4,4,0
2021-09-01,LKA,W.P. Labuan,0,0,0
2021-09-01,LSO,Johor,0,0,0
2021-09-01,LSO,Kedah,0,0,0
2021-09-01,LSO,Pulau Pinang,0,0,0
2021-09-01,LSO,Sarawak,0,0,0
2021-09-01,LSO,Selangor,0,0,0
2021-09-01,LTU,Johor,0,0,0
2021-09-01,LTU,Kedah,0,0,0
2021-09-01,LTU,Kelantan,0,0,0
2021-09-01,LTU,Pahang,0,0,0
2021-09-01,LTU,Perak,0,0,0
2021-09-01,LTU,Perlis,0,0,0
2021-09-01,LTU,Pulau Pinang,0,0,0
2021-09-01,LTU,Sabah,0,0,0
2021-09-01,LTU,Sarawak,0,0,0
2021-09-01,LTU,Selangor,6,3,3
2021-09-01,LTU,W.P. Labuan,0,0,0
2021-09-01,LUX,Johor,0,0,0
2021-09-01,LUX,Kedah,0,0,0
2021-09-01,LUX,Kelantan,0,0,0
2021-09-01,LUX,Perak,0,0,0
2021-09-01,LUX,Perlis,0,0,0
2021-09-01,LUX,Pulau Pinang,0,0,0
2021-09-01,LUX,Sabah,0,0,0
2021-09-01,LUX,Sarawak,0,0,0
2021-09-01,LUX,Selangor,1,1,0
2021-09-01,LVA,Johor,0,0,0
2021-09-01,LVA,Kedah,0,0,0
2021-09-01,LVA,Kelantan,0,0,0
2021-09-01,LVA,Pahang,0,0,0
2021-09-01,LVA,Perak,0,0,0
2021-09-01,LVA,Perlis,0,0,0
2021-09-01,LVA,Pulau Pinang,0,0,0
2021-09-01,LVA,Sabah,0,0,0
2021-09-01,LVA,Sarawak,0,0,0
2021-09-01,LVA,Selangor,4,2,2
2021-09-01,LVA,W.P. Labuan,0,0,0
2021-09-01,MAC,Johor,0,0,0
2021-09-01,MAC,Pahang,0,0,0
2021-09-01,MAC,Perak,0,0,0
2021-09-01,MAC,Selangor,0,0,0
2021-09-01,MAC,W.P. Labuan,0,0,0
2021-09-01,MAR,Johor,0,0,0
2021-09-01,MAR,Kedah,0,0,0
2021-09-01,MAR,Kelantan,0,0,0
2021-09-01,MAR,Melaka,0,0,0
2021-09-01,MAR,Pahang,0,0,0
2021-09-01,MAR,Perak,0,0,0
2021-09-01,MAR,Perlis,0,0,0
2021-09-01,MAR,Pulau Pinang,0,0,0
2021-09-01,MAR,Sabah,0,0,0
2021-09-01,MAR,Sarawak,0,0,0
2021-09-01,MAR,Selangor,16,8,8
2021-09-01,MAR,W.P. Labuan,0,0,0
2021-09-01,MCO,Johor,0,0,0
2021-09-01,MCO,Kedah,0,0,0
2021-09-01,MCO,Sabah,0,0,0
2021-09-01,MCO,Selangor,0,0,0
2021-09-01,MDA,Johor,0,0,0
2021-09-01,MDA,Kedah,0,0,0
2021-09-01,MDA,Kelantan,1,1,0
2021-09-01,MDA,Negeri Sembilan,0,0,0
2021-09-01,MDA,Perlis,0,0,0
2021-09-01,MDA,Pulau Pinang,0,0,0
2021-09-01,MDA,Sabah,0,0,0
2021-09-01,MDA,Sarawak,0,0,0
2021-09-01,MDA,Selangor,0,0,0
2021-09-01,MDG,Johor,0,0,0
2021-09-01,MDG,Kedah,0,0,0
2021-09-01,MDG,Perak,0,0,0
2021-09-01,MDG,Perlis,0,0,0
2021-09-01,MDG,Pulau Pinang,0,0,0
2021-09-01,MDG,Sabah,0,0,0
2021-09-01,MDG,Sarawak,0,0,0
2021-09-01,MDG,Selangor,0,0,0
2021-09-01,MDV,Johor,0,0,0
2021-09-01,MDV,Kedah,0,0,0
2021-09-01,MDV,Kelantan,0,0,0
2021-09-01,MDV,Perak,0,0,0
2021-09-01,MDV,Perlis,0,0,0
2021-09-01,MDV,Pulau Pinang,0,0,0
2021-09-01,MDV,Sabah,0,0,0
2021-09-01,MDV,Sarawak,0,0,0
2021-09-01,MDV,Selangor,52,20,32
2021-09-01,MEX,Johor,0,0,0
2021-09-01,MEX,Kedah,0,0,0
2021-09-01,MEX,Kelantan,0,0,0
2021-09-01,MEX,Pahang,0,0,0
2021-09-01,MEX,Perak,0,0,0
2021-09-01,MEX,Perlis,0,0,0
2021-09-01,MEX,Pulau Pinang,2,1,1
2021-09-01,MEX,Sabah,0,0,0
2021-09-01,MEX,Sarawak,0,0,0
2021-09-01,MEX,Selangor,10,7,3
2021-09-01,MEX,W.P. Labuan,0,0,0
2021-09-01,MHL,Johor,0,0,0
2021-09-01,MHL,Kedah,0,0,0
2021-09-01,MHL,Perak,0,0,0
2021-09-01,MHL,Pulau Pinang,0,0,0
2021-09-01,MHL,Sabah,0,0,0
2021-09-01,MHL,Selangor,0,0,0
2021-09-01,MKD,Johor,0,0,0
2021-09-01,MKD,Kedah,0,0,0
2021-09-01,MKD,Perak,0,0,0
2021-09-01,MKD,Pulau Pinang,0,0,0
2021-09-01,MKD,Sabah,0,0,0
2021-09-01,MKD,Sarawak,0,0,0
2021-09-01,MKD,Selangor,0,0,0
2021-09-01,MLI,Johor,0,0,0
2021-09-01,MLI,Sabah,0,0,0
2021-09-01,MLI,Selangor,0,0,0
2021-09-01,MLT,Johor,0,0,0
2021-09-01,MLT,Kedah,0,0,0
2021-09-01,MLT,Kelantan,0,0,0
2021-09-01,MLT,Perak,0,0,0
2021-09-01,MLT,Perlis,0,0,0
2021-09-01,MLT,Pulau Pinang,0,0,0
2021-09-01,MLT,Sabah,0,0,0
2021-09-01,MLT,Sarawak,0,0,0
2021-09-01,MLT,Selangor,2,2,0
2021-09-01,MLT,W.P. Labuan,0,0,0
2021-09-01,MMR,Johor,0,0,0
2021-09-01,MMR,Kedah,0,0,0
2021-09-01,MMR,Kelantan,0,0,0
2021-09-01,MMR,Negeri Sembilan,0,0,0
2021-09-01,MMR,Pahang,0,0,0
2021-09-01,MMR,Perak,0,0,0
2021-09-01,MMR,Perlis,0,0,0
2021-09-01,MMR,Pulau Pinang,0,0,0
2021-09-01,MMR,Sabah,0,0,0
2021-09-01,MMR,Sarawak,0,0,0
2021-09-01,MMR,Selangor,161,135,26
2021-09-01,MMR,Terengganu,0,0,0
2021-09-01,MMR,W.P. Labuan,0,0,0
2021-09-01,MNE,Johor,0,0,0
2021-09-01,MNE,Kedah,0,0,0
2021-09-01,MNE,Pulau Pinang,0,0,0
2021-09-01,MNE,Sabah,0,0,0
2021-09-01,MNE,Sarawak,0,0,0
2021-09-01,MNE,Selangor,5,5,0
2021-09-01,MNG,Johor,0,0,0
2021-09-01,MNG,Kedah,0,0,0
2021-09-01,MNG,Kelantan,0,0,0
2021-09-01,MNG,Perak,0,0,0
2021-09-01,MNG,Perlis,0,0,0
2021-09-01,MNG,Pulau Pinang,0,0,0
2021-09-01,MNG,Sabah,0,0,0
2021-09-01,MNG,Sarawak,0,0,0
2021-09-01,MNG,Selangor,2,0,2
2021-09-01,MNP,Selangor,0,0,0
2021-09-01,MOZ,Johor,0,0,0
2021-09-01,MOZ,Kedah,0,0,0
2021-09-01,MOZ,Perak,0,0,0
2021-09-01,MOZ,Pulau Pinang,0,0,0
2021-09-01,MOZ,Sabah,0,0,0
2021-09-01,MOZ,Sarawak,0,0,0
2021-09-01,MOZ,Selangor,3,2,1
2021-09-01,MRT,Johor,0,0,0
2021-09-01,MRT,Kedah,0,0,0
2021-09-01,MRT,Pulau Pinang,0,0,0
2021-09-01,MRT,Sabah,0,0,0
2021-09-01,MRT,Sarawak,0,0,0
2021-09-01,MRT,Selangor,5,4,1
2021-09-01,MUS,Johor,0,0,0
2021-09-01,MUS,Kedah,0,0,0
2021-09-01,MUS,Kelantan,0,0,0
2021-09-01,MUS,Pahang,0,0,0
2021-09-01,MUS,Perak,0,0,0
2021-09-01,MUS,Perlis,0,0,0
2021-09-01,MUS,Pulau Pinang,0,0,0
2021-09-01,MUS,Sabah,0,0,0
2021-09-01,MUS,Sarawak,0,0,0
2021-09-01,MUS,Selangor,7,4,3
2021-09-01,MWI,Johor,0,0,0
2021-09-01,MWI,Pulau Pinang,0,0,0
2021-09-01,MWI,Sabah,0,0,0
2021-09-01,MWI,Sarawak,0,0,0
2021-09-01,MWI,Selangor,0,0,0
2021-09-01,MYT,Selangor,0,0,0
2021-09-01,NAM,Johor,0,0,0
2021-09-01,NAM,Kedah,0,0,0
2021-09-01,NAM,Perak,0,0,0
2021-09-01,NAM,Perlis,0,0,0
2021-09-01,NAM,Pulau Pinang,0,0,0
2021-09-01,NAM,Sabah,0,0,0
2021-09-01,NAM,Sarawak,0,0,0
2021-09-01,NAM,Selangor,3,1,2
2021-09-01,NCL,Selangor,0,0,0
2021-09-01,NER,Johor,0,0,0
2021-09-01,NER,Sabah,0,0,0
2021-09-01,NER,Selangor,1,1,0
2021-09-01,NGA,Johor,0,0,0
2021-09-01,NGA,Kedah,0,0,0
2021-09-01,NGA,Perlis,0,0,0
2021-09-01,NGA,Pulau Pinang,0,0,0
2021-09-01,NGA,Sabah,0,0,0
2021-09-01,NGA,Sarawak,0,0,0
2021-09-01,NGA,Selangor,94,86,8
2021-09-01,NIC,Johor,0,0,0
2021-09-01,NIC,Kedah,0,0,0
2021-09-01,NIC,Pulau Pinang,0,0,0
2021-09-01,NIC,Sabah,0,0,0
2021-09-01,NIC,Selangor,0,0,0
2021-09-01,NLD,Johor,0,0,0
2021-09-01,NLD,Kedah,0,0,0
2021-09-01,NLD,Kelantan,0,0,0
2021-09-01,NLD,Melaka,0,0,0
2021-09-01,NLD,Negeri Sembilan,0,0,0
2021-09-01,NLD,Pahang,0,0,0
2021-09-01,NLD,Perak,0,0,0
2021-09-01,NLD,Perlis,0,0,0
2021-09-01,NLD,Pulau Pinang,2,2,0
2021-09-01,NLD,Sabah,0,0,0
2021-09-01,NLD,Sarawak,1,1,0
2021-09-01,NLD,Selangor,90,56,34
2021-09-01,NLD,Terengganu,0,0,0
2021-09-01,NLD,W.P. Labuan,0,0,0
2021-09-01,NOR,Johor,0,0,0
2021-09-01,NOR,Kedah,0,0,0
2021-09-01,NOR,Kelantan,0,0,0
2021-09-01,NOR,Melaka,0,0,0
2021-09-01,NOR,Pahang,0,0,0
2021-09-01,NOR,Perak,0,0,0
2021-09-01,NOR,Perlis,0,0,0
2021-09-01,NOR,Pulau Pinang,0,0,0
2021-09-01,NOR,Sabah,0,0,0
2021-09-01,NOR,Sarawak,2,2,0
2021-09-01,NOR,Selangor,19,15,4
2021-09-01,NOR,W.P. Labuan,0,0,0
2021-09-01,NPL,Johor,0,0,0
2021-09-01,NPL,Kedah,0,0,0
2021-09-01,NPL,Pahang,0,0,0
2021-09-01,NPL,Perak,0,0,0
2021-09-01,NPL,Perlis,0,0,0
2021-09-01,NPL,Pulau Pinang,0,0,0
2021-09-01,NPL,Sabah,0,0,0
2021-09-01,NPL,Sarawak,0,0,0
2021-09-01,NPL,Selangor,2,1,1
2021-09-01,NPL,W.P. Labuan,0,0,0
2021-09-01,NRU,Johor,0,0,0
2021-09-01,NRU,Pulau Pinang,0,0,0
2021-09-01,NRU,Selangor,0,0,0
2021-09-01,NZL,Johor,0,0,0
2021-09-01,NZL,Kedah,0,0,0
2021-09-01,NZL,Kelantan,0,0,0
2021-09-01,NZL,Melaka,0,0,0
2021-09-01,NZL,Negeri Sembilan,0,0,0
2021-09-01,NZL,Pahang,0,0,0
2021-09-01,NZL,Perak,0,0,0
2021-09-01,NZL,Perlis,0,0,0
2021-09-01,NZL,Pulau Pinang,1,1,0
2021-09-01,NZL,Sabah,0,0,0
2021-09-01,NZL,Sarawak,0,0,0
2021-09-01,NZL,Selangor,12,9,3
2021-09-01,NZL,Terengganu,0,0,0
2021-09-01,NZL,W.P. Labuan,0,0,0
2021-09-01,OMN,Johor,0,0,0
2021-09-01,OMN,Kedah,0,0,0
2021-09-01,OMN,Kelantan,0,0,0
2021-09-01,OMN,Melaka,0,0,0
2021-09-01,OMN,Perak,0,0,0
2021-09-01,OMN,Perlis,0,0,0
2021-09-01,OMN,Pulau Pinang,0,0,0
2021-09-01,OMN,Sabah,0,0,0
2021-09-01,OMN,Sarawak,0,0,0
2021-09-01,OMN,Selangor,15,11,4
2021-09-01,PAK,Johor,0,0,0
2021-09-01,PAK,Kedah,0,0,0
2021-09-01,PAK,Kelantan,0,0,0
2021-09-01,PAK,Melaka,0,0,0
2021-09-01,PAK,Negeri Sembilan,0,0,0
2021-09-01,PAK,Pahang,0,0,0
2021-09-01,PAK,Perak,0,0,0
2021-09-01,PAK,Perlis,0,0,0
2021-09-01,PAK,Pulau Pinang,0,0,0
2021-09-01,PAK,Sabah,0,0,0
2021-09-01,PAK,Sarawak,0,0,0
2021-09-01,PAK,Selangor,23,14,9
2021-09-01,PAK,W.P. Labuan,0,0,0
2021-09-01,PAN,Johor,0,0,0
2021-09-01,PAN,Kedah,0,0,0
2021-09-01,PAN,Perak,0,0,0
2021-09-01,PAN,Perlis,0,0,0
2021-09-01,PAN,Pulau Pinang,0,0,0
2021-09-01,PAN,Sabah,0,0,0
2021-09-01,PAN,Sarawak,0,0,0
2021-09-01,PAN,Selangor,4,4,0
2021-09-01,PER,Johor,0,0,0
2021-09-01,PER,Kedah,0,0,0
2021-09-01,PER,Kelantan,0,0,0
2021-09-01,PER,Pahang,0,0,0
2021-09-01,PER,Perak,0,0,0
2021-09-01,PER,Perlis,0,0,0
2021-09-01,PER,Pulau Pinang,0,0,0
2021-09-01,PER,Sabah,0,0,0
2021-09-01,PER,Sarawak,0,0,0
2021-09-01,PER,Selangor,0,0,0
2021-09-01,PER,W.P. Labuan,0,0,0
2021-09-01,PHL,Johor,3,2,1
2021-09-01,PHL,Kedah,0,0,0
2021-09-01,PHL,Kelantan,0,0,0
2021-09-01,PHL,Melaka,0,0,0
2021-09-01,PHL,Negeri Sembilan,0,0,0
2021-09-01,PHL,Pahang,0,0,0
2021-09-01,PHL,Perak,0,0,0
2021-09-01,PHL,Perlis,0,0,0
2021-09-01,PHL,Pulau Pinang,3,1,2
2021-09-01,PHL,Sabah,1,0,1
2021-09-01,PHL,Sarawak,28,28,0
2021-09-01,PHL,Selangor,456,398,58
2021-09-01,PHL,Terengganu,0,0,0
2021-09-01,PHL,W.P. Labuan,6,6,0
2021-09-01,PLW,Johor,0,0,0
2021-09-01,PLW,Pulau Pinang,0,0,0
2021-09-01,PLW,Selangor,0,0,0
2021-09-01,PNG,Johor,0,0,0
2021-09-01,PNG,Kedah,0,0,0
2021-09-01,PNG,Kelantan,0,0,0
2021-09-01,PNG,Perak,0,0,0
2021-09-01,PNG,Pulau Pinang,0,0,0
2021-09-01,PNG,Sabah,0,0,0
2021-09-01,PNG,Sarawak,0,0,0
2021-09-01,PNG,Selangor,0,0,0
2021-09-01,POL,Johor,0,0,0
2021-09-01,POL,Kedah,0,0,0
2021-09-01,POL,Kelantan,0,0,0
2021-09-01,POL,Melaka,0,0,0
2021-09-01,POL,Negeri Sembilan,0,0,0
2021-09-01,POL,Pahang,0,0,0
2021-09-01,POL,Perak,0,0,0
2021-09-01,POL,Perlis,0,0,0
2021-09-01,POL,Pulau Pinang,0,0,0
2021-09-01,POL,Sabah,0,0,0
2021-09-01,POL,Sarawak,0,0,0
2021-09-01,POL,Selangor,37,26,11
2021-09-01,POL,Terengganu,0,0,0
2021-09-01,POL,W.P. Labuan,0,0,0
2021-09-01,PRK,Selangor,0,0,0
2021-09-01,PRT,Johor,0,0,0
2021-09-01,PRT,Kedah,0,0,0
2021-09-01,PRT,Kelantan,0,0,0
2021-09-01,PRT,Melaka,0,0,0
2021-09-01,PRT,Pahang,0,0,0
2021-09-01,PRT,Perak,0,0,0
2021-09-01,PRT,Perlis,0,0,0
2021-09-01,PRT,Pulau Pinang,0,0,0
2021-09-01,PRT,Sabah,0,0,0
2021-09-01,PRT,Sarawak,0,0,0
2021-09-01,PRT,Selangor,10,6,4
2021-09-01,PRT,W.P. Labuan,0,0,0
2021-09-01,PRY,Johor,0,0,0
2021-09-01,PRY,Kedah,0,0,0
2021-09-01,PRY,Perak,0,0,0
2021-09-01,PRY,Perlis,0,0,0
2021-09-01,PRY,Pulau Pinang,0,0,0
2021-09-01,PRY,Sabah,0,0,0
2021-09-01,PRY,Sarawak,0,0,0
2021-09-01,PRY,Selangor,0,0,0
2021-09-01,PSE,Johor,0,0,0
2021-09-01,PSE,Kedah,0,0,0
2021-09-01,PSE,Kelantan,0,0,0
2021-09-01,PSE,Melaka,0,0,0
2021-09-01,PSE,Perak,0,0,0
2021-09-01,PSE,Perlis,0,0,0
2021-09-01,PSE,Pulau Pinang,0,0,0
2021-09-01,PSE,Sabah,0,0,0
2021-09-01,PSE,Sarawak,0,0,0
2021-09-01,PSE,Selangor,24,19,5
2021-09-01,QAT,Johor,0,0,0
2021-09-01,QAT,Kedah,0,0,0
2021-09-01,QAT,Perlis,0,0,0
2021-09-01,QAT,Pulau Pinang,0,0,0
2021-09-01,QAT,Sabah,0,0,0
2021-09-01,QAT,Sarawak,0,0,0
2021-09-01,QAT,Selangor,2,1,1
2021-09-01,REU,Johor,0,0,0
2021-09-01,REU,Sarawak,0,0,0
2021-09-01,ROU,Johor,0,0,0
2021-09-01,ROU,Kedah,0,0,0
2021-09-01,ROU,Kelantan,2,2,0
2021-09-01,ROU,Negeri Sembilan,0,0,0
2021-09-01,ROU,Pahang,0,0,0
2021-09-01,ROU,Perak,0,0,0
2021-09-01,ROU,Perlis,0,0,0
2021-09-01,ROU,Pulau Pinang,0,0,0
2021-09-01,ROU,Sabah,0,0,0
2021-09-01,ROU,Sarawak,1,1,0
2021-09-01,ROU,Selangor,30,24,6
2021-09-01,ROU,W.P. Labuan,0,0,0
2021-09-01,RUS,Johor,0,0,0
2021-09-01,RUS,Kedah,0,0,0
2021-09-01,RUS,Kelantan,2,0,2
2021-09-01,RUS,Melaka,0,0,0
2021-09-01,RUS,Negeri Sembilan,0,0,0
2021-09-01,RUS,Pahang,0,0,0
2021-09-01,RUS,Perak,0,0,0
2021-09-01,RUS,Perlis,0,0,0
2021-09-01,RUS,Pulau Pinang,0,0,0
2021-09-01,RUS,Sabah,0,0,0
2021-09-01,RUS,Sarawak,0,0,0
2021-09-01,RUS,Selangor,98,63,35
2021-09-01,RUS,W.P. Labuan,0,0,0
2021-09-01,RWA,Johor,0,0,0
2021-09-01,RWA,Kedah,0,0,0
2021-09-01,RWA,Pulau Pinang,0,0,0
2021-09-01,RWA,Selangor,1,0,1
2021-09-01,SAU,Johor,0,0,0
2021-09-01,SAU,Kedah,0,0,0
2021-09-01,SAU,Kelantan,0,0,0
2021-09-01,SAU,Melaka,0,0,0
2021-09-01,SAU,Perak,0,0,0
2021-09-01,SAU,Perlis,0,0,0
2021-09-01,SAU,Pulau Pinang,0,0,0
2021-09-01,SAU,Sabah,0,0,0
2021-09-01,SAU,Sarawak,0,0,0
2021-09-01,SAU,Selangor,141,85,56
2021-09-01,SAU,W.P. Labuan,0,0,0
2021-09-01,SDN,Johor,0,0,0
2021-09-01,SDN,Kedah,0,0,0
2021-09-01,SDN,Kelantan,0,0,0
2021-09-01,SDN,Perlis,0,0,0
2021-09-01,SDN,Pulau Pinang,0,0,0
2021-09-01,SDN,Sabah,0,0,0
2021-09-01,SDN,Sarawak,0,0,0
2021-09-01,SDN,Selangor,36,28,8
2021-09-01,SDN,W.P. Labuan,0,0,0
2021-09-01,SEN,Johor,0,0,0
2021-09-01,SEN,Kedah,0,0,0
2021-09-01,SEN,Kelantan,0,0,0
2021-09-01,SEN,Perak,0,0,0
2021-09-01,SEN,Perlis,0,0,0
2021-09-01,SEN,Pulau Pinang,0,0,0
2021-09-01,SEN,Sabah,0,0,0
2021-09-01,SEN,Sarawak,0,0,0
2021-09-01,SEN,Selangor,0,0,0
2021-09-01,SGP,Johor,107,89,18
2021-09-01,SGP,Kedah,0,0,0
2021-09-01,SGP,Kelantan,0,0,0
2021-09-01,SGP,Melaka,0,0,0
2021-09-01,SGP,Negeri Sembilan,0,0,0
2021-09-01,SGP,Pahang,0,0,0
2021-09-01,SGP,Perak,2,0,2
2021-09-01,SGP,Perlis,0,0,0
2021-09-01,SGP,Pulau Pinang,19,12,7
2021-09-01,SGP,Sabah,0,0,0
2021-09-01,SGP,Sarawak,5,3,2
2021-09-01,SGP,Selangor,103,76,27
2021-09-01,SGP,Terengganu,0,0,0
2021-09-01,SGP,W.P. Labuan,0,0,0
2021-09-01,SGS,Johor,0,0,0
2021-09-01,SGS,Sabah,0,0,0
2021-09-01,SGS,Selangor,0,0,0
2021-09-01,SHN,Sarawak,0,0,0
2021-09-01,SLB,Johor,0,0,0
2021-09-01,SLB,Perlis,0,0,0
2021-09-01,SLB,Pulau Pinang,0,0,0
2021-09-01,SLB,Sabah,0,0,0
2021-09-01,SLB,Sarawak,0,0,0
2021-09-01,SLB,Selangor,0,0,0
2021-09-01,SLB,W.P. Labuan,0,0,0
2021-09-01,SLE,Johor,0,0,0
2021-09-01,SLE,Kedah,0,0,0
2021-09-01,SLE,Perak,0,0,0
2021-09-01,SLE,Pulau Pinang,0,0,0
2021-09-01,SLE,Sabah,0,0,0
2021-09-01,SLE,Selangor,1,1,0
2021-09-01,SLV,Johor,0,0,0
2021-09-01,SLV,Kedah,0,0,0
2021-09-01,SLV,Perak,0,0,0
2021-09-01,SLV,Perlis,0,0,0
2021-09-01,SLV,Pulau Pinang,0,0,0
2021-09-01,SLV,Sabah,0,0,0
2021-09-01,SLV,Selangor,0,0,0
2021-09-01,SLV,W.P. Labuan,0,0,0
2021-09-01,SMR,Johor,0,0,0
2021-09-01,SMR,Selangor,0,0,0
2021-09-01,SOM,Johor,0,0,0
2021-09-01,SOM,Kedah,0,0,0
2021-09-01,SOM,Kelantan,0,0,0
2021-09-01,SOM,Perlis,0,0,0
2021-09-01,SOM,Sabah,0,0,0
2021-09-01,SOM,Sarawak,0,0,0
2021-09-01,SOM,Selangor,45,41,4
2021-09-01,SRB,Johor,0,0,0
2021-09-01,SRB,Kedah,0,0,0
2021-09-01,SRB,Kelantan,0,0,0
2021-09-01,SRB,Pahang,0,0,0
2021-09-01,SRB,Perak,0,0,0
2021-09-01,SRB,Perlis,0,0,0
2021-09-01,SRB,Pulau Pinang,0,0,0
2021-09-01,SRB,Sabah,0,0,0
2021-09-01,SRB,Sarawak,0,0,0
2021-09-01,SRB,Selangor,0,0,0
2021-09-01,SSD,Johor,0,0,0
2021-09-01,SSD,Kedah,0,0,0
2021-09-01,SSD,Sarawak,0,0,0
2021-09-01,SSD,Selangor,0,0,0
2021-09-01,SSD,W.P. Labuan,0,0,0
2021-09-01,STP,Selangor,0,0,0
2021-09-01,SUR,Johor,0,0,0
2021-09-01,SUR,Kedah,0,0,0
2021-09-01,SUR,Kelantan,0,0,0
2021-09-01,SUR,Perak,0,0,0
2021-09-01,SUR,Perlis,0,0,0
2021-09-01,SUR,Pulau Pinang,0,0,0
2021-09-01,SUR,Sabah,0,0,0
2021-09-01,SUR,Sarawak,0,0,0
2021-09-01,SUR,Selangor,0,0,0
2021-09-01,SVK,Johor,0,0,0
2021-09-01,SVK,Kedah,0,0,0
2021-09-01,SVK,Kelantan,0,0,0
2021-09-01,SVK,Negeri Sembilan,0,0,0
2021-09-01,SVK,Pahang,0,0,0
2021-09-01,SVK,Perak,0,0,0
2021-09-01,SVK,Perlis,0,0,0
2021-09-01,SVK,Pulau Pinang,0,0,0
2021-09-01,SVK,Sabah,0,0,0
2021-09-01,SVK,Sarawak,0,0,0
2021-09-01,SVK,Selangor,6,5,1
2021-09-01,SVK,W.P. Labuan,0,0,0
2021-09-01,SVN,Johor,0,0,0
2021-09-01,SVN,Kedah,0,0,0
2021-09-01,SVN,Kelantan,0,0,0
2021-09-01,SVN,Perak,0,0,0
2021-09-01,SVN,Perlis,0,0,0
2021-09-01,SVN,Pulau Pinang,0,0,0
2021-09-01,SVN,Sabah,0,0,0
2021-09-01,SVN,Sarawak,0,0,0
2021-09-01,SVN,Selangor,0,0,0
2021-09-01,SVN,W.P. Labuan,0,0,0
2021-09-01,SWE,Johor,0,0,0
2021-09-01,SWE,Kedah,0,0,0
2021-09-01,SWE,Kelantan,0,0,0
2021-09-01,SWE,Melaka,0,0,0
2021-09-01,SWE,Negeri Sembilan,0,0,0
2021-09-01,SWE,Pahang,0,0,0
2021-09-01,SWE,Perak,0,0,0
2021-09-01,SWE,Perlis,0,0,0
2021-09-01,SWE,Pulau Pinang,0,0,0
2021-09-01,SWE,Sabah,0,0,0
2021-09-01,SWE,Sarawak,0,0,0
2021-09-01,SWE,Selangor,51,38,13
2021-09-01,SWE,W.P. Labuan,0,0,0
2021-09-01,SWZ,Johor,0,0,0
2021-09-01,SWZ,Kedah,0,0,0
2021-09-01,SWZ,Pulau Pinang,0,0,0
2021-09-01,SWZ,Sabah,0,0,0
2021-09-01,SWZ,Selangor,0,0,0
2021-09-01,SYC,Johor,0,0,0
2021-09-01,SYC,Kedah,0,0,0
2021-09-01,SYC,Pulau Pinang,0,0,0
2021-09-01,SYC,Sabah,0,0,0
2021-09-01,SYC,Sarawak,0,0,0
2021-09-01,SYC,Selangor,18,5,13
2021-09-01,SYR,Johor,0,0,0
2021-09-01,SYR,Kedah,0,0,0
2021-09-01,SYR,Kelantan,0,0,0
2021-09-01,SYR,Pahang,0,0,0
2021-09-01,SYR,Perlis,0,0,0
2021-09-01,SYR,Pulau Pinang,0,0,0
2021-09-01,SYR,Sabah,0,0,0
2021-09-01,SYR,Sarawak,0,0,0
2021-09-01,SYR,Selangor,22,16,6
2021-09-01,SYR,W.P. Labuan,0,0,0
2021-09-01,TCA,Perlis,0,0,0
2021-09-01,TCD,Johor,0,0,0
2021-09-01,TCD,Kedah,0,0,0
2021-09-01,TCD,Perlis,0,0,0
2021-09-01,TCD,Selangor,2,2,0
2021-09-01,TGO,Johor,0,0,0
2021-09-01,TGO,Perak,0,0,0
2021-09-01,TGO,Pulau Pinang,0,0,0
2021-09-01,TGO,Selangor,0,0,0
2021-09-01,THA,Johor,16,16,0
2021-09-01,THA,Kedah,18826,18780,46
2021-09-01,THA,Kelantan,0,0,0
2021-09-01,THA,Melaka,0,0,0
2021-09-01,THA,Negeri Sembilan,0,0,0
2021-09-01,THA,Pahang,0,0,0
2021-09-01,THA,Perak,0,0,0
2021-09-01,THA,Perlis,7738,7657,81
2021-09-01,THA,Pulau Pinang,101,100,1
2021-09-01,THA,Sabah,0,0,0
2021-09-01,THA,Sarawak,15,14,1
2021-09-01,THA,Selangor,153,97,56
2021-09-01,THA,Terengganu,0,0,0
2021-09-01,THA,W.P. Labuan,0,0,0
2021-09-01,TJK,Johor,0,0,0
2021-09-01,TJK,Kedah,0,0,0
2021-09-01,TJK,Perlis,0,0,0
2021-09-01,TJK,Pulau Pinang,0,0,0
2021-09-01,TJK,Sabah,0,0,0
2021-09-01,TJK,Selangor,1,0,1
2021-09-01,TKL,Selangor,0,0,0
2021-09-01,TKM,Johor,0,0,0
2021-09-01,TKM,Kedah,0,0,0
2021-09-01,TKM,Kelantan,0,0,0
2021-09-01,TKM,Perlis,0,0,0
2021-09-01,TKM,Pulau Pinang,0,0,0
2021-09-01,TKM,Sabah,0,0,0
2021-09-01,TKM,Sarawak,0,0,0
2021-09-01,TKM,Selangor,1,0,1
2021-09-01,TLS,Johor,0,0,0
2021-09-01,TLS,Kedah,0,0,0
2021-09-01,TLS,Perlis,0,0,0
2021-09-01,TLS,Pulau Pinang,0,0,0
2021-09-01,TLS,Sabah,0,0,0
2021-09-01,TLS,Sarawak,0,0,0
2021-09-01,TLS,Selangor,0,0,0
2021-09-01,TON,Johor,0,0,0
2021-09-01,TON,Pulau Pinang,0,0,0
2021-09-01,TON,Sarawak,0,0,0
2021-09-01,TON,Selangor,0,0,0
2021-09-01,TTO,Johor,0,0,0
2021-09-01,TTO,Kedah,0,0,0
2021-09-01,TTO,Pahang,0,0,0
2021-09-01,TTO,Pulau Pinang,0,0,0
2021-09-01,TTO,Sabah,0,0,0
2021-09-01,TTO,Sarawak,0,0,0
2021-09-01,TTO,Selangor,1,1,0
2021-09-01,TUN,Johor,0,0,0
2021-09-01,TUN,Kedah,0,0,0
2021-09-01,TUN,Kelantan,0,0,0
2021-09-01,TUN,Melaka,0,0,0
2021-09-01,TUN,Perak,0,0,0
2021-09-01,TUN,Perlis,0,0,0
2021-09-01,TUN,Pulau Pinang,0,0,0
2021-09-01,TUN,Sabah,0,0,0
2021-09-01,TUN,Sarawak,0,0,0
2021-09-01,TUN,Selangor,10,3,7
2021-09-01,TUN,W.P. Labuan,0,0,0
2021-09-01,TUR,Johor,0,0,0
2021-09-01,TUR,Kedah,0,0,0
2021-09-01,TUR,Kelantan,0,0,0
2021-09-01,TUR,Melaka,0,0,0
2021-09-01,TUR,Negeri Sembilan,0,0,0
2021-09-01,TUR,Pahang,0,0,0
2021-09-01,TUR,Perak,0,0,0
2021-09-01,TUR,Perlis,0,0,0
2021-09-01,TUR,Pulau Pinang,0,0,0
2021-09-01,TUR,Sabah,0,0,0
2021-09-01,TUR,Sarawak,0,0,0
2021-09-01,TUR,Selangor,54,40,14
2021-09-01,TUR,W.P. Labuan,0,0,0
2021-09-01,TUV,Selangor,0,0,0
2021-09-01,TWN,Johor,0,0,0
2021-09-01,TWN,Kedah,0,0,0
2021-09-01,TWN,Kelantan,0,0,0
2021-09-01,TWN,Melaka,0,0,0
2021-09-01,TWN,Negeri Sembilan,0,0,0
2021-09-01,TWN,Pahang,0,0,0
2021-09-01,TWN,Perak,0,0,0
2021-09-01,TWN,Perlis,0,0,0
2021-09-01,TWN,Pulau Pinang,13,10,3
2021-09-01,TWN,Sabah,0,0,0
2021-09-01,TWN,Sarawak,0,0,0
2021-09-01,TWN,Selangor,40,27,13
2021-09-01,TWN,W.P. Labuan,0,0,0
2021-09-01,TZA,Johor,0,0,0
2021-09-01,TZA,Kedah,0,0,0
2021-09-01,TZA,Perak,0,0,0
2021-09-01,TZA,Perlis,0,0,0
2021-09-01,TZA,Pulau Pinang,0,0,0
2021-09-01,TZA,Sabah,0,0,0
2021-09-01,TZA,Sarawak,0,0,0
2021-09-01,TZA,Selangor,16,11,5
2021-09-01,UGA,Johor,0,0,0
2021-09-01,UGA,Kedah,0,0,0
2021-09-01,UGA,Perak,0,0,0
2021-09-01,UGA,Perlis,0,0,0
2021-09-01,UGA,Pulau Pinang,0,0,0
2021-09-01,UGA,Sabah,0,0,0
2021-09-01,UGA,Sarawak,0,0,0
2021-09-01,UGA,Selangor,7,2,5
2021-09-01,UKR,Johor,2,2,0
2021-09-01,UKR,Kedah,0,0,0
2021-09-01,UKR,Kelantan,0,0,0
2021-09-01,UKR,Melaka,0,0,0
2021-09-01,UKR,Negeri Sembilan,0,0,0
2021-09-01,UKR,Pahang,0,0,0
2021-09-01,UKR,Perak,0,0,0
2021-09-01,UKR,Perlis,0,0,0
2021-09-01,UKR,Pulau Pinang,0,0,0
2021-09-01,UKR,Sabah,0,0,0
2021-09-01,UKR,Sarawak,0,0,0
2021-09-01,UKR,Selangor,49,45,4
2021-09-01,UKR,W.P. Labuan,0,0,0
2021-09-01,URY,Johor,0,0,0
2021-09-01,URY,Kedah,0,0,0
2021-09-01,URY,Kelantan,0,0,0
2021-09-01,URY,Perak,0,0,0
2021-09-01,URY,Perlis,0,0,0
2021-09-01,URY,Pulau Pinang,0,0,0
2021-09-01,URY,Sabah,0,0,0
2021-09-01,URY,Sarawak,0,0,0
2021-09-01,URY,Selangor,1,0,1
2021-09-01,URY,W.P. Labuan,0,0,0
2021-09-01,USA,Johor,0,0,0
2021-09-01,USA,Kedah,0,0,0
2021-09-01,USA,Kelantan,0,0,0
2021-09-01,USA,Melaka,0,0,0
2021-09-01,USA,Negeri Sembilan,0,0,0
2021-09-01,USA,Pahang,0,0,0
2021-09-01,USA,Perak,0,0,0
2021-09-01,USA,Perlis,0,0,0
2021-09-01,USA,Pulau Pinang,11,6,5
2021-09-01,USA,Sabah,1,1,0
2021-09-01,USA,Sarawak,0,0,0
2021-09-01,USA,Selangor,226,143,83
2021-09-01,USA,Terengganu,0,0,0
2021-09-01,USA,W.P. Labuan,0,0,0
2021-09-01,UZB,Johor,0,0,0
2021-09-01,UZB,Kedah,0,0,0
2021-09-01,UZB,Kelantan,0,0,0
2021-09-01,UZB,Perak,0,0,0
2021-09-01,UZB,Perlis,0,0,0
2021-09-01,UZB,Pulau Pinang,0,0,0
2021-09-01,UZB,Sabah,0,0,0
2021-09-01,UZB,Sarawak,0,0,0
2021-09-01,UZB,Selangor,12,8,4
2021-09-01,VAT,Johor,0,0,0
2021-09-01,VAT,Sarawak,0,0,0
2021-09-01,VAT,Selangor,0,0,0
2021-09-01,VCT,Johor,0,0,0
2021-09-01,VCT,Kedah,0,0,0
2021-09-01,VCT,Pulau Pinang,0,0,0
2021-09-01,VCT,Sarawak,0,0,0
2021-09-01,VCT,Selangor,0,0,0
2021-09-01,VEN,Johor,0,0,0
2021-09-01,VEN,Kedah,0,0,0
2021-09-01,VEN,Kelantan,0,0,0
2021-09-01,VEN,Melaka,0,0,0
2021-09-01,VEN,Perak,0,0,0
2021-09-01,VEN,Perlis,0,0,0
2021-09-01,VEN,Pulau Pinang,0,0,0
2021-09-01,VEN,Sabah,0,0,0
2021-09-01,VEN,Sarawak,0,0,0
2021-09-01,VEN,Selangor,5,3,2
2021-09-01,VEN,W.P. Labuan,0,0,0
2021-09-01,VNM,Johor,1,0,1
2021-09-01,VNM,Kedah,0,0,0
2021-09-01,VNM,Kelantan,0,0,0
2021-09-01,VNM,Melaka,0,0,0
2021-09-01,VNM,Negeri Sembilan,0,0,0
2021-09-01,VNM,Pahang,0,0,0
2021-09-01,VNM,Perak,0,0,0
2021-09-01,VNM,Perlis,0,0,0
2021-09-01,VNM,Pulau Pinang,0,0,0
2021-09-01,VNM,Sabah,0,0,0
2021-09-01,VNM,Sarawak,0,0,0
2021-09-01,VNM,Selangor,57,22,35
2021-09-01,VNM,Terengganu,0,0,0
2021-09-01,VNM,W.P. Labuan,0,0,0
2021-09-01,VUT,Johor,0,0,0
2021-09-01,VUT,Kedah,0,0,0
2021-09-01,VUT,Pulau Pinang,0,0,0
2021-09-01,VUT,Sabah,0,0,0
2021-09-01,VUT,Sarawak,0,0,0
2021-09-01,VUT,Selangor,1,1,0
2021-09-01,WSM,Johor,0,0,0
2021-09-01,WSM,Sarawak,0,0,0
2021-09-01,WSM,Selangor,0,0,0
2021-09-01,XXX,Johor,0,0,0
2021-09-01,XXX,Kedah,0,0,0
2021-09-01,XXX,Kelantan,0,0,0
2021-09-01,XXX,Melaka,0,0,0
2021-09-01,XXX,Pahang,0,0,0
2021-09-01,XXX,Perak,0,0,0
2021-09-01,XXX,Perlis,0,0,0
2021-09-01,XXX,Pulau Pinang,1,0,1
2021-09-01,XXX,Sabah,0,0,0
2021-09-01,XXX,Sarawak,0,0,0
2021-09-01,XXX,Selangor,18,10,8
2021-09-01,XXX,W.P. Labuan,0,0,0
2021-09-01,YEM,Johor,0,0,0
2021-09-01,YEM,Kedah,0,0,0
2021-09-01,YEM,Kelantan,0,0,0
2021-09-01,YEM,Melaka,0,0,0
2021-09-01,YEM,Pahang,0,0,0
2021-09-01,YEM,Perak,0,0,0
2021-09-01,YEM,Perlis,0,0,0
2021-09-01,YEM,Pulau Pinang,0,0,0
2021-09-01,YEM,Sabah,0,0,0
2021-09-01,YEM,Sarawak,0,0,0
2021-09-01,YEM,Selangor,98,69,29
2021-09-01,YEM,W.P. Labuan,0,0,0
2021-09-01,ZAF,Johor,0,0,0
2021-09-01,ZAF,Kedah,0,0,0
2021-09-01,ZAF,Kelantan,0,0,0
2021-09-01,ZAF,Melaka,0,0,0
2021-09-01,ZAF,Pahang,0,0,0
2021-09-01,ZAF,Perak,0,0,0
2021-09-01,ZAF,Perlis,0,0,0
2021-09-01,ZAF,Pulau Pinang,0,0,0
2021-09-01,ZAF,Sabah,0,0,0
2021-09-01,ZAF,Sarawak,0,0,0
2021-09-01,ZAF,Selangor,61,48,13
2021-09-01,ZAF,Terengganu,0,0,0
2021-09-01,ZAF,W.P. Labuan,0,0,0
2021-09-01,ZAR,Selangor,0,0,0
2021-09-01,ZMB,Johor,0,0,0
2021-09-01,ZMB,Kedah,0,0,0
2021-09-01,ZMB,Perak,0,0,0
2021-09-01,ZMB,Perlis,0,0,0
2021-09-01,ZMB,Pulau Pinang,0,0,0
2021-09-01,ZMB,Sabah,0,0,0
2021-09-01,ZMB,Sarawak,0,0,0
2021-09-01,ZMB,Selangor,9,5,4
2021-09-01,ZWE,Johor,0,0,0
2021-09-01,ZWE,Kedah,0,0,0
2021-09-01,ZWE,Kelantan,0,0,0
2021-09-01,ZWE,Perak,0,0,0
2021-09-01,ZWE,Perlis,0,0,0
2021-09-01,ZWE,Pulau Pinang,0,0,0
2021-09-01,ZWE,Sabah,0,0,0
2021-09-01,ZWE,Sarawak,0,0,0
2021-09-01,ZWE,Selangor,8,3,5
2021-10-01,ABW,Kedah,0,0,0
2021-10-01,ABW,Pulau Pinang,0,0,0
2021-10-01,AFG,Johor,0,0,0
2021-10-01,AFG,Kedah,0,0,0
2021-10-01,AFG,Perlis,0,0,0
2021-10-01,AFG,Pulau Pinang,0,0,0
2021-10-01,AFG,Sarawak,0,0,0
2021-10-01,AFG,Selangor,16,11,5
2021-10-01,AGO,Johor,0,0,0
2021-10-01,AGO,Kedah,0,0,0
2021-10-01,AGO,Sabah,0,0,0
2021-10-01,AGO,Selangor,0,0,0
2021-10-01,AIA,Selangor,0,0,0
2021-10-01,ALB,Johor,0,0,0
2021-10-01,ALB,Kedah,0,0,0
2021-10-01,ALB,Perak,0,0,0
2021-10-01,ALB,Perlis,0,0,0
2021-10-01,ALB,Pulau Pinang,0,0,0
2021-10-01,ALB,Sabah,0,0,0
2021-10-01,ALB,Sarawak,0,0,0
2021-10-01,ALB,Selangor,1,1,0
2021-10-01,AND,Johor,0,0,0
2021-10-01,AND,Kedah,0,0,0
2021-10-01,AND,Perlis,0,0,0
2021-10-01,AND,Pulau Pinang,0,0,0
2021-10-01,AND,Selangor,0,0,0
2021-10-01,ANT,Selangor,0,0,0
2021-10-01,ARE,Johor,0,0,0
2021-10-01,ARE,Kedah,0,0,0
2021-10-01,ARE,Kelantan,0,0,0
2021-10-01,ARE,Perak,0,0,0
2021-10-01,ARE,Perlis,0,0,0
2021-10-01,ARE,Pulau Pinang,0,0,0
2021-10-01,ARE,Sabah,0,0,0
2021-10-01,ARE,Sarawak,0,0,0
2021-10-01,ARE,Selangor,2,2,0
2021-10-01,ARG,Johor,0,0,0
2021-10-01,ARG,Kedah,0,0,0
2021-10-01,ARG,Kelantan,0,0,0
2021-10-01,ARG,Melaka,0,0,0
2021-10-01,ARG,Perak,0,0,0
2021-10-01,ARG,Perlis,0,0,0
2021-10-01,ARG,Pulau Pinang,0,0,0
2021-10-01,ARG,Sabah,0,0,0
2021-10-01,ARG,Sarawak,0,0,0
2021-10-01,ARG,Selangor,12,7,5
2021-10-01,ARG,W.P. Labuan,0,0,0
2021-10-01,ARM,Johor,0,0,0
2021-10-01,ARM,Kedah,0,0,0
2021-10-01,ARM,Kelantan,0,0,0
2021-10-01,ARM,Perak,0,0,0
2021-10-01,ARM,Perlis,0,0,0
2021-10-01,ARM,Pulau Pinang,0,0,0
2021-10-01,ARM,Sabah,0,0,0
2021-10-01,ARM,Sarawak,0,0,0
2021-10-01,ARM,Selangor,0,0,0
2021-10-01,ATA,Selangor,0,0,0
2021-10-01,ATG,Johor,0,0,0
2021-10-01,ATG,Kedah,0,0,0
2021-10-01,ATG,Pulau Pinang,0,0,0
2021-10-01,ATG,Sarawak,0,0,0
2021-10-01,ATG,Selangor,0,0,0
2021-10-01,AUS,Johor,2,2,0
2021-10-01,AUS,Kedah,0,0,0
2021-10-01,AUS,Kelantan,0,0,0
2021-10-01,AUS,Melaka,0,0,0
2021-10-01,AUS,Negeri Sembilan,0,0,0
2021-10-01,AUS,Pahang,0,0,0
2021-10-01,AUS,Perak,0,0,0
2021-10-01,AUS,Perlis,0,0,0
2021-10-01,AUS,Pulau Pinang,4,2,2
2021-10-01,AUS,Sabah,0,0,0
2021-10-01,AUS,Sarawak,2,2,0
2021-10-01,AUS,Selangor,117,79,38
2021-10-01,AUS,Terengganu,0,0,0
2021-10-01,AUS,W.P. Labuan,0,0,0
2021-10-01,AUT,Johor,0,0,0
2021-10-01,AUT,Kedah,0,0,0
2021-10-01,AUT,Kelantan,0,0,0
2021-10-01,AUT,Melaka,0,0,0
2021-10-01,AUT,Negeri Sembilan,0,0,0
2021-10-01,AUT,Pahang,0,0,0
2021-10-01,AUT,Perak,0,0,0
2021-10-01,AUT,Perlis,0,0,0
2021-10-01,AUT,Pulau Pinang,1,0,1
2021-10-01,AUT,Sabah,0,0,0
2021-10-01,AUT,Sarawak,2,2,0
2021-10-01,AUT,Selangor,23,20,3
2021-10-01,AUT,Terengganu,0,0,0
2021-10-01,AUT,W.P. Labuan,0,0,0
2021-10-01,AZE,Johor,0,0,0
2021-10-01,AZE,Kedah,0,0,0
2021-10-01,AZE,Kelantan,0,0,0
2021-10-01,AZE,Melaka,0,0,0
2021-10-01,AZE,Perlis,0,0,0
2021-10-01,AZE,Pulau Pinang,0,0,0
2021-10-01,AZE,Sabah,0,0,0
2021-10-01,AZE,Sarawak,0,0,0
2021-10-01,AZE,Selangor,6,2,4
2021-10-01,AZE,W.P. Labuan,0,0,0
2021-10-01,BDI,Pulau Pinang,0,0,0
2021-10-01,BDI,Sarawak,0,0,0
2021-10-01,BDI,Selangor,0,0,0
2021-10-01,BEL,Johor,0,0,0
2021-10-01,BEL,Kedah,0,0,0
2021-10-01,BEL,Kelantan,0,0,0
2021-10-01,BEL,Melaka,0,0,0
2021-10-01,BEL,Negeri Sembilan,0,0,0
2021-10-01,BEL,Pahang,0,0,0
2021-10-01,BEL,Perak,0,0,0
2021-10-01,BEL,Perlis,0,0,0
2021-10-01,BEL,Pulau Pinang,1,1,0
2021-10-01,BEL,Sabah,0,0,0
2021-10-01,BEL,Sarawak,0,0,0
2021-10-01,BEL,Selangor,21,15,6
2021-10-01,BEL,W.P. Labuan,0,0,0
2021-10-01,BEN,Johor,0,0,0
2021-10-01,BEN,Kedah,0,0,0
2021-10-01,BEN,Perak,0,0,0
2021-10-01,BEN,Pulau Pinang,0,0,0
2021-10-01,BEN,Sabah,0,0,0
2021-10-01,BEN,Sarawak,0,0,0
2021-10-01,BEN,Selangor,0,0,0
2021-10-01,BFA,Perak,0,0,0
2021-10-01,BFA,Pulau Pinang,0,0,0
2021-10-01,BFA,Selangor,0,0,0
2021-10-01,BGD,Johor,1,1,0
2021-10-01,BGD,Kedah,0,0,0
2021-10-01,BGD,Kelantan,0,0,0
2021-10-01,BGD,Melaka,0,0,0
2021-10-01,BGD,Negeri Sembilan,0,0,0
2021-10-01,BGD,Pahang,0,0,0
2021-10-01,BGD,Perak,0,0,0
2021-10-01,BGD,Perlis,0,0,0
2021-10-01,BGD,Pulau Pinang,1,1,0
2021-10-01,BGD,Sabah,0,0,0
2021-10-01,BGD,Sarawak,0,0,0
2021-10-01,BGD,Selangor,215,153,62
2021-10-01,BGD,W.P. Labuan,0,0,0
2021-10-01,BGR,Johor,0,0,0
2021-10-01,BGR,Kedah,0,0,0
2021-10-01,BGR,Kelantan,0,0,0
2021-10-01,BGR,Pahang,0,0,0
2021-10-01,BGR,Perak,0,0,0
2021-10-01,BGR,Perlis,0,0,0
2021-10-01,BGR,Pulau Pinang,0,0,0
2021-10-01,BGR,Sabah,0,0,0
2021-10-01,BGR,Sarawak,0,0,0
2021-10-01,BGR,Selangor,18,15,3
2021-10-01,BGR,W.P. Labuan,0,0,0
2021-10-01,BHR,Johor,0,0,0
2021-10-01,BHR,Kedah,0,0,0
2021-10-01,BHR,Kelantan,0,0,0
2021-10-01,BHR,Perlis,0,0,0
2021-10-01,BHR,Pulau Pinang,0,0,0
2021-10-01,BHR,Sabah,0,0,0
2021-10-01,BHR,Sarawak,0,0,0
2021-10-01,BHR,Selangor,7,5,2
2021-10-01,BHS,Johor,0,0,0
2021-10-01,BHS,Kedah,0,0,0
2021-10-01,BHS,Perak,0,0,0
2021-10-01,BHS,Sabah,0,0,0
2021-10-01,BHS,Sarawak,0,0,0
2021-10-01,BHS,Selangor,0,0,0
2021-10-01,BIH,Johor,0,0,0
2021-10-01,BIH,Kedah,0,0,0
2021-10-01,BIH,Perlis,0,0,0
2021-10-01,BIH,Pulau Pinang,0,0,0
2021-10-01,BIH,Sabah,0,0,0
2021-10-01,BIH,Sarawak,1,1,0
2021-10-01,BIH,Selangor,6,3,3
2021-10-01,BLR,Johor,0,0,0
2021-10-01,BLR,Kedah,0,0,0
2021-10-01,BLR,Kelantan,0,0,0
2021-10-01,BLR,Pahang,0,0,0
2021-10-01,BLR,Perak,0,0,0
2021-10-01,BLR,Perlis,0,0,0
2021-10-01,BLR,Pulau Pinang,0,0,0
2021-10-01,BLR,Sabah,0,0,0
2021-10-01,BLR,Sarawak,0,0,0
2021-10-01,BLR,Selangor,3,1,2
2021-10-01,BLR,W.P. Labuan,0,0,0
2021-10-01,BLZ,Johor,0,0,0
2021-10-01,BLZ,Pulau Pinang,0,0,0
2021-10-01,BLZ,Sarawak,0,0,0
2021-10-01,BLZ,Selangor,0,0,0
2021-10-01,BMU,Selangor,0,0,0
2021-10-01,BOL,Johor,0,0,0
2021-10-01,BOL,Kedah,0,0,0
2021-10-01,BOL,Melaka,0,0,0
2021-10-01,BOL,Perak,0,0,0
2021-10-01,BOL,Perlis,0,0,0
2021-10-01,BOL,Pulau Pinang,0,0,0
2021-10-01,BOL,Sabah,0,0,0
2021-10-01,BOL,Sarawak,0,0,0
2021-10-01,BOL,Selangor,1,1,0
2021-10-01,BRA,Johor,0,0,0
2021-10-01,BRA,Kedah,1,0,1
2021-10-01,BRA,Kelantan,0,0,0
2021-10-01,BRA,Melaka,0,0,0
2021-10-01,BRA,Pahang,0,0,0
2021-10-01,BRA,Perak,0,0,0
2021-10-01,BRA,Perlis,0,0,0
2021-10-01,BRA,Pulau Pinang,0,0,0
2021-10-01,BRA,Sabah,0,0,0
2021-10-01,BRA,Sarawak,0,0,0
2021-10-01,BRA,Selangor,28,19,9
2021-10-01,BRA,W.P. Labuan,0,0,0
2021-10-01,BRB,Johor,0,0,0
2021-10-01,BRB,Kedah,0,0,0
2021-10-01,BRB,Perlis,0,0,0
2021-10-01,BRB,Pulau Pinang,0,0,0
2021-10-01,BRB,Selangor,0,0,0
2021-10-01,BRN,Johor,0,0,0
2021-10-01,BRN,Kedah,0,0,0
2021-10-01,BRN,Kelantan,0,0,0
2021-10-01,BRN,Melaka,0,0,0
2021-10-01,BRN,Pahang,0,0,0
2021-10-01,BRN,Perak,0,0,0
2021-10-01,BRN,Perlis,0,0,0
2021-10-01,BRN,Pulau Pinang,0,0,0
2021-10-01,BRN,Sabah,0,0,0
2021-10-01,BRN,Sarawak,210,208,2
2021-10-01,BRN,Selangor,27,15,12
2021-10-01,BRN,W.P. Labuan,0,0,0
2021-10-01,BTN,Johor,0,0,0
2021-10-01,BTN,Kedah,0,0,0
2021-10-01,BTN,Perak,0,0,0
2021-10-01,BTN,Perlis,0,0,0
2021-10-01,BTN,Pulau Pinang,0,0,0
2021-10-01,BTN,Sabah,0,0,0
2021-10-01,BTN,Sarawak,0,0,0
2021-10-01,BTN,Selangor,0,0,0
2021-10-01,BWA,Johor,0,0,0
2021-10-01,BWA,Kedah,0,0,0
2021-10-01,BWA,Perlis,0,0,0
2021-10-01,BWA,Pulau Pinang,0,0,0
2021-10-01,BWA,Sabah,0,0,0
2021-10-01,BWA,Sarawak,0,0,0
2021-10-01,BWA,Selangor,5,3,2
2021-10-01,CAF,Kedah,0,0,0
2021-10-01,CAF,Selangor,0,0,0
2021-10-01,CAN,Johor,0,0,0
2021-10-01,CAN,Kedah,0,0,0
2021-10-01,CAN,Kelantan,0,0,0
2021-10-01,CAN,Melaka,0,0,0
2021-10-01,CAN,Negeri Sembilan,0,0,0
2021-10-01,CAN,Pahang,0,0,0
2021-10-01,CAN,Perak,0,0,0
2021-10-01,CAN,Perlis,0,0,0
2021-10-01,CAN,Pulau Pinang,0,0,0
2021-10-01,CAN,Sabah,0,0,0
2021-10-01,CAN,Sarawak,0,0,0
2021-10-01,CAN,Selangor,68,50,18
2021-10-01,CAN,Terengganu,0,0,0
2021-10-01,CAN,W.P. Labuan,0,0,0
2021-10-01,CCK,Selangor,0,0,0
2021-10-01,CHE,Johor,0,0,0
2021-10-01,CHE,Kedah,0,0,0
2021-10-01,CHE,Kelantan,0,0,0
2021-10-01,CHE,Melaka,0,0,0
2021-10-01,CHE,Negeri Sembilan,0,0,0
2021-10-01,CHE,Pahang,0,0,0
2021-10-01,CHE,Perak,0,0,0
2021-10-01,CHE,Perlis,0,0,0
2021-10-01,CHE,Pulau Pinang,2,1,1
2021-10-01,CHE,Sabah,0,0,0
2021-10-01,CHE,Sarawak,0,0,0
2021-10-01,CHE,Selangor,41,26,15
2021-10-01,CHE,W.P. Labuan,0,0,0
2021-10-01,CHL,Johor,0,0,0
2021-10-01,CHL,Kedah,0,0,0
2021-10-01,CHL,Kelantan,0,0,0
2021-10-01,CHL,Melaka,0,0,0
2021-10-01,CHL,Pahang,0,0,0
2021-10-01,CHL,Perak,0,0,0
2021-10-01,CHL,Perlis,0,0,0
2021-10-01,CHL,Pulau Pinang,0,0,0
2021-10-01,CHL,Sabah,0,0,0
2021-10-01,CHL,Sarawak,0,0,0
2021-10-01,CHL,Selangor,15,9,6
2021-10-01,CHN,Johor,15,13,2
2021-10-01,CHN,Kedah,0,0,0
2021-10-01,CHN,Kelantan,0,0,0
2021-10-01,CHN,Melaka,0,0,0
2021-10-01,CHN,Pahang,0,0,0
2021-10-01,CHN,Perak,0,0,0
2021-10-01,CHN,Perlis,0,0,0
2021-10-01,CHN,Pulau Pinang,5,4,1
2021-10-01,CHN,Sabah,4,3,1
2021-10-01,CHN,Sarawak,31,28,3
2021-10-01,CHN,Selangor,1141,880,261
2021-10-01,CHN,Terengganu,0,0,0
2021-10-01,CHN,W.P. Labuan,0,0,0
2021-10-01,CIV,Johor,0,0,0
2021-10-01,CIV,Kedah,0,0,0
2021-10-01,CIV,Pulau Pinang,0,0,0
2021-10-01,CIV,Sabah,0,0,0
2021-10-01,CIV,Sarawak,0,0,0
2021-10-01,CIV,Selangor,1,0,1
2021-10-01,CMR,Johor,0,0,0
2021-10-01,CMR,Kedah,0,0,0
2021-10-01,CMR,Pulau Pinang,0,0,0
2021-10-01,CMR,Sabah,0,0,0
2021-10-01,CMR,Sarawak,0,0,0
2021-10-01,CMR,Selangor,5,3,2
2021-10-01,COD,Johor,0,0,0
2021-10-01,COD,Pulau Pinang,0,0,0
2021-10-01,COD,Sarawak,0,0,0
2021-10-01,COD,Selangor,6,3,3
2021-10-01,COG,Johor,0,0,0
2021-10-01,COG,Kedah,0,0,0
2021-10-01,COG,Selangor,1,1,0
2021-10-01,COK,Selangor,0,0,0
2021-10-01,COL,Johor,0,0,0
2021-10-01,COL,Kedah,0,0,0
2021-10-01,COL,Perak,0,0,0
2021-10-01,COL,Pulau Pinang,1,0,1
2021-10-01,COL,Sabah,0,0,0
2021-10-01,COL,Sarawak,0,0,0
2021-10-01,COL,Selangor,6,4,2
2021-10-01,COL,W.P. Labuan,0,0,0
2021-10-01,COM,Johor,0,0,0
2021-10-01,COM,Kedah,0,0,0
2021-10-01,COM,Selangor,2,2,0
2021-10-01,CPV,Johor,0,0,0
2021-10-01,CPV,Kedah,0,0,0
2021-10-01,CPV,Pulau Pinang,0,0,0
2021-10-01,CPV,Sabah,0,0,0
2021-10-01,CPV,Selangor,0,0,0
2021-10-01,CRI,Johor,0,0,0
2021-10-01,CRI,Kedah,0,0,0
2021-10-01,CRI,Perak,0,0,0
2021-10-01,CRI,Perlis,0,0,0
2021-10-01,CRI,Pulau Pinang,0,0,0
2021-10-01,CRI,Sabah,0,0,0
2021-10-01,CRI,Sarawak,0,0,0
2021-10-01,CRI,Selangor,2,1,1
2021-10-01,CUB,Johor,0,0,0
2021-10-01,CUB,Kedah,0,0,0
2021-10-01,CUB,Perlis,0,0,0
2021-10-01,CUB,Pulau Pinang,0,0,0
2021-10-01,CUB,Sabah,0,0,0
2021-10-01,CUB,Sarawak,0,0,0
2021-10-01,CUB,Selangor,0,0,0
2021-10-01,CYP,Johor,0,0,0
2021-10-01,CYP,Kedah,0,0,0
2021-10-01,CYP,Perak,0,0,0
2021-10-01,CYP,Perlis,0,0,0
2021-10-01,CYP,Pulau Pinang,0,0,0
2021-10-01,CYP,Sabah,0,0,0
2021-10-01,CYP,Sarawak,0,0,0
2021-10-01,CYP,Selangor,0,0,0
2021-10-01,CZE,Johor,0,0,0
2021-10-01,CZE,Kedah,0,0,0
2021-10-01,CZE,Kelantan,0,0,0
2021-10-01,CZE,Melaka,0,0,0
2021-10-01,CZE,Negeri Sembilan,0,0,0
2021-10-01,CZE,Perak,0,0,0
2021-10-01,CZE,Perlis,0,0,0
2021-10-01,CZE,Pulau Pinang,0,0,0
2021-10-01,CZE,Sabah,0,0,0
2021-10-01,CZE,Sarawak,0,0,0
2021-10-01,CZE,Selangor,4,4,0
2021-10-01,CZE,W.P. Labuan,0,0,0
2021-10-01,DEU,Johor,1,1,0
2021-10-01,DEU,Kedah,0,0,0
2021-10-01,DEU,Kelantan,0,0,0
2021-10-01,DEU,Melaka,0,0,0
2021-10-01,DEU,Negeri Sembilan,0,0,0
2021-10-01,DEU,Pahang,0,0,0
2021-10-01,DEU,Perak,0,0,0
2021-10-01,DEU,Perlis,0,0,0
2021-10-01,DEU,Pulau Pinang,6,4,2
2021-10-01,DEU,Sabah,0,0,0
2021-10-01,DEU,Sarawak,2,2,0
2021-10-01,DEU,Selangor,122,100,22
2021-10-01,DEU,Terengganu,0,0,0
2021-10-01,DEU,W.P. Labuan,0,0,0
2021-10-01,DJI,Johor,0,0,0
2021-10-01,DJI,Selangor,2,0,2
2021-10-01,DMA,Johor,0,0,0
2021-10-01,DMA,Kedah,0,0,0
2021-10-01,DMA,Pulau Pinang,0,0,0
2021-10-01,DMA,Sabah,0,0,0
2021-10-01,DMA,Sarawak,0,0,0
2021-10-01,DMA,Selangor,0,0,0
2021-10-01,DMA,W.P. Labuan,0,0,0
2021-10-01,DNK,Johor,0,0,0
2021-10-01,DNK,Kedah,0,0,0
2021-10-01,DNK,Kelantan,0,0,0
2021-10-01,DNK,Melaka,0,0,0
2021-10-01,DNK,Negeri Sembilan,0,0,0
2021-10-01,DNK,Pahang,0,0,0
2021-10-01,DNK,Perak,0,0,0
2021-10-01,DNK,Perlis,0,0,0
2021-10-01,DNK,Pulau Pinang,2,2,0
2021-10-01,DNK,Sabah,0,0,0
2021-10-01,DNK,Sarawak,0,0,0
2021-10-01,DNK,Selangor,28,19,9
2021-10-01,DNK,W.P. Labuan,0,0,0
2021-10-01,DOM,Johor,0,0,0
2021-10-01,DOM,Kedah,0,0,0
2021-10-01,DOM,Perak,0,0,0
2021-10-01,DOM,Perlis,0,0,0
2021-10-01,DOM,Pulau Pinang,0,0,0
2021-10-01,DOM,Sabah,0,0,0
2021-10-01,DOM,Sarawak,0,0,0
2021-10-01,DOM,Selangor,0,0,0
2021-10-01,DZA,Johor,0,0,0
2021-10-01,DZA,Kedah,0,0,0
2021-10-01,DZA,Kelantan,0,0,0
2021-10-01,DZA,Melaka,0,0,0
2021-10-01,DZA,Perak,0,0,0
2021-10-01,DZA,Perlis,0,0,0
2021-10-01,DZA,Pulau Pinang,0,0,0
2021-10-01,DZA,Sabah,0,0,0
2021-10-01,DZA,Sarawak,0,0,0
2021-10-01,DZA,Selangor,11,9,2
2021-10-01,DZA,W.P. Labuan,0,0,0
2021-10-01,ECU,Johor,0,0,0
2021-10-01,ECU,Kedah,0,0,0
2021-10-01,ECU,Perak,0,0,0
2021-10-01,ECU,Perlis,0,0,0
2021-10-01,ECU,Pulau Pinang,0,0,0
2021-10-01,ECU,Sabah,0,0,0
2021-10-01,ECU,Sarawak,0,0,0
2021-10-01,ECU,Selangor,1,1,0
2021-10-01,EGY,Johor,1,1,0
2021-10-01,EGY,Kedah,0,0,0
2021-10-01,EGY,Kelantan,0,0,0
2021-10-01,EGY,Melaka,0,0,0
2021-10-01,EGY,Pahang,0,0,0
2021-10-01,EGY,Perak,0,0,0
2021-10-01,EGY,Perlis,0,0,0
2021-10-01,EGY,Pulau Pinang,0,0,0
2021-10-01,EGY,Sabah,0,0,0
2021-10-01,EGY,Sarawak,0,0,0
2021-10-01,EGY,Selangor,164,124,40
2021-10-01,EGY,Terengganu,0,0,0
2021-10-01,EGY,W.P. Labuan,0,0,0
2021-10-01,ERI,Johor,0,0,0
2021-10-01,ERI,Pulau Pinang,0,0,0
2021-10-01,ERI,Sabah,0,0,0
2021-10-01,ERI,Selangor,2,1,1
2021-10-01,ESP,Johor,0,0,0
2021-10-01,ESP,Kedah,0,0,0
2021-10-01,ESP,Kelantan,0,0,0
2021-10-01,ESP,Melaka,0,0,0
2021-10-01,ESP,Negeri Sembilan,0,0,0
2021-10-01,ESP,Pahang,0,0,0
2021-10-01,ESP,Perak,0,0,0
2021-10-01,ESP,Perlis,0,0,0
2021-10-01,ESP,Pulau Pinang,0,0,0
2021-10-01,ESP,Sabah,0,0,0
2021-10-01,ESP,Sarawak,0,0,0
2021-10-01,ESP,Selangor,19,13,6
2021-10-01,ESP,W.P. Labuan,0,0,0
2021-10-01,EST,Johor,0,0,0
2021-10-01,EST,Kedah,0,0,0
2021-10-01,EST,Kelantan,0,0,0
2021-10-01,EST,Pahang,0,0,0
2021-10-01,EST,Perak,0,0,0
2021-10-01,EST,Perlis,0,0,0
2021-10-01,EST,Pulau Pinang,0,0,0
2021-10-01,EST,Sabah,0,0,0
2021-10-01,EST,Sarawak,0,0,0
2021-10-01,EST,Selangor,1,1,0
2021-10-01,EST,W.P. Labuan,0,0,0
2021-10-01,ETH,Johor,0,0,0
2021-10-01,ETH,Kedah,0,0,0
2021-10-01,ETH,Pulau Pinang,0,0,0
2021-10-01,ETH,Sarawak,0,0,0
2021-10-01,ETH,Selangor,4,2,2
2021-10-01,FIN,Johor,0,0,0
2021-10-01,FIN,Kedah,0,0,0
2021-10-01,FIN,Kelantan,0,0,0
2021-10-01,FIN,Melaka,0,0,0
2021-10-01,FIN,Negeri Sembilan,0,0,0
2021-10-01,FIN,Pahang,0,0,0
2021-10-01,FIN,Perak,0,0,0
2021-10-01,FIN,Perlis,0,0,0
2021-10-01,FIN,Pulau Pinang,0,0,0
2021-10-01,FIN,Sabah,0,0,0
2021-10-01,FIN,Sarawak,0,0,0
2021-10-01,FIN,Selangor,12,7,5
2021-10-01,FIN,W.P. Labuan,0,0,0
2021-10-01,FJI,Johor,0,0,0
2021-10-01,FJI,Kedah,0,0,0
2021-10-01,FJI,Kelantan,0,0,0
2021-10-01,FJI,Perak,0,0,0
2021-10-01,FJI,Perlis,0,0,0
2021-10-01,FJI,Pulau Pinang,0,0,0
2021-10-01,FJI,Sabah,0,0,0
2021-10-01,FJI,Sarawak,0,0,0
2021-10-01,FJI,Selangor,0,0,0
2021-10-01,FRA,Johor,0,0,0
2021-10-01,FRA,Kedah,0,0,0
2021-10-01,FRA,Kelantan,0,0,0
2021-10-01,FRA,Melaka,0,0,0
2021-10-01,FRA,Negeri Sembilan,0,0,0
2021-10-01,FRA,Pahang,0,0,0
2021-10-01,FRA,Perak,0,0,0
2021-10-01,FRA,Perlis,0,0,0
2021-10-01,FRA,Pulau Pinang,5,3,2
2021-10-01,FRA,Sabah,0,0,0
2021-10-01,FRA,Sarawak,0,0,0
2021-10-01,FRA,Selangor,180,120,60
2021-10-01,FRA,Terengganu,0,0,0
2021-10-01,FRA,W.P. Labuan,0,0,0
2021-10-01,FSM,Johor,0,0,0
2021-10-01,FSM,Pulau Pinang,0,0,0
2021-10-01,FSM,Selangor,0,0,0
2021-10-01,GAB,Johor,0,0,0
2021-10-01,GAB,Pulau Pinang,0,0,0
2021-10-01,GAB,Sarawak,0,0,0
2021-10-01,GAB,Selangor,1,1,0
2021-10-01,GBR,Johor,0,0,0
2021-10-01,GBR,Kedah,1,0,1
2021-10-01,GBR,Kelantan,0,0,0
2021-10-01,GBR,Melaka,0,0,0
2021-10-01,GBR,Negeri Sembilan,0,0,0
2021-10-01,GBR,Pahang,0,0,0
2021-10-01,GBR,Perak,1,0,1
2021-10-01,GBR,Perlis,0,0,0
2021-10-01,GBR,Pulau Pinang,17,9,8
2021-10-01,GBR,Sabah,0,0,0
2021-10-01,GBR,Sarawak,3,2,1
2021-10-01,GBR,Selangor,350,242,108
2021-10-01,GBR,Terengganu,0,0,0
2021-10-01,GBR,W.P. Labuan,0,0,0
2021-10-01,GEO,Johor,0,0,0
2021-10-01,GEO,Kedah,0,0,0
2021-10-01,GEO,Melaka,0,0,0
2021-10-01,GEO,Perak,0,0,0
2021-10-01,GEO,Perlis,0,0,0
2021-10-01,GEO,Pulau Pinang,0,0,0
2021-10-01,GEO,Sabah,0,0,0
2021-10-01,GEO,Sarawak,0,0,0
2021-10-01,GEO,Selangor,2,1,1
2021-10-01,GHA,Johor,0,0,0
2021-10-01,GHA,Kedah,0,0,0
2021-10-01,GHA,Kelantan,0,0,0
2021-10-01,GHA,Pulau Pinang,0,0,0
2021-10-01,GHA,Sabah,0,0,0
2021-10-01,GHA,Sarawak,0,0,0
2021-10-01,GHA,Selangor,6,3,3
2021-10-01,GIB,Johor,0,0,0
2021-10-01,GIB,Sarawak,0,0,0
2021-10-01,GIN,Johor,0,0,0
2021-10-01,GIN,Kedah,0,0,0
2021-10-01,GIN,Kelantan,0,0,0
2021-10-01,GIN,Perlis,0,0,0
2021-10-01,GIN,Pulau Pinang,0,0,0
2021-10-01,GIN,Sabah,0,0,0
2021-10-01,GIN,Sarawak,0,0,0
2021-10-01,GIN,Selangor,10,7,3
2021-10-01,GLP,Selangor,0,0,0
2021-10-01,GMB,Johor,0,0,0
2021-10-01,GMB,Kedah,0,0,0
2021-10-01,GMB,Kelantan,0,0,0
2021-10-01,GMB,Pulau Pinang,0,0,0
2021-10-01,GMB,Sabah,0,0,0
2021-10-01,GMB,Sarawak,0,0,0
2021-10-01,GMB,Selangor,1,1,0
2021-10-01,GNB,Johor,0,0,0
2021-10-01,GNB,Selangor,0,0,0
2021-10-01,GNQ,Johor,0,0,0
2021-10-01,GNQ,Selangor,0,0,0
2021-10-01,GRC,Johor,0,0,0
2021-10-01,GRC,Kedah,0,0,0
2021-10-01,GRC,Kelantan,0,0,0
2021-10-01,GRC,Melaka,0,0,0
2021-10-01,GRC,Negeri Sembilan,0,0,0
2021-10-01,GRC,Pahang,0,0,0
2021-10-01,GRC,Perak,0,0,0
2021-10-01,GRC,Perlis,0,0,0
2021-10-01,GRC,Pulau Pinang,0,0,0
2021-10-01,GRC,Sabah,0,0,0
2021-10-01,GRC,Sarawak,0,0,0
2021-10-01,GRC,Selangor,9,7,2
2021-10-01,GRD,Johor,0,0,0
2021-10-01,GRD,Kedah,0,0,0
2021-10-01,GRD,Pulau Pinang,0,0,0
2021-10-01,GRD,Sabah,0,0,0
2021-10-01,GRD,Sarawak,0,0,0
2021-10-01,GRD,Selangor,3,1,2
2021-10-01,GRL,Johor,0,0,0
2021-10-01,GRL,Selangor,0,0,0
2021-10-01,GTM,Johor,0,0,0
2021-10-01,GTM,Kedah,0,0,0
2021-10-01,GTM,Pahang,0,0,0
2021-10-01,GTM,Perak,0,0,0
2021-10-01,GTM,Pulau Pinang,0,0,0
2021-10-01,GTM,Sabah,0,0,0
2021-10-01,GTM,Sarawak,0,0,0
2021-10-01,GTM,Selangor,2,2,0
2021-10-01,GTM,W.P. Labuan,0,0,0
2021-10-01,GUY,Johor,0,0,0
2021-10-01,GUY,Kedah,0,0,0
2021-10-01,GUY,Pulau Pinang,0,0,0
2021-10-01,GUY,Sarawak,0,0,0
2021-10-01,GUY,Selangor,0,0,0
2021-10-01,HKG,Johor,0,0,0
2021-10-01,HKG,Kedah,0,0,0
2021-10-01,HKG,Kelantan,0,0,0
2021-10-01,HKG,Pahang,0,0,0
2021-10-01,HKG,Perak,0,0,0
2021-10-01,HKG,Perlis,0,0,0
2021-10-01,HKG,Pulau Pinang,1,0,1
2021-10-01,HKG,Sabah,0,0,0
2021-10-01,HKG,Sarawak,49,47,2
2021-10-01,HKG,Selangor,0,0,0
2021-10-01,HKG,Terengganu,0,0,0
2021-10-01,HMD,Johor,0,0,0
2021-10-01,HND,Johor,0,0,0
2021-10-01,HND,Kedah,0,0,0
2021-10-01,HND,Perak,0,0,0
2021-10-01,HND,Pulau Pinang,0,0,0
2021-10-01,HND,Sabah,0,0,0
2021-10-01,HND,Sarawak,0,0,0
2021-10-01,HND,Selangor,2,2,0
2021-10-01,HRV,Johor,0,0,0
2021-10-01,HRV,Kedah,0,0,0
2021-10-01,HRV,Kelantan,0,0,0
2021-10-01,HRV,Melaka,0,0,0
2021-10-01,HRV,Pahang,0,0,0
2021-10-01,HRV,Perak,0,0,0
2021-10-01,HRV,Perlis,0,0,0
2021-10-01,HRV,Pulau Pinang,0,0,0
2021-10-01,HRV,Sabah,0,0,0
2021-10-01,HRV,Sarawak,1,1,0
2021-10-01,HRV,Selangor,10,10,0
2021-10-01,HTI,Johor,0,0,0
2021-10-01,HTI,Kedah,0,0,0
2021-10-01,HTI,Kelantan,0,0,0
2021-10-01,HTI,Perak,0,0,0
2021-10-01,HTI,Pulau Pinang,0,0,0
2021-10-01,HTI,Sabah,0,0,0
2021-10-01,HTI,Selangor,0,0,0
2021-10-01,HUN,Johor,0,0,0
2021-10-01,HUN,Kedah,0,0,0
2021-10-01,HUN,Kelantan,0,0,0
2021-10-01,HUN,Pahang,0,0,0
2021-10-01,HUN,Perak,0,0,0
2021-10-01,HUN,Perlis,0,0,0
2021-10-01,HUN,Pulau Pinang,0,0,0
2021-10-01,HUN,Sabah,0,0,0
2021-10-01,HUN,Sarawak,0,0,0
2021-10-01,HUN,Selangor,8,3,5
2021-10-01,HUN,W.P. Labuan,0,0,0
2021-10-01,IDN,Johor,73,56,17
2021-10-01,IDN,Kedah,4,4,0
2021-10-01,IDN,Kelantan,0,0,0
2021-10-01,IDN,Melaka,0,0,0
2021-10-01,IDN,Negeri Sembilan,0,0,0
2021-10-01,IDN,Pahang,0,0,0
2021-10-01,IDN,Perak,2,0,2
2021-10-01,IDN,Perlis,8,8,0
2021-10-01,IDN,Pulau Pinang,36,14,22
2021-10-01,IDN,Sabah,1,0,1
2021-10-01,IDN,Sarawak,149,146,3
2021-10-01,IDN,Selangor,1241,658,583
2021-10-01,IDN,Terengganu,0,0,0
2021-10-01,IDN,W.P. Labuan,0,0,0
2021-10-01,IND,Johor,10,10,0
2021-10-01,IND,Kedah,1,1,0
2021-10-01,IND,Kelantan,0,0,0
2021-10-01,IND,Melaka,0,0,0
2021-10-01,IND,Negeri Sembilan,0,0,0
2021-10-01,IND,Pahang,0,0,0
2021-10-01,IND,Perak,0,0,0
2021-10-01,IND,Perlis,0,0,0
2021-10-01,IND,Pulau Pinang,5,3,2
2021-10-01,IND,Sabah,1,1,0
2021-10-01,IND,Sarawak,2,2,0
2021-10-01,IND,Selangor,926,695,231
2021-10-01,IND,Terengganu,0,0,0
2021-10-01,IND,W.P. Labuan,0,0,0
2021-10-01,IOT,Pulau Pinang,0,0,0
2021-10-01,IOT,Selangor,0,0,0
2021-10-01,IRL,Johor,1,1,0
2021-10-01,IRL,Kedah,0,0,0
2021-10-01,IRL,Kelantan,0,0,0
2021-10-01,IRL,Negeri Sembilan,0,0,0
2021-10-01,IRL,Pahang,0,0,0
2021-10-01,IRL,Perak,0,0,0
2021-10-01,IRL,Perlis,0,0,0
2021-10-01,IRL,Pulau Pinang,2,2,0
2021-10-01,IRL,Sabah,0,0,0
2021-10-01,IRL,Sarawak,0,0,0
2021-10-01,IRL,Selangor,17,11,6
2021-10-01,IRL,Terengganu,0,0,0
2021-10-01,IRL,W.P. Labuan,0,0,0
2021-10-01,IRN,Johor,0,0,0
2021-10-01,IRN,Kedah,0,0,0
2021-10-01,IRN,Kelantan,0,0,0
2021-10-01,IRN,Perak,0,0,0
2021-10-01,IRN,Perlis,0,0,0
2021-10-01,IRN,Pulau Pinang,0,0,0
2021-10-01,IRN,Sabah,0,0,0
2021-10-01,IRN,Sarawak,0,0,0
2021-10-01,IRN,Selangor,92,47,45
2021-10-01,IRN,W.P. Labuan,0,0,0
2021-10-01,IRQ,Johor,0,0,0
2021-10-01,IRQ,Kedah,0,0,0
2021-10-01,IRQ,Kelantan,0,0,0
2021-10-01,IRQ,Melaka,0,0,0
2021-10-01,IRQ,Pahang,0,0,0
2021-10-01,IRQ,Perak,0,0,0
2021-10-01,IRQ,Perlis,0,0,0
2021-10-01,IRQ,Pulau Pinang,0,0,0
2021-10-01,IRQ,Sabah,0,0,0
2021-10-01,IRQ,Sarawak,0,0,0
2021-10-01,IRQ,Selangor,69,49,20
2021-10-01,ISL,Johor,0,0,0
2021-10-01,ISL,Kedah,0,0,0
2021-10-01,ISL,Kelantan,0,0,0
2021-10-01,ISL,Perak,0,0,0
2021-10-01,ISL,Perlis,0,0,0
2021-10-01,ISL,Pulau Pinang,0,0,0
2021-10-01,ISL,Sabah,0,0,0
2021-10-01,ISL,Sarawak,0,0,0
2021-10-01,ISL,Selangor,0,0,0
2021-10-01,ISL,W.P. Labuan,0,0,0
2021-10-01,ISR,Pulau Pinang,0,0,0
2021-10-01,ITA,Johor,0,0,0
2021-10-01,ITA,Kedah,0,0,0
2021-10-01,ITA,Kelantan,0,0,0
2021-10-01,ITA,Melaka,0,0,0
2021-10-01,ITA,Negeri Sembilan,0,0,0
2021-10-01,ITA,Pahang,0,0,0
2021-10-01,ITA,Perak,0,0,0
2021-10-01,ITA,Perlis,0,0,0
2021-10-01,ITA,Pulau Pinang,0,0,0
2021-10-01,ITA,Sabah,0,0,0
2021-10-01,ITA,Sarawak,3,3,0
2021-10-01,ITA,Selangor,78,53,25
2021-10-01,ITA,W.P. Labuan,0,0,0
2021-10-01,JAM,Johor,0,0,0
2021-10-01,JAM,Kedah,0,0,0
2021-10-01,JAM,Perak,0,0,0
2021-10-01,JAM,Pulau Pinang,0,0,0
2021-10-01,JAM,Sabah,0,0,0
2021-10-01,JAM,Sarawak,0,0,0
2021-10-01,JAM,Selangor,1,0,1
2021-10-01,JAM,W.P. Labuan,0,0,0
2021-10-01,JOR,Johor,0,0,0
2021-10-01,JOR,Kedah,0,0,0
2021-10-01,JOR,Kelantan,0,0,0
2021-10-01,JOR,Melaka,0,0,0
2021-10-01,JOR,Perlis,0,0,0
2021-10-01,JOR,Pulau Pinang,0,0,0
2021-10-01,JOR,Sabah,0,0,0
2021-10-01,JOR,Sarawak,0,0,0
2021-10-01,JOR,Selangor,66,43,23
2021-10-01,JOR,W.P. Labuan,0,0,0
2021-10-01,JPN,Johor,0,0,0
2021-10-01,JPN,Kedah,0,0,0
2021-10-01,JPN,Kelantan,0,0,0
2021-10-01,JPN,Melaka,0,0,0
2021-10-01,JPN,Negeri Sembilan,0,0,0
2021-10-01,JPN,Pahang,0,0,0
2021-10-01,JPN,Perak,2,1,1
2021-10-01,JPN,Perlis,0,0,0
2021-10-01,JPN,Pulau Pinang,69,38,31
2021-10-01,JPN,Sabah,0,0,0
2021-10-01,JPN,Sarawak,4,4,0
2021-10-01,JPN,Selangor,834,541,293
2021-10-01,JPN,W.P. Labuan,0,0,0
2021-10-01,KAZ,Johor,0,0,0
2021-10-01,KAZ,Kedah,0,0,0
2021-10-01,KAZ,Kelantan,0,0,0
2021-10-01,KAZ,Melaka,0,0,0
2021-10-01,KAZ,Perak,0,0,0
2021-10-01,KAZ,Perlis,0,0,0
2021-10-01,KAZ,Pulau Pinang,0,0,0
2021-10-01,KAZ,Sabah,0,0,0
2021-10-01,KAZ,Sarawak,0,0,0
2021-10-01,KAZ,Selangor,23,9,14
2021-10-01,KAZ,W.P. Labuan,0,0,0
2021-10-01,KEN,Johor,0,0,0
2021-10-01,KEN,Kedah,0,0,0
2021-10-01,KEN,Kelantan,0,0,0
2021-10-01,KEN,Perak,0,0,0
2021-10-01,KEN,Perlis,0,0,0
2021-10-01,KEN,Pulau Pinang,0,0,0
2021-10-01,KEN,Sabah,0,0,0
2021-10-01,KEN,Sarawak,0,0,0
2021-10-01,KEN,Selangor,15,4,11
2021-10-01,KGZ,Johor,0,0,0
2021-10-01,KGZ,Kedah,0,0,0
2021-10-01,KGZ,Kelantan,0,0,0
2021-10-01,KGZ,Perak,0,0,0
2021-10-01,KGZ,Perlis,0,0,0
2021-10-01,KGZ,Pulau Pinang,0,0,0
2021-10-01,KGZ,Sabah,0,0,0
2021-10-01,KGZ,Sarawak,0,0,0
2021-10-01,KGZ,Selangor,4,1,3
2021-10-01,KHM,Johor,0,0,0
2021-10-01,KHM,Kedah,0,0,0
2021-10-01,KHM,Kelantan,0,0,0
2021-10-01,KHM,Melaka,0,0,0
2021-10-01,KHM,Negeri Sembilan,0,0,0
2021-10-01,KHM,Pahang,0,0,0
2021-10-01,KHM,Perak,0,0,0
2021-10-01,KHM,Perlis,0,0,0
2021-10-01,KHM,Pulau Pinang,0,0,0
2021-10-01,KHM,Sabah,0,0,0
2021-10-01,KHM,Sarawak,0,0,0
2021-10-01,KHM,Selangor,36,34,2
2021-10-01,KHM,W.P. Labuan,0,0,0
2021-10-01,KIR,Johor,0,0,0
2021-10-01,KIR,Sabah,0,0,0
2021-10-01,KIR,Selangor,0,0,0
2021-10-01,KNA,Johor,0,0,0
2021-10-01,KNA,Kedah,0,0,0
2021-10-01,KNA,Perlis,0,0,0
2021-10-01,KNA,Pulau Pinang,0,0,0
2021-10-01,KNA,Sabah,0,0,0
2021-10-01,KNA,Selangor,3,2,1
2021-10-01,KNA,W.P. Labuan,0,0,0
2021-10-01,KOR,Johor,0,0,0
2021-10-01,KOR,Kedah,0,0,0
2021-10-01,KOR,Kelantan,0,0,0
2021-10-01,KOR,Melaka,0,0,0
2021-10-01,KOR,Negeri Sembilan,0,0,0
2021-10-01,KOR,Pahang,0,0,0
2021-10-01,KOR,Perak,0,0,0
2021-10-01,KOR,Perlis,0,0,0
2021-10-01,KOR,Pulau Pinang,11,5,6
2021-10-01,KOR,Sabah,2,2,0
2021-10-01,KOR,Sarawak,36,31,5
2021-10-01,KOR,Selangor,627,423,204
2021-10-01,KOR,Terengganu,0,0,0
2021-10-01,KOR,W.P. Labuan,0,0,0
2021-10-01,KWT,Johor,0,0,0
2021-10-01,KWT,Kedah,0,0,0
2021-10-01,KWT,Kelantan,0,0,0
2021-10-01,KWT,Perak,0,0,0
2021-10-01,KWT,Perlis,0,0,0
2021-10-01,KWT,Pulau Pinang,0,0,0
2021-10-01,KWT,Sabah,0,0,0
2021-10-01,KWT,Sarawak,0,0,0
2021-10-01,KWT,Selangor,9,4,5
2021-10-01,KWT,W.P. Labuan,0,0,0
2021-10-01,LAO,Johor,0,0,0
2021-10-01,LAO,Kedah,0,0,0
2021-10-01,LAO,Kelantan,0,0,0
2021-10-01,LAO,Melaka,0,0,0
2021-10-01,LAO,Perak,0,0,0
2021-10-01,LAO,Perlis,0,0,0
2021-10-01,LAO,Pulau Pinang,0,0,0
2021-10-01,LAO,Sabah,0,0,0
2021-10-01,LAO,Sarawak,0,0,0
2021-10-01,LAO,Selangor,1,0,1
2021-10-01,LAO,W.P. Labuan,0,0,0
2021-10-01,LBN,Johor,0,0,0
2021-10-01,LBN,Kedah,0,0,0
2021-10-01,LBN,Kelantan,0,0,0
2021-10-01,LBN,Pahang,0,0,0
2021-10-01,LBN,Perak,0,0,0
2021-10-01,LBN,Perlis,0,0,0
2021-10-01,LBN,Pulau Pinang,0,0,0
2021-10-01,LBN,Sabah,0,0,0
2021-10-01,LBN,Sarawak,0,0,0
2021-10-01,LBN,Selangor,14,10,4
2021-10-01,LBN,W.P. Labuan,0,0,0
2021-10-01,LBR,Johor,0,0,0
2021-10-01,LBR,Kedah,0,0,0
2021-10-01,LBR,Sabah,0,0,0
2021-10-01,LBR,Sarawak,0,0,0
2021-10-01,LBR,Selangor,2,1,1
2021-10-01,LBY,Johor,0,0,0
2021-10-01,LBY,Kedah,0,0,0
2021-10-01,LBY,Perlis,0,0,0
2021-10-01,LBY,Pulau Pinang,0,0,0
2021-10-01,LBY,Sabah,0,0,0
2021-10-01,LBY,Sarawak,0,0,0
2021-10-01,LBY,Selangor,76,56,20
2021-10-01,LCA,Johor,0,0,0
2021-10-01,LCA,Kedah,0,0,0
2021-10-01,LCA,Pulau Pinang,0,0,0
2021-10-01,LCA,Sarawak,0,0,0
2021-10-01,LCA,Selangor,0,0,0
2021-10-01,LIE,Johor,0,0,0
2021-10-01,LIE,Kedah,0,0,0
2021-10-01,LIE,Perlis,0,0,0
2021-10-01,LIE,Pulau Pinang,0,0,0
2021-10-01,LIE,Sabah,0,0,0
2021-10-01,LIE,Sarawak,0,0,0
2021-10-01,LIE,Selangor,1,1,0
2021-10-01,LKA,Johor,0,0,0
2021-10-01,LKA,Kedah,0,0,0
2021-10-01,LKA,Kelantan,0,0,0
2021-10-01,LKA,Melaka,0,0,0
2021-10-01,LKA,Pahang,0,0,0
2021-10-01,LKA,Perak,0,0,0
2021-10-01,LKA,Perlis,0,0,0
2021-10-01,LKA,Pulau Pinang,1,0,1
2021-10-01,LKA,Sabah,0,0,0
2021-10-01,LKA,Sarawak,0,0,0
2021-10-01,LKA,Selangor,62,39,23
2021-10-01,LKA,W.P. Labuan,0,0,0
2021-10-01,LSO,Johor,0,0,0
2021-10-01,LSO,Kedah,0,0,0
2021-10-01,LSO,Pulau Pinang,0,0,0
2021-10-01,LSO,Sarawak,0,0,0
2021-10-01,LSO,Selangor,0,0,0
2021-10-01,LTU,Johor,0,0,0
2021-10-01,LTU,Kedah,0,0,0
2021-10-01,LTU,Kelantan,0,0,0
2021-10-01,LTU,Pahang,0,0,0
2021-10-01,LTU,Perak,0,0,0
2021-10-01,LTU,Perlis,0,0,0
2021-10-01,LTU,Pulau Pinang,0,0,0
2021-10-01,LTU,Sabah,0,0,0
2021-10-01,LTU,Sarawak,1,1,0
2021-10-01,LTU,Selangor,5,3,2
2021-10-01,LTU,W.P. Labuan,0,0,0
2021-10-01,LUX,Johor,0,0,0
2021-10-01,LUX,Kedah,0,0,0
2021-10-01,LUX,Kelantan,0,0,0
2021-10-01,LUX,Perak,0,0,0
2021-10-01,LUX,Perlis,0,0,0
2021-10-01,LUX,Pulau Pinang,0,0,0
2021-10-01,LUX,Sabah,0,0,0
2021-10-01,LUX,Sarawak,0,0,0
2021-10-01,LUX,Selangor,4,4,0
2021-10-01,LVA,Johor,0,0,0
2021-10-01,LVA,Kedah,0,0,0
2021-10-01,LVA,Kelantan,0,0,0
2021-10-01,LVA,Pahang,0,0,0
2021-10-01,LVA,Perak,0,0,0
2021-10-01,LVA,Perlis,0,0,0
2021-10-01,LVA,Pulau Pinang,0,0,0
2021-10-01,LVA,Sabah,0,0,0
2021-10-01,LVA,Sarawak,0,0,0
2021-10-01,LVA,Selangor,1,1,0
2021-10-01,LVA,W.P. Labuan,0,0,0
2021-10-01,MAC,Johor,0,0,0
2021-10-01,MAC,Pahang,0,0,0
2021-10-01,MAC,Perak,0,0,0
2021-10-01,MAC,Selangor,0,0,0
2021-10-01,MAC,W.P. Labuan,0,0,0
2021-10-01,MAR,Johor,0,0,0
2021-10-01,MAR,Kedah,0,0,0
2021-10-01,MAR,Kelantan,0,0,0
2021-10-01,MAR,Melaka,0,0,0
2021-10-01,MAR,Pahang,0,0,0
2021-10-01,MAR,Perak,0,0,0
2021-10-01,MAR,Perlis,0,0,0
2021-10-01,MAR,Pulau Pinang,0,0,0
2021-10-01,MAR,Sabah,0,0,0
2021-10-01,MAR,Sarawak,0,0,0
2021-10-01,MAR,Selangor,8,2,6
2021-10-01,MAR,W.P. Labuan,0,0,0
2021-10-01,MCO,Johor,0,0,0
2021-10-01,MCO,Kedah,0,0,0
2021-10-01,MCO,Sabah,0,0,0
2021-10-01,MCO,Selangor,0,0,0
2021-10-01,MDA,Johor,0,0,0
2021-10-01,MDA,Kedah,0,0,0
2021-10-01,MDA,Kelantan,0,0,0
2021-10-01,MDA,Negeri Sembilan,0,0,0
2021-10-01,MDA,Perlis,0,0,0
2021-10-01,MDA,Pulau Pinang,0,0,0
2021-10-01,MDA,Sabah,0,0,0
2021-10-01,MDA,Sarawak,0,0,0
2021-10-01,MDA,Selangor,0,0,0
2021-10-01,MDG,Johor,0,0,0
2021-10-01,MDG,Kedah,0,0,0
2021-10-01,MDG,Perak,0,0,0
2021-10-01,MDG,Perlis,0,0,0
2021-10-01,MDG,Pulau Pinang,0,0,0
2021-10-01,MDG,Sabah,0,0,0
2021-10-01,MDG,Sarawak,0,0,0
2021-10-01,MDG,Selangor,0,0,0
2021-10-01,MDV,Johor,0,0,0
2021-10-01,MDV,Kedah,0,0,0
2021-10-01,MDV,Kelantan,0,0,0
2021-10-01,MDV,Perak,0,0,0
2021-10-01,MDV,Perlis,0,0,0
2021-10-01,MDV,Pulau Pinang,0,0,0
2021-10-01,MDV,Sabah,0,0,0
2021-10-01,MDV,Sarawak,0,0,0
2021-10-01,MDV,Selangor,94,32,62
2021-10-01,MEX,Johor,0,0,0
2021-10-01,MEX,Kedah,0,0,0
2021-10-01,MEX,Kelantan,0,0,0
2021-10-01,MEX,Pahang,0,0,0
2021-10-01,MEX,Perak,0,0,0
2021-10-01,MEX,Perlis,0,0,0
2021-10-01,MEX,Pulau Pinang,0,0,0
2021-10-01,MEX,Sabah,0,0,0
2021-10-01,MEX,Sarawak,0,0,0
2021-10-01,MEX,Selangor,7,6,1
2021-10-01,MEX,W.P. Labuan,0,0,0
2021-10-01,MHL,Johor,0,0,0
2021-10-01,MHL,Kedah,0,0,0
2021-10-01,MHL,Perak,0,0,0
2021-10-01,MHL,Pulau Pinang,0,0,0
2021-10-01,MHL,Sabah,0,0,0
2021-10-01,MHL,Selangor,1,1,0
2021-10-01,MKD,Johor,0,0,0
2021-10-01,MKD,Kedah,0,0,0
2021-10-01,MKD,Perak,0,0,0
2021-10-01,MKD,Pulau Pinang,0,0,0
2021-10-01,MKD,Sabah,0,0,0
2021-10-01,MKD,Sarawak,0,0,0
2021-10-01,MKD,Selangor,4,2,2
2021-10-01,MLI,Johor,0,0,0
2021-10-01,MLI,Sabah,0,0,0
2021-10-01,MLI,Selangor,3,3,0
2021-10-01,MLT,Johor,0,0,0
2021-10-01,MLT,Kedah,0,0,0
2021-10-01,MLT,Kelantan,0,0,0
2021-10-01,MLT,Perak,0,0,0
2021-10-01,MLT,Perlis,0,0,0
2021-10-01,MLT,Pulau Pinang,0,0,0
2021-10-01,MLT,Sabah,0,0,0
2021-10-01,MLT,Sarawak,0,0,0
2021-10-01,MLT,Selangor,0,0,0
2021-10-01,MLT,W.P. Labuan,0,0,0
2021-10-01,MMR,Johor,0,0,0
2021-10-01,MMR,Kedah,0,0,0
2021-10-01,MMR,Kelantan,0,0,0
2021-10-01,MMR,Negeri Sembilan,0,0,0
2021-10-01,MMR,Pahang,0,0,0
2021-10-01,MMR,Perak,0,0,0
2021-10-01,MMR,Perlis,0,0,0
2021-10-01,MMR,Pulau Pinang,0,0,0
2021-10-01,MMR,Sabah,1,1,0
2021-10-01,MMR,Sarawak,2,1,1
2021-10-01,MMR,Selangor,177,145,32
2021-10-01,MMR,Terengganu,0,0,0
2021-10-01,MMR,W.P. Labuan,0,0,0
2021-10-01,MNE,Johor,0,0,0
2021-10-01,MNE,Kedah,0,0,0
2021-10-01,MNE,Pulau Pinang,0,0,0
2021-10-01,MNE,Sabah,0,0,0
2021-10-01,MNE,Sarawak,0,0,0
2021-10-01,MNE,Selangor,1,1,0
2021-10-01,MNG,Johor,0,0,0
2021-10-01,MNG,Kedah,0,0,0
2021-10-01,MNG,Kelantan,0,0,0
2021-10-01,MNG,Perak,0,0,0
2021-10-01,MNG,Perlis,0,0,0
2021-10-01,MNG,Pulau Pinang,0,0,0
2021-10-01,MNG,Sabah,0,0,0
2021-10-01,MNG,Sarawak,0,0,0
2021-10-01,MNG,Selangor,3,0,3
2021-10-01,MNP,Selangor,0,0,0
2021-10-01,MOZ,Johor,0,0,0
2021-10-01,MOZ,Kedah,0,0,0
2021-10-01,MOZ,Perak,0,0,0
2021-10-01,MOZ,Pulau Pinang,0,0,0
2021-10-01,MOZ,Sabah,0,0,0
2021-10-01,MOZ,Sarawak,0,0,0
2021-10-01,MOZ,Selangor,7,4,3
2021-10-01,MRT,Johor,0,0,0
2021-10-01,MRT,Kedah,0,0,0
2021-10-01,MRT,Pulau Pinang,0,0,0
2021-10-01,MRT,Sabah,0,0,0
2021-10-01,MRT,Sarawak,0,0,0
2021-10-01,MRT,Selangor,3,2,1
2021-10-01,MUS,Johor,0,0,0
2021-10-01,MUS,Kedah,0,0,0
2021-10-01,MUS,Kelantan,0,0,0
2021-10-01,MUS,Pahang,0,0,0
2021-10-01,MUS,Perak,0,0,0
2021-10-01,MUS,Perlis,0,0,0
2021-10-01,MUS,Pulau Pinang,0,0,0
2021-10-01,MUS,Sabah,0,0,0
2021-10-01,MUS,Sarawak,0,0,0
2021-10-01,MUS,Selangor,11,6,5
2021-10-01,MWI,Johor,0,0,0
2021-10-01,MWI,Pulau Pinang,0,0,0
2021-10-01,MWI,Sabah,0,0,0
2021-10-01,MWI,Sarawak,0,0,0
2021-10-01,MWI,Selangor,1,0,1
2021-10-01,MYT,Selangor,0,0,0
2021-10-01,NAM,Johor,0,0,0
2021-10-01,NAM,Kedah,0,0,0
2021-10-01,NAM,Perak,0,0,0
2021-10-01,NAM,Perlis,0,0,0
2021-10-01,NAM,Pulau Pinang,0,0,0
2021-10-01,NAM,Sabah,0,0,0
2021-10-01,NAM,Sarawak,0,0,0
2021-10-01,NAM,Selangor,0,0,0
2021-10-01,NCL,Selangor,0,0,0
2021-10-01,NER,Johor,0,0,0
2021-10-01,NER,Sabah,0,0,0
2021-10-01,NER,Selangor,0,0,0
2021-10-01,NGA,Johor,0,0,0
2021-10-01,NGA,Kedah,0,0,0
2021-10-01,NGA,Perlis,0,0,0
2021-10-01,NGA,Pulau Pinang,0,0,0
2021-10-01,NGA,Sabah,0,0,0
2021-10-01,NGA,Sarawak,2,2,0
2021-10-01,NGA,Selangor,118,94,24
2021-10-01,NIC,Johor,0,0,0
2021-10-01,NIC,Kedah,0,0,0
2021-10-01,NIC,Pulau Pinang,0,0,0
2021-10-01,NIC,Sabah,0,0,0
2021-10-01,NIC,Selangor,0,0,0
2021-10-01,NLD,Johor,1,1,0
2021-10-01,NLD,Kedah,0,0,0
2021-10-01,NLD,Kelantan,0,0,0
2021-10-01,NLD,Melaka,0,0,0
2021-10-01,NLD,Negeri Sembilan,0,0,0
2021-10-01,NLD,Pahang,0,0,0
2021-10-01,NLD,Perak,0,0,0
2021-10-01,NLD,Perlis,0,0,0
2021-10-01,NLD,Pulau Pinang,12,7,5
2021-10-01,NLD,Sabah,0,0,0
2021-10-01,NLD,Sarawak,5,4,1
2021-10-01,NLD,Selangor,76,61,15
2021-10-01,NLD,Terengganu,0,0,0
2021-10-01,NLD,W.P. Labuan,0,0,0
2021-10-01,NOR,Johor,0,0,0
2021-10-01,NOR,Kedah,0,0,0
2021-10-01,NOR,Kelantan,0,0,0
2021-10-01,NOR,Melaka,0,0,0
2021-10-01,NOR,Pahang,0,0,0
2021-10-01,NOR,Perak,0,0,0
2021-10-01,NOR,Perlis,0,0,0
2021-10-01,NOR,Pulau Pinang,0,0,0
2021-10-01,NOR,Sabah,0,0,0
2021-10-01,NOR,Sarawak,0,0,0
2021-10-01,NOR,Selangor,14,10,4
2021-10-01,NOR,W.P. Labuan,0,0,0
2021-10-01,NPL,Johor,0,0,0
2021-10-01,NPL,Kedah,0,0,0
2021-10-01,NPL,Pahang,0,0,0
2021-10-01,NPL,Perak,0,0,0
2021-10-01,NPL,Perlis,0,0,0
2021-10-01,NPL,Pulau Pinang,0,0,0
2021-10-01,NPL,Sabah,0,0,0
2021-10-01,NPL,Sarawak,0,0,0
2021-10-01,NPL,Selangor,16,12,4
2021-10-01,NPL,W.P. Labuan,0,0,0
2021-10-01,NRU,Johor,0,0,0
2021-10-01,NRU,Pulau Pinang,0,0,0
2021-10-01,NRU,Selangor,0,0,0
2021-10-01,NZL,Johor,0,0,0
2021-10-01,NZL,Kedah,0,0,0
2021-10-01,NZL,Kelantan,0,0,0
2021-10-01,NZL,Melaka,0,0,0
2021-10-01,NZL,Negeri Sembilan,0,0,0
2021-10-01,NZL,Pahang,0,0,0
2021-10-01,NZL,Perak,0,0,0
2021-10-01,NZL,Perlis,0,0,0
2021-10-01,NZL,Pulau Pinang,0,0,0
2021-10-01,NZL,Sabah,0,0,0
2021-10-01,NZL,Sarawak,0,0,0
2021-10-01,NZL,Selangor,19,15,4
2021-10-01,NZL,Terengganu,0,0,0
2021-10-01,NZL,W.P. Labuan,0,0,0
2021-10-01,OMN,Johor,0,0,0
2021-10-01,OMN,Kedah,0,0,0
2021-10-01,OMN,Kelantan,0,0,0
2021-10-01,OMN,Melaka,0,0,0
2021-10-01,OMN,Perak,0,0,0
2021-10-01,OMN,Perlis,0,0,0
2021-10-01,OMN,Pulau Pinang,0,0,0
2021-10-01,OMN,Sabah,0,0,0
2021-10-01,OMN,Sarawak,0,0,0
2021-10-01,OMN,Selangor,29,14,15
2021-10-01,PAK,Johor,1,1,0
2021-10-01,PAK,Kedah,0,0,0
2021-10-01,PAK,Kelantan,0,0,0
2021-10-01,PAK,Melaka,0,0,0
2021-10-01,PAK,Negeri Sembilan,0,0,0
2021-10-01,PAK,Pahang,0,0,0
2021-10-01,PAK,Perak,0,0,0
2021-10-01,PAK,Perlis,0,0,0
2021-10-01,PAK,Pulau Pinang,0,0,0
2021-10-01,PAK,Sabah,0,0,0
2021-10-01,PAK,Sarawak,0,0,0
2021-10-01,PAK,Selangor,204,157,47
2021-10-01,PAK,W.P. Labuan,0,0,0
2021-10-01,PAN,Johor,0,0,0
2021-10-01,PAN,Kedah,0,0,0
2021-10-01,PAN,Perak,0,0,0
2021-10-01,PAN,Perlis,0,0,0
2021-10-01,PAN,Pulau Pinang,0,0,0
2021-10-01,PAN,Sabah,0,0,0
2021-10-01,PAN,Sarawak,0,0,0
2021-10-01,PAN,Selangor,1,0,1
2021-10-01,PER,Johor,0,0,0
2021-10-01,PER,Kedah,0,0,0
2021-10-01,PER,Kelantan,0,0,0
2021-10-01,PER,Pahang,0,0,0
2021-10-01,PER,Perak,0,0,0
2021-10-01,PER,Perlis,0,0,0
2021-10-01,PER,Pulau Pinang,0,0,0
2021-10-01,PER,Sabah,0,0,0
2021-10-01,PER,Sarawak,0,0,0
2021-10-01,PER,Selangor,3,3,0
2021-10-01,PER,W.P. Labuan,0,0,0
2021-10-01,PHL,Johor,9,6,3
2021-10-01,PHL,Kedah,0,0,0
2021-10-01,PHL,Kelantan,0,0,0
2021-10-01,PHL,Melaka,0,0,0
2021-10-01,PHL,Negeri Sembilan,0,0,0
2021-10-01,PHL,Pahang,0,0,0
2021-10-01,PHL,Perak,0,0,0
2021-10-01,PHL,Perlis,0,0,0
2021-10-01,PHL,Pulau Pinang,8,6,2
2021-10-01,PHL,Sabah,0,0,0
2021-10-01,PHL,Sarawak,42,42,0
2021-10-01,PHL,Selangor,394,286,108
2021-10-01,PHL,Terengganu,0,0,0
2021-10-01,PHL,W.P. Labuan,0,0,0
2021-10-01,PLW,Johor,0,0,0
2021-10-01,PLW,Pulau Pinang,0,0,0
2021-10-01,PLW,Selangor,0,0,0
2021-10-01,PNG,Johor,0,0,0
2021-10-01,PNG,Kedah,0,0,0
2021-10-01,PNG,Kelantan,0,0,0
2021-10-01,PNG,Perak,0,0,0
2021-10-01,PNG,Pulau Pinang,0,0,0
2021-10-01,PNG,Sabah,0,0,0
2021-10-01,PNG,Sarawak,0,0,0
2021-10-01,PNG,Selangor,0,0,0
2021-10-01,POL,Johor,0,0,0
2021-10-01,POL,Kedah,0,0,0
2021-10-01,POL,Kelantan,0,0,0
2021-10-01,POL,Melaka,0,0,0
2021-10-01,POL,Negeri Sembilan,0,0,0
2021-10-01,POL,Pahang,0,0,0
2021-10-01,POL,Perak,0,0,0
2021-10-01,POL,Perlis,0,0,0
2021-10-01,POL,Pulau Pinang,0,0,0
2021-10-01,POL,Sabah,0,0,0
2021-10-01,POL,Sarawak,2,2,0
2021-10-01,POL,Selangor,18,15,3
2021-10-01,POL,Terengganu,0,0,0
2021-10-01,POL,W.P. Labuan,0,0,0
2021-10-01,PRK,Selangor,0,0,0
2021-10-01,PRT,Johor,0,0,0
2021-10-01,PRT,Kedah,0,0,0
2021-10-01,PRT,Kelantan,0,0,0
2021-10-01,PRT,Melaka,0,0,0
2021-10-01,PRT,Pahang,0,0,0
2021-10-01,PRT,Perak,0,0,0
2021-10-01,PRT,Perlis,0,0,0
2021-10-01,PRT,Pulau Pinang,1,0,1
2021-10-01,PRT,Sabah,0,0,0
2021-10-01,PRT,Sarawak,0,0,0
2021-10-01,PRT,Selangor,13,8,5
2021-10-01,PRT,W.P. Labuan,0,0,0
2021-10-01,PRY,Johor,0,0,0
2021-10-01,PRY,Kedah,0,0,0
2021-10-01,PRY,Perak,0,0,0
2021-10-01,PRY,Perlis,0,0,0
2021-10-01,PRY,Pulau Pinang,0,0,0
2021-10-01,PRY,Sabah,0,0,0
2021-10-01,PRY,Sarawak,0,0,0
2021-10-01,PRY,Selangor,0,0,0
2021-10-01,PSE,Johor,0,0,0
2021-10-01,PSE,Kedah,0,0,0
2021-10-01,PSE,Kelantan,0,0,0
2021-10-01,PSE,Melaka,0,0,0
2021-10-01,PSE,Perak,0,0,0
2021-10-01,PSE,Perlis,0,0,0
2021-10-01,PSE,Pulau Pinang,0,0,0
2021-10-01,PSE,Sabah,0,0,0
2021-10-01,PSE,Sarawak,0,0,0
2021-10-01,PSE,Selangor,37,35,2
2021-10-01,QAT,Johor,0,0,0
2021-10-01,QAT,Kedah,0,0,0
2021-10-01,QAT,Perlis,0,0,0
2021-10-01,QAT,Pulau Pinang,0,0,0
2021-10-01,QAT,Sabah,0,0,0
2021-10-01,QAT,Sarawak,0,0,0
2021-10-01,QAT,Selangor,2,2,0
2021-10-01,REU,Johor,0,0,0
2021-10-01,REU,Sarawak,0,0,0
2021-10-01,ROU,Johor,1,1,0
2021-10-01,ROU,Kedah,0,0,0
2021-10-01,ROU,Kelantan,0,0,0
2021-10-01,ROU,Negeri Sembilan,0,0,0
2021-10-01,ROU,Pahang,0,0,0
2021-10-01,ROU,Perak,0,0,0
2021-10-01,ROU,Perlis,0,0,0
2021-10-01,ROU,Pulau Pinang,0,0,0
2021-10-01,ROU,Sabah,0,0,0
2021-10-01,ROU,Sarawak,0,0,0
2021-10-01,ROU,Selangor,21,12,9
2021-10-01,ROU,W.P. Labuan,0,0,0
2021-10-01,RUS,Johor,2,1,1
2021-10-01,RUS,Kedah,0,0,0
2021-10-01,RUS,Kelantan,0,0,0
2021-10-01,RUS,Melaka,0,0,0
2021-10-01,RUS,Negeri Sembilan,0,0,0
2021-10-01,RUS,Pahang,0,0,0
2021-10-01,RUS,Perak,0,0,0
2021-10-01,RUS,Perlis,0,0,0
2021-10-01,RUS,Pulau Pinang,0,0,0
2021-10-01,RUS,Sabah,0,0,0
2021-10-01,RUS,Sarawak,0,0,0
2021-10-01,RUS,Selangor,54,32,22
2021-10-01,RUS,W.P. Labuan,0,0,0
2021-10-01,RWA,Johor,0,0,0
2021-10-01,RWA,Kedah,0,0,0
2021-10-01,RWA,Pulau Pinang,0,0,0
2021-10-01,RWA,Selangor,1,1,0
2021-10-01,SAU,Johor,0,0,0
2021-10-01,SAU,Kedah,0,0,0
2021-10-01,SAU,Kelantan,0,0,0
2021-10-01,SAU,Melaka,0,0,0
2021-10-01,SAU,Perak,0,0,0
2021-10-01,SAU,Perlis,0,0,0
2021-10-01,SAU,Pulau Pinang,0,0,0
2021-10-01,SAU,Sabah,0,0,0
2021-10-01,SAU,Sarawak,0,0,0
2021-10-01,SAU,Selangor,139,91,48
2021-10-01,SAU,W.P. Labuan,0,0,0
2021-10-01,SDN,Johor,0,0,0
2021-10-01,SDN,Kedah,0,0,0
2021-10-01,SDN,Kelantan,0,0,0
2021-10-01,SDN,Perlis,0,0,0
2021-10-01,SDN,Pulau Pinang,0,0,0
2021-10-01,SDN,Sabah,0,0,0
2021-10-01,SDN,Sarawak,0,0,0
2021-10-01,SDN,Selangor,93,61,32
2021-10-01,SDN,W.P. Labuan,0,0,0
2021-10-01,SEN,Johor,0,0,0
2021-10-01,SEN,Kedah,0,0,0
2021-10-01,SEN,Kelantan,0,0,0
2021-10-01,SEN,Perak,0,0,0
2021-10-01,SEN,Perlis,0,0,0
2021-10-01,SEN,Pulau Pinang,0,0,0
2021-10-01,SEN,Sabah,0,0,0
2021-10-01,SEN,Sarawak,0,0,0
2021-10-01,SEN,Selangor,3,1,2
2021-10-01,SGP,Johor,158,131,27
2021-10-01,SGP,Kedah,1,1,0
2021-10-01,SGP,Kelantan,0,0,0
2021-10-01,SGP,Melaka,0,0,0
2021-10-01,SGP,Negeri Sembilan,0,0,0
2021-10-01,SGP,Pahang,0,0,0
2021-10-01,SGP,Perak,2,1,1
2021-10-01,SGP,Perlis,2,2,0
2021-10-01,SGP,Pulau Pinang,19,11,8
2021-10-01,SGP,Sabah,0,0,0
2021-10-01,SGP,Sarawak,12,9,3
2021-10-01,SGP,Selangor,194,128,66
2021-10-01,SGP,Terengganu,0,0,0
2021-10-01,SGP,W.P. Labuan,0,0,0
2021-10-01,SGS,Johor,0,0,0
2021-10-01,SGS,Sabah,0,0,0
2021-10-01,SGS,Selangor,0,0,0
2021-10-01,SHN,Sarawak,0,0,0
2021-10-01,SLB,Johor,0,0,0
2021-10-01,SLB,Perlis,0,0,0
2021-10-01,SLB,Pulau Pinang,0,0,0
2021-10-01,SLB,Sabah,0,0,0
2021-10-01,SLB,Sarawak,0,0,0
2021-10-01,SLB,Selangor,0,0,0
2021-10-01,SLB,W.P. Labuan,0,0,0
2021-10-01,SLE,Johor,0,0,0
2021-10-01,SLE,Kedah,0,0,0
2021-10-01,SLE,Perak,0,0,0
2021-10-01,SLE,Pulau Pinang,0,0,0
2021-10-01,SLE,Sabah,0,0,0
2021-10-01,SLE,Selangor,3,1,2
2021-10-01,SLV,Johor,0,0,0
2021-10-01,SLV,Kedah,0,0,0
2021-10-01,SLV,Perak,0,0,0
2021-10-01,SLV,Perlis,0,0,0
2021-10-01,SLV,Pulau Pinang,0,0,0
2021-10-01,SLV,Sabah,0,0,0
2021-10-01,SLV,Selangor,0,0,0
2021-10-01,SLV,W.P. Labuan,0,0,0
2021-10-01,SMR,Johor,0,0,0
2021-10-01,SMR,Selangor,0,0,0
2021-10-01,SOM,Johor,0,0,0
2021-10-01,SOM,Kedah,0,0,0
2021-10-01,SOM,Kelantan,0,0,0
2021-10-01,SOM,Perlis,0,0,0
2021-10-01,SOM,Sabah,0,0,0
2021-10-01,SOM,Sarawak,0,0,0
2021-10-01,SOM,Selangor,78,63,15
2021-10-01,SRB,Johor,0,0,0
2021-10-01,SRB,Kedah,0,0,0
2021-10-01,SRB,Kelantan,0,0,0
2021-10-01,SRB,Pahang,0,0,0
2021-10-01,SRB,Perak,0,0,0
2021-10-01,SRB,Perlis,0,0,0
2021-10-01,SRB,Pulau Pinang,0,0,0
2021-10-01,SRB,Sabah,0,0,0
2021-10-01,SRB,Sarawak,0,0,0
2021-10-01,SRB,Selangor,3,2,1
2021-10-01,SSD,Johor,0,0,0
2021-10-01,SSD,Kedah,0,0,0
2021-10-01,SSD,Sarawak,0,0,0
2021-10-01,SSD,Selangor,5,4,1
2021-10-01,SSD,W.P. Labuan,0,0,0
2021-10-01,STP,Selangor,0,0,0
2021-10-01,SUR,Johor,0,0,0
2021-10-01,SUR,Kedah,0,0,0
2021-10-01,SUR,Kelantan,0,0,0
2021-10-01,SUR,Perak,0,0,0
2021-10-01,SUR,Perlis,0,0,0
2021-10-01,SUR,Pulau Pinang,0,0,0
2021-10-01,SUR,Sabah,0,0,0
2021-10-01,SUR,Sarawak,0,0,0
2021-10-01,SUR,Selangor,0,0,0
2021-10-01,SVK,Johor,0,0,0
2021-10-01,SVK,Kedah,0,0,0
2021-10-01,SVK,Kelantan,0,0,0
2021-10-01,SVK,Negeri Sembilan,0,0,0
2021-10-01,SVK,Pahang,0,0,0
2021-10-01,SVK,Perak,0,0,0
2021-10-01,SVK,Perlis,0,0,0
2021-10-01,SVK,Pulau Pinang,0,0,0
2021-10-01,SVK,Sabah,0,0,0
2021-10-01,SVK,Sarawak,0,0,0
2021-10-01,SVK,Selangor,11,9,2
2021-10-01,SVK,W.P. Labuan,0,0,0
2021-10-01,SVN,Johor,0,0,0
2021-10-01,SVN,Kedah,0,0,0
2021-10-01,SVN,Kelantan,0,0,0
2021-10-01,SVN,Perak,0,0,0
2021-10-01,SVN,Perlis,0,0,0
2021-10-01,SVN,Pulau Pinang,0,0,0
2021-10-01,SVN,Sabah,0,0,0
2021-10-01,SVN,Sarawak,0,0,0
2021-10-01,SVN,Selangor,4,3,1
2021-10-01,SVN,W.P. Labuan,0,0,0
2021-10-01,SWE,Johor,0,0,0
2021-10-01,SWE,Kedah,0,0,0
2021-10-01,SWE,Kelantan,0,0,0
2021-10-01,SWE,Melaka,0,0,0
2021-10-01,SWE,Negeri Sembilan,0,0,0
2021-10-01,SWE,Pahang,0,0,0
2021-10-01,SWE,Perak,0,0,0
2021-10-01,SWE,Perlis,0,0,0
2021-10-01,SWE,Pulau Pinang,0,0,0
2021-10-01,SWE,Sabah,0,0,0
2021-10-01,SWE,Sarawak,0,0,0
2021-10-01,SWE,Selangor,39,33,6
2021-10-01,SWE,W.P. Labuan,0,0,0
2021-10-01,SWZ,Johor,0,0,0
2021-10-01,SWZ,Kedah,0,0,0
2021-10-01,SWZ,Pulau Pinang,0,0,0
2021-10-01,SWZ,Sabah,0,0,0
2021-10-01,SWZ,Selangor,0,0,0
2021-10-01,SYC,Johor,0,0,0
2021-10-01,SYC,Kedah,0,0,0
2021-10-01,SYC,Pulau Pinang,0,0,0
2021-10-01,SYC,Sabah,0,0,0
2021-10-01,SYC,Sarawak,1,1,0
2021-10-01,SYC,Selangor,10,5,5
2021-10-01,SYR,Johor,0,0,0
2021-10-01,SYR,Kedah,0,0,0
2021-10-01,SYR,Kelantan,0,0,0
2021-10-01,SYR,Pahang,0,0,0
2021-10-01,SYR,Perlis,0,0,0
2021-10-01,SYR,Pulau Pinang,0,0,0
2021-10-01,SYR,Sabah,0,0,0
2021-10-01,SYR,Sarawak,0,0,0
2021-10-01,SYR,Selangor,53,45,8
2021-10-01,SYR,W.P. Labuan,0,0,0
2021-10-01,TCA,Perlis,0,0,0
2021-10-01,TCD,Johor,0,0,0
2021-10-01,TCD,Kedah,0,0,0
2021-10-01,TCD,Perlis,0,0,0
2021-10-01,TCD,Selangor,1,1,0
2021-10-01,TGO,Johor,0,0,0
2021-10-01,TGO,Perak,0,0,0
2021-10-01,TGO,Pulau Pinang,0,0,0
2021-10-01,TGO,Selangor,0,0,0
2021-10-01,THA,Johor,27,27,0
2021-10-01,THA,Kedah,19375,19336,39
2021-10-01,THA,Kelantan,0,0,0
2021-10-01,THA,Melaka,0,0,0
2021-10-01,THA,Negeri Sembilan,0,0,0
2021-10-01,THA,Pahang,0,0,0
2021-10-01,THA,Perak,0,0,0
2021-10-01,THA,Perlis,7946,7835,111
2021-10-01,THA,Pulau Pinang,40,36,4
2021-10-01,THA,Sabah,1,0,1
2021-10-01,THA,Sarawak,1,1,0
2021-10-01,THA,Selangor,154,68,86
2021-10-01,THA,Terengganu,0,0,0
2021-10-01,THA,W.P. Labuan,0,0,0
2021-10-01,TJK,Johor,0,0,0
2021-10-01,TJK,Kedah,0,0,0
2021-10-01,TJK,Perlis,0,0,0
2021-10-01,TJK,Pulau Pinang,0,0,0
2021-10-01,TJK,Sabah,0,0,0
2021-10-01,TJK,Selangor,2,2,0
2021-10-01,TKL,Selangor,0,0,0
2021-10-01,TKM,Johor,0,0,0
2021-10-01,TKM,Kedah,0,0,0
2021-10-01,TKM,Kelantan,0,0,0
2021-10-01,TKM,Perlis,0,0,0
2021-10-01,TKM,Pulau Pinang,0,0,0
2021-10-01,TKM,Sabah,0,0,0
2021-10-01,TKM,Sarawak,0,0,0
2021-10-01,TKM,Selangor,3,0,3
2021-10-01,TLS,Johor,0,0,0
2021-10-01,TLS,Kedah,0,0,0
2021-10-01,TLS,Perlis,0,0,0
2021-10-01,TLS,Pulau Pinang,0,0,0
2021-10-01,TLS,Sabah,0,0,0
2021-10-01,TLS,Sarawak,0,0,0
2021-10-01,TLS,Selangor,3,3,0
2021-10-01,TON,Johor,0,0,0
2021-10-01,TON,Pulau Pinang,0,0,0
2021-10-01,TON,Sarawak,0,0,0
2021-10-01,TON,Selangor,0,0,0
2021-10-01,TTO,Johor,0,0,0
2021-10-01,TTO,Kedah,0,0,0
2021-10-01,TTO,Pahang,0,0,0
2021-10-01,TTO,Pulau Pinang,0,0,0
2021-10-01,TTO,Sabah,0,0,0
2021-10-01,TTO,Sarawak,0,0,0
2021-10-01,TTO,Selangor,1,1,0
2021-10-01,TUN,Johor,0,0,0
2021-10-01,TUN,Kedah,0,0,0
2021-10-01,TUN,Kelantan,0,0,0
2021-10-01,TUN,Melaka,0,0,0
2021-10-01,TUN,Perak,0,0,0
2021-10-01,TUN,Perlis,0,0,0
2021-10-01,TUN,Pulau Pinang,0,0,0
2021-10-01,TUN,Sabah,0,0,0
2021-10-01,TUN,Sarawak,0,0,0
2021-10-01,TUN,Selangor,10,6,4
2021-10-01,TUN,W.P. Labuan,0,0,0
2021-10-01,TUR,Johor,1,1,0
2021-10-01,TUR,Kedah,0,0,0
2021-10-01,TUR,Kelantan,0,0,0
2021-10-01,TUR,Melaka,0,0,0
2021-10-01,TUR,Negeri Sembilan,0,0,0
2021-10-01,TUR,Pahang,0,0,0
2021-10-01,TUR,Perak,0,0,0
2021-10-01,TUR,Perlis,0,0,0
2021-10-01,TUR,Pulau Pinang,0,0,0
2021-10-01,TUR,Sabah,0,0,0
2021-10-01,TUR,Sarawak,2,2,0
2021-10-01,TUR,Selangor,82,51,31
2021-10-01,TUR,W.P. Labuan,0,0,0
2021-10-01,TUV,Selangor,0,0,0
2021-10-01,TWN,Johor,0,0,0
2021-10-01,TWN,Kedah,0,0,0
2021-10-01,TWN,Kelantan,0,0,0
2021-10-01,TWN,Melaka,0,0,0
2021-10-01,TWN,Negeri Sembilan,0,0,0
2021-10-01,TWN,Pahang,0,0,0
2021-10-01,TWN,Perak,0,0,0
2021-10-01,TWN,Perlis,0,0,0
2021-10-01,TWN,Pulau Pinang,19,14,5
2021-10-01,TWN,Sabah,0,0,0
2021-10-01,TWN,Sarawak,2,1,1
2021-10-01,TWN,Selangor,63,37,26
2021-10-01,TWN,W.P. Labuan,0,0,0
2021-10-01,TZA,Johor,0,0,0
2021-10-01,TZA,Kedah,0,0,0
2021-10-01,TZA,Perak,0,0,0
2021-10-01,TZA,Perlis,0,0,0
2021-10-01,TZA,Pulau Pinang,0,0,0
2021-10-01,TZA,Sabah,0,0,0
2021-10-01,TZA,Sarawak,0,0,0
2021-10-01,TZA,Selangor,11,2,9
2021-10-01,UGA,Johor,0,0,0
2021-10-01,UGA,Kedah,0,0,0
2021-10-01,UGA,Perak,0,0,0
2021-10-01,UGA,Perlis,0,0,0
2021-10-01,UGA,Pulau Pinang,0,0,0
2021-10-01,UGA,Sabah,0,0,0
2021-10-01,UGA,Sarawak,0,0,0
2021-10-01,UGA,Selangor,5,4,1
2021-10-01,UKR,Johor,1,1,0
2021-10-01,UKR,Kedah,0,0,0
2021-10-01,UKR,Kelantan,0,0,0
2021-10-01,UKR,Melaka,0,0,0
2021-10-01,UKR,Negeri Sembilan,0,0,0
2021-10-01,UKR,Pahang,0,0,0
2021-10-01,UKR,Perak,0,0,0
2021-10-01,UKR,Perlis,0,0,0
2021-10-01,UKR,Pulau Pinang,0,0,0
2021-10-01,UKR,Sabah,0,0,0
2021-10-01,UKR,Sarawak,1,1,0
2021-10-01,UKR,Selangor,44,32,12
2021-10-01,UKR,W.P. Labuan,0,0,0
2021-10-01,URY,Johor,0,0,0
2021-10-01,URY,Kedah,0,0,0
2021-10-01,URY,Kelantan,0,0,0
2021-10-01,URY,Perak,0,0,0
2021-10-01,URY,Perlis,0,0,0
2021-10-01,URY,Pulau Pinang,0,0,0
2021-10-01,URY,Sabah,0,0,0
2021-10-01,URY,Sarawak,0,0,0
2021-10-01,URY,Selangor,2,0,2
2021-10-01,URY,W.P. Labuan,0,0,0
2021-10-01,USA,Johor,0,0,0
2021-10-01,USA,Kedah,0,0,0
2021-10-01,USA,Kelantan,0,0,0
2021-10-01,USA,Melaka,0,0,0
2021-10-01,USA,Negeri Sembilan,0,0,0
2021-10-01,USA,Pahang,0,0,0
2021-10-01,USA,Perak,0,0,0
2021-10-01,USA,Perlis,0,0,0
2021-10-01,USA,Pulau Pinang,11,6,5
2021-10-01,USA,Sabah,0,0,0
2021-10-01,USA,Sarawak,1,0,1
2021-10-01,USA,Selangor,252,186,66
2021-10-01,USA,Terengganu,0,0,0
2021-10-01,USA,W.P. Labuan,0,0,0
2021-10-01,UZB,Johor,0,0,0
2021-10-01,UZB,Kedah,0,0,0
2021-10-01,UZB,Kelantan,0,0,0
2021-10-01,UZB,Perak,0,0,0
2021-10-01,UZB,Perlis,0,0,0
2021-10-01,UZB,Pulau Pinang,0,0,0
2021-10-01,UZB,Sabah,0,0,0
2021-10-01,UZB,Sarawak,0,0,0
2021-10-01,UZB,Selangor,36,26,10
2021-10-01,VAT,Johor,0,0,0
2021-10-01,VAT,Sarawak,0,0,0
2021-10-01,VAT,Selangor,0,0,0
2021-10-01,VCT,Johor,0,0,0
2021-10-01,VCT,Kedah,0,0,0
2021-10-01,VCT,Pulau Pinang,0,0,0
2021-10-01,VCT,Sarawak,0,0,0
2021-10-01,VCT,Selangor,0,0,0
2021-10-01,VEN,Johor,0,0,0
2021-10-01,VEN,Kedah,0,0,0
2021-10-01,VEN,Kelantan,0,0,0
2021-10-01,VEN,Melaka,0,0,0
2021-10-01,VEN,Perak,0,0,0
2021-10-01,VEN,Perlis,0,0,0
2021-10-01,VEN,Pulau Pinang,0,0,0
2021-10-01,VEN,Sabah,0,0,0
2021-10-01,VEN,Sarawak,0,0,0
2021-10-01,VEN,Selangor,1,1,0
2021-10-01,VEN,W.P. Labuan,0,0,0
2021-10-01,VNM,Johor,1,0,1
2021-10-01,VNM,Kedah,0,0,0
2021-10-01,VNM,Kelantan,0,0,0
2021-10-01,VNM,Melaka,0,0,0
2021-10-01,VNM,Negeri Sembilan,0,0,0
2021-10-01,VNM,Pahang,0,0,0
2021-10-01,VNM,Perak,0,0,0
2021-10-01,VNM,Perlis,0,0,0
2021-10-01,VNM,Pulau Pinang,1,0,1
2021-10-01,VNM,Sabah,0,0,0
2021-10-01,VNM,Sarawak,1,0,1
2021-10-01,VNM,Selangor,152,62,90
2021-10-01,VNM,Terengganu,0,0,0
2021-10-01,VNM,W.P. Labuan,0,0,0
2021-10-01,VUT,Johor,0,0,0
2021-10-01,VUT,Kedah,0,0,0
2021-10-01,VUT,Pulau Pinang,0,0,0
2021-10-01,VUT,Sabah,0,0,0
2021-10-01,VUT,Sarawak,0,0,0
2021-10-01,VUT,Selangor,0,0,0
2021-10-01,WSM,Johor,0,0,0
2021-10-01,WSM,Sarawak,0,0,0
2021-10-01,WSM,Selangor,0,0,0
2021-10-01,XXX,Johor,0,0,0
2021-10-01,XXX,Kedah,0,0,0
2021-10-01,XXX,Kelantan,0,0,0
2021-10-01,XXX,Melaka,0,0,0
2021-10-01,XXX,Pahang,0,0,0
2021-10-01,XXX,Perak,0,0,0
2021-10-01,XXX,Perlis,0,0,0
2021-10-01,XXX,Pulau Pinang,1,1,0
2021-10-01,XXX,Sabah,0,0,0
2021-10-01,XXX,Sarawak,0,0,0
2021-10-01,XXX,Selangor,23,16,7
2021-10-01,XXX,W.P. Labuan,0,0,0
2021-10-01,YEM,Johor,0,0,0
2021-10-01,YEM,Kedah,0,0,0
2021-10-01,YEM,Kelantan,0,0,0
2021-10-01,YEM,Melaka,0,0,0
2021-10-01,YEM,Pahang,0,0,0
2021-10-01,YEM,Perak,0,0,0
2021-10-01,YEM,Perlis,0,0,0
2021-10-01,YEM,Pulau Pinang,0,0,0
2021-10-01,YEM,Sabah,0,0,0
2021-10-01,YEM,Sarawak,0,0,0
2021-10-01,YEM,Selangor,206,165,41
2021-10-01,YEM,W.P. Labuan,0,0,0
2021-10-01,ZAF,Johor,0,0,0
2021-10-01,ZAF,Kedah,0,0,0
2021-10-01,ZAF,Kelantan,0,0,0
2021-10-01,ZAF,Melaka,0,0,0
2021-10-01,ZAF,Pahang,0,0,0
2021-10-01,ZAF,Perak,0,0,0
2021-10-01,ZAF,Perlis,0,0,0
2021-10-01,ZAF,Pulau Pinang,0,0,0
2021-10-01,ZAF,Sabah,0,0,0
2021-10-01,ZAF,Sarawak,0,0,0
2021-10-01,ZAF,Selangor,38,25,13
2021-10-01,ZAF,Terengganu,0,0,0
2021-10-01,ZAF,W.P. Labuan,0,0,0
2021-10-01,ZAR,Selangor,0,0,0
2021-10-01,ZMB,Johor,0,0,0
2021-10-01,ZMB,Kedah,0,0,0
2021-10-01,ZMB,Perak,0,0,0
2021-10-01,ZMB,Perlis,0,0,0
2021-10-01,ZMB,Pulau Pinang,0,0,0
2021-10-01,ZMB,Sabah,0,0,0
2021-10-01,ZMB,Sarawak,0,0,0
2021-10-01,ZMB,Selangor,10,3,7
2021-10-01,ZWE,Johor,0,0,0
2021-10-01,ZWE,Kedah,0,0,0
2021-10-01,ZWE,Kelantan,0,0,0
2021-10-01,ZWE,Perak,0,0,0
2021-10-01,ZWE,Perlis,0,0,0
2021-10-01,ZWE,Pulau Pinang,0,0,0
2021-10-01,ZWE,Sabah,0,0,0
2021-10-01,ZWE,Sarawak,0,0,0
2021-10-01,ZWE,Selangor,19,7,12
2021-11-01,ABW,Kedah,0,0,0
2021-11-01,ABW,Pulau Pinang,0,0,0
2021-11-01,AFG,Johor,0,0,0
2021-11-01,AFG,Kedah,0,0,0
2021-11-01,AFG,Perlis,0,0,0
2021-11-01,AFG,Pulau Pinang,0,0,0
2021-11-01,AFG,Sarawak,0,0,0
2021-11-01,AFG,Selangor,57,36,21
2021-11-01,AGO,Johor,0,0,0
2021-11-01,AGO,Kedah,0,0,0
2021-11-01,AGO,Sabah,0,0,0
2021-11-01,AGO,Selangor,0,0,0
2021-11-01,AIA,Selangor,0,0,0
2021-11-01,ALB,Johor,0,0,0
2021-11-01,ALB,Kedah,0,0,0
2021-11-01,ALB,Perak,0,0,0
2021-11-01,ALB,Perlis,0,0,0
2021-11-01,ALB,Pulau Pinang,0,0,0
2021-11-01,ALB,Sabah,0,0,0
2021-11-01,ALB,Sarawak,0,0,0
2021-11-01,ALB,Selangor,0,0,0
2021-11-01,AND,Johor,0,0,0
2021-11-01,AND,Kedah,0,0,0
2021-11-01,AND,Perlis,0,0,0
2021-11-01,AND,Pulau Pinang,0,0,0
2021-11-01,AND,Selangor,0,0,0
2021-11-01,ANT,Selangor,0,0,0
2021-11-01,ARE,Johor,0,0,0
2021-11-01,ARE,Kedah,0,0,0
2021-11-01,ARE,Kelantan,0,0,0
2021-11-01,ARE,Perak,0,0,0
2021-11-01,ARE,Perlis,0,0,0
2021-11-01,ARE,Pulau Pinang,0,0,0
2021-11-01,ARE,Sabah,0,0,0
2021-11-01,ARE,Sarawak,0,0,0
2021-11-01,ARE,Selangor,2,1,1
2021-11-01,ARG,Johor,0,0,0
2021-11-01,ARG,Kedah,0,0,0
2021-11-01,ARG,Kelantan,0,0,0
2021-11-01,ARG,Melaka,0,0,0
2021-11-01,ARG,Perak,0,0,0
2021-11-01,ARG,Perlis,0,0,0
2021-11-01,ARG,Pulau Pinang,0,0,0
2021-11-01,ARG,Sabah,0,0,0
2021-11-01,ARG,Sarawak,0,0,0
2021-11-01,ARG,Selangor,1,0,1
2021-11-01,ARG,W.P. Labuan,0,0,0
2021-11-01,ARM,Johor,0,0,0
2021-11-01,ARM,Kedah,0,0,0
2021-11-01,ARM,Kelantan,0,0,0
2021-11-01,ARM,Perak,0,0,0
2021-11-01,ARM,Perlis,0,0,0
2021-11-01,ARM,Pulau Pinang,0,0,0
2021-11-01,ARM,Sabah,0,0,0
2021-11-01,ARM,Sarawak,0,0,0
2021-11-01,ARM,Selangor,0,0,0
2021-11-01,ATA,Selangor,0,0,0
2021-11-01,ATG,Johor,0,0,0
2021-11-01,ATG,Kedah,0,0,0
2021-11-01,ATG,Pulau Pinang,0,0,0
2021-11-01,ATG,Sarawak,0,0,0
2021-11-01,ATG,Selangor,1,0,1
2021-11-01,AUS,Johor,0,0,0
2021-11-01,AUS,Kedah,0,0,0
2021-11-01,AUS,Kelantan,0,0,0
2021-11-01,AUS,Melaka,0,0,0
2021-11-01,AUS,Negeri Sembilan,0,0,0
2021-11-01,AUS,Pahang,0,0,0
2021-11-01,AUS,Perak,0,0,0
2021-11-01,AUS,Perlis,0,0,0
2021-11-01,AUS,Pulau Pinang,12,6,6
2021-11-01,AUS,Sabah,5,3,2
2021-11-01,AUS,Sarawak,4,3,1
2021-11-01,AUS,Selangor,200,129,71
2021-11-01,AUS,Terengganu,0,0,0
2021-11-01,AUS,W.P. Labuan,0,0,0
2021-11-01,AUT,Johor,0,0,0
2021-11-01,AUT,Kedah,0,0,0
2021-11-01,AUT,Kelantan,0,0,0
2021-11-01,AUT,Melaka,0,0,0
2021-11-01,AUT,Negeri Sembilan,0,0,0
2021-11-01,AUT,Pahang,0,0,0
2021-11-01,AUT,Perak,0,0,0
2021-11-01,AUT,Perlis,0,0,0
2021-11-01,AUT,Pulau Pinang,2,1,1
2021-11-01,AUT,Sabah,0,0,0
2021-11-01,AUT,Sarawak,1,1,0
2021-11-01,AUT,Selangor,28,21,7
2021-11-01,AUT,Terengganu,0,0,0
2021-11-01,AUT,W.P. Labuan,0,0,0
2021-11-01,AZE,Johor,0,0,0
2021-11-01,AZE,Kedah,0,0,0
2021-11-01,AZE,Kelantan,0,0,0
2021-11-01,AZE,Melaka,0,0,0
2021-11-01,AZE,Perlis,0,0,0
2021-11-01,AZE,Pulau Pinang,0,0,0
2021-11-01,AZE,Sabah,0,0,0
2021-11-01,AZE,Sarawak,0,0,0
2021-11-01,AZE,Selangor,7,6,1
2021-11-01,AZE,W.P. Labuan,0,0,0
2021-11-01,BDI,Pulau Pinang,0,0,0
2021-11-01,BDI,Sarawak,0,0,0
2021-11-01,BDI,Selangor,0,0,0
2021-11-01,BEL,Johor,0,0,0
2021-11-01,BEL,Kedah,0,0,0
2021-11-01,BEL,Kelantan,0,0,0
2021-11-01,BEL,Melaka,0,0,0
2021-11-01,BEL,Negeri Sembilan,0,0,0
2021-11-01,BEL,Pahang,0,0,0
2021-11-01,BEL,Perak,0,0,0
2021-11-01,BEL,Perlis,0,0,0
2021-11-01,BEL,Pulau Pinang,3,2,1
2021-11-01,BEL,Sabah,0,0,0
2021-11-01,BEL,Sarawak,1,1,0
2021-11-01,BEL,Selangor,21,18,3
2021-11-01,BEL,W.P. Labuan,0,0,0
2021-11-01,BEN,Johor,0,0,0
2021-11-01,BEN,Kedah,0,0,0
2021-11-01,BEN,Perak,0,0,0
2021-11-01,BEN,Pulau Pinang,0,0,0
2021-11-01,BEN,Sabah,0,0,0
2021-11-01,BEN,Sarawak,0,0,0
2021-11-01,BEN,Selangor,0,0,0
2021-11-01,BFA,Perak,0,0,0
2021-11-01,BFA,Pulau Pinang,0,0,0
2021-11-01,BFA,Selangor,1,1,0
2021-11-01,BGD,Johor,4,1,3
2021-11-01,BGD,Kedah,0,0,0
2021-11-01,BGD,Kelantan,0,0,0
2021-11-01,BGD,Melaka,0,0,0
2021-11-01,BGD,Negeri Sembilan,0,0,0
2021-11-01,BGD,Pahang,0,0,0
2021-11-01,BGD,Perak,0,0,0
2021-11-01,BGD,Perlis,0,0,0
2021-11-01,BGD,Pulau Pinang,1,1,0
2021-11-01,BGD,Sabah,0,0,0
2021-11-01,BGD,Sarawak,1,1,0
2021-11-01,BGD,Selangor,1092,947,145
2021-11-01,BGD,W.P. Labuan,0,0,0
2021-11-01,BGR,Johor,0,0,0
2021-11-01,BGR,Kedah,0,0,0
2021-11-01,BGR,Kelantan,0,0,0
2021-11-01,BGR,Pahang,0,0,0
2021-11-01,BGR,Perak,0,0,0
2021-11-01,BGR,Perlis,0,0,0
2021-11-01,BGR,Pulau Pinang,0,0,0
2021-11-01,BGR,Sabah,0,0,0
2021-11-01,BGR,Sarawak,0,0,0
2021-11-01,BGR,Selangor,15,14,1
2021-11-01,BGR,W.P. Labuan,0,0,0
2021-11-01,BHR,Johor,0,0,0
2021-11-01,BHR,Kedah,0,0,0
2021-11-01,BHR,Kelantan,0,0,0
2021-11-01,BHR,Perlis,0,0,0
2021-11-01,BHR,Pulau Pinang,0,0,0
2021-11-01,BHR,Sabah,0,0,0
2021-11-01,BHR,Sarawak,0,0,0
2021-11-01,BHR,Selangor,4,2,2
2021-11-01,BHS,Johor,0,0,0
2021-11-01,BHS,Kedah,0,0,0
2021-11-01,BHS,Perak,0,0,0
2021-11-01,BHS,Sabah,0,0,0
2021-11-01,BHS,Sarawak,0,0,0
2021-11-01,BHS,Selangor,0,0,0
2021-11-01,BIH,Johor,0,0,0
2021-11-01,BIH,Kedah,0,0,0
2021-11-01,BIH,Perlis,0,0,0
2021-11-01,BIH,Pulau Pinang,0,0,0
2021-11-01,BIH,Sabah,0,0,0
2021-11-01,BIH,Sarawak,0,0,0
2021-11-01,BIH,Selangor,2,1,1
2021-11-01,BLR,Johor,0,0,0
2021-11-01,BLR,Kedah,0,0,0
2021-11-01,BLR,Kelantan,0,0,0
2021-11-01,BLR,Pahang,0,0,0
2021-11-01,BLR,Perak,0,0,0
2021-11-01,BLR,Perlis,0,0,0
2021-11-01,BLR,Pulau Pinang,0,0,0
2021-11-01,BLR,Sabah,0,0,0
2021-11-01,BLR,Sarawak,0,0,0
2021-11-01,BLR,Selangor,0,0,0
2021-11-01,BLR,W.P. Labuan,0,0,0
2021-11-01,BLZ,Johor,0,0,0
2021-11-01,BLZ,Pulau Pinang,0,0,0
2021-11-01,BLZ,Sarawak,0,0,0
2021-11-01,BLZ,Selangor,1,0,1
2021-11-01,BMU,Selangor,0,0,0
2021-11-01,BOL,Johor,0,0,0
2021-11-01,BOL,Kedah,0,0,0
2021-11-01,BOL,Melaka,0,0,0
2021-11-01,BOL,Perak,0,0,0
2021-11-01,BOL,Perlis,0,0,0
2021-11-01,BOL,Pulau Pinang,0,0,0
2021-11-01,BOL,Sabah,0,0,0
2021-11-01,BOL,Sarawak,0,0,0
2021-11-01,BOL,Selangor,0,0,0
2021-11-01,BRA,Johor,0,0,0
2021-11-01,BRA,Kedah,0,0,0
2021-11-01,BRA,Kelantan,0,0,0
2021-11-01,BRA,Melaka,0,0,0
2021-11-01,BRA,Pahang,0,0,0
2021-11-01,BRA,Perak,0,0,0
2021-11-01,BRA,Perlis,0,0,0
2021-11-01,BRA,Pulau Pinang,0,0,0
2021-11-01,BRA,Sabah,0,0,0
2021-11-01,BRA,Sarawak,0,0,0
2021-11-01,BRA,Selangor,32,22,10
2021-11-01,BRA,W.P. Labuan,0,0,0
2021-11-01,BRB,Johor,0,0,0
2021-11-01,BRB,Kedah,0,0,0
2021-11-01,BRB,Perlis,0,0,0
2021-11-01,BRB,Pulau Pinang,0,0,0
2021-11-01,BRB,Selangor,1,1,0
2021-11-01,BRN,Johor,0,0,0
2021-11-01,BRN,Kedah,0,0,0
2021-11-01,BRN,Kelantan,0,0,0
2021-11-01,BRN,Melaka,0,0,0
2021-11-01,BRN,Pahang,0,0,0
2021-11-01,BRN,Perak,0,0,0
2021-11-01,BRN,Perlis,0,0,0
2021-11-01,BRN,Pulau Pinang,0,0,0
2021-11-01,BRN,Sabah,0,0,0
2021-11-01,BRN,Sarawak,312,310,2
2021-11-01,BRN,Selangor,40,20,20
2021-11-01,BRN,W.P. Labuan,1,1,0
2021-11-01,BTN,Johor,0,0,0
2021-11-01,BTN,Kedah,0,0,0
2021-11-01,BTN,Perak,0,0,0
2021-11-01,BTN,Perlis,0,0,0
2021-11-01,BTN,Pulau Pinang,0,0,0
2021-11-01,BTN,Sabah,0,0,0
2021-11-01,BTN,Sarawak,0,0,0
2021-11-01,BTN,Selangor,3,2,1
2021-11-01,BWA,Johor,0,0,0
2021-11-01,BWA,Kedah,0,0,0
2021-11-01,BWA,Perlis,0,0,0
2021-11-01,BWA,Pulau Pinang,0,0,0
2021-11-01,BWA,Sabah,0,0,0
2021-11-01,BWA,Sarawak,0,0,0
2021-11-01,BWA,Selangor,0,0,0
2021-11-01,CAF,Kedah,0,0,0
2021-11-01,CAF,Selangor,1,1,0
2021-11-01,CAN,Johor,1,1,0
2021-11-01,CAN,Kedah,0,0,0
2021-11-01,CAN,Kelantan,0,0,0
2021-11-01,CAN,Melaka,0,0,0
2021-11-01,CAN,Negeri Sembilan,0,0,0
2021-11-01,CAN,Pahang,0,0,0
2021-11-01,CAN,Perak,0,0,0
2021-11-01,CAN,Perlis,0,0,0
2021-11-01,CAN,Pulau Pinang,4,2,2
2021-11-01,CAN,Sabah,0,0,0
2021-11-01,CAN,Sarawak,1,1,0
2021-11-01,CAN,Selangor,79,44,35
2021-11-01,CAN,Terengganu,0,0,0
2021-11-01,CAN,W.P. Labuan,0,0,0
2021-11-01,CCK,Selangor,0,0,0
2021-11-01,CHE,Johor,0,0,0
2021-11-01,CHE,Kedah,0,0,0
2021-11-01,CHE,Kelantan,0,0,0
2021-11-01,CHE,Melaka,0,0,0
2021-11-01,CHE,Negeri Sembilan,0,0,0
2021-11-01,CHE,Pahang,0,0,0
2021-11-01,CHE,Perak,0,0,0
2021-11-01,CHE,Perlis,0,0,0
2021-11-01,CHE,Pulau Pinang,3,0,3
2021-11-01,CHE,Sabah,0,0,0
2021-11-01,CHE,Sarawak,0,0,0
2021-11-01,CHE,Selangor,28,17,11
2021-11-01,CHE,W.P. Labuan,0,0,0
2021-11-01,CHL,Johor,0,0,0
2021-11-01,CHL,Kedah,0,0,0
2021-11-01,CHL,Kelantan,0,0,0
2021-11-01,CHL,Melaka,0,0,0
2021-11-01,CHL,Pahang,0,0,0
2021-11-01,CHL,Perak,0,0,0
2021-11-01,CHL,Perlis,0,0,0
2021-11-01,CHL,Pulau Pinang,0,0,0
2021-11-01,CHL,Sabah,0,0,0
2021-11-01,CHL,Sarawak,0,0,0
2021-11-01,CHL,Selangor,2,0,2
2021-11-01,CHN,Johor,61,59,2
2021-11-01,CHN,Kedah,0,0,0
2021-11-01,CHN,Kelantan,0,0,0
2021-11-01,CHN,Melaka,0,0,0
2021-11-01,CHN,Pahang,0,0,0
2021-11-01,CHN,Perak,0,0,0
2021-11-01,CHN,Perlis,0,0,0
2021-11-01,CHN,Pulau Pinang,1,0,1
2021-11-01,CHN,Sabah,2,1,1
2021-11-01,CHN,Sarawak,64,60,4
2021-11-01,CHN,Selangor,1249,961,288
2021-11-01,CHN,Terengganu,0,0,0
2021-11-01,CHN,W.P. Labuan,0,0,0
2021-11-01,CIV,Johor,0,0,0
2021-11-01,CIV,Kedah,0,0,0
2021-11-01,CIV,Pulau Pinang,0,0,0
2021-11-01,CIV,Sabah,0,0,0
2021-11-01,CIV,Sarawak,0,0,0
2021-11-01,CIV,Selangor,0,0,0
2021-11-01,CMR,Johor,0,0,0
2021-11-01,CMR,Kedah,0,0,0
2021-11-01,CMR,Pulau Pinang,0,0,0
2021-11-01,CMR,Sabah,0,0,0
2021-11-01,CMR,Sarawak,0,0,0
2021-11-01,CMR,Selangor,1,1,0
2021-11-01,COD,Johor,0,0,0
2021-11-01,COD,Pulau Pinang,0,0,0
2021-11-01,COD,Sarawak,0,0,0
2021-11-01,COD,Selangor,0,0,0
2021-11-01,COG,Johor,0,0,0
2021-11-01,COG,Kedah,0,0,0
2021-11-01,COG,Selangor,0,0,0
2021-11-01,COK,Selangor,0,0,0
2021-11-01,COL,Johor,0,0,0
2021-11-01,COL,Kedah,0,0,0
2021-11-01,COL,Perak,0,0,0
2021-11-01,COL,Pulau Pinang,0,0,0
2021-11-01,COL,Sabah,0,0,0
2021-11-01,COL,Sarawak,0,0,0
2021-11-01,COL,Selangor,5,3,2
2021-11-01,COL,W.P. Labuan,0,0,0
2021-11-01,COM,Johor,0,0,0
2021-11-01,COM,Kedah,0,0,0
2021-11-01,COM,Selangor,1,0,1
2021-11-01,CPV,Johor,0,0,0
2021-11-01,CPV,Kedah,0,0,0
2021-11-01,CPV,Pulau Pinang,0,0,0
2021-11-01,CPV,Sabah,0,0,0
2021-11-01,CPV,Selangor,0,0,0
2021-11-01,CRI,Johor,0,0,0
2021-11-01,CRI,Kedah,0,0,0
2021-11-01,CRI,Perak,0,0,0
2021-11-01,CRI,Perlis,0,0,0
2021-11-01,CRI,Pulau Pinang,0,0,0
2021-11-01,CRI,Sabah,0,0,0
2021-11-01,CRI,Sarawak,0,0,0
2021-11-01,CRI,Selangor,3,1,2
2021-11-01,CUB,Johor,0,0,0
2021-11-01,CUB,Kedah,0,0,0
2021-11-01,CUB,Perlis,0,0,0
2021-11-01,CUB,Pulau Pinang,0,0,0
2021-11-01,CUB,Sabah,0,0,0
2021-11-01,CUB,Sarawak,0,0,0
2021-11-01,CUB,Selangor,0,0,0
2021-11-01,CYP,Johor,0,0,0
2021-11-01,CYP,Kedah,0,0,0
2021-11-01,CYP,Perak,0,0,0
2021-11-01,CYP,Perlis,0,0,0
2021-11-01,CYP,Pulau Pinang,0,0,0
2021-11-01,CYP,Sabah,0,0,0
2021-11-01,CYP,Sarawak,0,0,0
2021-11-01,CYP,Selangor,0,0,0
2021-11-01,CZE,Johor,0,0,0
2021-11-01,CZE,Kedah,0,0,0
2021-11-01,CZE,Kelantan,0,0,0
2021-11-01,CZE,Melaka,0,0,0
2021-11-01,CZE,Negeri Sembilan,0,0,0
2021-11-01,CZE,Perak,0,0,0
2021-11-01,CZE,Perlis,0,0,0
2021-11-01,CZE,Pulau Pinang,0,0,0
2021-11-01,CZE,Sabah,0,0,0
2021-11-01,CZE,Sarawak,0,0,0
2021-11-01,CZE,Selangor,13,10,3
2021-11-01,CZE,W.P. Labuan,0,0,0
2021-11-01,DEU,Johor,0,0,0
2021-11-01,DEU,Kedah,0,0,0
2021-11-01,DEU,Kelantan,0,0,0
2021-11-01,DEU,Melaka,0,0,0
2021-11-01,DEU,Negeri Sembilan,0,0,0
2021-11-01,DEU,Pahang,0,0,0
2021-11-01,DEU,Perak,0,0,0
2021-11-01,DEU,Perlis,0,0,0
2021-11-01,DEU,Pulau Pinang,7,7,0
2021-11-01,DEU,Sabah,0,0,0
2021-11-01,DEU,Sarawak,1,1,0
2021-11-01,DEU,Selangor,163,138,25
2021-11-01,DEU,Terengganu,0,0,0
2021-11-01,DEU,W.P. Labuan,0,0,0
2021-11-01,DJI,Johor,0,0,0
2021-11-01,DJI,Selangor,3,2,1
2021-11-01,DMA,Johor,0,0,0
2021-11-01,DMA,Kedah,0,0,0
2021-11-01,DMA,Pulau Pinang,0,0,0
2021-11-01,DMA,Sabah,0,0,0
2021-11-01,DMA,Sarawak,0,0,0
2021-11-01,DMA,Selangor,8,3,5
2021-11-01,DMA,W.P. Labuan,0,0,0
2021-11-01,DNK,Johor,0,0,0
2021-11-01,DNK,Kedah,0,0,0
2021-11-01,DNK,Kelantan,0,0,0
2021-11-01,DNK,Melaka,0,0,0
2021-11-01,DNK,Negeri Sembilan,0,0,0
2021-11-01,DNK,Pahang,0,0,0
2021-11-01,DNK,Perak,0,0,0
2021-11-01,DNK,Perlis,0,0,0
2021-11-01,DNK,Pulau Pinang,2,2,0
2021-11-01,DNK,Sabah,0,0,0
2021-11-01,DNK,Sarawak,0,0,0
2021-11-01,DNK,Selangor,34,30,4
2021-11-01,DNK,W.P. Labuan,0,0,0
2021-11-01,DOM,Johor,0,0,0
2021-11-01,DOM,Kedah,0,0,0
2021-11-01,DOM,Perak,0,0,0
2021-11-01,DOM,Perlis,0,0,0
2021-11-01,DOM,Pulau Pinang,0,0,0
2021-11-01,DOM,Sabah,0,0,0
2021-11-01,DOM,Sarawak,0,0,0
2021-11-01,DOM,Selangor,0,0,0
2021-11-01,DZA,Johor,0,0,0
2021-11-01,DZA,Kedah,0,0,0
2021-11-01,DZA,Kelantan,0,0,0
2021-11-01,DZA,Melaka,0,0,0
2021-11-01,DZA,Perak,0,0,0
2021-11-01,DZA,Perlis,0,0,0
2021-11-01,DZA,Pulau Pinang,0,0,0
2021-11-01,DZA,Sabah,0,0,0
2021-11-01,DZA,Sarawak,0,0,0
2021-11-01,DZA,Selangor,26,18,8
2021-11-01,DZA,W.P. Labuan,0,0,0
2021-11-01,ECU,Johor,0,0,0
2021-11-01,ECU,Kedah,0,0,0
2021-11-01,ECU,Perak,0,0,0
2021-11-01,ECU,Perlis,0,0,0
2021-11-01,ECU,Pulau Pinang,0,0,0
2021-11-01,ECU,Sabah,0,0,0
2021-11-01,ECU,Sarawak,0,0,0
2021-11-01,ECU,Selangor,0,0,0
2021-11-01,EGY,Johor,0,0,0
2021-11-01,EGY,Kedah,0,0,0
2021-11-01,EGY,Kelantan,0,0,0
2021-11-01,EGY,Melaka,0,0,0
2021-11-01,EGY,Pahang,0,0,0
2021-11-01,EGY,Perak,0,0,0
2021-11-01,EGY,Perlis,0,0,0
2021-11-01,EGY,Pulau Pinang,0,0,0
2021-11-01,EGY,Sabah,0,0,0
2021-11-01,EGY,Sarawak,0,0,0
2021-11-01,EGY,Selangor,213,160,53
2021-11-01,EGY,Terengganu,0,0,0
2021-11-01,EGY,W.P. Labuan,0,0,0
2021-11-01,ERI,Johor,0,0,0
2021-11-01,ERI,Pulau Pinang,0,0,0
2021-11-01,ERI,Sabah,0,0,0
2021-11-01,ERI,Selangor,1,0,1
2021-11-01,ESP,Johor,0,0,0
2021-11-01,ESP,Kedah,0,0,0
2021-11-01,ESP,Kelantan,0,0,0
2021-11-01,ESP,Melaka,0,0,0
2021-11-01,ESP,Negeri Sembilan,0,0,0
2021-11-01,ESP,Pahang,0,0,0
2021-11-01,ESP,Perak,0,0,0
2021-11-01,ESP,Perlis,0,0,0
2021-11-01,ESP,Pulau Pinang,0,0,0
2021-11-01,ESP,Sabah,0,0,0
2021-11-01,ESP,Sarawak,0,0,0
2021-11-01,ESP,Selangor,44,31,13
2021-11-01,ESP,W.P. Labuan,0,0,0
2021-11-01,EST,Johor,0,0,0
2021-11-01,EST,Kedah,1,1,0
2021-11-01,EST,Kelantan,0,0,0
2021-11-01,EST,Pahang,0,0,0
2021-11-01,EST,Perak,0,0,0
2021-11-01,EST,Perlis,0,0,0
2021-11-01,EST,Pulau Pinang,0,0,0
2021-11-01,EST,Sabah,0,0,0
2021-11-01,EST,Sarawak,0,0,0
2021-11-01,EST,Selangor,6,6,0
2021-11-01,EST,W.P. Labuan,0,0,0
2021-11-01,ETH,Johor,0,0,0
2021-11-01,ETH,Kedah,0,0,0
2021-11-01,ETH,Pulau Pinang,0,0,0
2021-11-01,ETH,Sarawak,0,0,0
2021-11-01,ETH,Selangor,10,2,8
2021-11-01,FIN,Johor,0,0,0
2021-11-01,FIN,Kedah,0,0,0
2021-11-01,FIN,Kelantan,0,0,0
2021-11-01,FIN,Melaka,0,0,0
2021-11-01,FIN,Negeri Sembilan,0,0,0
2021-11-01,FIN,Pahang,0,0,0
2021-11-01,FIN,Perak,0,0,0
2021-11-01,FIN,Perlis,0,0,0
2021-11-01,FIN,Pulau Pinang,0,0,0
2021-11-01,FIN,Sabah,0,0,0
2021-11-01,FIN,Sarawak,0,0,0
2021-11-01,FIN,Selangor,19,18,1
2021-11-01,FIN,W.P. Labuan,0,0,0
2021-11-01,FJI,Johor,0,0,0
2021-11-01,FJI,Kedah,0,0,0
2021-11-01,FJI,Kelantan,0,0,0
2021-11-01,FJI,Perak,0,0,0
2021-11-01,FJI,Perlis,0,0,0
2021-11-01,FJI,Pulau Pinang,0,0,0
2021-11-01,FJI,Sabah,0,0,0
2021-11-01,FJI,Sarawak,0,0,0
2021-11-01,FJI,Selangor,2,0,2
2021-11-01,FRA,Johor,0,0,0
2021-11-01,FRA,Kedah,0,0,0
2021-11-01,FRA,Kelantan,0,0,0
2021-11-01,FRA,Melaka,0,0,0
2021-11-01,FRA,Negeri Sembilan,0,0,0
2021-11-01,FRA,Pahang,0,0,0
2021-11-01,FRA,Perak,0,0,0
2021-11-01,FRA,Perlis,0,0,0
2021-11-01,FRA,Pulau Pinang,3,3,0
2021-11-01,FRA,Sabah,0,0,0
2021-11-01,FRA,Sarawak,2,2,0
2021-11-01,FRA,Selangor,166,120,46
2021-11-01,FRA,Terengganu,0,0,0
2021-11-01,FRA,W.P. Labuan,0,0,0
2021-11-01,FSM,Johor,0,0,0
2021-11-01,FSM,Pulau Pinang,0,0,0
2021-11-01,FSM,Selangor,0,0,0
2021-11-01,GAB,Johor,0,0,0
2021-11-01,GAB,Pulau Pinang,0,0,0
2021-11-01,GAB,Sarawak,0,0,0
2021-11-01,GAB,Selangor,1,1,0
2021-11-01,GBR,Johor,0,0,0
2021-11-01,GBR,Kedah,0,0,0
2021-11-01,GBR,Kelantan,0,0,0
2021-11-01,GBR,Melaka,0,0,0
2021-11-01,GBR,Negeri Sembilan,0,0,0
2021-11-01,GBR,Pahang,0,0,0
2021-11-01,GBR,Perak,0,0,0
2021-11-01,GBR,Perlis,0,0,0
2021-11-01,GBR,Pulau Pinang,18,11,7
2021-11-01,GBR,Sabah,0,0,0
2021-11-01,GBR,Sarawak,4,3,1
2021-11-01,GBR,Selangor,433,333,100
2021-11-01,GBR,Terengganu,0,0,0
2021-11-01,GBR,W.P. Labuan,0,0,0
2021-11-01,GEO,Johor,1,1,0
2021-11-01,GEO,Kedah,0,0,0
2021-11-01,GEO,Melaka,0,0,0
2021-11-01,GEO,Perak,0,0,0
2021-11-01,GEO,Perlis,0,0,0
2021-11-01,GEO,Pulau Pinang,0,0,0
2021-11-01,GEO,Sabah,0,0,0
2021-11-01,GEO,Sarawak,0,0,0
2021-11-01,GEO,Selangor,1,1,0
2021-11-01,GHA,Johor,0,0,0
2021-11-01,GHA,Kedah,0,0,0
2021-11-01,GHA,Kelantan,0,0,0
2021-11-01,GHA,Pulau Pinang,0,0,0
2021-11-01,GHA,Sabah,0,0,0
2021-11-01,GHA,Sarawak,0,0,0
2021-11-01,GHA,Selangor,2,1,1
2021-11-01,GIB,Johor,0,0,0
2021-11-01,GIB,Sarawak,0,0,0
2021-11-01,GIN,Johor,0,0,0
2021-11-01,GIN,Kedah,0,0,0
2021-11-01,GIN,Kelantan,0,0,0
2021-11-01,GIN,Perlis,0,0,0
2021-11-01,GIN,Pulau Pinang,0,0,0
2021-11-01,GIN,Sabah,0,0,0
2021-11-01,GIN,Sarawak,0,0,0
2021-11-01,GIN,Selangor,4,4,0
2021-11-01,GLP,Selangor,0,0,0
2021-11-01,GMB,Johor,0,0,0
2021-11-01,GMB,Kedah,0,0,0
2021-11-01,GMB,Kelantan,0,0,0
2021-11-01,GMB,Pulau Pinang,0,0,0
2021-11-01,GMB,Sabah,0,0,0
2021-11-01,GMB,Sarawak,0,0,0
2021-11-01,GMB,Selangor,3,1,2
2021-11-01,GNB,Johor,0,0,0
2021-11-01,GNB,Selangor,0,0,0
2021-11-01,GNQ,Johor,0,0,0
2021-11-01,GNQ,Selangor,0,0,0
2021-11-01,GRC,Johor,0,0,0
2021-11-01,GRC,Kedah,0,0,0
2021-11-01,GRC,Kelantan,0,0,0
2021-11-01,GRC,Melaka,0,0,0
2021-11-01,GRC,Negeri Sembilan,0,0,0
2021-11-01,GRC,Pahang,0,0,0
2021-11-01,GRC,Perak,0,0,0
2021-11-01,GRC,Perlis,0,0,0
2021-11-01,GRC,Pulau Pinang,0,0,0
2021-11-01,GRC,Sabah,0,0,0
2021-11-01,GRC,Sarawak,0,0,0
2021-11-01,GRC,Selangor,15,14,1
2021-11-01,GRD,Johor,0,0,0
2021-11-01,GRD,Kedah,0,0,0
2021-11-01,GRD,Pulau Pinang,0,0,0
2021-11-01,GRD,Sabah,0,0,0
2021-11-01,GRD,Sarawak,0,0,0
2021-11-01,GRD,Selangor,0,0,0
2021-11-01,GRL,Johor,0,0,0
2021-11-01,GRL,Selangor,0,0,0
2021-11-01,GTM,Johor,0,0,0
2021-11-01,GTM,Kedah,0,0,0
2021-11-01,GTM,Pahang,0,0,0
2021-11-01,GTM,Perak,0,0,0
2021-11-01,GTM,Pulau Pinang,0,0,0
2021-11-01,GTM,Sabah,0,0,0
2021-11-01,GTM,Sarawak,0,0,0
2021-11-01,GTM,Selangor,0,0,0
2021-11-01,GTM,W.P. Labuan,0,0,0
2021-11-01,GUY,Johor,0,0,0
2021-11-01,GUY,Kedah,0,0,0
2021-11-01,GUY,Pulau Pinang,0,0,0
2021-11-01,GUY,Sarawak,0,0,0
2021-11-01,GUY,Selangor,0,0,0
2021-11-01,HKG,Johor,0,0,0
2021-11-01,HKG,Kedah,0,0,0
2021-11-01,HKG,Kelantan,0,0,0
2021-11-01,HKG,Pahang,0,0,0
2021-11-01,HKG,Perak,0,0,0
2021-11-01,HKG,Perlis,0,0,0
2021-11-01,HKG,Pulau Pinang,4,2,2
2021-11-01,HKG,Sabah,0,0,0
2021-11-01,HKG,Sarawak,30,28,2
2021-11-01,HKG,Selangor,10,9,1
2021-11-01,HKG,Terengganu,0,0,0
2021-11-01,HMD,Johor,0,0,0
2021-11-01,HND,Johor,0,0,0
2021-11-01,HND,Kedah,0,0,0
2021-11-01,HND,Perak,0,0,0
2021-11-01,HND,Pulau Pinang,0,0,0
2021-11-01,HND,Sabah,0,0,0
2021-11-01,HND,Sarawak,0,0,0
2021-11-01,HND,Selangor,0,0,0
2021-11-01,HRV,Johor,0,0,0
2021-11-01,HRV,Kedah,0,0,0
2021-11-01,HRV,Kelantan,0,0,0
2021-11-01,HRV,Melaka,0,0,0
2021-11-01,HRV,Pahang,0,0,0
2021-11-01,HRV,Perak,0,0,0
2021-11-01,HRV,Perlis,0,0,0
2021-11-01,HRV,Pulau Pinang,0,0,0
2021-11-01,HRV,Sabah,0,0,0
2021-11-01,HRV,Sarawak,0,0,0
2021-11-01,HRV,Selangor,19,18,1
2021-11-01,HTI,Johor,0,0,0
2021-11-01,HTI,Kedah,0,0,0
2021-11-01,HTI,Kelantan,0,0,0
2021-11-01,HTI,Perak,0,0,0
2021-11-01,HTI,Pulau Pinang,0,0,0
2021-11-01,HTI,Sabah,0,0,0
2021-11-01,HTI,Selangor,0,0,0
2021-11-01,HUN,Johor,0,0,0
2021-11-01,HUN,Kedah,0,0,0
2021-11-01,HUN,Kelantan,0,0,0
2021-11-01,HUN,Pahang,0,0,0
2021-11-01,HUN,Perak,0,0,0
2021-11-01,HUN,Perlis,0,0,0
2021-11-01,HUN,Pulau Pinang,0,0,0
2021-11-01,HUN,Sabah,0,0,0
2021-11-01,HUN,Sarawak,0,0,0
2021-11-01,HUN,Selangor,5,3,2
2021-11-01,HUN,W.P. Labuan,0,0,0
2021-11-01,IDN,Johor,204,130,74
2021-11-01,IDN,Kedah,4,4,0
2021-11-01,IDN,Kelantan,0,0,0
2021-11-01,IDN,Melaka,0,0,0
2021-11-01,IDN,Negeri Sembilan,0,0,0
2021-11-01,IDN,Pahang,0,0,0
2021-11-01,IDN,Perak,0,0,0
2021-11-01,IDN,Perlis,4,4,0
2021-11-01,IDN,Pulau Pinang,45,18,27
2021-11-01,IDN,Sabah,10,4,6
2021-11-01,IDN,Sarawak,265,250,15
2021-11-01,IDN,Selangor,1970,915,1055
2021-11-01,IDN,Terengganu,0,0,0
2021-11-01,IDN,W.P. Labuan,0,0,0
2021-11-01,IND,Johor,12,12,0
2021-11-01,IND,Kedah,0,0,0
2021-11-01,IND,Kelantan,0,0,0
2021-11-01,IND,Melaka,0,0,0
2021-11-01,IND,Negeri Sembilan,0,0,0
2021-11-01,IND,Pahang,0,0,0
2021-11-01,IND,Perak,0,0,0
2021-11-01,IND,Perlis,0,0,0
2021-11-01,IND,Pulau Pinang,5,4,1
2021-11-01,IND,Sabah,1,1,0
2021-11-01,IND,Sarawak,0,0,0
2021-11-01,IND,Selangor,2054,1623,431
2021-11-01,IND,Terengganu,0,0,0
2021-11-01,IND,W.P. Labuan,0,0,0
2021-11-01,IOT,Pulau Pinang,0,0,0
2021-11-01,IOT,Selangor,0,0,0
2021-11-01,IRL,Johor,0,0,0
2021-11-01,IRL,Kedah,0,0,0
2021-11-01,IRL,Kelantan,0,0,0
2021-11-01,IRL,Negeri Sembilan,0,0,0
2021-11-01,IRL,Pahang,0,0,0
2021-11-01,IRL,Perak,0,0,0
2021-11-01,IRL,Perlis,0,0,0
2021-11-01,IRL,Pulau Pinang,0,0,0
2021-11-01,IRL,Sabah,0,0,0
2021-11-01,IRL,Sarawak,1,1,0
2021-11-01,IRL,Selangor,24,15,9
2021-11-01,IRL,Terengganu,0,0,0
2021-11-01,IRL,W.P. Labuan,0,0,0
2021-11-01,IRN,Johor,0,0,0
2021-11-01,IRN,Kedah,0,0,0
2021-11-01,IRN,Kelantan,0,0,0
2021-11-01,IRN,Perak,0,0,0
2021-11-01,IRN,Perlis,0,0,0
2021-11-01,IRN,Pulau Pinang,0,0,0
2021-11-01,IRN,Sabah,0,0,0
2021-11-01,IRN,Sarawak,0,0,0
2021-11-01,IRN,Selangor,99,58,41
2021-11-01,IRN,W.P. Labuan,0,0,0
2021-11-01,IRQ,Johor,0,0,0
2021-11-01,IRQ,Kedah,0,0,0
2021-11-01,IRQ,Kelantan,0,0,0
2021-11-01,IRQ,Melaka,0,0,0
2021-11-01,IRQ,Pahang,0,0,0
2021-11-01,IRQ,Perak,0,0,0
2021-11-01,IRQ,Perlis,0,0,0
2021-11-01,IRQ,Pulau Pinang,0,0,0
2021-11-01,IRQ,Sabah,0,0,0
2021-11-01,IRQ,Sarawak,0,0,0
2021-11-01,IRQ,Selangor,104,73,31
2021-11-01,ISL,Johor,0,0,0
2021-11-01,ISL,Kedah,0,0,0
2021-11-01,ISL,Kelantan,0,0,0
2021-11-01,ISL,Perak,0,0,0
2021-11-01,ISL,Perlis,0,0,0
2021-11-01,ISL,Pulau Pinang,0,0,0
2021-11-01,ISL,Sabah,0,0,0
2021-11-01,ISL,Sarawak,0,0,0
2021-11-01,ISL,Selangor,0,0,0
2021-11-01,ISL,W.P. Labuan,0,0,0
2021-11-01,ISR,Pulau Pinang,0,0,0
2021-11-01,ITA,Johor,0,0,0
2021-11-01,ITA,Kedah,0,0,0
2021-11-01,ITA,Kelantan,0,0,0
2021-11-01,ITA,Melaka,0,0,0
2021-11-01,ITA,Negeri Sembilan,0,0,0
2021-11-01,ITA,Pahang,0,0,0
2021-11-01,ITA,Perak,0,0,0
2021-11-01,ITA,Perlis,0,0,0
2021-11-01,ITA,Pulau Pinang,1,1,0
2021-11-01,ITA,Sabah,0,0,0
2021-11-01,ITA,Sarawak,0,0,0
2021-11-01,ITA,Selangor,73,61,12
2021-11-01,ITA,W.P. Labuan,0,0,0
2021-11-01,JAM,Johor,0,0,0
2021-11-01,JAM,Kedah,0,0,0
2021-11-01,JAM,Perak,0,0,0
2021-11-01,JAM,Pulau Pinang,0,0,0
2021-11-01,JAM,Sabah,0,0,0
2021-11-01,JAM,Sarawak,0,0,0
2021-11-01,JAM,Selangor,0,0,0
2021-11-01,JAM,W.P. Labuan,0,0,0
2021-11-01,JOR,Johor,0,0,0
2021-11-01,JOR,Kedah,0,0,0
2021-11-01,JOR,Kelantan,0,0,0
2021-11-01,JOR,Melaka,0,0,0
2021-11-01,JOR,Perlis,0,0,0
2021-11-01,JOR,Pulau Pinang,0,0,0
2021-11-01,JOR,Sabah,0,0,0
2021-11-01,JOR,Sarawak,1,1,0
2021-11-01,JOR,Selangor,50,45,5
2021-11-01,JOR,W.P. Labuan,0,0,0
2021-11-01,JPN,Johor,0,0,0
2021-11-01,JPN,Kedah,0,0,0
2021-11-01,JPN,Kelantan,0,0,0
2021-11-01,JPN,Melaka,0,0,0
2021-11-01,JPN,Negeri Sembilan,0,0,0
2021-11-01,JPN,Pahang,0,0,0
2021-11-01,JPN,Perak,0,0,0
2021-11-01,JPN,Perlis,0,0,0
2021-11-01,JPN,Pulau Pinang,54,38,16
2021-11-01,JPN,Sabah,1,1,0
2021-11-01,JPN,Sarawak,5,3,2
2021-11-01,JPN,Selangor,732,505,227
2021-11-01,JPN,W.P. Labuan,0,0,0
2021-11-01,KAZ,Johor,0,0,0
2021-11-01,KAZ,Kedah,0,0,0
2021-11-01,KAZ,Kelantan,0,0,0
2021-11-01,KAZ,Melaka,0,0,0
2021-11-01,KAZ,Perak,0,0,0
2021-11-01,KAZ,Perlis,0,0,0
2021-11-01,KAZ,Pulau Pinang,0,0,0
2021-11-01,KAZ,Sabah,0,0,0
2021-11-01,KAZ,Sarawak,0,0,0
2021-11-01,KAZ,Selangor,25,13,12
2021-11-01,KAZ,W.P. Labuan,0,0,0
2021-11-01,KEN,Johor,0,0,0
2021-11-01,KEN,Kedah,0,0,0
2021-11-01,KEN,Kelantan,0,0,0
2021-11-01,KEN,Perak,0,0,0
2021-11-01,KEN,Perlis,0,0,0
2021-11-01,KEN,Pulau Pinang,0,0,0
2021-11-01,KEN,Sabah,0,0,0
2021-11-01,KEN,Sarawak,0,0,0
2021-11-01,KEN,Selangor,42,32,10
2021-11-01,KGZ,Johor,0,0,0
2021-11-01,KGZ,Kedah,0,0,0
2021-11-01,KGZ,Kelantan,0,0,0
2021-11-01,KGZ,Perak,0,0,0
2021-11-01,KGZ,Perlis,0,0,0
2021-11-01,KGZ,Pulau Pinang,0,0,0
2021-11-01,KGZ,Sabah,0,0,0
2021-11-01,KGZ,Sarawak,0,0,0
2021-11-01,KGZ,Selangor,6,2,4
2021-11-01,KHM,Johor,0,0,0
2021-11-01,KHM,Kedah,0,0,0
2021-11-01,KHM,Kelantan,0,0,0
2021-11-01,KHM,Melaka,0,0,0
2021-11-01,KHM,Negeri Sembilan,0,0,0
2021-11-01,KHM,Pahang,0,0,0
2021-11-01,KHM,Perak,0,0,0
2021-11-01,KHM,Perlis,0,0,0
2021-11-01,KHM,Pulau Pinang,18,17,1
2021-11-01,KHM,Sabah,0,0,0
2021-11-01,KHM,Sarawak,1,1,0
2021-11-01,KHM,Selangor,28,15,13
2021-11-01,KHM,W.P. Labuan,0,0,0
2021-11-01,KIR,Johor,0,0,0
2021-11-01,KIR,Sabah,0,0,0
2021-11-01,KIR,Selangor,0,0,0
2021-11-01,KNA,Johor,0,0,0
2021-11-01,KNA,Kedah,0,0,0
2021-11-01,KNA,Perlis,0,0,0
2021-11-01,KNA,Pulau Pinang,0,0,0
2021-11-01,KNA,Sabah,0,0,0
2021-11-01,KNA,Selangor,0,0,0
2021-11-01,KNA,W.P. Labuan,0,0,0
2021-11-01,KOR,Johor,2,1,1
2021-11-01,KOR,Kedah,0,0,0
2021-11-01,KOR,Kelantan,0,0,0
2021-11-01,KOR,Melaka,0,0,0
2021-11-01,KOR,Negeri Sembilan,0,0,0
2021-11-01,KOR,Pahang,0,0,0
2021-11-01,KOR,Perak,1,1,0
2021-11-01,KOR,Perlis,0,0,0
2021-11-01,KOR,Pulau Pinang,34,13,21
2021-11-01,KOR,Sabah,6,3,3
2021-11-01,KOR,Sarawak,34,31,3
2021-11-01,KOR,Selangor,546,337,209
2021-11-01,KOR,Terengganu,0,0,0
2021-11-01,KOR,W.P. Labuan,0,0,0
2021-11-01,KWT,Johor,0,0,0
2021-11-01,KWT,Kedah,0,0,0
2021-11-01,KWT,Kelantan,0,0,0
2021-11-01,KWT,Perak,0,0,0
2021-11-01,KWT,Perlis,0,0,0
2021-11-01,KWT,Pulau Pinang,0,0,0
2021-11-01,KWT,Sabah,0,0,0
2021-11-01,KWT,Sarawak,0,0,0
2021-11-01,KWT,Selangor,2,2,0
2021-11-01,KWT,W.P. Labuan,0,0,0
2021-11-01,LAO,Johor,0,0,0
2021-11-01,LAO,Kedah,0,0,0
2021-11-01,LAO,Kelantan,0,0,0
2021-11-01,LAO,Melaka,0,0,0
2021-11-01,LAO,Perak,0,0,0
2021-11-01,LAO,Perlis,0,0,0
2021-11-01,LAO,Pulau Pinang,0,0,0
2021-11-01,LAO,Sabah,0,0,0
2021-11-01,LAO,Sarawak,0,0,0
2021-11-01,LAO,Selangor,1,0,1
2021-11-01,LAO,W.P. Labuan,0,0,0
2021-11-01,LBN,Johor,0,0,0
2021-11-01,LBN,Kedah,0,0,0
2021-11-01,LBN,Kelantan,0,0,0
2021-11-01,LBN,Pahang,0,0,0
2021-11-01,LBN,Perak,0,0,0
2021-11-01,LBN,Perlis,0,0,0
2021-11-01,LBN,Pulau Pinang,0,0,0
2021-11-01,LBN,Sabah,0,0,0
2021-11-01,LBN,Sarawak,0,0,0
2021-11-01,LBN,Selangor,14,9,5
2021-11-01,LBN,W.P. Labuan,0,0,0
2021-11-01,LBR,Johor,0,0,0
2021-11-01,LBR,Kedah,0,0,0
2021-11-01,LBR,Sabah,0,0,0
2021-11-01,LBR,Sarawak,0,0,0
2021-11-01,LBR,Selangor,0,0,0
2021-11-01,LBY,Johor,0,0,0
2021-11-01,LBY,Kedah,0,0,0
2021-11-01,LBY,Perlis,0,0,0
2021-11-01,LBY,Pulau Pinang,0,0,0
2021-11-01,LBY,Sabah,0,0,0
2021-11-01,LBY,Sarawak,0,0,0
2021-11-01,LBY,Selangor,58,49,9
2021-11-01,LCA,Johor,0,0,0
2021-11-01,LCA,Kedah,0,0,0
2021-11-01,LCA,Pulau Pinang,0,0,0
2021-11-01,LCA,Sarawak,0,0,0
2021-11-01,LCA,Selangor,1,1,0
2021-11-01,LIE,Johor,0,0,0
2021-11-01,LIE,Kedah,0,0,0
2021-11-01,LIE,Perlis,0,0,0
2021-11-01,LIE,Pulau Pinang,0,0,0
2021-11-01,LIE,Sabah,0,0,0
2021-11-01,LIE,Sarawak,0,0,0
2021-11-01,LIE,Selangor,0,0,0
2021-11-01,LKA,Johor,0,0,0
2021-11-01,LKA,Kedah,0,0,0
2021-11-01,LKA,Kelantan,0,0,0
2021-11-01,LKA,Melaka,0,0,0
2021-11-01,LKA,Pahang,0,0,0
2021-11-01,LKA,Perak,0,0,0
2021-11-01,LKA,Perlis,0,0,0
2021-11-01,LKA,Pulau Pinang,0,0,0
2021-11-01,LKA,Sabah,0,0,0
2021-11-01,LKA,Sarawak,1,1,0
2021-11-01,LKA,Selangor,126,76,50
2021-11-01,LKA,W.P. Labuan,0,0,0
2021-11-01,LSO,Johor,0,0,0
2021-11-01,LSO,Kedah,0,0,0
2021-11-01,LSO,Pulau Pinang,0,0,0
2021-11-01,LSO,Sarawak,0,0,0
2021-11-01,LSO,Selangor,0,0,0
2021-11-01,LTU,Johor,0,0,0
2021-11-01,LTU,Kedah,0,0,0
2021-11-01,LTU,Kelantan,0,0,0
2021-11-01,LTU,Pahang,0,0,0
2021-11-01,LTU,Perak,0,0,0
2021-11-01,LTU,Perlis,0,0,0
2021-11-01,LTU,Pulau Pinang,0,0,0
2021-11-01,LTU,Sabah,0,0,0
2021-11-01,LTU,Sarawak,0,0,0
2021-11-01,LTU,Selangor,3,2,1
2021-11-01,LTU,W.P. Labuan,0,0,0
2021-11-01,LUX,Johor,0,0,0
2021-11-01,LUX,Kedah,0,0,0
2021-11-01,LUX,Kelantan,0,0,0
2021-11-01,LUX,Perak,0,0,0
2021-11-01,LUX,Perlis,0,0,0
2021-11-01,LUX,Pulau Pinang,0,0,0
2021-11-01,LUX,Sabah,0,0,0
2021-11-01,LUX,Sarawak,0,0,0
2021-11-01,LUX,Selangor,0,0,0
2021-11-01,LVA,Johor,0,0,0
2021-11-01,LVA,Kedah,0,0,0
2021-11-01,LVA,Kelantan,0,0,0
2021-11-01,LVA,Pahang,0,0,0
2021-11-01,LVA,Perak,0,0,0
2021-11-01,LVA,Perlis,0,0,0
2021-11-01,LVA,Pulau Pinang,0,0,0
2021-11-01,LVA,Sabah,0,0,0
2021-11-01,LVA,Sarawak,0,0,0
2021-11-01,LVA,Selangor,2,2,0
2021-11-01,LVA,W.P. Labuan,0,0,0
2021-11-01,MAC,Johor,0,0,0
2021-11-01,MAC,Pahang,0,0,0
2021-11-01,MAC,Perak,0,0,0
2021-11-01,MAC,Selangor,0,0,0
2021-11-01,MAC,W.P. Labuan,0,0,0
2021-11-01,MAR,Johor,0,0,0
2021-11-01,MAR,Kedah,0,0,0
2021-11-01,MAR,Kelantan,0,0,0
2021-11-01,MAR,Melaka,0,0,0
2021-11-01,MAR,Pahang,0,0,0
2021-11-01,MAR,Perak,0,0,0
2021-11-01,MAR,Perlis,0,0,0
2021-11-01,MAR,Pulau Pinang,0,0,0
2021-11-01,MAR,Sabah,0,0,0
2021-11-01,MAR,Sarawak,0,0,0
2021-11-01,MAR,Selangor,18,9,9
2021-11-01,MAR,W.P. Labuan,0,0,0
2021-11-01,MCO,Johor,0,0,0
2021-11-01,MCO,Kedah,0,0,0
2021-11-01,MCO,Sabah,0,0,0
2021-11-01,MCO,Selangor,0,0,0
2021-11-01,MDA,Johor,0,0,0
2021-11-01,MDA,Kedah,0,0,0
2021-11-01,MDA,Kelantan,0,0,0
2021-11-01,MDA,Negeri Sembilan,0,0,0
2021-11-01,MDA,Perlis,0,0,0
2021-11-01,MDA,Pulau Pinang,0,0,0
2021-11-01,MDA,Sabah,0,0,0
2021-11-01,MDA,Sarawak,0,0,0
2021-11-01,MDA,Selangor,0,0,0
2021-11-01,MDG,Johor,0,0,0
2021-11-01,MDG,Kedah,0,0,0
2021-11-01,MDG,Perak,0,0,0
2021-11-01,MDG,Perlis,0,0,0
2021-11-01,MDG,Pulau Pinang,0,0,0
2021-11-01,MDG,Sabah,0,0,0
2021-11-01,MDG,Sarawak,0,0,0
2021-11-01,MDG,Selangor,1,0,1
2021-11-01,MDV,Johor,0,0,0
2021-11-01,MDV,Kedah,0,0,0
2021-11-01,MDV,Kelantan,0,0,0
2021-11-01,MDV,Perak,0,0,0
2021-11-01,MDV,Perlis,0,0,0
2021-11-01,MDV,Pulau Pinang,1,1,0
2021-11-01,MDV,Sabah,0,0,0
2021-11-01,MDV,Sarawak,0,0,0
2021-11-01,MDV,Selangor,99,44,55
2021-11-01,MEX,Johor,0,0,0
2021-11-01,MEX,Kedah,0,0,0
2021-11-01,MEX,Kelantan,0,0,0
2021-11-01,MEX,Pahang,0,0,0
2021-11-01,MEX,Perak,0,0,0
2021-11-01,MEX,Perlis,0,0,0
2021-11-01,MEX,Pulau Pinang,0,0,0
2021-11-01,MEX,Sabah,0,0,0
2021-11-01,MEX,Sarawak,0,0,0
2021-11-01,MEX,Selangor,7,5,2
2021-11-01,MEX,W.P. Labuan,0,0,0
2021-11-01,MHL,Johor,0,0,0
2021-11-01,MHL,Kedah,0,0,0
2021-11-01,MHL,Perak,0,0,0
2021-11-01,MHL,Pulau Pinang,0,0,0
2021-11-01,MHL,Sabah,0,0,0
2021-11-01,MHL,Selangor,0,0,0
2021-11-01,MKD,Johor,0,0,0
2021-11-01,MKD,Kedah,0,0,0
2021-11-01,MKD,Perak,0,0,0
2021-11-01,MKD,Pulau Pinang,0,0,0
2021-11-01,MKD,Sabah,0,0,0
2021-11-01,MKD,Sarawak,0,0,0
2021-11-01,MKD,Selangor,1,0,1
2021-11-01,MLI,Johor,0,0,0
2021-11-01,MLI,Sabah,0,0,0
2021-11-01,MLI,Selangor,4,4,0
2021-11-01,MLT,Johor,0,0,0
2021-11-01,MLT,Kedah,0,0,0
2021-11-01,MLT,Kelantan,0,0,0
2021-11-01,MLT,Perak,0,0,0
2021-11-01,MLT,Perlis,0,0,0
2021-11-01,MLT,Pulau Pinang,0,0,0
2021-11-01,MLT,Sabah,0,0,0
2021-11-01,MLT,Sarawak,0,0,0
2021-11-01,MLT,Selangor,1,0,1
2021-11-01,MLT,W.P. Labuan,0,0,0
2021-11-01,MMR,Johor,2,2,0
2021-11-01,MMR,Kedah,0,0,0
2021-11-01,MMR,Kelantan,0,0,0
2021-11-01,MMR,Negeri Sembilan,0,0,0
2021-11-01,MMR,Pahang,0,0,0
2021-11-01,MMR,Perak,0,0,0
2021-11-01,MMR,Perlis,0,0,0
2021-11-01,MMR,Pulau Pinang,0,0,0
2021-11-01,MMR,Sabah,0,0,0
2021-11-01,MMR,Sarawak,0,0,0
2021-11-01,MMR,Selangor,208,193,15
2021-11-01,MMR,Terengganu,0,0,0
2021-11-01,MMR,W.P. Labuan,0,0,0
2021-11-01,MNE,Johor,0,0,0
2021-11-01,MNE,Kedah,0,0,0
2021-11-01,MNE,Pulau Pinang,0,0,0
2021-11-01,MNE,Sabah,0,0,0
2021-11-01,MNE,Sarawak,0,0,0
2021-11-01,MNE,Selangor,6,6,0
2021-11-01,MNG,Johor,0,0,0
2021-11-01,MNG,Kedah,0,0,0
2021-11-01,MNG,Kelantan,0,0,0
2021-11-01,MNG,Perak,0,0,0
2021-11-01,MNG,Perlis,0,0,0
2021-11-01,MNG,Pulau Pinang,0,0,0
2021-11-01,MNG,Sabah,0,0,0
2021-11-01,MNG,Sarawak,0,0,0
2021-11-01,MNG,Selangor,2,1,1
2021-11-01,MNP,Selangor,0,0,0
2021-11-01,MOZ,Johor,0,0,0
2021-11-01,MOZ,Kedah,0,0,0
2021-11-01,MOZ,Perak,0,0,0
2021-11-01,MOZ,Pulau Pinang,0,0,0
2021-11-01,MOZ,Sabah,0,0,0
2021-11-01,MOZ,Sarawak,0,0,0
2021-11-01,MOZ,Selangor,0,0,0
2021-11-01,MRT,Johor,0,0,0
2021-11-01,MRT,Kedah,0,0,0
2021-11-01,MRT,Pulau Pinang,0,0,0
2021-11-01,MRT,Sabah,0,0,0
2021-11-01,MRT,Sarawak,0,0,0
2021-11-01,MRT,Selangor,9,8,1
2021-11-01,MUS,Johor,0,0,0
2021-11-01,MUS,Kedah,0,0,0
2021-11-01,MUS,Kelantan,0,0,0
2021-11-01,MUS,Pahang,0,0,0
2021-11-01,MUS,Perak,0,0,0
2021-11-01,MUS,Perlis,0,0,0
2021-11-01,MUS,Pulau Pinang,0,0,0
2021-11-01,MUS,Sabah,0,0,0
2021-11-01,MUS,Sarawak,0,0,0
2021-11-01,MUS,Selangor,16,9,7
2021-11-01,MWI,Johor,0,0,0
2021-11-01,MWI,Pulau Pinang,0,0,0
2021-11-01,MWI,Sabah,0,0,0
2021-11-01,MWI,Sarawak,0,0,0
2021-11-01,MWI,Selangor,4,2,2
2021-11-01,MYT,Selangor,0,0,0
2021-11-01,NAM,Johor,0,0,0
2021-11-01,NAM,Kedah,0,0,0
2021-11-01,NAM,Perak,0,0,0
2021-11-01,NAM,Perlis,0,0,0
2021-11-01,NAM,Pulau Pinang,0,0,0
2021-11-01,NAM,Sabah,0,0,0
2021-11-01,NAM,Sarawak,0,0,0
2021-11-01,NAM,Selangor,0,0,0
2021-11-01,NCL,Selangor,0,0,0
2021-11-01,NER,Johor,0,0,0
2021-11-01,NER,Sabah,0,0,0
2021-11-01,NER,Selangor,1,1,0
2021-11-01,NGA,Johor,0,0,0
2021-11-01,NGA,Kedah,0,0,0
2021-11-01,NGA,Perlis,0,0,0
2021-11-01,NGA,Pulau Pinang,0,0,0
2021-11-01,NGA,Sabah,1,1,0
2021-11-01,NGA,Sarawak,1,1,0
2021-11-01,NGA,Selangor,95,88,7
2021-11-01,NIC,Johor,0,0,0
2021-11-01,NIC,Kedah,0,0,0
2021-11-01,NIC,Pulau Pinang,0,0,0
2021-11-01,NIC,Sabah,0,0,0
2021-11-01,NIC,Selangor,0,0,0
2021-11-01,NLD,Johor,0,0,0
2021-11-01,NLD,Kedah,0,0,0
2021-11-01,NLD,Kelantan,0,0,0
2021-11-01,NLD,Melaka,0,0,0
2021-11-01,NLD,Negeri Sembilan,0,0,0
2021-11-01,NLD,Pahang,0,0,0
2021-11-01,NLD,Perak,0,0,0
2021-11-01,NLD,Perlis,0,0,0
2021-11-01,NLD,Pulau Pinang,5,3,2
2021-11-01,NLD,Sabah,0,0,0
2021-11-01,NLD,Sarawak,0,0,0
2021-11-01,NLD,Selangor,90,67,23
2021-11-01,NLD,Terengganu,0,0,0
2021-11-01,NLD,W.P. Labuan,0,0,0
2021-11-01,NOR,Johor,0,0,0
2021-11-01,NOR,Kedah,0,0,0
2021-11-01,NOR,Kelantan,0,0,0
2021-11-01,NOR,Melaka,0,0,0
2021-11-01,NOR,Pahang,0,0,0
2021-11-01,NOR,Perak,0,0,0
2021-11-01,NOR,Perlis,0,0,0
2021-11-01,NOR,Pulau Pinang,0,0,0
2021-11-01,NOR,Sabah,0,0,0
2021-11-01,NOR,Sarawak,0,0,0
2021-11-01,NOR,Selangor,28,24,4
2021-11-01,NOR,W.P. Labuan,0,0,0
2021-11-01,NPL,Johor,0,0,0
2021-11-01,NPL,Kedah,0,0,0
2021-11-01,NPL,Pahang,0,0,0
2021-11-01,NPL,Perak,0,0,0
2021-11-01,NPL,Perlis,0,0,0
2021-11-01,NPL,Pulau Pinang,0,0,0
2021-11-01,NPL,Sabah,0,0,0
2021-11-01,NPL,Sarawak,0,0,0
2021-11-01,NPL,Selangor,98,87,11
2021-11-01,NPL,W.P. Labuan,0,0,0
2021-11-01,NRU,Johor,0,0,0
2021-11-01,NRU,Pulau Pinang,0,0,0
2021-11-01,NRU,Selangor,0,0,0
2021-11-01,NZL,Johor,0,0,0
2021-11-01,NZL,Kedah,0,0,0
2021-11-01,NZL,Kelantan,0,0,0
2021-11-01,NZL,Melaka,0,0,0
2021-11-01,NZL,Negeri Sembilan,0,0,0
2021-11-01,NZL,Pahang,0,0,0
2021-11-01,NZL,Perak,0,0,0
2021-11-01,NZL,Perlis,0,0,0
2021-11-01,NZL,Pulau Pinang,0,0,0
2021-11-01,NZL,Sabah,1,1,0
2021-11-01,NZL,Sarawak,0,0,0
2021-11-01,NZL,Selangor,21,14,7
2021-11-01,NZL,Terengganu,0,0,0
2021-11-01,NZL,W.P. Labuan,0,0,0
2021-11-01,OMN,Johor,0,0,0
2021-11-01,OMN,Kedah,0,0,0
2021-11-01,OMN,Kelantan,0,0,0
2021-11-01,OMN,Melaka,0,0,0
2021-11-01,OMN,Perak,0,0,0
2021-11-01,OMN,Perlis,0,0,0
2021-11-01,OMN,Pulau Pinang,0,0,0
2021-11-01,OMN,Sabah,0,0,0
2021-11-01,OMN,Sarawak,0,0,0
2021-11-01,OMN,Selangor,16,11,5
2021-11-01,PAK,Johor,1,1,0
2021-11-01,PAK,Kedah,0,0,0
2021-11-01,PAK,Kelantan,0,0,0
2021-11-01,PAK,Melaka,0,0,0
2021-11-01,PAK,Negeri Sembilan,0,0,0
2021-11-01,PAK,Pahang,0,0,0
2021-11-01,PAK,Perak,0,0,0
2021-11-01,PAK,Perlis,0,0,0
2021-11-01,PAK,Pulau Pinang,1,1,0
2021-11-01,PAK,Sabah,1,1,0
2021-11-01,PAK,Sarawak,1,1,0
2021-11-01,PAK,Selangor,939,869,70
2021-11-01,PAK,W.P. Labuan,0,0,0
2021-11-01,PAN,Johor,0,0,0
2021-11-01,PAN,Kedah,0,0,0
2021-11-01,PAN,Perak,0,0,0
2021-11-01,PAN,Perlis,0,0,0
2021-11-01,PAN,Pulau Pinang,0,0,0
2021-11-01,PAN,Sabah,0,0,0
2021-11-01,PAN,Sarawak,0,0,0
2021-11-01,PAN,Selangor,1,1,0
2021-11-01,PER,Johor,0,0,0
2021-11-01,PER,Kedah,0,0,0
2021-11-01,PER,Kelantan,0,0,0
2021-11-01,PER,Pahang,0,0,0
2021-11-01,PER,Perak,0,0,0
2021-11-01,PER,Perlis,0,0,0
2021-11-01,PER,Pulau Pinang,0,0,0
2021-11-01,PER,Sabah,0,0,0
2021-11-01,PER,Sarawak,0,0,0
2021-11-01,PER,Selangor,3,3,0
2021-11-01,PER,W.P. Labuan,0,0,0
2021-11-01,PHL,Johor,23,21,2
2021-11-01,PHL,Kedah,0,0,0
2021-11-01,PHL,Kelantan,0,0,0
2021-11-01,PHL,Melaka,0,0,0
2021-11-01,PHL,Negeri Sembilan,0,0,0
2021-11-01,PHL,Pahang,0,0,0
2021-11-01,PHL,Perak,0,0,0
2021-11-01,PHL,Perlis,0,0,0
2021-11-01,PHL,Pulau Pinang,5,4,1
2021-11-01,PHL,Sabah,3,1,2
2021-11-01,PHL,Sarawak,45,42,3
2021-11-01,PHL,Selangor,626,502,124
2021-11-01,PHL,Terengganu,0,0,0
2021-11-01,PHL,W.P. Labuan,2,2,0
2021-11-01,PLW,Johor,0,0,0
2021-11-01,PLW,Pulau Pinang,0,0,0
2021-11-01,PLW,Selangor,0,0,0
2021-11-01,PNG,Johor,0,0,0
2021-11-01,PNG,Kedah,0,0,0
2021-11-01,PNG,Kelantan,0,0,0
2021-11-01,PNG,Perak,0,0,0
2021-11-01,PNG,Pulau Pinang,0,0,0
2021-11-01,PNG,Sabah,0,0,0
2021-11-01,PNG,Sarawak,1,0,1
2021-11-01,PNG,Selangor,1,0,1
2021-11-01,POL,Johor,2,2,0
2021-11-01,POL,Kedah,0,0,0
2021-11-01,POL,Kelantan,0,0,0
2021-11-01,POL,Melaka,0,0,0
2021-11-01,POL,Negeri Sembilan,0,0,0
2021-11-01,POL,Pahang,0,0,0
2021-11-01,POL,Perak,0,0,0
2021-11-01,POL,Perlis,0,0,0
2021-11-01,POL,Pulau Pinang,0,0,0
2021-11-01,POL,Sabah,0,0,0
2021-11-01,POL,Sarawak,1,1,0
2021-11-01,POL,Selangor,33,32,1
2021-11-01,POL,Terengganu,0,0,0
2021-11-01,POL,W.P. Labuan,0,0,0
2021-11-01,PRK,Selangor,0,0,0
2021-11-01,PRT,Johor,0,0,0
2021-11-01,PRT,Kedah,0,0,0
2021-11-01,PRT,Kelantan,0,0,0
2021-11-01,PRT,Melaka,0,0,0
2021-11-01,PRT,Pahang,0,0,0
2021-11-01,PRT,Perak,0,0,0
2021-11-01,PRT,Perlis,0,0,0
2021-11-01,PRT,Pulau Pinang,1,0,1
2021-11-01,PRT,Sabah,0,0,0
2021-11-01,PRT,Sarawak,0,0,0
2021-11-01,PRT,Selangor,15,12,3
2021-11-01,PRT,W.P. Labuan,0,0,0
2021-11-01,PRY,Johor,0,0,0
2021-11-01,PRY,Kedah,0,0,0
2021-11-01,PRY,Perak,0,0,0
2021-11-01,PRY,Perlis,0,0,0
2021-11-01,PRY,Pulau Pinang,0,0,0
2021-11-01,PRY,Sabah,0,0,0
2021-11-01,PRY,Sarawak,0,0,0
2021-11-01,PRY,Selangor,0,0,0
2021-11-01,PSE,Johor,0,0,0
2021-11-01,PSE,Kedah,0,0,0
2021-11-01,PSE,Kelantan,0,0,0
2021-11-01,PSE,Melaka,0,0,0
2021-11-01,PSE,Perak,0,0,0
2021-11-01,PSE,Perlis,0,0,0
2021-11-01,PSE,Pulau Pinang,0,0,0
2021-11-01,PSE,Sabah,0,0,0
2021-11-01,PSE,Sarawak,0,0,0
2021-11-01,PSE,Selangor,34,24,10
2021-11-01,QAT,Johor,0,0,0
2021-11-01,QAT,Kedah,0,0,0
2021-11-01,QAT,Perlis,0,0,0
2021-11-01,QAT,Pulau Pinang,0,0,0
2021-11-01,QAT,Sabah,0,0,0
2021-11-01,QAT,Sarawak,0,0,0
2021-11-01,QAT,Selangor,1,1,0
2021-11-01,REU,Johor,0,0,0
2021-11-01,REU,Sarawak,0,0,0
2021-11-01,ROU,Johor,1,1,0
2021-11-01,ROU,Kedah,0,0,0
2021-11-01,ROU,Kelantan,0,0,0
2021-11-01,ROU,Negeri Sembilan,0,0,0
2021-11-01,ROU,Pahang,0,0,0
2021-11-01,ROU,Perak,0,0,0
2021-11-01,ROU,Perlis,0,0,0
2021-11-01,ROU,Pulau Pinang,0,0,0
2021-11-01,ROU,Sabah,0,0,0
2021-11-01,ROU,Sarawak,1,1,0
2021-11-01,ROU,Selangor,21,18,3
2021-11-01,ROU,W.P. Labuan,0,0,0
2021-11-01,RUS,Johor,1,1,0
2021-11-01,RUS,Kedah,0,0,0
2021-11-01,RUS,Kelantan,0,0,0
2021-11-01,RUS,Melaka,0,0,0
2021-11-01,RUS,Negeri Sembilan,0,0,0
2021-11-01,RUS,Pahang,0,0,0
2021-11-01,RUS,Perak,0,0,0
2021-11-01,RUS,Perlis,0,0,0
2021-11-01,RUS,Pulau Pinang,0,0,0
2021-11-01,RUS,Sabah,0,0,0
2021-11-01,RUS,Sarawak,0,0,0
2021-11-01,RUS,Selangor,72,47,25
2021-11-01,RUS,W.P. Labuan,0,0,0
2021-11-01,RWA,Johor,0,0,0
2021-11-01,RWA,Kedah,0,0,0
2021-11-01,RWA,Pulau Pinang,0,0,0
2021-11-01,RWA,Selangor,2,0,2
2021-11-01,SAU,Johor,0,0,0
2021-11-01,SAU,Kedah,0,0,0
2021-11-01,SAU,Kelantan,0,0,0
2021-11-01,SAU,Melaka,0,0,0
2021-11-01,SAU,Perak,0,0,0
2021-11-01,SAU,Perlis,0,0,0
2021-11-01,SAU,Pulau Pinang,0,0,0
2021-11-01,SAU,Sabah,0,0,0
2021-11-01,SAU,Sarawak,0,0,0
2021-11-01,SAU,Selangor,137,82,55
2021-11-01,SAU,W.P. Labuan,0,0,0
2021-11-01,SDN,Johor,0,0,0
2021-11-01,SDN,Kedah,0,0,0
2021-11-01,SDN,Kelantan,0,0,0
2021-11-01,SDN,Perlis,0,0,0
2021-11-01,SDN,Pulau Pinang,0,0,0
2021-11-01,SDN,Sabah,0,0,0
2021-11-01,SDN,Sarawak,0,0,0
2021-11-01,SDN,Selangor,103,77,26
2021-11-01,SDN,W.P. Labuan,0,0,0
2021-11-01,SEN,Johor,0,0,0
2021-11-01,SEN,Kedah,0,0,0
2021-11-01,SEN,Kelantan,0,0,0
2021-11-01,SEN,Perak,0,0,0
2021-11-01,SEN,Perlis,0,0,0
2021-11-01,SEN,Pulau Pinang,0,0,0
2021-11-01,SEN,Sabah,0,0,0
2021-11-01,SEN,Sarawak,0,0,0
2021-11-01,SEN,Selangor,3,0,3
2021-11-01,SGP,Johor,257,174,83
2021-11-01,SGP,Kedah,2,2,0
2021-11-01,SGP,Kelantan,0,0,0
2021-11-01,SGP,Melaka,0,0,0
2021-11-01,SGP,Negeri Sembilan,0,0,0
2021-11-01,SGP,Pahang,0,0,0
2021-11-01,SGP,Perak,3,1,2
2021-11-01,SGP,Perlis,0,0,0
2021-11-01,SGP,Pulau Pinang,28,18,10
2021-11-01,SGP,Sabah,3,1,2
2021-11-01,SGP,Sarawak,17,7,10
2021-11-01,SGP,Selangor,726,437,289
2021-11-01,SGP,Terengganu,0,0,0
2021-11-01,SGP,W.P. Labuan,0,0,0
2021-11-01,SGS,Johor,0,0,0
2021-11-01,SGS,Sabah,0,0,0
2021-11-01,SGS,Selangor,0,0,0
2021-11-01,SHN,Sarawak,0,0,0
2021-11-01,SLB,Johor,0,0,0
2021-11-01,SLB,Perlis,0,0,0
2021-11-01,SLB,Pulau Pinang,0,0,0
2021-11-01,SLB,Sabah,0,0,0
2021-11-01,SLB,Sarawak,0,0,0
2021-11-01,SLB,Selangor,0,0,0
2021-11-01,SLB,W.P. Labuan,0,0,0
2021-11-01,SLE,Johor,0,0,0
2021-11-01,SLE,Kedah,0,0,0
2021-11-01,SLE,Perak,0,0,0
2021-11-01,SLE,Pulau Pinang,0,0,0
2021-11-01,SLE,Sabah,0,0,0
2021-11-01,SLE,Selangor,3,2,1
2021-11-01,SLV,Johor,0,0,0
2021-11-01,SLV,Kedah,0,0,0
2021-11-01,SLV,Perak,0,0,0
2021-11-01,SLV,Perlis,0,0,0
2021-11-01,SLV,Pulau Pinang,0,0,0
2021-11-01,SLV,Sabah,0,0,0
2021-11-01,SLV,Selangor,0,0,0
2021-11-01,SLV,W.P. Labuan,0,0,0
2021-11-01,SMR,Johor,0,0,0
2021-11-01,SMR,Selangor,0,0,0
2021-11-01,SOM,Johor,0,0,0
2021-11-01,SOM,Kedah,0,0,0
2021-11-01,SOM,Kelantan,0,0,0
2021-11-01,SOM,Perlis,0,0,0
2021-11-01,SOM,Sabah,0,0,0
2021-11-01,SOM,Sarawak,0,0,0
2021-11-01,SOM,Selangor,43,33,10
2021-11-01,SRB,Johor,0,0,0
2021-11-01,SRB,Kedah,0,0,0
2021-11-01,SRB,Kelantan,0,0,0
2021-11-01,SRB,Pahang,0,0,0
2021-11-01,SRB,Perak,0,0,0
2021-11-01,SRB,Perlis,0,0,0
2021-11-01,SRB,Pulau Pinang,0,0,0
2021-11-01,SRB,Sabah,0,0,0
2021-11-01,SRB,Sarawak,0,0,0
2021-11-01,SRB,Selangor,6,4,2
2021-11-01,SSD,Johor,0,0,0
2021-11-01,SSD,Kedah,0,0,0
2021-11-01,SSD,Sarawak,0,0,0
2021-11-01,SSD,Selangor,1,1,0
2021-11-01,SSD,W.P. Labuan,0,0,0
2021-11-01,STP,Selangor,0,0,0
2021-11-01,SUR,Johor,0,0,0
2021-11-01,SUR,Kedah,0,0,0
2021-11-01,SUR,Kelantan,0,0,0
2021-11-01,SUR,Perak,0,0,0
2021-11-01,SUR,Perlis,0,0,0
2021-11-01,SUR,Pulau Pinang,0,0,0
2021-11-01,SUR,Sabah,0,0,0
2021-11-01,SUR,Sarawak,0,0,0
2021-11-01,SUR,Selangor,0,0,0
2021-11-01,SVK,Johor,0,0,0
2021-11-01,SVK,Kedah,0,0,0
2021-11-01,SVK,Kelantan,0,0,0
2021-11-01,SVK,Negeri Sembilan,0,0,0
2021-11-01,SVK,Pahang,0,0,0
2021-11-01,SVK,Perak,0,0,0
2021-11-01,SVK,Perlis,0,0,0
2021-11-01,SVK,Pulau Pinang,0,0,0
2021-11-01,SVK,Sabah,0,0,0
2021-11-01,SVK,Sarawak,0,0,0
2021-11-01,SVK,Selangor,20,18,2
2021-11-01,SVK,W.P. Labuan,0,0,0
2021-11-01,SVN,Johor,0,0,0
2021-11-01,SVN,Kedah,0,0,0
2021-11-01,SVN,Kelantan,0,0,0
2021-11-01,SVN,Perak,0,0,0
2021-11-01,SVN,Perlis,0,0,0
2021-11-01,SVN,Pulau Pinang,0,0,0
2021-11-01,SVN,Sabah,0,0,0
2021-11-01,SVN,Sarawak,0,0,0
2021-11-01,SVN,Selangor,2,1,1
2021-11-01,SVN,W.P. Labuan,0,0,0
2021-11-01,SWE,Johor,0,0,0
2021-11-01,SWE,Kedah,0,0,0
2021-11-01,SWE,Kelantan,0,0,0
2021-11-01,SWE,Melaka,0,0,0
2021-11-01,SWE,Negeri Sembilan,0,0,0
2021-11-01,SWE,Pahang,0,0,0
2021-11-01,SWE,Perak,0,0,0
2021-11-01,SWE,Perlis,0,0,0
2021-11-01,SWE,Pulau Pinang,2,2,0
2021-11-01,SWE,Sabah,0,0,0
2021-11-01,SWE,Sarawak,0,0,0
2021-11-01,SWE,Selangor,27,26,1
2021-11-01,SWE,W.P. Labuan,0,0,0
2021-11-01,SWZ,Johor,0,0,0
2021-11-01,SWZ,Kedah,0,0,0
2021-11-01,SWZ,Pulau Pinang,0,0,0
2021-11-01,SWZ,Sabah,0,0,0
2021-11-01,SWZ,Selangor,0,0,0
2021-11-01,SYC,Johor,0,0,0
2021-11-01,SYC,Kedah,0,0,0
2021-11-01,SYC,Pulau Pinang,0,0,0
2021-11-01,SYC,Sabah,0,0,0
2021-11-01,SYC,Sarawak,0,0,0
2021-11-01,SYC,Selangor,15,8,7
2021-11-01,SYR,Johor,0,0,0
2021-11-01,SYR,Kedah,0,0,0
2021-11-01,SYR,Kelantan,0,0,0
2021-11-01,SYR,Pahang,0,0,0
2021-11-01,SYR,Perlis,0,0,0
2021-11-01,SYR,Pulau Pinang,0,0,0
2021-11-01,SYR,Sabah,0,0,0
2021-11-01,SYR,Sarawak,1,1,0
2021-11-01,SYR,Selangor,46,34,12
2021-11-01,SYR,W.P. Labuan,0,0,0
2021-11-01,TCA,Perlis,0,0,0
2021-11-01,TCD,Johor,0,0,0
2021-11-01,TCD,Kedah,0,0,0
2021-11-01,TCD,Perlis,0,0,0
2021-11-01,TCD,Selangor,2,2,0
2021-11-01,TGO,Johor,0,0,0
2021-11-01,TGO,Perak,0,0,0
2021-11-01,TGO,Pulau Pinang,0,0,0
2021-11-01,TGO,Selangor,3,3,0
2021-11-01,THA,Johor,34,33,1
2021-11-01,THA,Kedah,18311,18250,61
2021-11-01,THA,Kelantan,4,0,4
2021-11-01,THA,Melaka,0,0,0
2021-11-01,THA,Negeri Sembilan,0,0,0
2021-11-01,THA,Pahang,0,0,0
2021-11-01,THA,Perak,0,0,0
2021-11-01,THA,Perlis,7400,7287,113
2021-11-01,THA,Pulau Pinang,20,13,7
2021-11-01,THA,Sabah,0,0,0
2021-11-01,THA,Sarawak,9,8,1
2021-11-01,THA,Selangor,173,80,93
2021-11-01,THA,Terengganu,0,0,0
2021-11-01,THA,W.P. Labuan,0,0,0
2021-11-01,TJK,Johor,0,0,0
2021-11-01,TJK,Kedah,0,0,0
2021-11-01,TJK,Perlis,0,0,0
2021-11-01,TJK,Pulau Pinang,0,0,0
2021-11-01,TJK,Sabah,0,0,0
2021-11-01,TJK,Selangor,5,3,2
2021-11-01,TKL,Selangor,0,0,0
2021-11-01,TKM,Johor,0,0,0
2021-11-01,TKM,Kedah,0,0,0
2021-11-01,TKM,Kelantan,0,0,0
2021-11-01,TKM,Perlis,0,0,0
2021-11-01,TKM,Pulau Pinang,0,0,0
2021-11-01,TKM,Sabah,0,0,0
2021-11-01,TKM,Sarawak,0,0,0
2021-11-01,TKM,Selangor,7,3,4
2021-11-01,TLS,Johor,0,0,0
2021-11-01,TLS,Kedah,0,0,0
2021-11-01,TLS,Perlis,0,0,0
2021-11-01,TLS,Pulau Pinang,0,0,0
2021-11-01,TLS,Sabah,0,0,0
2021-11-01,TLS,Sarawak,0,0,0
2021-11-01,TLS,Selangor,3,1,2
2021-11-01,TON,Johor,0,0,0
2021-11-01,TON,Pulau Pinang,0,0,0
2021-11-01,TON,Sarawak,0,0,0
2021-11-01,TON,Selangor,0,0,0
2021-11-01,TTO,Johor,0,0,0
2021-11-01,TTO,Kedah,0,0,0
2021-11-01,TTO,Pahang,0,0,0
2021-11-01,TTO,Pulau Pinang,0,0,0
2021-11-01,TTO,Sabah,0,0,0
2021-11-01,TTO,Sarawak,0,0,0
2021-11-01,TTO,Selangor,3,2,1
2021-11-01,TUN,Johor,0,0,0
2021-11-01,TUN,Kedah,0,0,0
2021-11-01,TUN,Kelantan,0,0,0
2021-11-01,TUN,Melaka,0,0,0
2021-11-01,TUN,Perak,0,0,0
2021-11-01,TUN,Perlis,0,0,0
2021-11-01,TUN,Pulau Pinang,0,0,0
2021-11-01,TUN,Sabah,0,0,0
2021-11-01,TUN,Sarawak,0,0,0
2021-11-01,TUN,Selangor,12,6,6
2021-11-01,TUN,W.P. Labuan,0,0,0
2021-11-01,TUR,Johor,0,0,0
2021-11-01,TUR,Kedah,0,0,0
2021-11-01,TUR,Kelantan,0,0,0
2021-11-01,TUR,Melaka,0,0,0
2021-11-01,TUR,Negeri Sembilan,0,0,0
2021-11-01,TUR,Pahang,0,0,0
2021-11-01,TUR,Perak,0,0,0
2021-11-01,TUR,Perlis,0,0,0
2021-11-01,TUR,Pulau Pinang,0,0,0
2021-11-01,TUR,Sabah,0,0,0
2021-11-01,TUR,Sarawak,1,1,0
2021-11-01,TUR,Selangor,53,41,12
2021-11-01,TUR,W.P. Labuan,0,0,0
2021-11-01,TUV,Selangor,0,0,0
2021-11-01,TWN,Johor,2,0,2
2021-11-01,TWN,Kedah,0,0,0
2021-11-01,TWN,Kelantan,0,0,0
2021-11-01,TWN,Melaka,0,0,0
2021-11-01,TWN,Negeri Sembilan,0,0,0
2021-11-01,TWN,Pahang,0,0,0
2021-11-01,TWN,Perak,0,0,0
2021-11-01,TWN,Perlis,0,0,0
2021-11-01,TWN,Pulau Pinang,25,17,8
2021-11-01,TWN,Sabah,0,0,0
2021-11-01,TWN,Sarawak,2,1,1
2021-11-01,TWN,Selangor,94,56,38
2021-11-01,TWN,W.P. Labuan,0,0,0
2021-11-01,TZA,Johor,0,0,0
2021-11-01,TZA,Kedah,0,0,0
2021-11-01,TZA,Perak,0,0,0
2021-11-01,TZA,Perlis,0,0,0
2021-11-01,TZA,Pulau Pinang,0,0,0
2021-11-01,TZA,Sabah,0,0,0
2021-11-01,TZA,Sarawak,0,0,0
2021-11-01,TZA,Selangor,26,20,6
2021-11-01,UGA,Johor,0,0,0
2021-11-01,UGA,Kedah,0,0,0
2021-11-01,UGA,Perak,0,0,0
2021-11-01,UGA,Perlis,0,0,0
2021-11-01,UGA,Pulau Pinang,0,0,0
2021-11-01,UGA,Sabah,0,0,0
2021-11-01,UGA,Sarawak,0,0,0
2021-11-01,UGA,Selangor,3,3,0
2021-11-01,UKR,Johor,4,3,1
2021-11-01,UKR,Kedah,0,0,0
2021-11-01,UKR,Kelantan,0,0,0
2021-11-01,UKR,Melaka,3,3,0
2021-11-01,UKR,Negeri Sembilan,0,0,0
2021-11-01,UKR,Pahang,0,0,0
2021-11-01,UKR,Perak,0,0,0
2021-11-01,UKR,Perlis,0,0,0
2021-11-01,UKR,Pulau Pinang,0,0,0
2021-11-01,UKR,Sabah,0,0,0
2021-11-01,UKR,Sarawak,0,0,0
2021-11-01,UKR,Selangor,40,33,7
2021-11-01,UKR,W.P. Labuan,0,0,0
2021-11-01,URY,Johor,0,0,0
2021-11-01,URY,Kedah,0,0,0
2021-11-01,URY,Kelantan,0,0,0
2021-11-01,URY,Perak,0,0,0
2021-11-01,URY,Perlis,0,0,0
2021-11-01,URY,Pulau Pinang,0,0,0
2021-11-01,URY,Sabah,0,0,0
2021-11-01,URY,Sarawak,0,0,0
2021-11-01,URY,Selangor,0,0,0
2021-11-01,URY,W.P. Labuan,0,0,0
2021-11-01,USA,Johor,3,1,2
2021-11-01,USA,Kedah,0,0,0
2021-11-01,USA,Kelantan,0,0,0
2021-11-01,USA,Melaka,0,0,0
2021-11-01,USA,Negeri Sembilan,0,0,0
2021-11-01,USA,Pahang,0,0,0
2021-11-01,USA,Perak,1,1,0
2021-11-01,USA,Perlis,0,0,0
2021-11-01,USA,Pulau Pinang,55,46,9
2021-11-01,USA,Sabah,0,0,0
2021-11-01,USA,Sarawak,2,1,1
2021-11-01,USA,Selangor,274,180,94
2021-11-01,USA,Terengganu,0,0,0
2021-11-01,USA,W.P. Labuan,0,0,0
2021-11-01,UZB,Johor,0,0,0
2021-11-01,UZB,Kedah,0,0,0
2021-11-01,UZB,Kelantan,0,0,0
2021-11-01,UZB,Perak,0,0,0
2021-11-01,UZB,Perlis,0,0,0
2021-11-01,UZB,Pulau Pinang,0,0,0
2021-11-01,UZB,Sabah,0,0,0
2021-11-01,UZB,Sarawak,0,0,0
2021-11-01,UZB,Selangor,17,11,6
2021-11-01,VAT,Johor,0,0,0
2021-11-01,VAT,Sarawak,0,0,0
2021-11-01,VAT,Selangor,0,0,0
2021-11-01,VCT,Johor,0,0,0
2021-11-01,VCT,Kedah,0,0,0
2021-11-01,VCT,Pulau Pinang,0,0,0
2021-11-01,VCT,Sarawak,0,0,0
2021-11-01,VCT,Selangor,0,0,0
2021-11-01,VEN,Johor,0,0,0
2021-11-01,VEN,Kedah,0,0,0
2021-11-01,VEN,Kelantan,0,0,0
2021-11-01,VEN,Melaka,0,0,0
2021-11-01,VEN,Perak,0,0,0
2021-11-01,VEN,Perlis,0,0,0
2021-11-01,VEN,Pulau Pinang,0,0,0
2021-11-01,VEN,Sabah,0,0,0
2021-11-01,VEN,Sarawak,0,0,0
2021-11-01,VEN,Selangor,3,2,1
2021-11-01,VEN,W.P. Labuan,0,0,0
2021-11-01,VNM,Johor,5,4,1
2021-11-01,VNM,Kedah,0,0,0
2021-11-01,VNM,Kelantan,0,0,0
2021-11-01,VNM,Melaka,0,0,0
2021-11-01,VNM,Negeri Sembilan,0,0,0
2021-11-01,VNM,Pahang,0,0,0
2021-11-01,VNM,Perak,0,0,0
2021-11-01,VNM,Perlis,0,0,0
2021-11-01,VNM,Pulau Pinang,3,1,2
2021-11-01,VNM,Sabah,0,0,0
2021-11-01,VNM,Sarawak,0,0,0
2021-11-01,VNM,Selangor,126,46,80
2021-11-01,VNM,Terengganu,0,0,0
2021-11-01,VNM,W.P. Labuan,0,0,0
2021-11-01,VUT,Johor,0,0,0
2021-11-01,VUT,Kedah,0,0,0
2021-11-01,VUT,Pulau Pinang,0,0,0
2021-11-01,VUT,Sabah,0,0,0
2021-11-01,VUT,Sarawak,0,0,0
2021-11-01,VUT,Selangor,0,0,0
2021-11-01,WSM,Johor,0,0,0
2021-11-01,WSM,Sarawak,0,0,0
2021-11-01,WSM,Selangor,0,0,0
2021-11-01,XXX,Johor,0,0,0
2021-11-01,XXX,Kedah,0,0,0
2021-11-01,XXX,Kelantan,0,0,0
2021-11-01,XXX,Melaka,0,0,0
2021-11-01,XXX,Pahang,0,0,0
2021-11-01,XXX,Perak,0,0,0
2021-11-01,XXX,Perlis,0,0,0
2021-11-01,XXX,Pulau Pinang,0,0,0
2021-11-01,XXX,Sabah,0,0,0
2021-11-01,XXX,Sarawak,0,0,0
2021-11-01,XXX,Selangor,18,13,5
2021-11-01,XXX,W.P. Labuan,0,0,0
2021-11-01,YEM,Johor,0,0,0
2021-11-01,YEM,Kedah,0,0,0
2021-11-01,YEM,Kelantan,0,0,0
2021-11-01,YEM,Melaka,0,0,0
2021-11-01,YEM,Pahang,0,0,0
2021-11-01,YEM,Perak,0,0,0
2021-11-01,YEM,Perlis,0,0,0
2021-11-01,YEM,Pulau Pinang,0,0,0
2021-11-01,YEM,Sabah,0,0,0
2021-11-01,YEM,Sarawak,0,0,0
2021-11-01,YEM,Selangor,190,150,40
2021-11-01,YEM,W.P. Labuan,0,0,0
2021-11-01,ZAF,Johor,0,0,0
2021-11-01,ZAF,Kedah,0,0,0
2021-11-01,ZAF,Kelantan,0,0,0
2021-11-01,ZAF,Melaka,0,0,0
2021-11-01,ZAF,Pahang,0,0,0
2021-11-01,ZAF,Perak,0,0,0
2021-11-01,ZAF,Perlis,0,0,0
2021-11-01,ZAF,Pulau Pinang,3,1,2
2021-11-01,ZAF,Sabah,1,1,0
2021-11-01,ZAF,Sarawak,0,0,0
2021-11-01,ZAF,Selangor,40,30,10
2021-11-01,ZAF,Terengganu,0,0,0
2021-11-01,ZAF,W.P. Labuan,0,0,0
2021-11-01,ZAR,Selangor,0,0,0
2021-11-01,ZMB,Johor,0,0,0
2021-11-01,ZMB,Kedah,0,0,0
2021-11-01,ZMB,Perak,0,0,0
2021-11-01,ZMB,Perlis,0,0,0
2021-11-01,ZMB,Pulau Pinang,0,0,0
2021-11-01,ZMB,Sabah,0,0,0
2021-11-01,ZMB,Sarawak,0,0,0
2021-11-01,ZMB,Selangor,6,3,3
2021-11-01,ZWE,Johor,0,0,0
2021-11-01,ZWE,Kedah,0,0,0
2021-11-01,ZWE,Kelantan,0,0,0
2021-11-01,ZWE,Perak,0,0,0
2021-11-01,ZWE,Perlis,0,0,0
2021-11-01,ZWE,Pulau Pinang,0,0,0
2021-11-01,ZWE,Sabah,0,0,0
2021-11-01,ZWE,Sarawak,0,0,0
2021-11-01,ZWE,Selangor,13,6,7
2021-12-01,ABW,Kedah,0,0,0
2021-12-01,ABW,Pulau Pinang,0,0,0
2021-12-01,AFG,Johor,0,0,0
2021-12-01,AFG,Kedah,0,0,0
2021-12-01,AFG,Perlis,0,0,0
2021-12-01,AFG,Pulau Pinang,0,0,0
2021-12-01,AFG,Sarawak,0,0,0
2021-12-01,AFG,Selangor,68,44,24
2021-12-01,AGO,Johor,0,0,0
2021-12-01,AGO,Kedah,0,0,0
2021-12-01,AGO,Sabah,0,0,0
2021-12-01,AGO,Selangor,0,0,0
2021-12-01,AIA,Selangor,0,0,0
2021-12-01,ALB,Johor,0,0,0
2021-12-01,ALB,Kedah,0,0,0
2021-12-01,ALB,Perak,0,0,0
2021-12-01,ALB,Perlis,0,0,0
2021-12-01,ALB,Pulau Pinang,0,0,0
2021-12-01,ALB,Sabah,0,0,0
2021-12-01,ALB,Sarawak,0,0,0
2021-12-01,ALB,Selangor,5,4,1
2021-12-01,AND,Johor,0,0,0
2021-12-01,AND,Kedah,0,0,0
2021-12-01,AND,Perlis,0,0,0
2021-12-01,AND,Pulau Pinang,0,0,0
2021-12-01,AND,Selangor,0,0,0
2021-12-01,ANT,Selangor,0,0,0
2021-12-01,ARE,Johor,0,0,0
2021-12-01,ARE,Kedah,0,0,0
2021-12-01,ARE,Kelantan,0,0,0
2021-12-01,ARE,Perak,0,0,0
2021-12-01,ARE,Perlis,0,0,0
2021-12-01,ARE,Pulau Pinang,0,0,0
2021-12-01,ARE,Sabah,0,0,0
2021-12-01,ARE,Sarawak,0,0,0
2021-12-01,ARE,Selangor,21,15,6
2021-12-01,ARG,Johor,0,0,0
2021-12-01,ARG,Kedah,0,0,0
2021-12-01,ARG,Kelantan,0,0,0
2021-12-01,ARG,Melaka,0,0,0
2021-12-01,ARG,Perak,0,0,0
2021-12-01,ARG,Perlis,0,0,0
2021-12-01,ARG,Pulau Pinang,0,0,0
2021-12-01,ARG,Sabah,0,0,0
2021-12-01,ARG,Sarawak,0,0,0
2021-12-01,ARG,Selangor,11,5,6
2021-12-01,ARG,W.P. Labuan,0,0,0
2021-12-01,ARM,Johor,0,0,0
2021-12-01,ARM,Kedah,0,0,0
2021-12-01,ARM,Kelantan,0,0,0
2021-12-01,ARM,Perak,0,0,0
2021-12-01,ARM,Perlis,0,0,0
2021-12-01,ARM,Pulau Pinang,0,0,0
2021-12-01,ARM,Sabah,0,0,0
2021-12-01,ARM,Sarawak,0,0,0
2021-12-01,ARM,Selangor,1,0,1
2021-12-01,ATA,Selangor,0,0,0
2021-12-01,ATG,Johor,0,0,0
2021-12-01,ATG,Kedah,0,0,0
2021-12-01,ATG,Pulau Pinang,0,0,0
2021-12-01,ATG,Sarawak,0,0,0
2021-12-01,ATG,Selangor,1,1,0
2021-12-01,AUS,Johor,2,1,1
2021-12-01,AUS,Kedah,20,12,8
2021-12-01,AUS,Kelantan,0,0,0
2021-12-01,AUS,Melaka,0,0,0
2021-12-01,AUS,Negeri Sembilan,0,0,0
2021-12-01,AUS,Pahang,0,0,0
2021-12-01,AUS,Perak,1,1,0
2021-12-01,AUS,Perlis,0,0,0
2021-12-01,AUS,Pulau Pinang,23,12,11
2021-12-01,AUS,Sabah,0,0,0
2021-12-01,AUS,Sarawak,2,2,0
2021-12-01,AUS,Selangor,580,378,202
2021-12-01,AUS,Terengganu,0,0,0
2021-12-01,AUS,W.P. Labuan,0,0,0
2021-12-01,AUT,Johor,0,0,0
2021-12-01,AUT,Kedah,0,0,0
2021-12-01,AUT,Kelantan,0,0,0
2021-12-01,AUT,Melaka,0,0,0
2021-12-01,AUT,Negeri Sembilan,0,0,0
2021-12-01,AUT,Pahang,0,0,0
2021-12-01,AUT,Perak,0,0,0
2021-12-01,AUT,Perlis,0,0,0
2021-12-01,AUT,Pulau Pinang,0,0,0
2021-12-01,AUT,Sabah,0,0,0
2021-12-01,AUT,Sarawak,0,0,0
2021-12-01,AUT,Selangor,21,15,6
2021-12-01,AUT,Terengganu,0,0,0
2021-12-01,AUT,W.P. Labuan,0,0,0
2021-12-01,AZE,Johor,0,0,0
2021-12-01,AZE,Kedah,0,0,0
2021-12-01,AZE,Kelantan,0,0,0
2021-12-01,AZE,Melaka,0,0,0
2021-12-01,AZE,Perlis,0,0,0
2021-12-01,AZE,Pulau Pinang,0,0,0
2021-12-01,AZE,Sabah,0,0,0
2021-12-01,AZE,Sarawak,0,0,0
2021-12-01,AZE,Selangor,1,1,0
2021-12-01,AZE,W.P. Labuan,0,0,0
2021-12-01,BDI,Pulau Pinang,0,0,0
2021-12-01,BDI,Sarawak,0,0,0
2021-12-01,BDI,Selangor,0,0,0
2021-12-01,BEL,Johor,0,0,0
2021-12-01,BEL,Kedah,1,1,0
2021-12-01,BEL,Kelantan,0,0,0
2021-12-01,BEL,Melaka,0,0,0
2021-12-01,BEL,Negeri Sembilan,0,0,0
2021-12-01,BEL,Pahang,0,0,0
2021-12-01,BEL,Perak,0,0,0
2021-12-01,BEL,Perlis,0,0,0
2021-12-01,BEL,Pulau Pinang,2,1,1
2021-12-01,BEL,Sabah,0,0,0
2021-12-01,BEL,Sarawak,1,1,0
2021-12-01,BEL,Selangor,56,47,9
2021-12-01,BEL,W.P. Labuan,0,0,0
2021-12-01,BEN,Johor,0,0,0
2021-12-01,BEN,Kedah,0,0,0
2021-12-01,BEN,Perak,0,0,0
2021-12-01,BEN,Pulau Pinang,0,0,0
2021-12-01,BEN,Sabah,0,0,0
2021-12-01,BEN,Sarawak,0,0,0
2021-12-01,BEN,Selangor,1,1,0
2021-12-01,BFA,Perak,0,0,0
2021-12-01,BFA,Pulau Pinang,0,0,0
2021-12-01,BFA,Selangor,0,0,0
2021-12-01,BGD,Johor,3,3,0
2021-12-01,BGD,Kedah,0,0,0
2021-12-01,BGD,Kelantan,0,0,0
2021-12-01,BGD,Melaka,0,0,0
2021-12-01,BGD,Negeri Sembilan,0,0,0
2021-12-01,BGD,Pahang,0,0,0
2021-12-01,BGD,Perak,0,0,0
2021-12-01,BGD,Perlis,0,0,0
2021-12-01,BGD,Pulau Pinang,0,0,0
2021-12-01,BGD,Sabah,0,0,0
2021-12-01,BGD,Sarawak,0,0,0
2021-12-01,BGD,Selangor,5749,5372,377
2021-12-01,BGD,W.P. Labuan,0,0,0
2021-12-01,BGR,Johor,0,0,0
2021-12-01,BGR,Kedah,0,0,0
2021-12-01,BGR,Kelantan,0,0,0
2021-12-01,BGR,Pahang,0,0,0
2021-12-01,BGR,Perak,0,0,0
2021-12-01,BGR,Perlis,0,0,0
2021-12-01,BGR,Pulau Pinang,0,0,0
2021-12-01,BGR,Sabah,0,0,0
2021-12-01,BGR,Sarawak,0,0,0
2021-12-01,BGR,Selangor,6,5,1
2021-12-01,BGR,W.P. Labuan,0,0,0
2021-12-01,BHR,Johor,0,0,0
2021-12-01,BHR,Kedah,0,0,0
2021-12-01,BHR,Kelantan,0,0,0
2021-12-01,BHR,Perlis,0,0,0
2021-12-01,BHR,Pulau Pinang,0,0,0
2021-12-01,BHR,Sabah,0,0,0
2021-12-01,BHR,Sarawak,0,0,0
2021-12-01,BHR,Selangor,5,4,1
2021-12-01,BHS,Johor,0,0,0
2021-12-01,BHS,Kedah,0,0,0
2021-12-01,BHS,Perak,0,0,0
2021-12-01,BHS,Sabah,0,0,0
2021-12-01,BHS,Sarawak,0,0,0
2021-12-01,BHS,Selangor,0,0,0
2021-12-01,BIH,Johor,0,0,0
2021-12-01,BIH,Kedah,0,0,0
2021-12-01,BIH,Perlis,0,0,0
2021-12-01,BIH,Pulau Pinang,0,0,0
2021-12-01,BIH,Sabah,0,0,0
2021-12-01,BIH,Sarawak,0,0,0
2021-12-01,BIH,Selangor,10,5,5
2021-12-01,BLR,Johor,0,0,0
2021-12-01,BLR,Kedah,0,0,0
2021-12-01,BLR,Kelantan,0,0,0
2021-12-01,BLR,Pahang,0,0,0
2021-12-01,BLR,Perak,0,0,0
2021-12-01,BLR,Perlis,0,0,0
2021-12-01,BLR,Pulau Pinang,0,0,0
2021-12-01,BLR,Sabah,0,0,0
2021-12-01,BLR,Sarawak,0,0,0
2021-12-01,BLR,Selangor,2,2,0
2021-12-01,BLR,W.P. Labuan,0,0,0
2021-12-01,BLZ,Johor,0,0,0
2021-12-01,BLZ,Pulau Pinang,0,0,0
2021-12-01,BLZ,Sarawak,0,0,0
2021-12-01,BLZ,Selangor,0,0,0
2021-12-01,BMU,Selangor,0,0,0
2021-12-01,BOL,Johor,0,0,0
2021-12-01,BOL,Kedah,0,0,0
2021-12-01,BOL,Melaka,0,0,0
2021-12-01,BOL,Perak,0,0,0
2021-12-01,BOL,Perlis,0,0,0
2021-12-01,BOL,Pulau Pinang,0,0,0
2021-12-01,BOL,Sabah,0,0,0
2021-12-01,BOL,Sarawak,0,0,0
2021-12-01,BOL,Selangor,0,0,0
2021-12-01,BRA,Johor,0,0,0
2021-12-01,BRA,Kedah,0,0,0
2021-12-01,BRA,Kelantan,0,0,0
2021-12-01,BRA,Melaka,0,0,0
2021-12-01,BRA,Pahang,0,0,0
2021-12-01,BRA,Perak,0,0,0
2021-12-01,BRA,Perlis,0,0,0
2021-12-01,BRA,Pulau Pinang,0,0,0
2021-12-01,BRA,Sabah,0,0,0
2021-12-01,BRA,Sarawak,3,2,1
2021-12-01,BRA,Selangor,31,16,15
2021-12-01,BRA,W.P. Labuan,0,0,0
2021-12-01,BRB,Johor,0,0,0
2021-12-01,BRB,Kedah,0,0,0
2021-12-01,BRB,Perlis,0,0,0
2021-12-01,BRB,Pulau Pinang,0,0,0
2021-12-01,BRB,Selangor,1,1,0
2021-12-01,BRN,Johor,0,0,0
2021-12-01,BRN,Kedah,2,2,0
2021-12-01,BRN,Kelantan,0,0,0
2021-12-01,BRN,Melaka,0,0,0
2021-12-01,BRN,Pahang,0,0,0
2021-12-01,BRN,Perak,0,0,0
2021-12-01,BRN,Perlis,0,0,0
2021-12-01,BRN,Pulau Pinang,0,0,0
2021-12-01,BRN,Sabah,0,0,0
2021-12-01,BRN,Sarawak,303,291,12
2021-12-01,BRN,Selangor,97,55,42
2021-12-01,BRN,W.P. Labuan,1,1,0
2021-12-01,BTN,Johor,0,0,0
2021-12-01,BTN,Kedah,0,0,0
2021-12-01,BTN,Perak,0,0,0
2021-12-01,BTN,Perlis,0,0,0
2021-12-01,BTN,Pulau Pinang,0,0,0
2021-12-01,BTN,Sabah,0,0,0
2021-12-01,BTN,Sarawak,0,0,0
2021-12-01,BTN,Selangor,8,7,1
2021-12-01,BWA,Johor,0,0,0
2021-12-01,BWA,Kedah,0,0,0
2021-12-01,BWA,Perlis,0,0,0
2021-12-01,BWA,Pulau Pinang,0,0,0
2021-12-01,BWA,Sabah,0,0,0
2021-12-01,BWA,Sarawak,0,0,0
2021-12-01,BWA,Selangor,0,0,0
2021-12-01,CAF,Kedah,0,0,0
2021-12-01,CAF,Selangor,0,0,0
2021-12-01,CAN,Johor,0,0,0
2021-12-01,CAN,Kedah,2,2,0
2021-12-01,CAN,Kelantan,0,0,0
2021-12-01,CAN,Melaka,0,0,0
2021-12-01,CAN,Negeri Sembilan,0,0,0
2021-12-01,CAN,Pahang,0,0,0
2021-12-01,CAN,Perak,0,0,0
2021-12-01,CAN,Perlis,0,0,0
2021-12-01,CAN,Pulau Pinang,1,0,1
2021-12-01,CAN,Sabah,0,0,0
2021-12-01,CAN,Sarawak,2,2,0
2021-12-01,CAN,Selangor,181,115,66
2021-12-01,CAN,Terengganu,0,0,0
2021-12-01,CAN,W.P. Labuan,0,0,0
2021-12-01,CCK,Selangor,0,0,0
2021-12-01,CHE,Johor,0,0,0
2021-12-01,CHE,Kedah,1,1,0
2021-12-01,CHE,Kelantan,0,0,0
2021-12-01,CHE,Melaka,0,0,0
2021-12-01,CHE,Negeri Sembilan,0,0,0
2021-12-01,CHE,Pahang,0,0,0
2021-12-01,CHE,Perak,0,0,0
2021-12-01,CHE,Perlis,0,0,0
2021-12-01,CHE,Pulau Pinang,6,3,3
2021-12-01,CHE,Sabah,0,0,0
2021-12-01,CHE,Sarawak,0,0,0
2021-12-01,CHE,Selangor,67,47,20
2021-12-01,CHE,W.P. Labuan,0,0,0
2021-12-01,CHL,Johor,0,0,0
2021-12-01,CHL,Kedah,0,0,0
2021-12-01,CHL,Kelantan,0,0,0
2021-12-01,CHL,Melaka,0,0,0
2021-12-01,CHL,Pahang,0,0,0
2021-12-01,CHL,Perak,0,0,0
2021-12-01,CHL,Perlis,0,0,0
2021-12-01,CHL,Pulau Pinang,0,0,0
2021-12-01,CHL,Sabah,1,1,0
2021-12-01,CHL,Sarawak,0,0,0
2021-12-01,CHL,Selangor,8,5,3
2021-12-01,CHN,Johor,83,77,6
2021-12-01,CHN,Kedah,3,3,0
2021-12-01,CHN,Kelantan,0,0,0
2021-12-01,CHN,Melaka,0,0,0
2021-12-01,CHN,Pahang,0,0,0
2021-12-01,CHN,Perak,0,0,0
2021-12-01,CHN,Perlis,0,0,0
2021-12-01,CHN,Pulau Pinang,15,8,7
2021-12-01,CHN,Sabah,2,1,1
2021-12-01,CHN,Sarawak,31,28,3
2021-12-01,CHN,Selangor,2250,1486,764
2021-12-01,CHN,Terengganu,0,0,0
2021-12-01,CHN,W.P. Labuan,0,0,0
2021-12-01,CIV,Johor,0,0,0
2021-12-01,CIV,Kedah,0,0,0
2021-12-01,CIV,Pulau Pinang,0,0,0
2021-12-01,CIV,Sabah,0,0,0
2021-12-01,CIV,Sarawak,0,0,0
2021-12-01,CIV,Selangor,2,2,0
2021-12-01,CMR,Johor,0,0,0
2021-12-01,CMR,Kedah,0,0,0
2021-12-01,CMR,Pulau Pinang,0,0,0
2021-12-01,CMR,Sabah,0,0,0
2021-12-01,CMR,Sarawak,0,0,0
2021-12-01,CMR,Selangor,0,0,0
2021-12-01,COD,Johor,0,0,0
2021-12-01,COD,Pulau Pinang,0,0,0
2021-12-01,COD,Sarawak,0,0,0
2021-12-01,COD,Selangor,1,0,1
2021-12-01,COG,Johor,0,0,0
2021-12-01,COG,Kedah,0,0,0
2021-12-01,COG,Selangor,0,0,0
2021-12-01,COK,Selangor,0,0,0
2021-12-01,COL,Johor,0,0,0
2021-12-01,COL,Kedah,0,0,0
2021-12-01,COL,Perak,0,0,0
2021-12-01,COL,Pulau Pinang,0,0,0
2021-12-01,COL,Sabah,0,0,0
2021-12-01,COL,Sarawak,0,0,0
2021-12-01,COL,Selangor,10,6,4
2021-12-01,COL,W.P. Labuan,0,0,0
2021-12-01,COM,Johor,0,0,0
2021-12-01,COM,Kedah,0,0,0
2021-12-01,COM,Selangor,2,1,1
2021-12-01,CPV,Johor,0,0,0
2021-12-01,CPV,Kedah,0,0,0
2021-12-01,CPV,Pulau Pinang,0,0,0
2021-12-01,CPV,Sabah,0,0,0
2021-12-01,CPV,Selangor,0,0,0
2021-12-01,CRI,Johor,0,0,0
2021-12-01,CRI,Kedah,0,0,0
2021-12-01,CRI,Perak,0,0,0
2021-12-01,CRI,Perlis,0,0,0
2021-12-01,CRI,Pulau Pinang,0,0,0
2021-12-01,CRI,Sabah,0,0,0
2021-12-01,CRI,Sarawak,0,0,0
2021-12-01,CRI,Selangor,1,0,1
2021-12-01,CUB,Johor,0,0,0
2021-12-01,CUB,Kedah,0,0,0
2021-12-01,CUB,Perlis,0,0,0
2021-12-01,CUB,Pulau Pinang,0,0,0
2021-12-01,CUB,Sabah,0,0,0
2021-12-01,CUB,Sarawak,0,0,0
2021-12-01,CUB,Selangor,2,1,1
2021-12-01,CYP,Johor,0,0,0
2021-12-01,CYP,Kedah,0,0,0
2021-12-01,CYP,Perak,0,0,0
2021-12-01,CYP,Perlis,0,0,0
2021-12-01,CYP,Pulau Pinang,0,0,0
2021-12-01,CYP,Sabah,0,0,0
2021-12-01,CYP,Sarawak,0,0,0
2021-12-01,CYP,Selangor,0,0,0
2021-12-01,CZE,Johor,0,0,0
2021-12-01,CZE,Kedah,0,0,0
2021-12-01,CZE,Kelantan,0,0,0
2021-12-01,CZE,Melaka,0,0,0
2021-12-01,CZE,Negeri Sembilan,0,0,0
2021-12-01,CZE,Perak,0,0,0
2021-12-01,CZE,Perlis,0,0,0
2021-12-01,CZE,Pulau Pinang,0,0,0
2021-12-01,CZE,Sabah,0,0,0
2021-12-01,CZE,Sarawak,0,0,0
2021-12-01,CZE,Selangor,15,8,7
2021-12-01,CZE,W.P. Labuan,0,0,0
2021-12-01,DEU,Johor,3,3,0
2021-12-01,DEU,Kedah,8,5,3
2021-12-01,DEU,Kelantan,0,0,0
2021-12-01,DEU,Melaka,0,0,0
2021-12-01,DEU,Negeri Sembilan,0,0,0
2021-12-01,DEU,Pahang,0,0,0
2021-12-01,DEU,Perak,1,1,0
2021-12-01,DEU,Perlis,0,0,0
2021-12-01,DEU,Pulau Pinang,6,5,1
2021-12-01,DEU,Sabah,0,0,0
2021-12-01,DEU,Sarawak,5,3,2
2021-12-01,DEU,Selangor,348,247,101
2021-12-01,DEU,Terengganu,0,0,0
2021-12-01,DEU,W.P. Labuan,0,0,0
2021-12-01,DJI,Johor,0,0,0
2021-12-01,DJI,Selangor,6,1,5
2021-12-01,DMA,Johor,0,0,0
2021-12-01,DMA,Kedah,0,0,0
2021-12-01,DMA,Pulau Pinang,0,0,0
2021-12-01,DMA,Sabah,0,0,0
2021-12-01,DMA,Sarawak,0,0,0
2021-12-01,DMA,Selangor,5,5,0
2021-12-01,DMA,W.P. Labuan,0,0,0
2021-12-01,DNK,Johor,1,1,0
2021-12-01,DNK,Kedah,1,1,0
2021-12-01,DNK,Kelantan,0,0,0
2021-12-01,DNK,Melaka,0,0,0
2021-12-01,DNK,Negeri Sembilan,0,0,0
2021-12-01,DNK,Pahang,0,0,0
2021-12-01,DNK,Perak,0,0,0
2021-12-01,DNK,Perlis,0,0,0
2021-12-01,DNK,Pulau Pinang,5,5,0
2021-12-01,DNK,Sabah,0,0,0
2021-12-01,DNK,Sarawak,1,1,0
2021-12-01,DNK,Selangor,50,39,11
2021-12-01,DNK,W.P. Labuan,0,0,0
2021-12-01,DOM,Johor,0,0,0
2021-12-01,DOM,Kedah,0,0,0
2021-12-01,DOM,Perak,0,0,0
2021-12-01,DOM,Perlis,0,0,0
2021-12-01,DOM,Pulau Pinang,0,0,0
2021-12-01,DOM,Sabah,0,0,0
2021-12-01,DOM,Sarawak,0,0,0
2021-12-01,DOM,Selangor,1,1,0
2021-12-01,DZA,Johor,0,0,0
2021-12-01,DZA,Kedah,0,0,0
2021-12-01,DZA,Kelantan,0,0,0
2021-12-01,DZA,Melaka,0,0,0
2021-12-01,DZA,Perak,0,0,0
2021-12-01,DZA,Perlis,0,0,0
2021-12-01,DZA,Pulau Pinang,0,0,0
2021-12-01,DZA,Sabah,0,0,0
2021-12-01,DZA,Sarawak,0,0,0
2021-12-01,DZA,Selangor,45,35,10
2021-12-01,DZA,W.P. Labuan,0,0,0
2021-12-01,ECU,Johor,0,0,0
2021-12-01,ECU,Kedah,0,0,0
2021-12-01,ECU,Perak,0,0,0
2021-12-01,ECU,Perlis,0,0,0
2021-12-01,ECU,Pulau Pinang,0,0,0
2021-12-01,ECU,Sabah,0,0,0
2021-12-01,ECU,Sarawak,0,0,0
2021-12-01,ECU,Selangor,3,3,0
2021-12-01,EGY,Johor,0,0,0
2021-12-01,EGY,Kedah,0,0,0
2021-12-01,EGY,Kelantan,0,0,0
2021-12-01,EGY,Melaka,0,0,0
2021-12-01,EGY,Pahang,0,0,0
2021-12-01,EGY,Perak,0,0,0
2021-12-01,EGY,Perlis,0,0,0
2021-12-01,EGY,Pulau Pinang,0,0,0
2021-12-01,EGY,Sabah,0,0,0
2021-12-01,EGY,Sarawak,0,0,0
2021-12-01,EGY,Selangor,271,206,65
2021-12-01,EGY,Terengganu,0,0,0
2021-12-01,EGY,W.P. Labuan,0,0,0
2021-12-01,ERI,Johor,0,0,0
2021-12-01,ERI,Pulau Pinang,0,0,0
2021-12-01,ERI,Sabah,0,0,0
2021-12-01,ERI,Selangor,4,2,2
2021-12-01,ESP,Johor,0,0,0
2021-12-01,ESP,Kedah,0,0,0
2021-12-01,ESP,Kelantan,0,0,0
2021-12-01,ESP,Melaka,0,0,0
2021-12-01,ESP,Negeri Sembilan,0,0,0
2021-12-01,ESP,Pahang,0,0,0
2021-12-01,ESP,Perak,0,0,0
2021-12-01,ESP,Perlis,0,0,0
2021-12-01,ESP,Pulau Pinang,0,0,0
2021-12-01,ESP,Sabah,0,0,0
2021-12-01,ESP,Sarawak,0,0,0
2021-12-01,ESP,Selangor,44,30,14
2021-12-01,ESP,W.P. Labuan,0,0,0
2021-12-01,EST,Johor,0,0,0
2021-12-01,EST,Kedah,0,0,0
2021-12-01,EST,Kelantan,0,0,0
2021-12-01,EST,Pahang,0,0,0
2021-12-01,EST,Perak,0,0,0
2021-12-01,EST,Perlis,0,0,0
2021-12-01,EST,Pulau Pinang,0,0,0
2021-12-01,EST,Sabah,0,0,0
2021-12-01,EST,Sarawak,0,0,0
2021-12-01,EST,Selangor,4,3,1
2021-12-01,EST,W.P. Labuan,0,0,0
2021-12-01,ETH,Johor,0,0,0
2021-12-01,ETH,Kedah,0,0,0
2021-12-01,ETH,Pulau Pinang,0,0,0
2021-12-01,ETH,Sarawak,0,0,0
2021-12-01,ETH,Selangor,3,2,1
2021-12-01,FIN,Johor,0,0,0
2021-12-01,FIN,Kedah,0,0,0
2021-12-01,FIN,Kelantan,0,0,0
2021-12-01,FIN,Melaka,0,0,0
2021-12-01,FIN,Negeri Sembilan,0,0,0
2021-12-01,FIN,Pahang,0,0,0
2021-12-01,FIN,Perak,0,0,0
2021-12-01,FIN,Perlis,0,0,0
2021-12-01,FIN,Pulau Pinang,0,0,0
2021-12-01,FIN,Sabah,0,0,0
2021-12-01,FIN,Sarawak,0,0,0
2021-12-01,FIN,Selangor,36,25,11
2021-12-01,FIN,W.P. Labuan,0,0,0
2021-12-01,FJI,Johor,0,0,0
2021-12-01,FJI,Kedah,0,0,0
2021-12-01,FJI,Kelantan,0,0,0
2021-12-01,FJI,Perak,0,0,0
2021-12-01,FJI,Perlis,0,0,0
2021-12-01,FJI,Pulau Pinang,0,0,0
2021-12-01,FJI,Sabah,0,0,0
2021-12-01,FJI,Sarawak,0,0,0
2021-12-01,FJI,Selangor,6,4,2
2021-12-01,FRA,Johor,0,0,0
2021-12-01,FRA,Kedah,3,2,1
2021-12-01,FRA,Kelantan,0,0,0
2021-12-01,FRA,Melaka,0,0,0
2021-12-01,FRA,Negeri Sembilan,0,0,0
2021-12-01,FRA,Pahang,0,0,0
2021-12-01,FRA,Perak,0,0,0
2021-12-01,FRA,Perlis,0,0,0
2021-12-01,FRA,Pulau Pinang,4,4,0
2021-12-01,FRA,Sabah,0,0,0
2021-12-01,FRA,Sarawak,1,1,0
2021-12-01,FRA,Selangor,390,265,125
2021-12-01,FRA,Terengganu,0,0,0
2021-12-01,FRA,W.P. Labuan,0,0,0
2021-12-01,FSM,Johor,0,0,0
2021-12-01,FSM,Pulau Pinang,0,0,0
2021-12-01,FSM,Selangor,0,0,0
2021-12-01,GAB,Johor,0,0,0
2021-12-01,GAB,Pulau Pinang,0,0,0
2021-12-01,GAB,Sarawak,0,0,0
2021-12-01,GAB,Selangor,1,1,0
2021-12-01,GBR,Johor,0,0,0
2021-12-01,GBR,Kedah,17,11,6
2021-12-01,GBR,Kelantan,0,0,0
2021-12-01,GBR,Melaka,0,0,0
2021-12-01,GBR,Negeri Sembilan,0,0,0
2021-12-01,GBR,Pahang,0,0,0
2021-12-01,GBR,Perak,1,0,1
2021-12-01,GBR,Perlis,0,0,0
2021-12-01,GBR,Pulau Pinang,20,14,6
2021-12-01,GBR,Sabah,2,1,1
2021-12-01,GBR,Sarawak,4,4,0
2021-12-01,GBR,Selangor,1347,874,473
2021-12-01,GBR,Terengganu,0,0,0
2021-12-01,GBR,W.P. Labuan,0,0,0
2021-12-01,GEO,Johor,0,0,0
2021-12-01,GEO,Kedah,0,0,0
2021-12-01,GEO,Melaka,0,0,0
2021-12-01,GEO,Perak,0,0,0
2021-12-01,GEO,Perlis,0,0,0
2021-12-01,GEO,Pulau Pinang,0,0,0
2021-12-01,GEO,Sabah,0,0,0
2021-12-01,GEO,Sarawak,0,0,0
2021-12-01,GEO,Selangor,12,10,2
2021-12-01,GHA,Johor,0,0,0
2021-12-01,GHA,Kedah,0,0,0
2021-12-01,GHA,Kelantan,0,0,0
2021-12-01,GHA,Pulau Pinang,0,0,0
2021-12-01,GHA,Sabah,0,0,0
2021-12-01,GHA,Sarawak,0,0,0
2021-12-01,GHA,Selangor,9,8,1
2021-12-01,GIB,Johor,0,0,0
2021-12-01,GIB,Sarawak,0,0,0
2021-12-01,GIN,Johor,0,0,0
2021-12-01,GIN,Kedah,0,0,0
2021-12-01,GIN,Kelantan,0,0,0
2021-12-01,GIN,Perlis,0,0,0
2021-12-01,GIN,Pulau Pinang,0,0,0
2021-12-01,GIN,Sabah,0,0,0
2021-12-01,GIN,Sarawak,0,0,0
2021-12-01,GIN,Selangor,8,5,3
2021-12-01,GLP,Selangor,0,0,0
2021-12-01,GMB,Johor,0,0,0
2021-12-01,GMB,Kedah,0,0,0
2021-12-01,GMB,Kelantan,0,0,0
2021-12-01,GMB,Pulau Pinang,0,0,0
2021-12-01,GMB,Sabah,0,0,0
2021-12-01,GMB,Sarawak,0,0,0
2021-12-01,GMB,Selangor,3,3,0
2021-12-01,GNB,Johor,0,0,0
2021-12-01,GNB,Selangor,0,0,0
2021-12-01,GNQ,Johor,0,0,0
2021-12-01,GNQ,Selangor,8,6,2
2021-12-01,GRC,Johor,0,0,0
2021-12-01,GRC,Kedah,0,0,0
2021-12-01,GRC,Kelantan,0,0,0
2021-12-01,GRC,Melaka,0,0,0
2021-12-01,GRC,Negeri Sembilan,0,0,0
2021-12-01,GRC,Pahang,0,0,0
2021-12-01,GRC,Perak,0,0,0
2021-12-01,GRC,Perlis,0,0,0
2021-12-01,GRC,Pulau Pinang,0,0,0
2021-12-01,GRC,Sabah,0,0,0
2021-12-01,GRC,Sarawak,0,0,0
2021-12-01,GRC,Selangor,8,8,0
2021-12-01,GRD,Johor,0,0,0
2021-12-01,GRD,Kedah,0,0,0
2021-12-01,GRD,Pulau Pinang,0,0,0
2021-12-01,GRD,Sabah,0,0,0
2021-12-01,GRD,Sarawak,0,0,0
2021-12-01,GRD,Selangor,0,0,0
2021-12-01,GRL,Johor,0,0,0
2021-12-01,GRL,Selangor,0,0,0
2021-12-01,GTM,Johor,0,0,0
2021-12-01,GTM,Kedah,0,0,0
2021-12-01,GTM,Pahang,0,0,0
2021-12-01,GTM,Perak,0,0,0
2021-12-01,GTM,Pulau Pinang,0,0,0
2021-12-01,GTM,Sabah,0,0,0
2021-12-01,GTM,Sarawak,0,0,0
2021-12-01,GTM,Selangor,0,0,0
2021-12-01,GTM,W.P. Labuan,0,0,0
2021-12-01,GUY,Johor,0,0,0
2021-12-01,GUY,Kedah,0,0,0
2021-12-01,GUY,Pulau Pinang,0,0,0
2021-12-01,GUY,Sarawak,0,0,0
2021-12-01,GUY,Selangor,0,0,0
2021-12-01,HKG,Johor,0,0,0
2021-12-01,HKG,Kedah,0,0,0
2021-12-01,HKG,Kelantan,0,0,0
2021-12-01,HKG,Pahang,0,0,0
2021-12-01,HKG,Perak,0,0,0
2021-12-01,HKG,Perlis,0,0,0
2021-12-01,HKG,Pulau Pinang,2,1,1
2021-12-01,HKG,Sabah,0,0,0
2021-12-01,HKG,Sarawak,44,38,6
2021-12-01,HKG,Selangor,1,1,0
2021-12-01,HKG,Terengganu,0,0,0
2021-12-01,HMD,Johor,0,0,0
2021-12-01,HND,Johor,0,0,0
2021-12-01,HND,Kedah,0,0,0
2021-12-01,HND,Perak,0,0,0
2021-12-01,HND,Pulau Pinang,0,0,0
2021-12-01,HND,Sabah,0,0,0
2021-12-01,HND,Sarawak,0,0,0
2021-12-01,HND,Selangor,0,0,0
2021-12-01,HRV,Johor,0,0,0
2021-12-01,HRV,Kedah,0,0,0
2021-12-01,HRV,Kelantan,0,0,0
2021-12-01,HRV,Melaka,0,0,0
2021-12-01,HRV,Pahang,0,0,0
2021-12-01,HRV,Perak,0,0,0
2021-12-01,HRV,Perlis,0,0,0
2021-12-01,HRV,Pulau Pinang,0,0,0
2021-12-01,HRV,Sabah,0,0,0
2021-12-01,HRV,Sarawak,0,0,0
2021-12-01,HRV,Selangor,12,11,1
2021-12-01,HTI,Johor,0,0,0
2021-12-01,HTI,Kedah,0,0,0
2021-12-01,HTI,Kelantan,0,0,0
2021-12-01,HTI,Perak,0,0,0
2021-12-01,HTI,Pulau Pinang,0,0,0
2021-12-01,HTI,Sabah,0,0,0
2021-12-01,HTI,Selangor,0,0,0
2021-12-01,HUN,Johor,0,0,0
2021-12-01,HUN,Kedah,0,0,0
2021-12-01,HUN,Kelantan,0,0,0
2021-12-01,HUN,Pahang,0,0,0
2021-12-01,HUN,Perak,0,0,0
2021-12-01,HUN,Perlis,0,0,0
2021-12-01,HUN,Pulau Pinang,0,0,0
2021-12-01,HUN,Sabah,0,0,0
2021-12-01,HUN,Sarawak,0,0,0
2021-12-01,HUN,Selangor,15,10,5
2021-12-01,HUN,W.P. Labuan,0,0,0
2021-12-01,IDN,Johor,332,174,158
2021-12-01,IDN,Kedah,19,10,9
2021-12-01,IDN,Kelantan,0,0,0
2021-12-01,IDN,Melaka,0,0,0
2021-12-01,IDN,Negeri Sembilan,0,0,0
2021-12-01,IDN,Pahang,0,0,0
2021-12-01,IDN,Perak,0,0,0
2021-12-01,IDN,Perlis,1,1,0
2021-12-01,IDN,Pulau Pinang,22,11,11
2021-12-01,IDN,Sabah,3,2,1
2021-12-01,IDN,Sarawak,154,144,10
2021-12-01,IDN,Selangor,3834,1643,2191
2021-12-01,IDN,Terengganu,0,0,0
2021-12-01,IDN,W.P. Labuan,0,0,0
2021-12-01,IND,Johor,35,32,3
2021-12-01,IND,Kedah,0,0,0
2021-12-01,IND,Kelantan,0,0,0
2021-12-01,IND,Melaka,0,0,0
2021-12-01,IND,Negeri Sembilan,0,0,0
2021-12-01,IND,Pahang,0,0,0
2021-12-01,IND,Perak,0,0,0
2021-12-01,IND,Perlis,0,0,0
2021-12-01,IND,Pulau Pinang,9,7,2
2021-12-01,IND,Sabah,4,3,1
2021-12-01,IND,Sarawak,3,3,0
2021-12-01,IND,Selangor,6305,4601,1704
2021-12-01,IND,Terengganu,0,0,0
2021-12-01,IND,W.P. Labuan,0,0,0
2021-12-01,IOT,Pulau Pinang,0,0,0
2021-12-01,IOT,Selangor,0,0,0
2021-12-01,IRL,Johor,0,0,0
2021-12-01,IRL,Kedah,0,0,0
2021-12-01,IRL,Kelantan,0,0,0
2021-12-01,IRL,Negeri Sembilan,0,0,0
2021-12-01,IRL,Pahang,0,0,0
2021-12-01,IRL,Perak,0,0,0
2021-12-01,IRL,Perlis,0,0,0
2021-12-01,IRL,Pulau Pinang,0,0,0
2021-12-01,IRL,Sabah,0,0,0
2021-12-01,IRL,Sarawak,0,0,0
2021-12-01,IRL,Selangor,74,46,28
2021-12-01,IRL,Terengganu,0,0,0
2021-12-01,IRL,W.P. Labuan,0,0,0
2021-12-01,IRN,Johor,0,0,0
2021-12-01,IRN,Kedah,0,0,0
2021-12-01,IRN,Kelantan,0,0,0
2021-12-01,IRN,Perak,0,0,0
2021-12-01,IRN,Perlis,0,0,0
2021-12-01,IRN,Pulau Pinang,0,0,0
2021-12-01,IRN,Sabah,0,0,0
2021-12-01,IRN,Sarawak,0,0,0
2021-12-01,IRN,Selangor,175,101,74
2021-12-01,IRN,W.P. Labuan,0,0,0
2021-12-01,IRQ,Johor,0,0,0
2021-12-01,IRQ,Kedah,0,0,0
2021-12-01,IRQ,Kelantan,0,0,0
2021-12-01,IRQ,Melaka,0,0,0
2021-12-01,IRQ,Pahang,0,0,0
2021-12-01,IRQ,Perak,0,0,0
2021-12-01,IRQ,Perlis,0,0,0
2021-12-01,IRQ,Pulau Pinang,0,0,0
2021-12-01,IRQ,Sabah,0,0,0
2021-12-01,IRQ,Sarawak,0,0,0
2021-12-01,IRQ,Selangor,256,164,92
2021-12-01,ISL,Johor,0,0,0
2021-12-01,ISL,Kedah,0,0,0
2021-12-01,ISL,Kelantan,0,0,0
2021-12-01,ISL,Perak,0,0,0
2021-12-01,ISL,Perlis,0,0,0
2021-12-01,ISL,Pulau Pinang,0,0,0
2021-12-01,ISL,Sabah,0,0,0
2021-12-01,ISL,Sarawak,0,0,0
2021-12-01,ISL,Selangor,1,1,0
2021-12-01,ISL,W.P. Labuan,0,0,0
2021-12-01,ISR,Pulau Pinang,0,0,0
2021-12-01,ITA,Johor,0,0,0
2021-12-01,ITA,Kedah,4,3,1
2021-12-01,ITA,Kelantan,0,0,0
2021-12-01,ITA,Melaka,0,0,0
2021-12-01,ITA,Negeri Sembilan,0,0,0
2021-12-01,ITA,Pahang,0,0,0
2021-12-01,ITA,Perak,0,0,0
2021-12-01,ITA,Perlis,0,0,0
2021-12-01,ITA,Pulau Pinang,1,1,0
2021-12-01,ITA,Sabah,1,1,0
2021-12-01,ITA,Sarawak,0,0,0
2021-12-01,ITA,Selangor,85,70,15
2021-12-01,ITA,W.P. Labuan,0,0,0
2021-12-01,JAM,Johor,0,0,0
2021-12-01,JAM,Kedah,0,0,0
2021-12-01,JAM,Perak,0,0,0
2021-12-01,JAM,Pulau Pinang,0,0,0
2021-12-01,JAM,Sabah,0,0,0
2021-12-01,JAM,Sarawak,0,0,0
2021-12-01,JAM,Selangor,2,2,0
2021-12-01,JAM,W.P. Labuan,0,0,0
2021-12-01,JOR,Johor,0,0,0
2021-12-01,JOR,Kedah,0,0,0
2021-12-01,JOR,Kelantan,0,0,0
2021-12-01,JOR,Melaka,0,0,0
2021-12-01,JOR,Perlis,0,0,0
2021-12-01,JOR,Pulau Pinang,0,0,0
2021-12-01,JOR,Sabah,0,0,0
2021-12-01,JOR,Sarawak,0,0,0
2021-12-01,JOR,Selangor,78,62,16
2021-12-01,JOR,W.P. Labuan,0,0,0
2021-12-01,JPN,Johor,5,4,1
2021-12-01,JPN,Kedah,7,1,6
2021-12-01,JPN,Kelantan,0,0,0
2021-12-01,JPN,Melaka,0,0,0
2021-12-01,JPN,Negeri Sembilan,0,0,0
2021-12-01,JPN,Pahang,0,0,0
2021-12-01,JPN,Perak,3,2,1
2021-12-01,JPN,Perlis,0,0,0
2021-12-01,JPN,Pulau Pinang,58,32,26
2021-12-01,JPN,Sabah,3,1,2
2021-12-01,JPN,Sarawak,9,8,1
2021-12-01,JPN,Selangor,1066,624,442
2021-12-01,JPN,W.P. Labuan,0,0,0
2021-12-01,KAZ,Johor,0,0,0
2021-12-01,KAZ,Kedah,0,0,0
2021-12-01,KAZ,Kelantan,0,0,0
2021-12-01,KAZ,Melaka,0,0,0
2021-12-01,KAZ,Perak,0,0,0
2021-12-01,KAZ,Perlis,0,0,0
2021-12-01,KAZ,Pulau Pinang,0,0,0
2021-12-01,KAZ,Sabah,0,0,0
2021-12-01,KAZ,Sarawak,0,0,0
2021-12-01,KAZ,Selangor,21,10,11
2021-12-01,KAZ,W.P. Labuan,0,0,0
2021-12-01,KEN,Johor,0,0,0
2021-12-01,KEN,Kedah,0,0,0
2021-12-01,KEN,Kelantan,0,0,0
2021-12-01,KEN,Perak,0,0,0
2021-12-01,KEN,Perlis,0,0,0
2021-12-01,KEN,Pulau Pinang,0,0,0
2021-12-01,KEN,Sabah,0,0,0
2021-12-01,KEN,Sarawak,0,0,0
2021-12-01,KEN,Selangor,37,22,15
2021-12-01,KGZ,Johor,0,0,0
2021-12-01,KGZ,Kedah,0,0,0
2021-12-01,KGZ,Kelantan,0,0,0
2021-12-01,KGZ,Perak,0,0,0
2021-12-01,KGZ,Perlis,0,0,0
2021-12-01,KGZ,Pulau Pinang,0,0,0
2021-12-01,KGZ,Sabah,0,0,0
2021-12-01,KGZ,Sarawak,0,0,0
2021-12-01,KGZ,Selangor,13,6,7
2021-12-01,KHM,Johor,0,0,0
2021-12-01,KHM,Kedah,0,0,0
2021-12-01,KHM,Kelantan,0,0,0
2021-12-01,KHM,Melaka,0,0,0
2021-12-01,KHM,Negeri Sembilan,0,0,0
2021-12-01,KHM,Pahang,0,0,0
2021-12-01,KHM,Perak,0,0,0
2021-12-01,KHM,Perlis,0,0,0
2021-12-01,KHM,Pulau Pinang,16,16,0
2021-12-01,KHM,Sabah,0,0,0
2021-12-01,KHM,Sarawak,0,0,0
2021-12-01,KHM,Selangor,67,42,25
2021-12-01,KHM,W.P. Labuan,0,0,0
2021-12-01,KIR,Johor,0,0,0
2021-12-01,KIR,Sabah,0,0,0
2021-12-01,KIR,Selangor,0,0,0
2021-12-01,KNA,Johor,0,0,0
2021-12-01,KNA,Kedah,0,0,0
2021-12-01,KNA,Perlis,0,0,0
2021-12-01,KNA,Pulau Pinang,0,0,0
2021-12-01,KNA,Sabah,0,0,0
2021-12-01,KNA,Selangor,1,1,0
2021-12-01,KNA,W.P. Labuan,0,0,0
2021-12-01,KOR,Johor,2,2,0
2021-12-01,KOR,Kedah,0,0,0
2021-12-01,KOR,Kelantan,0,0,0
2021-12-01,KOR,Melaka,0,0,0
2021-12-01,KOR,Negeri Sembilan,0,0,0
2021-12-01,KOR,Pahang,0,0,0
2021-12-01,KOR,Perak,0,0,0
2021-12-01,KOR,Perlis,0,0,0
2021-12-01,KOR,Pulau Pinang,22,6,16
2021-12-01,KOR,Sabah,2,0,2
2021-12-01,KOR,Sarawak,40,34,6
2021-12-01,KOR,Selangor,1288,809,479
2021-12-01,KOR,Terengganu,0,0,0
2021-12-01,KOR,W.P. Labuan,0,0,0
2021-12-01,KWT,Johor,0,0,0
2021-12-01,KWT,Kedah,0,0,0
2021-12-01,KWT,Kelantan,0,0,0
2021-12-01,KWT,Perak,0,0,0
2021-12-01,KWT,Perlis,0,0,0
2021-12-01,KWT,Pulau Pinang,0,0,0
2021-12-01,KWT,Sabah,0,0,0
2021-12-01,KWT,Sarawak,0,0,0
2021-12-01,KWT,Selangor,6,5,1
2021-12-01,KWT,W.P. Labuan,0,0,0
2021-12-01,LAO,Johor,0,0,0
2021-12-01,LAO,Kedah,0,0,0
2021-12-01,LAO,Kelantan,0,0,0
2021-12-01,LAO,Melaka,0,0,0
2021-12-01,LAO,Perak,0,0,0
2021-12-01,LAO,Perlis,0,0,0
2021-12-01,LAO,Pulau Pinang,0,0,0
2021-12-01,LAO,Sabah,0,0,0
2021-12-01,LAO,Sarawak,0,0,0
2021-12-01,LAO,Selangor,19,15,4
2021-12-01,LAO,W.P. Labuan,0,0,0
2021-12-01,LBN,Johor,0,0,0
2021-12-01,LBN,Kedah,0,0,0
2021-12-01,LBN,Kelantan,0,0,0
2021-12-01,LBN,Pahang,0,0,0
2021-12-01,LBN,Perak,0,0,0
2021-12-01,LBN,Perlis,0,0,0
2021-12-01,LBN,Pulau Pinang,0,0,0
2021-12-01,LBN,Sabah,0,0,0
2021-12-01,LBN,Sarawak,0,0,0
2021-12-01,LBN,Selangor,14,8,6
2021-12-01,LBN,W.P. Labuan,0,0,0
2021-12-01,LBR,Johor,0,0,0
2021-12-01,LBR,Kedah,0,0,0
2021-12-01,LBR,Sabah,0,0,0
2021-12-01,LBR,Sarawak,0,0,0
2021-12-01,LBR,Selangor,5,5,0
2021-12-01,LBY,Johor,0,0,0
2021-12-01,LBY,Kedah,0,0,0
2021-12-01,LBY,Perlis,0,0,0
2021-12-01,LBY,Pulau Pinang,0,0,0
2021-12-01,LBY,Sabah,0,0,0
2021-12-01,LBY,Sarawak,0,0,0
2021-12-01,LBY,Selangor,194,124,70
2021-12-01,LCA,Johor,0,0,0
2021-12-01,LCA,Kedah,0,0,0
2021-12-01,LCA,Pulau Pinang,0,0,0
2021-12-01,LCA,Sarawak,0,0,0
2021-12-01,LCA,Selangor,1,1,0
2021-12-01,LIE,Johor,0,0,0
2021-12-01,LIE,Kedah,0,0,0
2021-12-01,LIE,Perlis,0,0,0
2021-12-01,LIE,Pulau Pinang,0,0,0
2021-12-01,LIE,Sabah,0,0,0
2021-12-01,LIE,Sarawak,0,0,0
2021-12-01,LIE,Selangor,1,1,0
2021-12-01,LKA,Johor,0,0,0
2021-12-01,LKA,Kedah,0,0,0
2021-12-01,LKA,Kelantan,0,0,0
2021-12-01,LKA,Melaka,0,0,0
2021-12-01,LKA,Pahang,0,0,0
2021-12-01,LKA,Perak,0,0,0
2021-12-01,LKA,Perlis,0,0,0
2021-12-01,LKA,Pulau Pinang,0,0,0
2021-12-01,LKA,Sabah,0,0,0
2021-12-01,LKA,Sarawak,0,0,0
2021-12-01,LKA,Selangor,204,119,85
2021-12-01,LKA,W.P. Labuan,0,0,0
2021-12-01,LSO,Johor,0,0,0
2021-12-01,LSO,Kedah,0,0,0
2021-12-01,LSO,Pulau Pinang,0,0,0
2021-12-01,LSO,Sarawak,0,0,0
2021-12-01,LSO,Selangor,0,0,0
2021-12-01,LTU,Johor,1,0,1
2021-12-01,LTU,Kedah,0,0,0
2021-12-01,LTU,Kelantan,0,0,0
2021-12-01,LTU,Pahang,0,0,0
2021-12-01,LTU,Perak,0,0,0
2021-12-01,LTU,Perlis,0,0,0
2021-12-01,LTU,Pulau Pinang,0,0,0
2021-12-01,LTU,Sabah,0,0,0
2021-12-01,LTU,Sarawak,0,0,0
2021-12-01,LTU,Selangor,15,13,2
2021-12-01,LTU,W.P. Labuan,0,0,0
2021-12-01,LUX,Johor,0,0,0
2021-12-01,LUX,Kedah,0,0,0
2021-12-01,LUX,Kelantan,0,0,0
2021-12-01,LUX,Perak,0,0,0
2021-12-01,LUX,Perlis,0,0,0
2021-12-01,LUX,Pulau Pinang,0,0,0
2021-12-01,LUX,Sabah,0,0,0
2021-12-01,LUX,Sarawak,0,0,0
2021-12-01,LUX,Selangor,1,0,1
2021-12-01,LVA,Johor,0,0,0
2021-12-01,LVA,Kedah,0,0,0
2021-12-01,LVA,Kelantan,0,0,0
2021-12-01,LVA,Pahang,0,0,0
2021-12-01,LVA,Perak,0,0,0
2021-12-01,LVA,Perlis,0,0,0
2021-12-01,LVA,Pulau Pinang,0,0,0
2021-12-01,LVA,Sabah,0,0,0
2021-12-01,LVA,Sarawak,0,0,0
2021-12-01,LVA,Selangor,7,5,2
2021-12-01,LVA,W.P. Labuan,0,0,0
2021-12-01,MAC,Johor,0,0,0
2021-12-01,MAC,Pahang,0,0,0
2021-12-01,MAC,Perak,0,0,0
2021-12-01,MAC,Selangor,0,0,0
2021-12-01,MAC,W.P. Labuan,0,0,0
2021-12-01,MAR,Johor,0,0,0
2021-12-01,MAR,Kedah,1,1,0
2021-12-01,MAR,Kelantan,0,0,0
2021-12-01,MAR,Melaka,0,0,0
2021-12-01,MAR,Pahang,0,0,0
2021-12-01,MAR,Perak,0,0,0
2021-12-01,MAR,Perlis,0,0,0
2021-12-01,MAR,Pulau Pinang,0,0,0
2021-12-01,MAR,Sabah,0,0,0
2021-12-01,MAR,Sarawak,0,0,0
2021-12-01,MAR,Selangor,21,5,16
2021-12-01,MAR,W.P. Labuan,0,0,0
2021-12-01,MCO,Johor,0,0,0
2021-12-01,MCO,Kedah,0,0,0
2021-12-01,MCO,Sabah,0,0,0
2021-12-01,MCO,Selangor,0,0,0
2021-12-01,MDA,Johor,0,0,0
2021-12-01,MDA,Kedah,0,0,0
2021-12-01,MDA,Kelantan,0,0,0
2021-12-01,MDA,Negeri Sembilan,0,0,0
2021-12-01,MDA,Perlis,0,0,0
2021-12-01,MDA,Pulau Pinang,0,0,0
2021-12-01,MDA,Sabah,0,0,0
2021-12-01,MDA,Sarawak,0,0,0
2021-12-01,MDA,Selangor,0,0,0
2021-12-01,MDG,Johor,0,0,0
2021-12-01,MDG,Kedah,0,0,0
2021-12-01,MDG,Perak,0,0,0
2021-12-01,MDG,Perlis,0,0,0
2021-12-01,MDG,Pulau Pinang,0,0,0
2021-12-01,MDG,Sabah,0,0,0
2021-12-01,MDG,Sarawak,0,0,0
2021-12-01,MDG,Selangor,0,0,0
2021-12-01,MDV,Johor,0,0,0
2021-12-01,MDV,Kedah,4,3,1
2021-12-01,MDV,Kelantan,0,0,0
2021-12-01,MDV,Perak,0,0,0
2021-12-01,MDV,Perlis,0,0,0
2021-12-01,MDV,Pulau Pinang,0,0,0
2021-12-01,MDV,Sabah,0,0,0
2021-12-01,MDV,Sarawak,0,0,0
2021-12-01,MDV,Selangor,223,99,124
2021-12-01,MEX,Johor,0,0,0
2021-12-01,MEX,Kedah,0,0,0
2021-12-01,MEX,Kelantan,0,0,0
2021-12-01,MEX,Pahang,0,0,0
2021-12-01,MEX,Perak,0,0,0
2021-12-01,MEX,Perlis,0,0,0
2021-12-01,MEX,Pulau Pinang,0,0,0
2021-12-01,MEX,Sabah,0,0,0
2021-12-01,MEX,Sarawak,0,0,0
2021-12-01,MEX,Selangor,22,12,10
2021-12-01,MEX,W.P. Labuan,0,0,0
2021-12-01,MHL,Johor,0,0,0
2021-12-01,MHL,Kedah,0,0,0
2021-12-01,MHL,Perak,0,0,0
2021-12-01,MHL,Pulau Pinang,0,0,0
2021-12-01,MHL,Sabah,0,0,0
2021-12-01,MHL,Selangor,0,0,0
2021-12-01,MKD,Johor,0,0,0
2021-12-01,MKD,Kedah,0,0,0
2021-12-01,MKD,Perak,0,0,0
2021-12-01,MKD,Pulau Pinang,0,0,0
2021-12-01,MKD,Sabah,0,0,0
2021-12-01,MKD,Sarawak,0,0,0
2021-12-01,MKD,Selangor,0,0,0
2021-12-01,MLI,Johor,0,0,0
2021-12-01,MLI,Sabah,0,0,0
2021-12-01,MLI,Selangor,1,0,1
2021-12-01,MLT,Johor,0,0,0
2021-12-01,MLT,Kedah,0,0,0
2021-12-01,MLT,Kelantan,0,0,0
2021-12-01,MLT,Perak,0,0,0
2021-12-01,MLT,Perlis,0,0,0
2021-12-01,MLT,Pulau Pinang,0,0,0
2021-12-01,MLT,Sabah,0,0,0
2021-12-01,MLT,Sarawak,0,0,0
2021-12-01,MLT,Selangor,2,2,0
2021-12-01,MLT,W.P. Labuan,0,0,0
2021-12-01,MMR,Johor,0,0,0
2021-12-01,MMR,Kedah,0,0,0
2021-12-01,MMR,Kelantan,0,0,0
2021-12-01,MMR,Negeri Sembilan,0,0,0
2021-12-01,MMR,Pahang,0,0,0
2021-12-01,MMR,Perak,0,0,0
2021-12-01,MMR,Perlis,0,0,0
2021-12-01,MMR,Pulau Pinang,0,0,0
2021-12-01,MMR,Sabah,0,0,0
2021-12-01,MMR,Sarawak,0,0,0
2021-12-01,MMR,Selangor,341,295,46
2021-12-01,MMR,Terengganu,0,0,0
2021-12-01,MMR,W.P. Labuan,0,0,0
2021-12-01,MNE,Johor,0,0,0
2021-12-01,MNE,Kedah,0,0,0
2021-12-01,MNE,Pulau Pinang,0,0,0
2021-12-01,MNE,Sabah,0,0,0
2021-12-01,MNE,Sarawak,0,0,0
2021-12-01,MNE,Selangor,8,8,0
2021-12-01,MNG,Johor,0,0,0
2021-12-01,MNG,Kedah,0,0,0
2021-12-01,MNG,Kelantan,0,0,0
2021-12-01,MNG,Perak,0,0,0
2021-12-01,MNG,Perlis,0,0,0
2021-12-01,MNG,Pulau Pinang,0,0,0
2021-12-01,MNG,Sabah,0,0,0
2021-12-01,MNG,Sarawak,0,0,0
2021-12-01,MNG,Selangor,7,2,5
2021-12-01,MNP,Selangor,0,0,0
2021-12-01,MOZ,Johor,0,0,0
2021-12-01,MOZ,Kedah,0,0,0
2021-12-01,MOZ,Perak,0,0,0
2021-12-01,MOZ,Pulau Pinang,0,0,0
2021-12-01,MOZ,Sabah,0,0,0
2021-12-01,MOZ,Sarawak,0,0,0
2021-12-01,MOZ,Selangor,0,0,0
2021-12-01,MRT,Johor,0,0,0
2021-12-01,MRT,Kedah,0,0,0
2021-12-01,MRT,Pulau Pinang,0,0,0
2021-12-01,MRT,Sabah,0,0,0
2021-12-01,MRT,Sarawak,0,0,0
2021-12-01,MRT,Selangor,8,7,1
2021-12-01,MUS,Johor,0,0,0
2021-12-01,MUS,Kedah,0,0,0
2021-12-01,MUS,Kelantan,0,0,0
2021-12-01,MUS,Pahang,0,0,0
2021-12-01,MUS,Perak,0,0,0
2021-12-01,MUS,Perlis,0,0,0
2021-12-01,MUS,Pulau Pinang,0,0,0
2021-12-01,MUS,Sabah,0,0,0
2021-12-01,MUS,Sarawak,0,0,0
2021-12-01,MUS,Selangor,31,15,16
2021-12-01,MWI,Johor,0,0,0
2021-12-01,MWI,Pulau Pinang,0,0,0
2021-12-01,MWI,Sabah,0,0,0
2021-12-01,MWI,Sarawak,0,0,0
2021-12-01,MWI,Selangor,0,0,0
2021-12-01,MYT,Selangor,0,0,0
2021-12-01,NAM,Johor,0,0,0
2021-12-01,NAM,Kedah,0,0,0
2021-12-01,NAM,Perak,0,0,0
2021-12-01,NAM,Perlis,0,0,0
2021-12-01,NAM,Pulau Pinang,0,0,0
2021-12-01,NAM,Sabah,0,0,0
2021-12-01,NAM,Sarawak,0,0,0
2021-12-01,NAM,Selangor,1,1,0
2021-12-01,NCL,Selangor,0,0,0
2021-12-01,NER,Johor,0,0,0
2021-12-01,NER,Sabah,0,0,0
2021-12-01,NER,Selangor,0,0,0
2021-12-01,NGA,Johor,0,0,0
2021-12-01,NGA,Kedah,0,0,0
2021-12-01,NGA,Perlis,0,0,0
2021-12-01,NGA,Pulau Pinang,0,0,0
2021-12-01,NGA,Sabah,0,0,0
2021-12-01,NGA,Sarawak,4,2,2
2021-12-01,NGA,Selangor,169,145,24
2021-12-01,NIC,Johor,0,0,0
2021-12-01,NIC,Kedah,0,0,0
2021-12-01,NIC,Pulau Pinang,0,0,0
2021-12-01,NIC,Sabah,0,0,0
2021-12-01,NIC,Selangor,0,0,0
2021-12-01,NLD,Johor,0,0,0
2021-12-01,NLD,Kedah,1,0,1
2021-12-01,NLD,Kelantan,0,0,0
2021-12-01,NLD,Melaka,0,0,0
2021-12-01,NLD,Negeri Sembilan,0,0,0
2021-12-01,NLD,Pahang,0,0,0
2021-12-01,NLD,Perak,0,0,0
2021-12-01,NLD,Perlis,0,0,0
2021-12-01,NLD,Pulau Pinang,3,1,2
2021-12-01,NLD,Sabah,1,1,0
2021-12-01,NLD,Sarawak,2,2,0
2021-12-01,NLD,Selangor,163,128,35
2021-12-01,NLD,Terengganu,0,0,0
2021-12-01,NLD,W.P. Labuan,0,0,0
2021-12-01,NOR,Johor,0,0,0
2021-12-01,NOR,Kedah,0,0,0
2021-12-01,NOR,Kelantan,0,0,0
2021-12-01,NOR,Melaka,0,0,0
2021-12-01,NOR,Pahang,0,0,0
2021-12-01,NOR,Perak,0,0,0
2021-12-01,NOR,Perlis,0,0,0
2021-12-01,NOR,Pulau Pinang,1,1,0
2021-12-01,NOR,Sabah,0,0,0
2021-12-01,NOR,Sarawak,1,1,0
2021-12-01,NOR,Selangor,54,39,15
2021-12-01,NOR,W.P. Labuan,0,0,0
2021-12-01,NPL,Johor,0,0,0
2021-12-01,NPL,Kedah,0,0,0
2021-12-01,NPL,Pahang,0,0,0
2021-12-01,NPL,Perak,0,0,0
2021-12-01,NPL,Perlis,0,0,0
2021-12-01,NPL,Pulau Pinang,1,1,0
2021-12-01,NPL,Sabah,0,0,0
2021-12-01,NPL,Sarawak,0,0,0
2021-12-01,NPL,Selangor,599,570,29
2021-12-01,NPL,W.P. Labuan,0,0,0
2021-12-01,NRU,Johor,0,0,0
2021-12-01,NRU,Pulau Pinang,0,0,0
2021-12-01,NRU,Selangor,0,0,0
2021-12-01,NZL,Johor,0,0,0
2021-12-01,NZL,Kedah,1,0,1
2021-12-01,NZL,Kelantan,0,0,0
2021-12-01,NZL,Melaka,0,0,0
2021-12-01,NZL,Negeri Sembilan,0,0,0
2021-12-01,NZL,Pahang,0,0,0
2021-12-01,NZL,Perak,0,0,0
2021-12-01,NZL,Perlis,0,0,0
2021-12-01,NZL,Pulau Pinang,0,0,0
2021-12-01,NZL,Sabah,1,1,0
2021-12-01,NZL,Sarawak,0,0,0
2021-12-01,NZL,Selangor,95,66,29
2021-12-01,NZL,Terengganu,0,0,0
2021-12-01,NZL,W.P. Labuan,0,0,0
2021-12-01,OMN,Johor,0,0,0
2021-12-01,OMN,Kedah,0,0,0
2021-12-01,OMN,Kelantan,0,0,0
2021-12-01,OMN,Melaka,0,0,0
2021-12-01,OMN,Perak,0,0,0
2021-12-01,OMN,Perlis,0,0,0
2021-12-01,OMN,Pulau Pinang,0,0,0
2021-12-01,OMN,Sabah,0,0,0
2021-12-01,OMN,Sarawak,0,0,0
2021-12-01,OMN,Selangor,38,28,10
2021-12-01,PAK,Johor,0,0,0
2021-12-01,PAK,Kedah,0,0,0
2021-12-01,PAK,Kelantan,0,0,0
2021-12-01,PAK,Melaka,0,0,0
2021-12-01,PAK,Negeri Sembilan,0,0,0
2021-12-01,PAK,Pahang,0,0,0
2021-12-01,PAK,Perak,0,0,0
2021-12-01,PAK,Perlis,0,0,0
2021-12-01,PAK,Pulau Pinang,0,0,0
2021-12-01,PAK,Sabah,0,0,0
2021-12-01,PAK,Sarawak,2,2,0
2021-12-01,PAK,Selangor,2812,2519,293
2021-12-01,PAK,W.P. Labuan,0,0,0
2021-12-01,PAN,Johor,0,0,0
2021-12-01,PAN,Kedah,0,0,0
2021-12-01,PAN,Perak,0,0,0
2021-12-01,PAN,Perlis,0,0,0
2021-12-01,PAN,Pulau Pinang,0,0,0
2021-12-01,PAN,Sabah,0,0,0
2021-12-01,PAN,Sarawak,0,0,0
2021-12-01,PAN,Selangor,1,0,1
2021-12-01,PER,Johor,0,0,0
2021-12-01,PER,Kedah,0,0,0
2021-12-01,PER,Kelantan,0,0,0
2021-12-01,PER,Pahang,0,0,0
2021-12-01,PER,Perak,0,0,0
2021-12-01,PER,Perlis,0,0,0
2021-12-01,PER,Pulau Pinang,0,0,0
2021-12-01,PER,Sabah,0,0,0
2021-12-01,PER,Sarawak,0,0,0
2021-12-01,PER,Selangor,7,2,5
2021-12-01,PER,W.P. Labuan,0,0,0
2021-12-01,PHL,Johor,24,18,6
2021-12-01,PHL,Kedah,0,0,0
2021-12-01,PHL,Kelantan,0,0,0
2021-12-01,PHL,Melaka,0,0,0
2021-12-01,PHL,Negeri Sembilan,0,0,0
2021-12-01,PHL,Pahang,0,0,0
2021-12-01,PHL,Perak,0,0,0
2021-12-01,PHL,Perlis,0,0,0
2021-12-01,PHL,Pulau Pinang,5,4,1
2021-12-01,PHL,Sabah,4,0,4
2021-12-01,PHL,Sarawak,23,18,5
2021-12-01,PHL,Selangor,1108,649,459
2021-12-01,PHL,Terengganu,0,0,0
2021-12-01,PHL,W.P. Labuan,9,9,0
2021-12-01,PLW,Johor,0,0,0
2021-12-01,PLW,Pulau Pinang,0,0,0
2021-12-01,PLW,Selangor,0,0,0
2021-12-01,PNG,Johor,0,0,0
2021-12-01,PNG,Kedah,1,0,1
2021-12-01,PNG,Kelantan,0,0,0
2021-12-01,PNG,Perak,0,0,0
2021-12-01,PNG,Pulau Pinang,0,0,0
2021-12-01,PNG,Sabah,0,0,0
2021-12-01,PNG,Sarawak,0,0,0
2021-12-01,PNG,Selangor,2,1,1
2021-12-01,POL,Johor,0,0,0
2021-12-01,POL,Kedah,1,0,1
2021-12-01,POL,Kelantan,0,0,0
2021-12-01,POL,Melaka,0,0,0
2021-12-01,POL,Negeri Sembilan,0,0,0
2021-12-01,POL,Pahang,0,0,0
2021-12-01,POL,Perak,0,0,0
2021-12-01,POL,Perlis,0,0,0
2021-12-01,POL,Pulau Pinang,0,0,0
2021-12-01,POL,Sabah,0,0,0
2021-12-01,POL,Sarawak,0,0,0
2021-12-01,POL,Selangor,29,21,8
2021-12-01,POL,Terengganu,0,0,0
2021-12-01,POL,W.P. Labuan,0,0,0
2021-12-01,PRK,Selangor,0,0,0
2021-12-01,PRT,Johor,0,0,0
2021-12-01,PRT,Kedah,0,0,0
2021-12-01,PRT,Kelantan,0,0,0
2021-12-01,PRT,Melaka,0,0,0
2021-12-01,PRT,Pahang,0,0,0
2021-12-01,PRT,Perak,0,0,0
2021-12-01,PRT,Perlis,0,0,0
2021-12-01,PRT,Pulau Pinang,1,1,0
2021-12-01,PRT,Sabah,0,0,0
2021-12-01,PRT,Sarawak,0,0,0
2021-12-01,PRT,Selangor,31,20,11
2021-12-01,PRT,W.P. Labuan,0,0,0
2021-12-01,PRY,Johor,0,0,0
2021-12-01,PRY,Kedah,0,0,0
2021-12-01,PRY,Perak,0,0,0
2021-12-01,PRY,Perlis,0,0,0
2021-12-01,PRY,Pulau Pinang,0,0,0
2021-12-01,PRY,Sabah,0,0,0
2021-12-01,PRY,Sarawak,0,0,0
2021-12-01,PRY,Selangor,0,0,0
2021-12-01,PSE,Johor,0,0,0
2021-12-01,PSE,Kedah,0,0,0
2021-12-01,PSE,Kelantan,0,0,0
2021-12-01,PSE,Melaka,0,0,0
2021-12-01,PSE,Perak,0,0,0
2021-12-01,PSE,Perlis,0,0,0
2021-12-01,PSE,Pulau Pinang,0,0,0
2021-12-01,PSE,Sabah,0,0,0
2021-12-01,PSE,Sarawak,0,0,0
2021-12-01,PSE,Selangor,61,49,12
2021-12-01,QAT,Johor,0,0,0
2021-12-01,QAT,Kedah,0,0,0
2021-12-01,QAT,Perlis,0,0,0
2021-12-01,QAT,Pulau Pinang,0,0,0
2021-12-01,QAT,Sabah,0,0,0
2021-12-01,QAT,Sarawak,0,0,0
2021-12-01,QAT,Selangor,1,1,0
2021-12-01,REU,Johor,0,0,0
2021-12-01,REU,Sarawak,0,0,0
2021-12-01,ROU,Johor,2,2,0
2021-12-01,ROU,Kedah,0,0,0
2021-12-01,ROU,Kelantan,0,0,0
2021-12-01,ROU,Negeri Sembilan,0,0,0
2021-12-01,ROU,Pahang,0,0,0
2021-12-01,ROU,Perak,0,0,0
2021-12-01,ROU,Perlis,0,0,0
2021-12-01,ROU,Pulau Pinang,0,0,0
2021-12-01,ROU,Sabah,0,0,0
2021-12-01,ROU,Sarawak,0,0,0
2021-12-01,ROU,Selangor,29,23,6
2021-12-01,ROU,W.P. Labuan,0,0,0
2021-12-01,RUS,Johor,0,0,0
2021-12-01,RUS,Kedah,0,0,0
2021-12-01,RUS,Kelantan,0,0,0
2021-12-01,RUS,Melaka,0,0,0
2021-12-01,RUS,Negeri Sembilan,0,0,0
2021-12-01,RUS,Pahang,0,0,0
2021-12-01,RUS,Perak,0,0,0
2021-12-01,RUS,Perlis,0,0,0
2021-12-01,RUS,Pulau Pinang,0,0,0
2021-12-01,RUS,Sabah,0,0,0
2021-12-01,RUS,Sarawak,8,7,1
2021-12-01,RUS,Selangor,113,77,36
2021-12-01,RUS,W.P. Labuan,0,0,0
2021-12-01,RWA,Johor,0,0,0
2021-12-01,RWA,Kedah,0,0,0
2021-12-01,RWA,Pulau Pinang,0,0,0
2021-12-01,RWA,Selangor,2,1,1
2021-12-01,SAU,Johor,0,0,0
2021-12-01,SAU,Kedah,0,0,0
2021-12-01,SAU,Kelantan,0,0,0
2021-12-01,SAU,Melaka,0,0,0
2021-12-01,SAU,Perak,0,0,0
2021-12-01,SAU,Perlis,0,0,0
2021-12-01,SAU,Pulau Pinang,0,0,0
2021-12-01,SAU,Sabah,0,0,0
2021-12-01,SAU,Sarawak,1,1,0
2021-12-01,SAU,Selangor,211,132,79
2021-12-01,SAU,W.P. Labuan,0,0,0
2021-12-01,SDN,Johor,0,0,0
2021-12-01,SDN,Kedah,0,0,0
2021-12-01,SDN,Kelantan,0,0,0
2021-12-01,SDN,Perlis,0,0,0
2021-12-01,SDN,Pulau Pinang,0,0,0
2021-12-01,SDN,Sabah,0,0,0
2021-12-01,SDN,Sarawak,0,0,0
2021-12-01,SDN,Selangor,146,95,51
2021-12-01,SDN,W.P. Labuan,0,0,0
2021-12-01,SEN,Johor,0,0,0
2021-12-01,SEN,Kedah,0,0,0
2021-12-01,SEN,Kelantan,0,0,0
2021-12-01,SEN,Perak,0,0,0
2021-12-01,SEN,Perlis,0,0,0
2021-12-01,SEN,Pulau Pinang,0,0,0
2021-12-01,SEN,Sabah,0,0,0
2021-12-01,SEN,Sarawak,0,0,0
2021-12-01,SEN,Selangor,4,2,2
2021-12-01,SGP,Johor,2642,1423,1219
2021-12-01,SGP,Kedah,16,7,9
2021-12-01,SGP,Kelantan,0,0,0
2021-12-01,SGP,Melaka,0,0,0
2021-12-01,SGP,Negeri Sembilan,0,0,0
2021-12-01,SGP,Pahang,0,0,0
2021-12-01,SGP,Perak,4,2,2
2021-12-01,SGP,Perlis,0,0,0
2021-12-01,SGP,Pulau Pinang,18,6,12
2021-12-01,SGP,Sabah,0,0,0
2021-12-01,SGP,Sarawak,28,17,11
2021-12-01,SGP,Selangor,10716,6000,4716
2021-12-01,SGP,Terengganu,0,0,0
2021-12-01,SGP,W.P. Labuan,0,0,0
2021-12-01,SGS,Johor,0,0,0
2021-12-01,SGS,Sabah,0,0,0
2021-12-01,SGS,Selangor,0,0,0
2021-12-01,SHN,Sarawak,0,0,0
2021-12-01,SLB,Johor,0,0,0
2021-12-01,SLB,Perlis,0,0,0
2021-12-01,SLB,Pulau Pinang,0,0,0
2021-12-01,SLB,Sabah,0,0,0
2021-12-01,SLB,Sarawak,1,1,0
2021-12-01,SLB,Selangor,1,1,0
2021-12-01,SLB,W.P. Labuan,0,0,0
2021-12-01,SLE,Johor,0,0,0
2021-12-01,SLE,Kedah,0,0,0
2021-12-01,SLE,Perak,0,0,0
2021-12-01,SLE,Pulau Pinang,0,0,0
2021-12-01,SLE,Sabah,0,0,0
2021-12-01,SLE,Selangor,0,0,0
2021-12-01,SLV,Johor,0,0,0
2021-12-01,SLV,Kedah,0,0,0
2021-12-01,SLV,Perak,0,0,0
2021-12-01,SLV,Perlis,0,0,0
2021-12-01,SLV,Pulau Pinang,0,0,0
2021-12-01,SLV,Sabah,0,0,0
2021-12-01,SLV,Selangor,0,0,0
2021-12-01,SLV,W.P. Labuan,0,0,0
2021-12-01,SMR,Johor,0,0,0
2021-12-01,SMR,Selangor,0,0,0
2021-12-01,SOM,Johor,0,0,0
2021-12-01,SOM,Kedah,0,0,0
2021-12-01,SOM,Kelantan,0,0,0
2021-12-01,SOM,Perlis,0,0,0
2021-12-01,SOM,Sabah,0,0,0
2021-12-01,SOM,Sarawak,0,0,0
2021-12-01,SOM,Selangor,80,51,29
2021-12-01,SRB,Johor,0,0,0
2021-12-01,SRB,Kedah,0,0,0
2021-12-01,SRB,Kelantan,0,0,0
2021-12-01,SRB,Pahang,0,0,0
2021-12-01,SRB,Perak,0,0,0
2021-12-01,SRB,Perlis,0,0,0
2021-12-01,SRB,Pulau Pinang,0,0,0
2021-12-01,SRB,Sabah,0,0,0
2021-12-01,SRB,Sarawak,0,0,0
2021-12-01,SRB,Selangor,5,5,0
2021-12-01,SSD,Johor,0,0,0
2021-12-01,SSD,Kedah,0,0,0
2021-12-01,SSD,Sarawak,0,0,0
2021-12-01,SSD,Selangor,2,1,1
2021-12-01,SSD,W.P. Labuan,0,0,0
2021-12-01,STP,Selangor,0,0,0
2021-12-01,SUR,Johor,0,0,0
2021-12-01,SUR,Kedah,0,0,0
2021-12-01,SUR,Kelantan,0,0,0
2021-12-01,SUR,Perak,0,0,0
2021-12-01,SUR,Perlis,0,0,0
2021-12-01,SUR,Pulau Pinang,0,0,0
2021-12-01,SUR,Sabah,0,0,0
2021-12-01,SUR,Sarawak,0,0,0
2021-12-01,SUR,Selangor,0,0,0
2021-12-01,SVK,Johor,0,0,0
2021-12-01,SVK,Kedah,0,0,0
2021-12-01,SVK,Kelantan,0,0,0
2021-12-01,SVK,Negeri Sembilan,0,0,0
2021-12-01,SVK,Pahang,0,0,0
2021-12-01,SVK,Perak,0,0,0
2021-12-01,SVK,Perlis,0,0,0
2021-12-01,SVK,Pulau Pinang,0,0,0
2021-12-01,SVK,Sabah,0,0,0
2021-12-01,SVK,Sarawak,0,0,0
2021-12-01,SVK,Selangor,10,4,6
2021-12-01,SVK,W.P. Labuan,0,0,0
2021-12-01,SVN,Johor,0,0,0
2021-12-01,SVN,Kedah,0,0,0
2021-12-01,SVN,Kelantan,0,0,0
2021-12-01,SVN,Perak,0,0,0
2021-12-01,SVN,Perlis,0,0,0
2021-12-01,SVN,Pulau Pinang,0,0,0
2021-12-01,SVN,Sabah,0,0,0
2021-12-01,SVN,Sarawak,0,0,0
2021-12-01,SVN,Selangor,3,2,1
2021-12-01,SVN,W.P. Labuan,0,0,0
2021-12-01,SWE,Johor,0,0,0
2021-12-01,SWE,Kedah,0,0,0
2021-12-01,SWE,Kelantan,0,0,0
2021-12-01,SWE,Melaka,0,0,0
2021-12-01,SWE,Negeri Sembilan,0,0,0
2021-12-01,SWE,Pahang,0,0,0
2021-12-01,SWE,Perak,0,0,0
2021-12-01,SWE,Perlis,0,0,0
2021-12-01,SWE,Pulau Pinang,3,1,2
2021-12-01,SWE,Sabah,0,0,0
2021-12-01,SWE,Sarawak,0,0,0
2021-12-01,SWE,Selangor,79,54,25
2021-12-01,SWE,W.P. Labuan,0,0,0
2021-12-01,SWZ,Johor,0,0,0
2021-12-01,SWZ,Kedah,0,0,0
2021-12-01,SWZ,Pulau Pinang,0,0,0
2021-12-01,SWZ,Sabah,0,0,0
2021-12-01,SWZ,Selangor,1,1,0
2021-12-01,SYC,Johor,0,0,0
2021-12-01,SYC,Kedah,0,0,0
2021-12-01,SYC,Pulau Pinang,0,0,0
2021-12-01,SYC,Sabah,0,0,0
2021-12-01,SYC,Sarawak,1,1,0
2021-12-01,SYC,Selangor,12,3,9
2021-12-01,SYR,Johor,0,0,0
2021-12-01,SYR,Kedah,0,0,0
2021-12-01,SYR,Kelantan,0,0,0
2021-12-01,SYR,Pahang,0,0,0
2021-12-01,SYR,Perlis,0,0,0
2021-12-01,SYR,Pulau Pinang,0,0,0
2021-12-01,SYR,Sabah,0,0,0
2021-12-01,SYR,Sarawak,0,0,0
2021-12-01,SYR,Selangor,90,55,35
2021-12-01,SYR,W.P. Labuan,0,0,0
2021-12-01,TCA,Perlis,0,0,0
2021-12-01,TCD,Johor,0,0,0
2021-12-01,TCD,Kedah,0,0,0
2021-12-01,TCD,Perlis,0,0,0
2021-12-01,TCD,Selangor,4,3,1
2021-12-01,TGO,Johor,0,0,0
2021-12-01,TGO,Perak,0,0,0
2021-12-01,TGO,Pulau Pinang,0,0,0
2021-12-01,TGO,Selangor,0,0,0
2021-12-01,THA,Johor,44,43,1
2021-12-01,THA,Kedah,18122,18065,57
2021-12-01,THA,Kelantan,0,0,0
2021-12-01,THA,Melaka,0,0,0
2021-12-01,THA,Negeri Sembilan,0,0,0
2021-12-01,THA,Pahang,0,0,0
2021-12-01,THA,Perak,0,0,0
2021-12-01,THA,Perlis,9207,9060,147
2021-12-01,THA,Pulau Pinang,77,73,4
2021-12-01,THA,Sabah,0,0,0
2021-12-01,THA,Sarawak,9,8,1
2021-12-01,THA,Selangor,583,183,400
2021-12-01,THA,Terengganu,0,0,0
2021-12-01,THA,W.P. Labuan,0,0,0
2021-12-01,TJK,Johor,0,0,0
2021-12-01,TJK,Kedah,0,0,0
2021-12-01,TJK,Perlis,0,0,0
2021-12-01,TJK,Pulau Pinang,0,0,0
2021-12-01,TJK,Sabah,0,0,0
2021-12-01,TJK,Selangor,8,4,4
2021-12-01,TKL,Selangor,0,0,0
2021-12-01,TKM,Johor,0,0,0
2021-12-01,TKM,Kedah,0,0,0
2021-12-01,TKM,Kelantan,0,0,0
2021-12-01,TKM,Perlis,0,0,0
2021-12-01,TKM,Pulau Pinang,0,0,0
2021-12-01,TKM,Sabah,0,0,0
2021-12-01,TKM,Sarawak,0,0,0
2021-12-01,TKM,Selangor,9,6,3
2021-12-01,TLS,Johor,0,0,0
2021-12-01,TLS,Kedah,0,0,0
2021-12-01,TLS,Perlis,0,0,0
2021-12-01,TLS,Pulau Pinang,0,0,0
2021-12-01,TLS,Sabah,0,0,0
2021-12-01,TLS,Sarawak,0,0,0
2021-12-01,TLS,Selangor,7,2,5
2021-12-01,TON,Johor,0,0,0
2021-12-01,TON,Pulau Pinang,0,0,0
2021-12-01,TON,Sarawak,0,0,0
2021-12-01,TON,Selangor,0,0,0
2021-12-01,TTO,Johor,0,0,0
2021-12-01,TTO,Kedah,0,0,0
2021-12-01,TTO,Pahang,0,0,0
2021-12-01,TTO,Pulau Pinang,0,0,0
2021-12-01,TTO,Sabah,0,0,0
2021-12-01,TTO,Sarawak,0,0,0
2021-12-01,TTO,Selangor,0,0,0
2021-12-01,TUN,Johor,0,0,0
2021-12-01,TUN,Kedah,0,0,0
2021-12-01,TUN,Kelantan,0,0,0
2021-12-01,TUN,Melaka,0,0,0
2021-12-01,TUN,Perak,0,0,0
2021-12-01,TUN,Perlis,0,0,0
2021-12-01,TUN,Pulau Pinang,0,0,0
2021-12-01,TUN,Sabah,0,0,0
2021-12-01,TUN,Sarawak,0,0,0
2021-12-01,TUN,Selangor,11,5,6
2021-12-01,TUN,W.P. Labuan,0,0,0
2021-12-01,TUR,Johor,0,0,0
2021-12-01,TUR,Kedah,0,0,0
2021-12-01,TUR,Kelantan,0,0,0
2021-12-01,TUR,Melaka,0,0,0
2021-12-01,TUR,Negeri Sembilan,0,0,0
2021-12-01,TUR,Pahang,0,0,0
2021-12-01,TUR,Perak,1,1,0
2021-12-01,TUR,Perlis,0,0,0
2021-12-01,TUR,Pulau Pinang,0,0,0
2021-12-01,TUR,Sabah,0,0,0
2021-12-01,TUR,Sarawak,0,0,0
2021-12-01,TUR,Selangor,92,73,19
2021-12-01,TUR,W.P. Labuan,0,0,0
2021-12-01,TUV,Selangor,0,0,0
2021-12-01,TWN,Johor,4,2,2
2021-12-01,TWN,Kedah,3,1,2
2021-12-01,TWN,Kelantan,0,0,0
2021-12-01,TWN,Melaka,0,0,0
2021-12-01,TWN,Negeri Sembilan,0,0,0
2021-12-01,TWN,Pahang,0,0,0
2021-12-01,TWN,Perak,0,0,0
2021-12-01,TWN,Perlis,0,0,0
2021-12-01,TWN,Pulau Pinang,13,8,5
2021-12-01,TWN,Sabah,1,0,1
2021-12-01,TWN,Sarawak,2,0,2
2021-12-01,TWN,Selangor,205,128,77
2021-12-01,TWN,W.P. Labuan,0,0,0
2021-12-01,TZA,Johor,0,0,0
2021-12-01,TZA,Kedah,0,0,0
2021-12-01,TZA,Perak,0,0,0
2021-12-01,TZA,Perlis,0,0,0
2021-12-01,TZA,Pulau Pinang,0,0,0
2021-12-01,TZA,Sabah,0,0,0
2021-12-01,TZA,Sarawak,0,0,0
2021-12-01,TZA,Selangor,36,14,22
2021-12-01,UGA,Johor,0,0,0
2021-12-01,UGA,Kedah,0,0,0
2021-12-01,UGA,Perak,0,0,0
2021-12-01,UGA,Perlis,0,0,0
2021-12-01,UGA,Pulau Pinang,0,0,0
2021-12-01,UGA,Sabah,0,0,0
2021-12-01,UGA,Sarawak,0,0,0
2021-12-01,UGA,Selangor,15,10,5
2021-12-01,UKR,Johor,0,0,0
2021-12-01,UKR,Kedah,0,0,0
2021-12-01,UKR,Kelantan,0,0,0
2021-12-01,UKR,Melaka,0,0,0
2021-12-01,UKR,Negeri Sembilan,0,0,0
2021-12-01,UKR,Pahang,0,0,0
2021-12-01,UKR,Perak,0,0,0
2021-12-01,UKR,Perlis,0,0,0
2021-12-01,UKR,Pulau Pinang,8,8,0
2021-12-01,UKR,Sabah,0,0,0
2021-12-01,UKR,Sarawak,0,0,0
2021-12-01,UKR,Selangor,85,81,4
2021-12-01,UKR,W.P. Labuan,0,0,0
2021-12-01,URY,Johor,0,0,0
2021-12-01,URY,Kedah,0,0,0
2021-12-01,URY,Kelantan,0,0,0
2021-12-01,URY,Perak,0,0,0
2021-12-01,URY,Perlis,0,0,0
2021-12-01,URY,Pulau Pinang,0,0,0
2021-12-01,URY,Sabah,0,0,0
2021-12-01,URY,Sarawak,0,0,0
2021-12-01,URY,Selangor,6,3,3
2021-12-01,URY,W.P. Labuan,0,0,0
2021-12-01,USA,Johor,0,0,0
2021-12-01,USA,Kedah,7,7,0
2021-12-01,USA,Kelantan,0,0,0
2021-12-01,USA,Melaka,0,0,0
2021-12-01,USA,Negeri Sembilan,0,0,0
2021-12-01,USA,Pahang,0,0,0
2021-12-01,USA,Perak,0,0,0
2021-12-01,USA,Perlis,0,0,0
2021-12-01,USA,Pulau Pinang,21,8,13
2021-12-01,USA,Sabah,2,1,1
2021-12-01,USA,Sarawak,7,5,2
2021-12-01,USA,Selangor,704,453,251
2021-12-01,USA,Terengganu,0,0,0
2021-12-01,USA,W.P. Labuan,0,0,0
2021-12-01,UZB,Johor,0,0,0
2021-12-01,UZB,Kedah,0,0,0
2021-12-01,UZB,Kelantan,0,0,0
2021-12-01,UZB,Perak,0,0,0
2021-12-01,UZB,Perlis,0,0,0
2021-12-01,UZB,Pulau Pinang,0,0,0
2021-12-01,UZB,Sabah,0,0,0
2021-12-01,UZB,Sarawak,0,0,0
2021-12-01,UZB,Selangor,45,30,15
2021-12-01,VAT,Johor,0,0,0
2021-12-01,VAT,Sarawak,0,0,0
2021-12-01,VAT,Selangor,1,1,0
2021-12-01,VCT,Johor,0,0,0
2021-12-01,VCT,Kedah,0,0,0
2021-12-01,VCT,Pulau Pinang,0,0,0
2021-12-01,VCT,Sarawak,0,0,0
2021-12-01,VCT,Selangor,0,0,0
2021-12-01,VEN,Johor,0,0,0
2021-12-01,VEN,Kedah,0,0,0
2021-12-01,VEN,Kelantan,0,0,0
2021-12-01,VEN,Melaka,0,0,0
2021-12-01,VEN,Perak,0,0,0
2021-12-01,VEN,Perlis,0,0,0
2021-12-01,VEN,Pulau Pinang,0,0,0
2021-12-01,VEN,Sabah,0,0,0
2021-12-01,VEN,Sarawak,0,0,0
2021-12-01,VEN,Selangor,4,4,0
2021-12-01,VEN,W.P. Labuan,0,0,0
2021-12-01,VNM,Johor,2,0,2
2021-12-01,VNM,Kedah,9,2,7
2021-12-01,VNM,Kelantan,0,0,0
2021-12-01,VNM,Melaka,0,0,0
2021-12-01,VNM,Negeri Sembilan,0,0,0
2021-12-01,VNM,Pahang,0,0,0
2021-12-01,VNM,Perak,1,0,1
2021-12-01,VNM,Perlis,0,0,0
2021-12-01,VNM,Pulau Pinang,3,1,2
2021-12-01,VNM,Sabah,1,0,1
2021-12-01,VNM,Sarawak,2,0,2
2021-12-01,VNM,Selangor,240,63,177
2021-12-01,VNM,Terengganu,0,0,0
2021-12-01,VNM,W.P. Labuan,0,0,0
2021-12-01,VUT,Johor,0,0,0
2021-12-01,VUT,Kedah,0,0,0
2021-12-01,VUT,Pulau Pinang,0,0,0
2021-12-01,VUT,Sabah,0,0,0
2021-12-01,VUT,Sarawak,0,0,0
2021-12-01,VUT,Selangor,6,4,2
2021-12-01,WSM,Johor,0,0,0
2021-12-01,WSM,Sarawak,0,0,0
2021-12-01,WSM,Selangor,0,0,0
2021-12-01,XXX,Johor,0,0,0
2021-12-01,XXX,Kedah,0,0,0
2021-12-01,XXX,Kelantan,0,0,0
2021-12-01,XXX,Melaka,0,0,0
2021-12-01,XXX,Pahang,0,0,0
2021-12-01,XXX,Perak,0,0,0
2021-12-01,XXX,Perlis,0,0,0
2021-12-01,XXX,Pulau Pinang,0,0,0
2021-12-01,XXX,Sabah,0,0,0
2021-12-01,XXX,Sarawak,0,0,0
2021-12-01,XXX,Selangor,24,13,11
2021-12-01,XXX,W.P. Labuan,0,0,0
2021-12-01,YEM,Johor,0,0,0
2021-12-01,YEM,Kedah,2,2,0
2021-12-01,YEM,Kelantan,0,0,0
2021-12-01,YEM,Melaka,0,0,0
2021-12-01,YEM,Pahang,0,0,0
2021-12-01,YEM,Perak,0,0,0
2021-12-01,YEM,Perlis,0,0,0
2021-12-01,YEM,Pulau Pinang,0,0,0
2021-12-01,YEM,Sabah,0,0,0
2021-12-01,YEM,Sarawak,0,0,0
2021-12-01,YEM,Selangor,283,202,81
2021-12-01,YEM,W.P. Labuan,0,0,0
2021-12-01,ZAF,Johor,0,0,0
2021-12-01,ZAF,Kedah,1,1,0
2021-12-01,ZAF,Kelantan,0,0,0
2021-12-01,ZAF,Melaka,0,0,0
2021-12-01,ZAF,Pahang,0,0,0
2021-12-01,ZAF,Perak,0,0,0
2021-12-01,ZAF,Perlis,0,0,0
2021-12-01,ZAF,Pulau Pinang,0,0,0
2021-12-01,ZAF,Sabah,0,0,0
2021-12-01,ZAF,Sarawak,0,0,0
2021-12-01,ZAF,Selangor,37,24,13
2021-12-01,ZAF,Terengganu,0,0,0
2021-12-01,ZAF,W.P. Labuan,0,0,0
2021-12-01,ZAR,Selangor,0,0,0
2021-12-01,ZMB,Johor,0,0,0
2021-12-01,ZMB,Kedah,0,0,0
2021-12-01,ZMB,Perak,0,0,0
2021-12-01,ZMB,Perlis,0,0,0
2021-12-01,ZMB,Pulau Pinang,0,0,0
2021-12-01,ZMB,Sabah,0,0,0
2021-12-01,ZMB,Sarawak,0,0,0
2021-12-01,ZMB,Selangor,6,3,3
2021-12-01,ZWE,Johor,0,0,0
2021-12-01,ZWE,Kedah,0,0,0
2021-12-01,ZWE,Kelantan,0,0,0
2021-12-01,ZWE,Perak,0,0,0
2021-12-01,ZWE,Perlis,0,0,0
2021-12-01,ZWE,Pulau Pinang,0,0,0
2021-12-01,ZWE,Sabah,0,0,0
2021-12-01,ZWE,Sarawak,0,0,0
2021-12-01,ZWE,Selangor,1,0,1
2022-01-01,ABW,Kedah,0,0,0
2022-01-01,ABW,Pulau Pinang,0,0,0
2022-01-01,AFG,Johor,0,0,0
2022-01-01,AFG,Kedah,0,0,0
2022-01-01,AFG,Perlis,0,0,0
2022-01-01,AFG,Pulau Pinang,0,0,0
2022-01-01,AFG,Sarawak,0,0,0
2022-01-01,AFG,Selangor,65,52,13
2022-01-01,AGO,Johor,0,0,0
2022-01-01,AGO,Kedah,0,0,0
2022-01-01,AGO,Sabah,0,0,0
2022-01-01,AGO,Selangor,4,3,1
2022-01-01,AIA,Selangor,0,0,0
2022-01-01,ALB,Johor,0,0,0
2022-01-01,ALB,Kedah,0,0,0
2022-01-01,ALB,Perak,0,0,0
2022-01-01,ALB,Perlis,0,0,0
2022-01-01,ALB,Pulau Pinang,0,0,0
2022-01-01,ALB,Sabah,0,0,0
2022-01-01,ALB,Sarawak,0,0,0
2022-01-01,ALB,Selangor,5,4,1
2022-01-01,AND,Johor,0,0,0
2022-01-01,AND,Kedah,0,0,0
2022-01-01,AND,Perlis,0,0,0
2022-01-01,AND,Pulau Pinang,0,0,0
2022-01-01,AND,Selangor,0,0,0
2022-01-01,ANT,Selangor,0,0,0
2022-01-01,ARE,Johor,0,0,0
2022-01-01,ARE,Kedah,0,0,0
2022-01-01,ARE,Kelantan,0,0,0
2022-01-01,ARE,Perak,0,0,0
2022-01-01,ARE,Perlis,0,0,0
2022-01-01,ARE,Pulau Pinang,0,0,0
2022-01-01,ARE,Sabah,0,0,0
2022-01-01,ARE,Sarawak,0,0,0
2022-01-01,ARE,Selangor,10,7,3
2022-01-01,ARG,Johor,0,0,0
2022-01-01,ARG,Kedah,0,0,0
2022-01-01,ARG,Kelantan,0,0,0
2022-01-01,ARG,Melaka,0,0,0
2022-01-01,ARG,Perak,0,0,0
2022-01-01,ARG,Perlis,0,0,0
2022-01-01,ARG,Pulau Pinang,0,0,0
2022-01-01,ARG,Sabah,0,0,0
2022-01-01,ARG,Sarawak,0,0,0
2022-01-01,ARG,Selangor,42,24,18
2022-01-01,ARG,W.P. Labuan,0,0,0
2022-01-01,ARM,Johor,0,0,0
2022-01-01,ARM,Kedah,0,0,0
2022-01-01,ARM,Kelantan,0,0,0
2022-01-01,ARM,Perak,0,0,0
2022-01-01,ARM,Perlis,0,0,0
2022-01-01,ARM,Pulau Pinang,0,0,0
2022-01-01,ARM,Sabah,0,0,0
2022-01-01,ARM,Sarawak,0,0,0
2022-01-01,ARM,Selangor,6,2,4
2022-01-01,ATA,Selangor,0,0,0
2022-01-01,ATG,Johor,0,0,0
2022-01-01,ATG,Kedah,0,0,0
2022-01-01,ATG,Pulau Pinang,0,0,0
2022-01-01,ATG,Sarawak,0,0,0
2022-01-01,ATG,Selangor,0,0,0
2022-01-01,AUS,Johor,0,0,0
2022-01-01,AUS,Kedah,45,29,16
2022-01-01,AUS,Kelantan,0,0,0
2022-01-01,AUS,Melaka,0,0,0
2022-01-01,AUS,Negeri Sembilan,0,0,0
2022-01-01,AUS,Pahang,0,0,0
2022-01-01,AUS,Perak,0,0,0
2022-01-01,AUS,Perlis,0,0,0
2022-01-01,AUS,Pulau Pinang,20,11,9
2022-01-01,AUS,Sabah,0,0,0
2022-01-01,AUS,Sarawak,7,3,4
2022-01-01,AUS,Selangor,901,569,332
2022-01-01,AUS,Terengganu,0,0,0
2022-01-01,AUS,W.P. Labuan,0,0,0
2022-01-01,AUT,Johor,1,0,1
2022-01-01,AUT,Kedah,1,1,0
2022-01-01,AUT,Kelantan,0,0,0
2022-01-01,AUT,Melaka,0,0,0
2022-01-01,AUT,Negeri Sembilan,0,0,0
2022-01-01,AUT,Pahang,0,0,0
2022-01-01,AUT,Perak,0,0,0
2022-01-01,AUT,Perlis,0,0,0
2022-01-01,AUT,Pulau Pinang,0,0,0
2022-01-01,AUT,Sabah,1,1,0
2022-01-01,AUT,Sarawak,0,0,0
2022-01-01,AUT,Selangor,63,52,11
2022-01-01,AUT,Terengganu,0,0,0
2022-01-01,AUT,W.P. Labuan,0,0,0
2022-01-01,AZE,Johor,0,0,0
2022-01-01,AZE,Kedah,0,0,0
2022-01-01,AZE,Kelantan,0,0,0
2022-01-01,AZE,Melaka,0,0,0
2022-01-01,AZE,Perlis,0,0,0
2022-01-01,AZE,Pulau Pinang,0,0,0
2022-01-01,AZE,Sabah,0,0,0
2022-01-01,AZE,Sarawak,0,0,0
2022-01-01,AZE,Selangor,14,9,5
2022-01-01,AZE,W.P. Labuan,0,0,0
2022-01-01,BDI,Pulau Pinang,0,0,0
2022-01-01,BDI,Sarawak,0,0,0
2022-01-01,BDI,Selangor,2,2,0
2022-01-01,BEL,Johor,0,0,0
2022-01-01,BEL,Kedah,0,0,0
2022-01-01,BEL,Kelantan,0,0,0
2022-01-01,BEL,Melaka,0,0,0
2022-01-01,BEL,Negeri Sembilan,0,0,0
2022-01-01,BEL,Pahang,0,0,0
2022-01-01,BEL,Perak,0,0,0
2022-01-01,BEL,Perlis,0,0,0
2022-01-01,BEL,Pulau Pinang,0,0,0
2022-01-01,BEL,Sabah,0,0,0
2022-01-01,BEL,Sarawak,0,0,0
2022-01-01,BEL,Selangor,65,43,22
2022-01-01,BEL,W.P. Labuan,0,0,0
2022-01-01,BEN,Johor,0,0,0
2022-01-01,BEN,Kedah,0,0,0
2022-01-01,BEN,Perak,0,0,0
2022-01-01,BEN,Pulau Pinang,0,0,0
2022-01-01,BEN,Sabah,0,0,0
2022-01-01,BEN,Sarawak,0,0,0
2022-01-01,BEN,Selangor,1,1,0
2022-01-01,BFA,Perak,0,0,0
2022-01-01,BFA,Pulau Pinang,0,0,0
2022-01-01,BFA,Selangor,2,2,0
2022-01-01,BGD,Johor,11,9,2
2022-01-01,BGD,Kedah,0,0,0
2022-01-01,BGD,Kelantan,0,0,0
2022-01-01,BGD,Melaka,0,0,0
2022-01-01,BGD,Negeri Sembilan,0,0,0
2022-01-01,BGD,Pahang,0,0,0
2022-01-01,BGD,Perak,0,0,0
2022-01-01,BGD,Perlis,0,0,0
2022-01-01,BGD,Pulau Pinang,1,1,0
2022-01-01,BGD,Sabah,1,1,0
2022-01-01,BGD,Sarawak,0,0,0
2022-01-01,BGD,Selangor,5380,4995,385
2022-01-01,BGD,W.P. Labuan,0,0,0
2022-01-01,BGR,Johor,1,1,0
2022-01-01,BGR,Kedah,0,0,0
2022-01-01,BGR,Kelantan,0,0,0
2022-01-01,BGR,Pahang,0,0,0
2022-01-01,BGR,Perak,0,0,0
2022-01-01,BGR,Perlis,0,0,0
2022-01-01,BGR,Pulau Pinang,0,0,0
2022-01-01,BGR,Sabah,0,0,0
2022-01-01,BGR,Sarawak,0,0,0
2022-01-01,BGR,Selangor,17,15,2
2022-01-01,BGR,W.P. Labuan,0,0,0
2022-01-01,BHR,Johor,0,0,0
2022-01-01,BHR,Kedah,0,0,0
2022-01-01,BHR,Kelantan,0,0,0
2022-01-01,BHR,Perlis,0,0,0
2022-01-01,BHR,Pulau Pinang,0,0,0
2022-01-01,BHR,Sabah,0,0,0
2022-01-01,BHR,Sarawak,0,0,0
2022-01-01,BHR,Selangor,8,7,1
2022-01-01,BHS,Johor,0,0,0
2022-01-01,BHS,Kedah,0,0,0
2022-01-01,BHS,Perak,0,0,0
2022-01-01,BHS,Sabah,0,0,0
2022-01-01,BHS,Sarawak,0,0,0
2022-01-01,BHS,Selangor,0,0,0
2022-01-01,BIH,Johor,0,0,0
2022-01-01,BIH,Kedah,0,0,0
2022-01-01,BIH,Perlis,0,0,0
2022-01-01,BIH,Pulau Pinang,0,0,0
2022-01-01,BIH,Sabah,0,0,0
2022-01-01,BIH,Sarawak,0,0,0
2022-01-01,BIH,Selangor,6,5,1
2022-01-01,BLR,Johor,0,0,0
2022-01-01,BLR,Kedah,0,0,0
2022-01-01,BLR,Kelantan,0,0,0
2022-01-01,BLR,Pahang,0,0,0
2022-01-01,BLR,Perak,0,0,0
2022-01-01,BLR,Perlis,0,0,0
2022-01-01,BLR,Pulau Pinang,0,0,0
2022-01-01,BLR,Sabah,0,0,0
2022-01-01,BLR,Sarawak,0,0,0
2022-01-01,BLR,Selangor,3,3,0
2022-01-01,BLR,W.P. Labuan,0,0,0
2022-01-01,BLZ,Johor,0,0,0
2022-01-01,BLZ,Pulau Pinang,0,0,0
2022-01-01,BLZ,Sarawak,0,0,0
2022-01-01,BLZ,Selangor,0,0,0
2022-01-01,BMU,Selangor,0,0,0
2022-01-01,BOL,Johor,0,0,0
2022-01-01,BOL,Kedah,0,0,0
2022-01-01,BOL,Melaka,0,0,0
2022-01-01,BOL,Perak,0,0,0
2022-01-01,BOL,Perlis,0,0,0
2022-01-01,BOL,Pulau Pinang,0,0,0
2022-01-01,BOL,Sabah,0,0,0
2022-01-01,BOL,Sarawak,0,0,0
2022-01-01,BOL,Selangor,0,0,0
2022-01-01,BRA,Johor,0,0,0
2022-01-01,BRA,Kedah,3,2,1
2022-01-01,BRA,Kelantan,0,0,0
2022-01-01,BRA,Melaka,0,0,0
2022-01-01,BRA,Pahang,0,0,0
2022-01-01,BRA,Perak,0,0,0
2022-01-01,BRA,Perlis,0,0,0
2022-01-01,BRA,Pulau Pinang,0,0,0
2022-01-01,BRA,Sabah,0,0,0
2022-01-01,BRA,Sarawak,0,0,0
2022-01-01,BRA,Selangor,128,75,53
2022-01-01,BRA,W.P. Labuan,0,0,0
2022-01-01,BRB,Johor,0,0,0
2022-01-01,BRB,Kedah,0,0,0
2022-01-01,BRB,Perlis,0,0,0
2022-01-01,BRB,Pulau Pinang,0,0,0
2022-01-01,BRB,Selangor,1,1,0
2022-01-01,BRN,Johor,0,0,0
2022-01-01,BRN,Kedah,0,0,0
2022-01-01,BRN,Kelantan,0,0,0
2022-01-01,BRN,Melaka,0,0,0
2022-01-01,BRN,Pahang,0,0,0
2022-01-01,BRN,Perak,0,0,0
2022-01-01,BRN,Perlis,0,0,0
2022-01-01,BRN,Pulau Pinang,0,0,0
2022-01-01,BRN,Sabah,0,0,0
2022-01-01,BRN,Sarawak,422,408,14
2022-01-01,BRN,Selangor,81,51,30
2022-01-01,BRN,W.P. Labuan,2,2,0
2022-01-01,BTN,Johor,0,0,0
2022-01-01,BTN,Kedah,0,0,0
2022-01-01,BTN,Perak,0,0,0
2022-01-01,BTN,Perlis,0,0,0
2022-01-01,BTN,Pulau Pinang,0,0,0
2022-01-01,BTN,Sabah,0,0,0
2022-01-01,BTN,Sarawak,0,0,0
2022-01-01,BTN,Selangor,2,0,2
2022-01-01,BWA,Johor,0,0,0
2022-01-01,BWA,Kedah,0,0,0
2022-01-01,BWA,Perlis,0,0,0
2022-01-01,BWA,Pulau Pinang,0,0,0
2022-01-01,BWA,Sabah,0,0,0
2022-01-01,BWA,Sarawak,0,0,0
2022-01-01,BWA,Selangor,3,1,2
2022-01-01,CAF,Kedah,0,0,0
2022-01-01,CAF,Selangor,0,0,0
2022-01-01,CAN,Johor,1,1,0
2022-01-01,CAN,Kedah,3,2,1
2022-01-01,CAN,Kelantan,0,0,0
2022-01-01,CAN,Melaka,0,0,0
2022-01-01,CAN,Negeri Sembilan,0,0,0
2022-01-01,CAN,Pahang,0,0,0
2022-01-01,CAN,Perak,0,0,0
2022-01-01,CAN,Perlis,0,0,0
2022-01-01,CAN,Pulau Pinang,0,0,0
2022-01-01,CAN,Sabah,1,1,0
2022-01-01,CAN,Sarawak,1,0,1
2022-01-01,CAN,Selangor,254,153,101
2022-01-01,CAN,Terengganu,0,0,0
2022-01-01,CAN,W.P. Labuan,0,0,0
2022-01-01,CCK,Selangor,0,0,0
2022-01-01,CHE,Johor,0,0,0
2022-01-01,CHE,Kedah,3,2,1
2022-01-01,CHE,Kelantan,0,0,0
2022-01-01,CHE,Melaka,0,0,0
2022-01-01,CHE,Negeri Sembilan,0,0,0
2022-01-01,CHE,Pahang,0,0,0
2022-01-01,CHE,Perak,0,0,0
2022-01-01,CHE,Perlis,0,0,0
2022-01-01,CHE,Pulau Pinang,3,3,0
2022-01-01,CHE,Sabah,1,0,1
2022-01-01,CHE,Sarawak,0,0,0
2022-01-01,CHE,Selangor,111,67,44
2022-01-01,CHE,W.P. Labuan,0,0,0
2022-01-01,CHL,Johor,0,0,0
2022-01-01,CHL,Kedah,0,0,0
2022-01-01,CHL,Kelantan,0,0,0
2022-01-01,CHL,Melaka,0,0,0
2022-01-01,CHL,Pahang,0,0,0
2022-01-01,CHL,Perak,0,0,0
2022-01-01,CHL,Perlis,0,0,0
2022-01-01,CHL,Pulau Pinang,0,0,0
2022-01-01,CHL,Sabah,0,0,0
2022-01-01,CHL,Sarawak,0,0,0
2022-01-01,CHL,Selangor,18,6,12
2022-01-01,CHN,Johor,154,145,9
2022-01-01,CHN,Kedah,6,1,5
2022-01-01,CHN,Kelantan,0,0,0
2022-01-01,CHN,Melaka,0,0,0
2022-01-01,CHN,Pahang,0,0,0
2022-01-01,CHN,Perak,0,0,0
2022-01-01,CHN,Perlis,0,0,0
2022-01-01,CHN,Pulau Pinang,7,4,3
2022-01-01,CHN,Sabah,4,3,1
2022-01-01,CHN,Sarawak,37,33,4
2022-01-01,CHN,Selangor,1844,1117,727
2022-01-01,CHN,Terengganu,0,0,0
2022-01-01,CHN,W.P. Labuan,0,0,0
2022-01-01,CIV,Johor,0,0,0
2022-01-01,CIV,Kedah,0,0,0
2022-01-01,CIV,Pulau Pinang,0,0,0
2022-01-01,CIV,Sabah,0,0,0
2022-01-01,CIV,Sarawak,0,0,0
2022-01-01,CIV,Selangor,2,1,1
2022-01-01,CMR,Johor,0,0,0
2022-01-01,CMR,Kedah,0,0,0
2022-01-01,CMR,Pulau Pinang,0,0,0
2022-01-01,CMR,Sabah,0,0,0
2022-01-01,CMR,Sarawak,0,0,0
2022-01-01,CMR,Selangor,4,2,2
2022-01-01,COD,Johor,0,0,0
2022-01-01,COD,Pulau Pinang,0,0,0
2022-01-01,COD,Sarawak,0,0,0
2022-01-01,COD,Selangor,2,2,0
2022-01-01,COG,Johor,0,0,0
2022-01-01,COG,Kedah,0,0,0
2022-01-01,COG,Selangor,0,0,0
2022-01-01,COK,Selangor,0,0,0
2022-01-01,COL,Johor,0,0,0
2022-01-01,COL,Kedah,0,0,0
2022-01-01,COL,Perak,0,0,0
2022-01-01,COL,Pulau Pinang,0,0,0
2022-01-01,COL,Sabah,0,0,0
2022-01-01,COL,Sarawak,0,0,0
2022-01-01,COL,Selangor,37,20,17
2022-01-01,COL,W.P. Labuan,0,0,0
2022-01-01,COM,Johor,0,0,0
2022-01-01,COM,Kedah,0,0,0
2022-01-01,COM,Selangor,1,1,0
2022-01-01,CPV,Johor,0,0,0
2022-01-01,CPV,Kedah,0,0,0
2022-01-01,CPV,Pulau Pinang,0,0,0
2022-01-01,CPV,Sabah,0,0,0
2022-01-01,CPV,Selangor,0,0,0
2022-01-01,CRI,Johor,0,0,0
2022-01-01,CRI,Kedah,0,0,0
2022-01-01,CRI,Perak,0,0,0
2022-01-01,CRI,Perlis,0,0,0
2022-01-01,CRI,Pulau Pinang,0,0,0
2022-01-01,CRI,Sabah,0,0,0
2022-01-01,CRI,Sarawak,0,0,0
2022-01-01,CRI,Selangor,17,6,11
2022-01-01,CUB,Johor,0,0,0
2022-01-01,CUB,Kedah,0,0,0
2022-01-01,CUB,Perlis,0,0,0
2022-01-01,CUB,Pulau Pinang,0,0,0
2022-01-01,CUB,Sabah,0,0,0
2022-01-01,CUB,Sarawak,0,0,0
2022-01-01,CUB,Selangor,5,2,3
2022-01-01,CYP,Johor,0,0,0
2022-01-01,CYP,Kedah,6,6,0
2022-01-01,CYP,Perak,0,0,0
2022-01-01,CYP,Perlis,0,0,0
2022-01-01,CYP,Pulau Pinang,0,0,0
2022-01-01,CYP,Sabah,0,0,0
2022-01-01,CYP,Sarawak,0,0,0
2022-01-01,CYP,Selangor,4,2,2
2022-01-01,CZE,Johor,0,0,0
2022-01-01,CZE,Kedah,0,0,0
2022-01-01,CZE,Kelantan,0,0,0
2022-01-01,CZE,Melaka,0,0,0
2022-01-01,CZE,Negeri Sembilan,0,0,0
2022-01-01,CZE,Perak,0,0,0
2022-01-01,CZE,Perlis,0,0,0
2022-01-01,CZE,Pulau Pinang,0,0,0
2022-01-01,CZE,Sabah,0,0,0
2022-01-01,CZE,Sarawak,2,2,0
2022-01-01,CZE,Selangor,18,13,5
2022-01-01,CZE,W.P. Labuan,0,0,0
2022-01-01,DEU,Johor,1,1,0
2022-01-01,DEU,Kedah,8,7,1
2022-01-01,DEU,Kelantan,0,0,0
2022-01-01,DEU,Melaka,0,0,0
2022-01-01,DEU,Negeri Sembilan,0,0,0
2022-01-01,DEU,Pahang,0,0,0
2022-01-01,DEU,Perak,0,0,0
2022-01-01,DEU,Perlis,0,0,0
2022-01-01,DEU,Pulau Pinang,7,5,2
2022-01-01,DEU,Sabah,0,0,0
2022-01-01,DEU,Sarawak,0,0,0
2022-01-01,DEU,Selangor,433,332,101
2022-01-01,DEU,Terengganu,0,0,0
2022-01-01,DEU,W.P. Labuan,0,0,0
2022-01-01,DJI,Johor,0,0,0
2022-01-01,DJI,Selangor,6,3,3
2022-01-01,DMA,Johor,0,0,0
2022-01-01,DMA,Kedah,0,0,0
2022-01-01,DMA,Pulau Pinang,0,0,0
2022-01-01,DMA,Sabah,0,0,0
2022-01-01,DMA,Sarawak,0,0,0
2022-01-01,DMA,Selangor,0,0,0
2022-01-01,DMA,W.P. Labuan,0,0,0
2022-01-01,DNK,Johor,2,2,0
2022-01-01,DNK,Kedah,2,1,1
2022-01-01,DNK,Kelantan,0,0,0
2022-01-01,DNK,Melaka,0,0,0
2022-01-01,DNK,Negeri Sembilan,0,0,0
2022-01-01,DNK,Pahang,0,0,0
2022-01-01,DNK,Perak,0,0,0
2022-01-01,DNK,Perlis,0,0,0
2022-01-01,DNK,Pulau Pinang,2,1,1
2022-01-01,DNK,Sabah,0,0,0
2022-01-01,DNK,Sarawak,0,0,0
2022-01-01,DNK,Selangor,121,89,32
2022-01-01,DNK,W.P. Labuan,0,0,0
2022-01-01,DOM,Johor,0,0,0
2022-01-01,DOM,Kedah,0,0,0
2022-01-01,DOM,Perak,0,0,0
2022-01-01,DOM,Perlis,0,0,0
2022-01-01,DOM,Pulau Pinang,0,0,0
2022-01-01,DOM,Sabah,0,0,0
2022-01-01,DOM,Sarawak,0,0,0
2022-01-01,DOM,Selangor,1,1,0
2022-01-01,DZA,Johor,0,0,0
2022-01-01,DZA,Kedah,0,0,0
2022-01-01,DZA,Kelantan,0,0,0
2022-01-01,DZA,Melaka,0,0,0
2022-01-01,DZA,Perak,0,0,0
2022-01-01,DZA,Perlis,0,0,0
2022-01-01,DZA,Pulau Pinang,0,0,0
2022-01-01,DZA,Sabah,0,0,0
2022-01-01,DZA,Sarawak,0,0,0
2022-01-01,DZA,Selangor,50,37,13
2022-01-01,DZA,W.P. Labuan,0,0,0
2022-01-01,ECU,Johor,0,0,0
2022-01-01,ECU,Kedah,0,0,0
2022-01-01,ECU,Perak,0,0,0
2022-01-01,ECU,Perlis,0,0,0
2022-01-01,ECU,Pulau Pinang,0,0,0
2022-01-01,ECU,Sabah,0,0,0
2022-01-01,ECU,Sarawak,0,0,0
2022-01-01,ECU,Selangor,2,2,0
2022-01-01,EGY,Johor,1,1,0
2022-01-01,EGY,Kedah,0,0,0
2022-01-01,EGY,Kelantan,0,0,0
2022-01-01,EGY,Melaka,0,0,0
2022-01-01,EGY,Pahang,0,0,0
2022-01-01,EGY,Perak,0,0,0
2022-01-01,EGY,Perlis,0,0,0
2022-01-01,EGY,Pulau Pinang,0,0,0
2022-01-01,EGY,Sabah,0,0,0
2022-01-01,EGY,Sarawak,1,1,0
2022-01-01,EGY,Selangor,340,246,94
2022-01-01,EGY,Terengganu,0,0,0
2022-01-01,EGY,W.P. Labuan,0,0,0
2022-01-01,ERI,Johor,0,0,0
2022-01-01,ERI,Pulau Pinang,0,0,0
2022-01-01,ERI,Sabah,0,0,0
2022-01-01,ERI,Selangor,1,0,1
2022-01-01,ESP,Johor,0,0,0
2022-01-01,ESP,Kedah,3,2,1
2022-01-01,ESP,Kelantan,0,0,0
2022-01-01,ESP,Melaka,0,0,0
2022-01-01,ESP,Negeri Sembilan,0,0,0
2022-01-01,ESP,Pahang,0,0,0
2022-01-01,ESP,Perak,0,0,0
2022-01-01,ESP,Perlis,0,0,0
2022-01-01,ESP,Pulau Pinang,0,0,0
2022-01-01,ESP,Sabah,0,0,0
2022-01-01,ESP,Sarawak,0,0,0
2022-01-01,ESP,Selangor,271,198,73
2022-01-01,ESP,W.P. Labuan,0,0,0
2022-01-01,EST,Johor,0,0,0
2022-01-01,EST,Kedah,0,0,0
2022-01-01,EST,Kelantan,0,0,0
2022-01-01,EST,Pahang,0,0,0
2022-01-01,EST,Perak,0,0,0
2022-01-01,EST,Perlis,0,0,0
2022-01-01,EST,Pulau Pinang,0,0,0
2022-01-01,EST,Sabah,0,0,0
2022-01-01,EST,Sarawak,0,0,0
2022-01-01,EST,Selangor,7,4,3
2022-01-01,EST,W.P. Labuan,0,0,0
2022-01-01,ETH,Johor,1,1,0
2022-01-01,ETH,Kedah,0,0,0
2022-01-01,ETH,Pulau Pinang,0,0,0
2022-01-01,ETH,Sarawak,0,0,0
2022-01-01,ETH,Selangor,14,8,6
2022-01-01,FIN,Johor,0,0,0
2022-01-01,FIN,Kedah,1,1,0
2022-01-01,FIN,Kelantan,0,0,0
2022-01-01,FIN,Melaka,0,0,0
2022-01-01,FIN,Negeri Sembilan,0,0,0
2022-01-01,FIN,Pahang,0,0,0
2022-01-01,FIN,Perak,0,0,0
2022-01-01,FIN,Perlis,0,0,0
2022-01-01,FIN,Pulau Pinang,0,0,0
2022-01-01,FIN,Sabah,0,0,0
2022-01-01,FIN,Sarawak,0,0,0
2022-01-01,FIN,Selangor,47,30,17
2022-01-01,FIN,W.P. Labuan,0,0,0
2022-01-01,FJI,Johor,0,0,0
2022-01-01,FJI,Kedah,0,0,0
2022-01-01,FJI,Kelantan,0,0,0
2022-01-01,FJI,Perak,0,0,0
2022-01-01,FJI,Perlis,0,0,0
2022-01-01,FJI,Pulau Pinang,0,0,0
2022-01-01,FJI,Sabah,0,0,0
2022-01-01,FJI,Sarawak,0,0,0
2022-01-01,FJI,Selangor,2,0,2
2022-01-01,FRA,Johor,5,5,0
2022-01-01,FRA,Kedah,3,3,0
2022-01-01,FRA,Kelantan,0,0,0
2022-01-01,FRA,Melaka,0,0,0
2022-01-01,FRA,Negeri Sembilan,0,0,0
2022-01-01,FRA,Pahang,0,0,0
2022-01-01,FRA,Perak,0,0,0
2022-01-01,FRA,Perlis,0,0,0
2022-01-01,FRA,Pulau Pinang,0,0,0
2022-01-01,FRA,Sabah,0,0,0
2022-01-01,FRA,Sarawak,1,1,0
2022-01-01,FRA,Selangor,668,482,186
2022-01-01,FRA,Terengganu,0,0,0
2022-01-01,FRA,W.P. Labuan,0,0,0
2022-01-01,FSM,Johor,0,0,0
2022-01-01,FSM,Pulau Pinang,0,0,0
2022-01-01,FSM,Selangor,0,0,0
2022-01-01,GAB,Johor,0,0,0
2022-01-01,GAB,Pulau Pinang,0,0,0
2022-01-01,GAB,Sarawak,0,0,0
2022-01-01,GAB,Selangor,2,1,1
2022-01-01,GBR,Johor,8,4,4
2022-01-01,GBR,Kedah,34,23,11
2022-01-01,GBR,Kelantan,0,0,0
2022-01-01,GBR,Melaka,0,0,0
2022-01-01,GBR,Negeri Sembilan,0,0,0
2022-01-01,GBR,Pahang,0,0,0
2022-01-01,GBR,Perak,0,0,0
2022-01-01,GBR,Perlis,0,0,0
2022-01-01,GBR,Pulau Pinang,13,10,3
2022-01-01,GBR,Sabah,4,1,3
2022-01-01,GBR,Sarawak,4,3,1
2022-01-01,GBR,Selangor,1735,1116,619
2022-01-01,GBR,Terengganu,0,0,0
2022-01-01,GBR,W.P. Labuan,0,0,0
2022-01-01,GEO,Johor,0,0,0
2022-01-01,GEO,Kedah,0,0,0
2022-01-01,GEO,Melaka,0,0,0
2022-01-01,GEO,Perak,0,0,0
2022-01-01,GEO,Perlis,0,0,0
2022-01-01,GEO,Pulau Pinang,0,0,0
2022-01-01,GEO,Sabah,0,0,0
2022-01-01,GEO,Sarawak,0,0,0
2022-01-01,GEO,Selangor,10,10,0
2022-01-01,GHA,Johor,0,0,0
2022-01-01,GHA,Kedah,0,0,0
2022-01-01,GHA,Kelantan,0,0,0
2022-01-01,GHA,Pulau Pinang,0,0,0
2022-01-01,GHA,Sabah,0,0,0
2022-01-01,GHA,Sarawak,0,0,0
2022-01-01,GHA,Selangor,15,12,3
2022-01-01,GIB,Johor,0,0,0
2022-01-01,GIB,Sarawak,0,0,0
2022-01-01,GIN,Johor,0,0,0
2022-01-01,GIN,Kedah,0,0,0
2022-01-01,GIN,Kelantan,0,0,0
2022-01-01,GIN,Perlis,0,0,0
2022-01-01,GIN,Pulau Pinang,0,0,0
2022-01-01,GIN,Sabah,0,0,0
2022-01-01,GIN,Sarawak,0,0,0
2022-01-01,GIN,Selangor,16,11,5
2022-01-01,GLP,Selangor,0,0,0
2022-01-01,GMB,Johor,0,0,0
2022-01-01,GMB,Kedah,0,0,0
2022-01-01,GMB,Kelantan,0,0,0
2022-01-01,GMB,Pulau Pinang,0,0,0
2022-01-01,GMB,Sabah,0,0,0
2022-01-01,GMB,Sarawak,0,0,0
2022-01-01,GMB,Selangor,5,4,1
2022-01-01,GNB,Johor,0,0,0
2022-01-01,GNB,Selangor,0,0,0
2022-01-01,GNQ,Johor,0,0,0
2022-01-01,GNQ,Selangor,4,4,0
2022-01-01,GRC,Johor,0,0,0
2022-01-01,GRC,Kedah,0,0,0
2022-01-01,GRC,Kelantan,0,0,0
2022-01-01,GRC,Melaka,0,0,0
2022-01-01,GRC,Negeri Sembilan,0,0,0
2022-01-01,GRC,Pahang,0,0,0
2022-01-01,GRC,Perak,0,0,0
2022-01-01,GRC,Perlis,0,0,0
2022-01-01,GRC,Pulau Pinang,0,0,0
2022-01-01,GRC,Sabah,0,0,0
2022-01-01,GRC,Sarawak,0,0,0
2022-01-01,GRC,Selangor,9,6,3
2022-01-01,GRD,Johor,0,0,0
2022-01-01,GRD,Kedah,0,0,0
2022-01-01,GRD,Pulau Pinang,0,0,0
2022-01-01,GRD,Sabah,0,0,0
2022-01-01,GRD,Sarawak,0,0,0
2022-01-01,GRD,Selangor,1,0,1
2022-01-01,GRL,Johor,0,0,0
2022-01-01,GRL,Selangor,0,0,0
2022-01-01,GTM,Johor,0,0,0
2022-01-01,GTM,Kedah,0,0,0
2022-01-01,GTM,Pahang,0,0,0
2022-01-01,GTM,Perak,0,0,0
2022-01-01,GTM,Pulau Pinang,0,0,0
2022-01-01,GTM,Sabah,0,0,0
2022-01-01,GTM,Sarawak,0,0,0
2022-01-01,GTM,Selangor,1,1,0
2022-01-01,GTM,W.P. Labuan,0,0,0
2022-01-01,GUY,Johor,0,0,0
2022-01-01,GUY,Kedah,0,0,0
2022-01-01,GUY,Pulau Pinang,0,0,0
2022-01-01,GUY,Sarawak,0,0,0
2022-01-01,GUY,Selangor,0,0,0
2022-01-01,HKG,Johor,0,0,0
2022-01-01,HKG,Kedah,7,2,5
2022-01-01,HKG,Kelantan,0,0,0
2022-01-01,HKG,Pahang,0,0,0
2022-01-01,HKG,Perak,0,0,0
2022-01-01,HKG,Perlis,0,0,0
2022-01-01,HKG,Pulau Pinang,1,1,0
2022-01-01,HKG,Sabah,0,0,0
2022-01-01,HKG,Sarawak,19,15,4
2022-01-01,HKG,Selangor,4,4,0
2022-01-01,HKG,Terengganu,0,0,0
2022-01-01,HMD,Johor,0,0,0
2022-01-01,HND,Johor,0,0,0
2022-01-01,HND,Kedah,0,0,0
2022-01-01,HND,Perak,0,0,0
2022-01-01,HND,Pulau Pinang,0,0,0
2022-01-01,HND,Sabah,0,0,0
2022-01-01,HND,Sarawak,0,0,0
2022-01-01,HND,Selangor,1,0,1
2022-01-01,HRV,Johor,0,0,0
2022-01-01,HRV,Kedah,0,0,0
2022-01-01,HRV,Kelantan,0,0,0
2022-01-01,HRV,Melaka,0,0,0
2022-01-01,HRV,Pahang,0,0,0
2022-01-01,HRV,Perak,0,0,0
2022-01-01,HRV,Perlis,0,0,0
2022-01-01,HRV,Pulau Pinang,0,0,0
2022-01-01,HRV,Sabah,0,0,0
2022-01-01,HRV,Sarawak,0,0,0
2022-01-01,HRV,Selangor,34,32,2
2022-01-01,HTI,Johor,0,0,0
2022-01-01,HTI,Kedah,0,0,0
2022-01-01,HTI,Kelantan,0,0,0
2022-01-01,HTI,Perak,0,0,0
2022-01-01,HTI,Pulau Pinang,0,0,0
2022-01-01,HTI,Sabah,0,0,0
2022-01-01,HTI,Selangor,1,1,0
2022-01-01,HUN,Johor,0,0,0
2022-01-01,HUN,Kedah,0,0,0
2022-01-01,HUN,Kelantan,0,0,0
2022-01-01,HUN,Pahang,0,0,0
2022-01-01,HUN,Perak,0,0,0
2022-01-01,HUN,Perlis,0,0,0
2022-01-01,HUN,Pulau Pinang,0,0,0
2022-01-01,HUN,Sabah,0,0,0
2022-01-01,HUN,Sarawak,0,0,0
2022-01-01,HUN,Selangor,19,13,6
2022-01-01,HUN,W.P. Labuan,0,0,0
2022-01-01,IDN,Johor,1078,341,737
2022-01-01,IDN,Kedah,58,23,35
2022-01-01,IDN,Kelantan,0,0,0
2022-01-01,IDN,Melaka,0,0,0
2022-01-01,IDN,Negeri Sembilan,0,0,0
2022-01-01,IDN,Pahang,0,0,0
2022-01-01,IDN,Perak,0,0,0
2022-01-01,IDN,Perlis,0,0,0
2022-01-01,IDN,Pulau Pinang,24,9,15
2022-01-01,IDN,Sabah,8,3,5
2022-01-01,IDN,Sarawak,395,364,31
2022-01-01,IDN,Selangor,2943,1651,1292
2022-01-01,IDN,Terengganu,0,0,0
2022-01-01,IDN,W.P. Labuan,4,4,0
2022-01-01,IND,Johor,48,46,2
2022-01-01,IND,Kedah,2,1,1
2022-01-01,IND,Kelantan,0,0,0
2022-01-01,IND,Melaka,0,0,0
2022-01-01,IND,Negeri Sembilan,0,0,0
2022-01-01,IND,Pahang,0,0,0
2022-01-01,IND,Perak,0,0,0
2022-01-01,IND,Perlis,0,0,0
2022-01-01,IND,Pulau Pinang,0,0,0
2022-01-01,IND,Sabah,0,0,0
2022-01-01,IND,Sarawak,5,5,0
2022-01-01,IND,Selangor,6829,4696,2133
2022-01-01,IND,Terengganu,0,0,0
2022-01-01,IND,W.P. Labuan,0,0,0
2022-01-01,IOT,Pulau Pinang,0,0,0
2022-01-01,IOT,Selangor,0,0,0
2022-01-01,IRL,Johor,0,0,0
2022-01-01,IRL,Kedah,1,1,0
2022-01-01,IRL,Kelantan,0,0,0
2022-01-01,IRL,Negeri Sembilan,0,0,0
2022-01-01,IRL,Pahang,0,0,0
2022-01-01,IRL,Perak,0,0,0
2022-01-01,IRL,Perlis,0,0,0
2022-01-01,IRL,Pulau Pinang,0,0,0
2022-01-01,IRL,Sabah,0,0,0
2022-01-01,IRL,Sarawak,0,0,0
2022-01-01,IRL,Selangor,118,83,35
2022-01-01,IRL,Terengganu,0,0,0
2022-01-01,IRL,W.P. Labuan,0,0,0
2022-01-01,IRN,Johor,0,0,0
2022-01-01,IRN,Kedah,0,0,0
2022-01-01,IRN,Kelantan,0,0,0
2022-01-01,IRN,Perak,0,0,0
2022-01-01,IRN,Perlis,0,0,0
2022-01-01,IRN,Pulau Pinang,0,0,0
2022-01-01,IRN,Sabah,1,1,0
2022-01-01,IRN,Sarawak,0,0,0
2022-01-01,IRN,Selangor,189,110,79
2022-01-01,IRN,W.P. Labuan,0,0,0
2022-01-01,IRQ,Johor,0,0,0
2022-01-01,IRQ,Kedah,0,0,0
2022-01-01,IRQ,Kelantan,0,0,0
2022-01-01,IRQ,Melaka,0,0,0
2022-01-01,IRQ,Pahang,0,0,0
2022-01-01,IRQ,Perak,0,0,0
2022-01-01,IRQ,Perlis,0,0,0
2022-01-01,IRQ,Pulau Pinang,0,0,0
2022-01-01,IRQ,Sabah,0,0,0
2022-01-01,IRQ,Sarawak,0,0,0
2022-01-01,IRQ,Selangor,194,127,67
2022-01-01,ISL,Johor,0,0,0
2022-01-01,ISL,Kedah,0,0,0
2022-01-01,ISL,Kelantan,0,0,0
2022-01-01,ISL,Perak,0,0,0
2022-01-01,ISL,Perlis,0,0,0
2022-01-01,ISL,Pulau Pinang,0,0,0
2022-01-01,ISL,Sabah,0,0,0
2022-01-01,ISL,Sarawak,0,0,0
2022-01-01,ISL,Selangor,4,2,2
2022-01-01,ISL,W.P. Labuan,0,0,0
2022-01-01,ISR,Pulau Pinang,0,0,0
2022-01-01,ITA,Johor,2,1,1
2022-01-01,ITA,Kedah,1,1,0
2022-01-01,ITA,Kelantan,0,0,0
2022-01-01,ITA,Melaka,0,0,0
2022-01-01,ITA,Negeri Sembilan,0,0,0
2022-01-01,ITA,Pahang,0,0,0
2022-01-01,ITA,Perak,0,0,0
2022-01-01,ITA,Perlis,0,0,0
2022-01-01,ITA,Pulau Pinang,1,1,0
2022-01-01,ITA,Sabah,0,0,0
2022-01-01,ITA,Sarawak,1,0,1
2022-01-01,ITA,Selangor,343,277,66
2022-01-01,ITA,W.P. Labuan,0,0,0
2022-01-01,JAM,Johor,0,0,0
2022-01-01,JAM,Kedah,0,0,0
2022-01-01,JAM,Perak,0,0,0
2022-01-01,JAM,Pulau Pinang,0,0,0
2022-01-01,JAM,Sabah,0,0,0
2022-01-01,JAM,Sarawak,0,0,0
2022-01-01,JAM,Selangor,2,1,1
2022-01-01,JAM,W.P. Labuan,0,0,0
2022-01-01,JOR,Johor,0,0,0
2022-01-01,JOR,Kedah,0,0,0
2022-01-01,JOR,Kelantan,0,0,0
2022-01-01,JOR,Melaka,0,0,0
2022-01-01,JOR,Perlis,0,0,0
2022-01-01,JOR,Pulau Pinang,0,0,0
2022-01-01,JOR,Sabah,0,0,0
2022-01-01,JOR,Sarawak,0,0,0
2022-01-01,JOR,Selangor,65,49,16
2022-01-01,JOR,W.P. Labuan,0,0,0
2022-01-01,JPN,Johor,1,1,0
2022-01-01,JPN,Kedah,4,3,1
2022-01-01,JPN,Kelantan,0,0,0
2022-01-01,JPN,Melaka,0,0,0
2022-01-01,JPN,Negeri Sembilan,0,0,0
2022-01-01,JPN,Pahang,0,0,0
2022-01-01,JPN,Perak,0,0,0
2022-01-01,JPN,Perlis,0,0,0
2022-01-01,JPN,Pulau Pinang,75,52,23
2022-01-01,JPN,Sabah,4,3,1
2022-01-01,JPN,Sarawak,18,16,2
2022-01-01,JPN,Selangor,1256,845,411
2022-01-01,JPN,W.P. Labuan,0,0,0
2022-01-01,KAZ,Johor,0,0,0
2022-01-01,KAZ,Kedah,0,0,0
2022-01-01,KAZ,Kelantan,0,0,0
2022-01-01,KAZ,Melaka,0,0,0
2022-01-01,KAZ,Perak,0,0,0
2022-01-01,KAZ,Perlis,0,0,0
2022-01-01,KAZ,Pulau Pinang,0,0,0
2022-01-01,KAZ,Sabah,0,0,0
2022-01-01,KAZ,Sarawak,0,0,0
2022-01-01,KAZ,Selangor,62,22,40
2022-01-01,KAZ,W.P. Labuan,0,0,0
2022-01-01,KEN,Johor,0,0,0
2022-01-01,KEN,Kedah,0,0,0
2022-01-01,KEN,Kelantan,0,0,0
2022-01-01,KEN,Perak,0,0,0
2022-01-01,KEN,Perlis,0,0,0
2022-01-01,KEN,Pulau Pinang,0,0,0
2022-01-01,KEN,Sabah,0,0,0
2022-01-01,KEN,Sarawak,0,0,0
2022-01-01,KEN,Selangor,115,50,65
2022-01-01,KGZ,Johor,0,0,0
2022-01-01,KGZ,Kedah,0,0,0
2022-01-01,KGZ,Kelantan,0,0,0
2022-01-01,KGZ,Perak,0,0,0
2022-01-01,KGZ,Perlis,0,0,0
2022-01-01,KGZ,Pulau Pinang,0,0,0
2022-01-01,KGZ,Sabah,0,0,0
2022-01-01,KGZ,Sarawak,0,0,0
2022-01-01,KGZ,Selangor,31,18,13
2022-01-01,KHM,Johor,0,0,0
2022-01-01,KHM,Kedah,0,0,0
2022-01-01,KHM,Kelantan,0,0,0
2022-01-01,KHM,Melaka,0,0,0
2022-01-01,KHM,Negeri Sembilan,0,0,0
2022-01-01,KHM,Pahang,0,0,0
2022-01-01,KHM,Perak,0,0,0
2022-01-01,KHM,Perlis,0,0,0
2022-01-01,KHM,Pulau Pinang,1,1,0
2022-01-01,KHM,Sabah,0,0,0
2022-01-01,KHM,Sarawak,1,0,1
2022-01-01,KHM,Selangor,85,49,36
2022-01-01,KHM,W.P. Labuan,0,0,0
2022-01-01,KIR,Johor,0,0,0
2022-01-01,KIR,Sabah,0,0,0
2022-01-01,KIR,Selangor,0,0,0
2022-01-01,KNA,Johor,0,0,0
2022-01-01,KNA,Kedah,0,0,0
2022-01-01,KNA,Perlis,0,0,0
2022-01-01,KNA,Pulau Pinang,0,0,0
2022-01-01,KNA,Sabah,0,0,0
2022-01-01,KNA,Selangor,2,2,0
2022-01-01,KNA,W.P. Labuan,0,0,0
2022-01-01,KOR,Johor,0,0,0
2022-01-01,KOR,Kedah,2,2,0
2022-01-01,KOR,Kelantan,0,0,0
2022-01-01,KOR,Melaka,0,0,0
2022-01-01,KOR,Negeri Sembilan,0,0,0
2022-01-01,KOR,Pahang,0,0,0
2022-01-01,KOR,Perak,0,0,0
2022-01-01,KOR,Perlis,0,0,0
2022-01-01,KOR,Pulau Pinang,16,6,10
2022-01-01,KOR,Sabah,1,0,1
2022-01-01,KOR,Sarawak,25,16,9
2022-01-01,KOR,Selangor,1179,685,494
2022-01-01,KOR,Terengganu,0,0,0
2022-01-01,KOR,W.P. Labuan,0,0,0
2022-01-01,KWT,Johor,0,0,0
2022-01-01,KWT,Kedah,0,0,0
2022-01-01,KWT,Kelantan,0,0,0
2022-01-01,KWT,Perak,0,0,0
2022-01-01,KWT,Perlis,0,0,0
2022-01-01,KWT,Pulau Pinang,0,0,0
2022-01-01,KWT,Sabah,0,0,0
2022-01-01,KWT,Sarawak,0,0,0
2022-01-01,KWT,Selangor,27,19,8
2022-01-01,KWT,W.P. Labuan,0,0,0
2022-01-01,LAO,Johor,0,0,0
2022-01-01,LAO,Kedah,0,0,0
2022-01-01,LAO,Kelantan,0,0,0
2022-01-01,LAO,Melaka,0,0,0
2022-01-01,LAO,Perak,0,0,0
2022-01-01,LAO,Perlis,0,0,0
2022-01-01,LAO,Pulau Pinang,0,0,0
2022-01-01,LAO,Sabah,0,0,0
2022-01-01,LAO,Sarawak,0,0,0
2022-01-01,LAO,Selangor,19,13,6
2022-01-01,LAO,W.P. Labuan,0,0,0
2022-01-01,LBN,Johor,0,0,0
2022-01-01,LBN,Kedah,1,1,0
2022-01-01,LBN,Kelantan,0,0,0
2022-01-01,LBN,Pahang,0,0,0
2022-01-01,LBN,Perak,0,0,0
2022-01-01,LBN,Perlis,0,0,0
2022-01-01,LBN,Pulau Pinang,0,0,0
2022-01-01,LBN,Sabah,0,0,0
2022-01-01,LBN,Sarawak,0,0,0
2022-01-01,LBN,Selangor,27,16,11
2022-01-01,LBN,W.P. Labuan,0,0,0
2022-01-01,LBR,Johor,0,0,0
2022-01-01,LBR,Kedah,0,0,0
2022-01-01,LBR,Sabah,0,0,0
2022-01-01,LBR,Sarawak,0,0,0
2022-01-01,LBR,Selangor,3,2,1
2022-01-01,LBY,Johor,0,0,0
2022-01-01,LBY,Kedah,0,0,0
2022-01-01,LBY,Perlis,0,0,0
2022-01-01,LBY,Pulau Pinang,0,0,0
2022-01-01,LBY,Sabah,0,0,0
2022-01-01,LBY,Sarawak,0,0,0
2022-01-01,LBY,Selangor,135,92,43
2022-01-01,LCA,Johor,0,0,0
2022-01-01,LCA,Kedah,0,0,0
2022-01-01,LCA,Pulau Pinang,0,0,0
2022-01-01,LCA,Sarawak,0,0,0
2022-01-01,LCA,Selangor,2,2,0
2022-01-01,LIE,Johor,0,0,0
2022-01-01,LIE,Kedah,0,0,0
2022-01-01,LIE,Perlis,0,0,0
2022-01-01,LIE,Pulau Pinang,0,0,0
2022-01-01,LIE,Sabah,0,0,0
2022-01-01,LIE,Sarawak,0,0,0
2022-01-01,LIE,Selangor,0,0,0
2022-01-01,LKA,Johor,6,6,0
2022-01-01,LKA,Kedah,3,3,0
2022-01-01,LKA,Kelantan,0,0,0
2022-01-01,LKA,Melaka,0,0,0
2022-01-01,LKA,Pahang,0,0,0
2022-01-01,LKA,Perak,0,0,0
2022-01-01,LKA,Perlis,0,0,0
2022-01-01,LKA,Pulau Pinang,0,0,0
2022-01-01,LKA,Sabah,0,0,0
2022-01-01,LKA,Sarawak,0,0,0
2022-01-01,LKA,Selangor,431,234,197
2022-01-01,LKA,W.P. Labuan,0,0,0
2022-01-01,LSO,Johor,0,0,0
2022-01-01,LSO,Kedah,0,0,0
2022-01-01,LSO,Pulau Pinang,0,0,0
2022-01-01,LSO,Sarawak,0,0,0
2022-01-01,LSO,Selangor,0,0,0
2022-01-01,LTU,Johor,0,0,0
2022-01-01,LTU,Kedah,0,0,0
2022-01-01,LTU,Kelantan,0,0,0
2022-01-01,LTU,Pahang,0,0,0
2022-01-01,LTU,Perak,0,0,0
2022-01-01,LTU,Perlis,0,0,0
2022-01-01,LTU,Pulau Pinang,0,0,0
2022-01-01,LTU,Sabah,0,0,0
2022-01-01,LTU,Sarawak,0,0,0
2022-01-01,LTU,Selangor,14,8,6
2022-01-01,LTU,W.P. Labuan,0,0,0
2022-01-01,LUX,Johor,0,0,0
2022-01-01,LUX,Kedah,0,0,0
2022-01-01,LUX,Kelantan,0,0,0
2022-01-01,LUX,Perak,0,0,0
2022-01-01,LUX,Perlis,0,0,0
2022-01-01,LUX,Pulau Pinang,0,0,0
2022-01-01,LUX,Sabah,0,0,0
2022-01-01,LUX,Sarawak,0,0,0
2022-01-01,LUX,Selangor,0,0,0
2022-01-01,LVA,Johor,0,0,0
2022-01-01,LVA,Kedah,0,0,0
2022-01-01,LVA,Kelantan,0,0,0
2022-01-01,LVA,Pahang,0,0,0
2022-01-01,LVA,Perak,0,0,0
2022-01-01,LVA,Perlis,0,0,0
2022-01-01,LVA,Pulau Pinang,0,0,0
2022-01-01,LVA,Sabah,0,0,0
2022-01-01,LVA,Sarawak,0,0,0
2022-01-01,LVA,Selangor,4,4,0
2022-01-01,LVA,W.P. Labuan,0,0,0
2022-01-01,MAC,Johor,0,0,0
2022-01-01,MAC,Pahang,0,0,0
2022-01-01,MAC,Perak,0,0,0
2022-01-01,MAC,Selangor,0,0,0
2022-01-01,MAC,W.P. Labuan,0,0,0
2022-01-01,MAR,Johor,0,0,0
2022-01-01,MAR,Kedah,0,0,0
2022-01-01,MAR,Kelantan,0,0,0
2022-01-01,MAR,Melaka,0,0,0
2022-01-01,MAR,Pahang,0,0,0
2022-01-01,MAR,Perak,0,0,0
2022-01-01,MAR,Perlis,0,0,0
2022-01-01,MAR,Pulau Pinang,0,0,0
2022-01-01,MAR,Sabah,0,0,0
2022-01-01,MAR,Sarawak,0,0,0
2022-01-01,MAR,Selangor,30,13,17
2022-01-01,MAR,W.P. Labuan,0,0,0
2022-01-01,MCO,Johor,0,0,0
2022-01-01,MCO,Kedah,0,0,0
2022-01-01,MCO,Sabah,0,0,0
2022-01-01,MCO,Selangor,0,0,0
2022-01-01,MDA,Johor,0,0,0
2022-01-01,MDA,Kedah,0,0,0
2022-01-01,MDA,Kelantan,0,0,0
2022-01-01,MDA,Negeri Sembilan,0,0,0
2022-01-01,MDA,Perlis,0,0,0
2022-01-01,MDA,Pulau Pinang,0,0,0
2022-01-01,MDA,Sabah,0,0,0
2022-01-01,MDA,Sarawak,0,0,0
2022-01-01,MDA,Selangor,0,0,0
2022-01-01,MDG,Johor,0,0,0
2022-01-01,MDG,Kedah,0,0,0
2022-01-01,MDG,Perak,0,0,0
2022-01-01,MDG,Perlis,0,0,0
2022-01-01,MDG,Pulau Pinang,0,0,0
2022-01-01,MDG,Sabah,0,0,0
2022-01-01,MDG,Sarawak,0,0,0
2022-01-01,MDG,Selangor,2,0,2
2022-01-01,MDV,Johor,0,0,0
2022-01-01,MDV,Kedah,17,10,7
2022-01-01,MDV,Kelantan,0,0,0
2022-01-01,MDV,Perak,0,0,0
2022-01-01,MDV,Perlis,0,0,0
2022-01-01,MDV,Pulau Pinang,1,1,0
2022-01-01,MDV,Sabah,0,0,0
2022-01-01,MDV,Sarawak,0,0,0
2022-01-01,MDV,Selangor,329,147,182
2022-01-01,MEX,Johor,2,0,2
2022-01-01,MEX,Kedah,0,0,0
2022-01-01,MEX,Kelantan,0,0,0
2022-01-01,MEX,Pahang,0,0,0
2022-01-01,MEX,Perak,0,0,0
2022-01-01,MEX,Perlis,0,0,0
2022-01-01,MEX,Pulau Pinang,0,0,0
2022-01-01,MEX,Sabah,0,0,0
2022-01-01,MEX,Sarawak,0,0,0
2022-01-01,MEX,Selangor,84,49,35
2022-01-01,MEX,W.P. Labuan,0,0,0
2022-01-01,MHL,Johor,0,0,0
2022-01-01,MHL,Kedah,0,0,0
2022-01-01,MHL,Perak,0,0,0
2022-01-01,MHL,Pulau Pinang,0,0,0
2022-01-01,MHL,Sabah,0,0,0
2022-01-01,MHL,Selangor,0,0,0
2022-01-01,MKD,Johor,0,0,0
2022-01-01,MKD,Kedah,0,0,0
2022-01-01,MKD,Perak,0,0,0
2022-01-01,MKD,Pulau Pinang,0,0,0
2022-01-01,MKD,Sabah,0,0,0
2022-01-01,MKD,Sarawak,0,0,0
2022-01-01,MKD,Selangor,0,0,0
2022-01-01,MLI,Johor,0,0,0
2022-01-01,MLI,Sabah,0,0,0
2022-01-01,MLI,Selangor,1,1,0
2022-01-01,MLT,Johor,0,0,0
2022-01-01,MLT,Kedah,0,0,0
2022-01-01,MLT,Kelantan,0,0,0
2022-01-01,MLT,Perak,0,0,0
2022-01-01,MLT,Perlis,0,0,0
2022-01-01,MLT,Pulau Pinang,0,0,0
2022-01-01,MLT,Sabah,0,0,0
2022-01-01,MLT,Sarawak,0,0,0
2022-01-01,MLT,Selangor,3,3,0
2022-01-01,MLT,W.P. Labuan,0,0,0
2022-01-01,MMR,Johor,16,15,1
2022-01-01,MMR,Kedah,0,0,0
2022-01-01,MMR,Kelantan,0,0,0
2022-01-01,MMR,Negeri Sembilan,0,0,0
2022-01-01,MMR,Pahang,0,0,0
2022-01-01,MMR,Perak,0,0,0
2022-01-01,MMR,Perlis,0,0,0
2022-01-01,MMR,Pulau Pinang,0,0,0
2022-01-01,MMR,Sabah,0,0,0
2022-01-01,MMR,Sarawak,1,0,1
2022-01-01,MMR,Selangor,357,305,52
2022-01-01,MMR,Terengganu,0,0,0
2022-01-01,MMR,W.P. Labuan,0,0,0
2022-01-01,MNE,Johor,1,1,0
2022-01-01,MNE,Kedah,0,0,0
2022-01-01,MNE,Pulau Pinang,0,0,0
2022-01-01,MNE,Sabah,0,0,0
2022-01-01,MNE,Sarawak,0,0,0
2022-01-01,MNE,Selangor,4,4,0
2022-01-01,MNG,Johor,0,0,0
2022-01-01,MNG,Kedah,0,0,0
2022-01-01,MNG,Kelantan,0,0,0
2022-01-01,MNG,Perak,0,0,0
2022-01-01,MNG,Perlis,0,0,0
2022-01-01,MNG,Pulau Pinang,0,0,0
2022-01-01,MNG,Sabah,0,0,0
2022-01-01,MNG,Sarawak,0,0,0
2022-01-01,MNG,Selangor,9,3,6
2022-01-01,MNP,Selangor,0,0,0
2022-01-01,MOZ,Johor,0,0,0
2022-01-01,MOZ,Kedah,0,0,0
2022-01-01,MOZ,Perak,0,0,0
2022-01-01,MOZ,Pulau Pinang,0,0,0
2022-01-01,MOZ,Sabah,0,0,0
2022-01-01,MOZ,Sarawak,0,0,0
2022-01-01,MOZ,Selangor,14,7,7
2022-01-01,MRT,Johor,0,0,0
2022-01-01,MRT,Kedah,0,0,0
2022-01-01,MRT,Pulau Pinang,0,0,0
2022-01-01,MRT,Sabah,0,0,0
2022-01-01,MRT,Sarawak,0,0,0
2022-01-01,MRT,Selangor,18,15,3
2022-01-01,MUS,Johor,0,0,0
2022-01-01,MUS,Kedah,0,0,0
2022-01-01,MUS,Kelantan,0,0,0
2022-01-01,MUS,Pahang,0,0,0
2022-01-01,MUS,Perak,0,0,0
2022-01-01,MUS,Perlis,0,0,0
2022-01-01,MUS,Pulau Pinang,0,0,0
2022-01-01,MUS,Sabah,0,0,0
2022-01-01,MUS,Sarawak,0,0,0
2022-01-01,MUS,Selangor,47,16,31
2022-01-01,MWI,Johor,0,0,0
2022-01-01,MWI,Pulau Pinang,0,0,0
2022-01-01,MWI,Sabah,0,0,0
2022-01-01,MWI,Sarawak,0,0,0
2022-01-01,MWI,Selangor,7,3,4
2022-01-01,MYT,Selangor,0,0,0
2022-01-01,NAM,Johor,0,0,0
2022-01-01,NAM,Kedah,0,0,0
2022-01-01,NAM,Perak,0,0,0
2022-01-01,NAM,Perlis,0,0,0
2022-01-01,NAM,Pulau Pinang,0,0,0
2022-01-01,NAM,Sabah,0,0,0
2022-01-01,NAM,Sarawak,0,0,0
2022-01-01,NAM,Selangor,1,1,0
2022-01-01,NCL,Selangor,0,0,0
2022-01-01,NER,Johor,0,0,0
2022-01-01,NER,Sabah,0,0,0
2022-01-01,NER,Selangor,0,0,0
2022-01-01,NGA,Johor,0,0,0
2022-01-01,NGA,Kedah,0,0,0
2022-01-01,NGA,Perlis,0,0,0
2022-01-01,NGA,Pulau Pinang,0,0,0
2022-01-01,NGA,Sabah,0,0,0
2022-01-01,NGA,Sarawak,0,0,0
2022-01-01,NGA,Selangor,202,157,45
2022-01-01,NIC,Johor,0,0,0
2022-01-01,NIC,Kedah,0,0,0
2022-01-01,NIC,Pulau Pinang,0,0,0
2022-01-01,NIC,Sabah,0,0,0
2022-01-01,NIC,Selangor,1,1,0
2022-01-01,NLD,Johor,1,1,0
2022-01-01,NLD,Kedah,10,8,2
2022-01-01,NLD,Kelantan,0,0,0
2022-01-01,NLD,Melaka,0,0,0
2022-01-01,NLD,Negeri Sembilan,0,0,0
2022-01-01,NLD,Pahang,0,0,0
2022-01-01,NLD,Perak,0,0,0
2022-01-01,NLD,Perlis,0,0,0
2022-01-01,NLD,Pulau Pinang,3,2,1
2022-01-01,NLD,Sabah,0,0,0
2022-01-01,NLD,Sarawak,0,0,0
2022-01-01,NLD,Selangor,262,183,79
2022-01-01,NLD,Terengganu,0,0,0
2022-01-01,NLD,W.P. Labuan,0,0,0
2022-01-01,NOR,Johor,0,0,0
2022-01-01,NOR,Kedah,0,0,0
2022-01-01,NOR,Kelantan,0,0,0
2022-01-01,NOR,Melaka,0,0,0
2022-01-01,NOR,Pahang,0,0,0
2022-01-01,NOR,Perak,0,0,0
2022-01-01,NOR,Perlis,0,0,0
2022-01-01,NOR,Pulau Pinang,0,0,0
2022-01-01,NOR,Sabah,0,0,0
2022-01-01,NOR,Sarawak,1,1,0
2022-01-01,NOR,Selangor,66,45,21
2022-01-01,NOR,W.P. Labuan,0,0,0
2022-01-01,NPL,Johor,0,0,0
2022-01-01,NPL,Kedah,0,0,0
2022-01-01,NPL,Pahang,0,0,0
2022-01-01,NPL,Perak,0,0,0
2022-01-01,NPL,Perlis,0,0,0
2022-01-01,NPL,Pulau Pinang,7,7,0
2022-01-01,NPL,Sabah,0,0,0
2022-01-01,NPL,Sarawak,0,0,0
2022-01-01,NPL,Selangor,647,615,32
2022-01-01,NPL,W.P. Labuan,0,0,0
2022-01-01,NRU,Johor,0,0,0
2022-01-01,NRU,Pulau Pinang,0,0,0
2022-01-01,NRU,Selangor,0,0,0
2022-01-01,NZL,Johor,3,1,2
2022-01-01,NZL,Kedah,3,2,1
2022-01-01,NZL,Kelantan,0,0,0
2022-01-01,NZL,Melaka,0,0,0
2022-01-01,NZL,Negeri Sembilan,0,0,0
2022-01-01,NZL,Pahang,0,0,0
2022-01-01,NZL,Perak,0,0,0
2022-01-01,NZL,Perlis,0,0,0
2022-01-01,NZL,Pulau Pinang,9,5,4
2022-01-01,NZL,Sabah,1,0,1
2022-01-01,NZL,Sarawak,0,0,0
2022-01-01,NZL,Selangor,140,89,51
2022-01-01,NZL,Terengganu,0,0,0
2022-01-01,NZL,W.P. Labuan,0,0,0
2022-01-01,OMN,Johor,0,0,0
2022-01-01,OMN,Kedah,0,0,0
2022-01-01,OMN,Kelantan,0,0,0
2022-01-01,OMN,Melaka,0,0,0
2022-01-01,OMN,Perak,0,0,0
2022-01-01,OMN,Perlis,0,0,0
2022-01-01,OMN,Pulau Pinang,0,0,0
2022-01-01,OMN,Sabah,0,0,0
2022-01-01,OMN,Sarawak,0,0,0
2022-01-01,OMN,Selangor,82,57,25
2022-01-01,PAK,Johor,9,9,0
2022-01-01,PAK,Kedah,0,0,0
2022-01-01,PAK,Kelantan,0,0,0
2022-01-01,PAK,Melaka,0,0,0
2022-01-01,PAK,Negeri Sembilan,0,0,0
2022-01-01,PAK,Pahang,0,0,0
2022-01-01,PAK,Perak,0,0,0
2022-01-01,PAK,Perlis,0,0,0
2022-01-01,PAK,Pulau Pinang,0,0,0
2022-01-01,PAK,Sabah,2,2,0
2022-01-01,PAK,Sarawak,2,1,1
2022-01-01,PAK,Selangor,3086,2663,423
2022-01-01,PAK,W.P. Labuan,0,0,0
2022-01-01,PAN,Johor,0,0,0
2022-01-01,PAN,Kedah,0,0,0
2022-01-01,PAN,Perak,0,0,0
2022-01-01,PAN,Perlis,0,0,0
2022-01-01,PAN,Pulau Pinang,0,0,0
2022-01-01,PAN,Sabah,0,0,0
2022-01-01,PAN,Sarawak,0,0,0
2022-01-01,PAN,Selangor,1,1,0
2022-01-01,PER,Johor,0,0,0
2022-01-01,PER,Kedah,0,0,0
2022-01-01,PER,Kelantan,0,0,0
2022-01-01,PER,Pahang,0,0,0
2022-01-01,PER,Perak,0,0,0
2022-01-01,PER,Perlis,0,0,0
2022-01-01,PER,Pulau Pinang,0,0,0
2022-01-01,PER,Sabah,0,0,0
2022-01-01,PER,Sarawak,0,0,0
2022-01-01,PER,Selangor,8,5,3
2022-01-01,PER,W.P. Labuan,0,0,0
2022-01-01,PHL,Johor,121,116,5
2022-01-01,PHL,Kedah,3,1,2
2022-01-01,PHL,Kelantan,0,0,0
2022-01-01,PHL,Melaka,0,0,0
2022-01-01,PHL,Negeri Sembilan,0,0,0
2022-01-01,PHL,Pahang,0,0,0
2022-01-01,PHL,Perak,0,0,0
2022-01-01,PHL,Perlis,0,0,0
2022-01-01,PHL,Pulau Pinang,3,2,1
2022-01-01,PHL,Sabah,4,1,3
2022-01-01,PHL,Sarawak,13,10,3
2022-01-01,PHL,Selangor,1336,676,660
2022-01-01,PHL,Terengganu,0,0,0
2022-01-01,PHL,W.P. Labuan,4,4,0
2022-01-01,PLW,Johor,0,0,0
2022-01-01,PLW,Pulau Pinang,0,0,0
2022-01-01,PLW,Selangor,0,0,0
2022-01-01,PNG,Johor,0,0,0
2022-01-01,PNG,Kedah,0,0,0
2022-01-01,PNG,Kelantan,0,0,0
2022-01-01,PNG,Perak,0,0,0
2022-01-01,PNG,Pulau Pinang,0,0,0
2022-01-01,PNG,Sabah,0,0,0
2022-01-01,PNG,Sarawak,0,0,0
2022-01-01,PNG,Selangor,0,0,0
2022-01-01,POL,Johor,0,0,0
2022-01-01,POL,Kedah,0,0,0
2022-01-01,POL,Kelantan,0,0,0
2022-01-01,POL,Melaka,0,0,0
2022-01-01,POL,Negeri Sembilan,0,0,0
2022-01-01,POL,Pahang,0,0,0
2022-01-01,POL,Perak,0,0,0
2022-01-01,POL,Perlis,0,0,0
2022-01-01,POL,Pulau Pinang,0,0,0
2022-01-01,POL,Sabah,0,0,0
2022-01-01,POL,Sarawak,0,0,0
2022-01-01,POL,Selangor,74,51,23
2022-01-01,POL,Terengganu,0,0,0
2022-01-01,POL,W.P. Labuan,0,0,0
2022-01-01,PRK,Selangor,0,0,0
2022-01-01,PRT,Johor,1,0,1
2022-01-01,PRT,Kedah,0,0,0
2022-01-01,PRT,Kelantan,0,0,0
2022-01-01,PRT,Melaka,0,0,0
2022-01-01,PRT,Pahang,0,0,0
2022-01-01,PRT,Perak,0,0,0
2022-01-01,PRT,Perlis,0,0,0
2022-01-01,PRT,Pulau Pinang,0,0,0
2022-01-01,PRT,Sabah,0,0,0
2022-01-01,PRT,Sarawak,0,0,0
2022-01-01,PRT,Selangor,40,27,13
2022-01-01,PRT,W.P. Labuan,0,0,0
2022-01-01,PRY,Johor,0,0,0
2022-01-01,PRY,Kedah,0,0,0
2022-01-01,PRY,Perak,0,0,0
2022-01-01,PRY,Perlis,0,0,0
2022-01-01,PRY,Pulau Pinang,0,0,0
2022-01-01,PRY,Sabah,0,0,0
2022-01-01,PRY,Sarawak,0,0,0
2022-01-01,PRY,Selangor,0,0,0
2022-01-01,PSE,Johor,0,0,0
2022-01-01,PSE,Kedah,0,0,0
2022-01-01,PSE,Kelantan,0,0,0
2022-01-01,PSE,Melaka,0,0,0
2022-01-01,PSE,Perak,0,0,0
2022-01-01,PSE,Perlis,0,0,0
2022-01-01,PSE,Pulau Pinang,0,0,0
2022-01-01,PSE,Sabah,0,0,0
2022-01-01,PSE,Sarawak,0,0,0
2022-01-01,PSE,Selangor,56,40,16
2022-01-01,QAT,Johor,0,0,0
2022-01-01,QAT,Kedah,0,0,0
2022-01-01,QAT,Perlis,0,0,0
2022-01-01,QAT,Pulau Pinang,0,0,0
2022-01-01,QAT,Sabah,0,0,0
2022-01-01,QAT,Sarawak,0,0,0
2022-01-01,QAT,Selangor,6,5,1
2022-01-01,REU,Johor,0,0,0
2022-01-01,REU,Sarawak,0,0,0
2022-01-01,ROU,Johor,3,3,0
2022-01-01,ROU,Kedah,3,1,2
2022-01-01,ROU,Kelantan,0,0,0
2022-01-01,ROU,Negeri Sembilan,0,0,0
2022-01-01,ROU,Pahang,0,0,0
2022-01-01,ROU,Perak,0,0,0
2022-01-01,ROU,Perlis,0,0,0
2022-01-01,ROU,Pulau Pinang,0,0,0
2022-01-01,ROU,Sabah,0,0,0
2022-01-01,ROU,Sarawak,2,1,1
2022-01-01,ROU,Selangor,46,31,15
2022-01-01,ROU,W.P. Labuan,0,0,0
2022-01-01,RUS,Johor,14,14,0
2022-01-01,RUS,Kedah,1,1,0
2022-01-01,RUS,Kelantan,0,0,0
2022-01-01,RUS,Melaka,0,0,0
2022-01-01,RUS,Negeri Sembilan,0,0,0
2022-01-01,RUS,Pahang,0,0,0
2022-01-01,RUS,Perak,0,0,0
2022-01-01,RUS,Perlis,0,0,0
2022-01-01,RUS,Pulau Pinang,1,1,0
2022-01-01,RUS,Sabah,0,0,0
2022-01-01,RUS,Sarawak,0,0,0
2022-01-01,RUS,Selangor,111,48,63
2022-01-01,RUS,W.P. Labuan,0,0,0
2022-01-01,RWA,Johor,0,0,0
2022-01-01,RWA,Kedah,0,0,0
2022-01-01,RWA,Pulau Pinang,0,0,0
2022-01-01,RWA,Selangor,4,1,3
2022-01-01,SAU,Johor,0,0,0
2022-01-01,SAU,Kedah,4,3,1
2022-01-01,SAU,Kelantan,0,0,0
2022-01-01,SAU,Melaka,0,0,0
2022-01-01,SAU,Perak,0,0,0
2022-01-01,SAU,Perlis,0,0,0
2022-01-01,SAU,Pulau Pinang,0,0,0
2022-01-01,SAU,Sabah,0,0,0
2022-01-01,SAU,Sarawak,0,0,0
2022-01-01,SAU,Selangor,240,157,83
2022-01-01,SAU,W.P. Labuan,0,0,0
2022-01-01,SDN,Johor,0,0,0
2022-01-01,SDN,Kedah,0,0,0
2022-01-01,SDN,Kelantan,0,0,0
2022-01-01,SDN,Perlis,0,0,0
2022-01-01,SDN,Pulau Pinang,0,0,0
2022-01-01,SDN,Sabah,0,0,0
2022-01-01,SDN,Sarawak,0,0,0
2022-01-01,SDN,Selangor,143,104,39
2022-01-01,SDN,W.P. Labuan,0,0,0
2022-01-01,SEN,Johor,0,0,0
2022-01-01,SEN,Kedah,0,0,0
2022-01-01,SEN,Kelantan,0,0,0
2022-01-01,SEN,Perak,0,0,0
2022-01-01,SEN,Perlis,0,0,0
2022-01-01,SEN,Pulau Pinang,0,0,0
2022-01-01,SEN,Sabah,0,0,0
2022-01-01,SEN,Sarawak,0,0,0
2022-01-01,SEN,Selangor,2,2,0
2022-01-01,SGP,Johor,3211,1801,1410
2022-01-01,SGP,Kedah,12,8,4
2022-01-01,SGP,Kelantan,0,0,0
2022-01-01,SGP,Melaka,0,0,0
2022-01-01,SGP,Negeri Sembilan,0,0,0
2022-01-01,SGP,Pahang,0,0,0
2022-01-01,SGP,Perak,12,5,7
2022-01-01,SGP,Perlis,0,0,0
2022-01-01,SGP,Pulau Pinang,14,9,5
2022-01-01,SGP,Sabah,1,0,1
2022-01-01,SGP,Sarawak,22,13,9
2022-01-01,SGP,Selangor,4312,2308,2004
2022-01-01,SGP,Terengganu,0,0,0
2022-01-01,SGP,W.P. Labuan,0,0,0
2022-01-01,SGS,Johor,0,0,0
2022-01-01,SGS,Sabah,0,0,0
2022-01-01,SGS,Selangor,0,0,0
2022-01-01,SHN,Sarawak,0,0,0
2022-01-01,SLB,Johor,0,0,0
2022-01-01,SLB,Perlis,0,0,0
2022-01-01,SLB,Pulau Pinang,0,0,0
2022-01-01,SLB,Sabah,0,0,0
2022-01-01,SLB,Sarawak,0,0,0
2022-01-01,SLB,Selangor,0,0,0
2022-01-01,SLB,W.P. Labuan,0,0,0
2022-01-01,SLE,Johor,0,0,0
2022-01-01,SLE,Kedah,0,0,0
2022-01-01,SLE,Perak,0,0,0
2022-01-01,SLE,Pulau Pinang,0,0,0
2022-01-01,SLE,Sabah,0,0,0
2022-01-01,SLE,Selangor,2,2,0
2022-01-01,SLV,Johor,0,0,0
2022-01-01,SLV,Kedah,0,0,0
2022-01-01,SLV,Perak,0,0,0
2022-01-01,SLV,Perlis,0,0,0
2022-01-01,SLV,Pulau Pinang,0,0,0
2022-01-01,SLV,Sabah,0,0,0
2022-01-01,SLV,Selangor,0,0,0
2022-01-01,SLV,W.P. Labuan,0,0,0
2022-01-01,SMR,Johor,0,0,0
2022-01-01,SMR,Selangor,1,1,0
2022-01-01,SOM,Johor,0,0,0
2022-01-01,SOM,Kedah,0,0,0
2022-01-01,SOM,Kelantan,0,0,0
2022-01-01,SOM,Perlis,0,0,0
2022-01-01,SOM,Sabah,0,0,0
2022-01-01,SOM,Sarawak,0,0,0
2022-01-01,SOM,Selangor,77,52,25
2022-01-01,SRB,Johor,0,0,0
2022-01-01,SRB,Kedah,0,0,0
2022-01-01,SRB,Kelantan,0,0,0
2022-01-01,SRB,Pahang,0,0,0
2022-01-01,SRB,Perak,0,0,0
2022-01-01,SRB,Perlis,0,0,0
2022-01-01,SRB,Pulau Pinang,0,0,0
2022-01-01,SRB,Sabah,0,0,0
2022-01-01,SRB,Sarawak,0,0,0
2022-01-01,SRB,Selangor,4,3,1
2022-01-01,SSD,Johor,0,0,0
2022-01-01,SSD,Kedah,0,0,0
2022-01-01,SSD,Sarawak,0,0,0
2022-01-01,SSD,Selangor,8,8,0
2022-01-01,SSD,W.P. Labuan,0,0,0
2022-01-01,STP,Selangor,0,0,0
2022-01-01,SUR,Johor,0,0,0
2022-01-01,SUR,Kedah,0,0,0
2022-01-01,SUR,Kelantan,0,0,0
2022-01-01,SUR,Perak,0,0,0
2022-01-01,SUR,Perlis,0,0,0
2022-01-01,SUR,Pulau Pinang,0,0,0
2022-01-01,SUR,Sabah,0,0,0
2022-01-01,SUR,Sarawak,0,0,0
2022-01-01,SUR,Selangor,0,0,0
2022-01-01,SVK,Johor,0,0,0
2022-01-01,SVK,Kedah,0,0,0
2022-01-01,SVK,Kelantan,0,0,0
2022-01-01,SVK,Negeri Sembilan,0,0,0
2022-01-01,SVK,Pahang,0,0,0
2022-01-01,SVK,Perak,0,0,0
2022-01-01,SVK,Perlis,0,0,0
2022-01-01,SVK,Pulau Pinang,0,0,0
2022-01-01,SVK,Sabah,0,0,0
2022-01-01,SVK,Sarawak,1,1,0
2022-01-01,SVK,Selangor,33,27,6
2022-01-01,SVK,W.P. Labuan,0,0,0
2022-01-01,SVN,Johor,0,0,0
2022-01-01,SVN,Kedah,0,0,0
2022-01-01,SVN,Kelantan,0,0,0
2022-01-01,SVN,Perak,0,0,0
2022-01-01,SVN,Perlis,0,0,0
2022-01-01,SVN,Pulau Pinang,0,0,0
2022-01-01,SVN,Sabah,0,0,0
2022-01-01,SVN,Sarawak,0,0,0
2022-01-01,SVN,Selangor,3,3,0
2022-01-01,SVN,W.P. Labuan,0,0,0
2022-01-01,SWE,Johor,0,0,0
2022-01-01,SWE,Kedah,1,1,0
2022-01-01,SWE,Kelantan,0,0,0
2022-01-01,SWE,Melaka,0,0,0
2022-01-01,SWE,Negeri Sembilan,0,0,0
2022-01-01,SWE,Pahang,0,0,0
2022-01-01,SWE,Perak,0,0,0
2022-01-01,SWE,Perlis,0,0,0
2022-01-01,SWE,Pulau Pinang,0,0,0
2022-01-01,SWE,Sabah,0,0,0
2022-01-01,SWE,Sarawak,0,0,0
2022-01-01,SWE,Selangor,86,59,27
2022-01-01,SWE,W.P. Labuan,0,0,0
2022-01-01,SWZ,Johor,0,0,0
2022-01-01,SWZ,Kedah,0,0,0
2022-01-01,SWZ,Pulau Pinang,0,0,0
2022-01-01,SWZ,Sabah,0,0,0
2022-01-01,SWZ,Selangor,3,1,2
2022-01-01,SYC,Johor,0,0,0
2022-01-01,SYC,Kedah,0,0,0
2022-01-01,SYC,Pulau Pinang,0,0,0
2022-01-01,SYC,Sabah,0,0,0
2022-01-01,SYC,Sarawak,0,0,0
2022-01-01,SYC,Selangor,19,6,13
2022-01-01,SYR,Johor,0,0,0
2022-01-01,SYR,Kedah,0,0,0
2022-01-01,SYR,Kelantan,0,0,0
2022-01-01,SYR,Pahang,0,0,0
2022-01-01,SYR,Perlis,0,0,0
2022-01-01,SYR,Pulau Pinang,0,0,0
2022-01-01,SYR,Sabah,0,0,0
2022-01-01,SYR,Sarawak,0,0,0
2022-01-01,SYR,Selangor,98,66,32
2022-01-01,SYR,W.P. Labuan,0,0,0
2022-01-01,TCA,Perlis,0,0,0
2022-01-01,TCD,Johor,0,0,0
2022-01-01,TCD,Kedah,0,0,0
2022-01-01,TCD,Perlis,0,0,0
2022-01-01,TCD,Selangor,8,8,0
2022-01-01,TGO,Johor,0,0,0
2022-01-01,TGO,Perak,0,0,0
2022-01-01,TGO,Pulau Pinang,0,0,0
2022-01-01,TGO,Selangor,0,0,0
2022-01-01,THA,Johor,70,68,2
2022-01-01,THA,Kedah,18304,18252,52
2022-01-01,THA,Kelantan,2,1,1
2022-01-01,THA,Melaka,0,0,0
2022-01-01,THA,Negeri Sembilan,0,0,0
2022-01-01,THA,Pahang,0,0,0
2022-01-01,THA,Perak,0,0,0
2022-01-01,THA,Perlis,9168,9012,156
2022-01-01,THA,Pulau Pinang,16,11,5
2022-01-01,THA,Sabah,3,1,2
2022-01-01,THA,Sarawak,13,12,1
2022-01-01,THA,Selangor,1071,401,670
2022-01-01,THA,Terengganu,0,0,0
2022-01-01,THA,W.P. Labuan,0,0,0
2022-01-01,TJK,Johor,0,0,0
2022-01-01,TJK,Kedah,0,0,0
2022-01-01,TJK,Perlis,0,0,0
2022-01-01,TJK,Pulau Pinang,0,0,0
2022-01-01,TJK,Sabah,0,0,0
2022-01-01,TJK,Selangor,6,5,1
2022-01-01,TKL,Selangor,0,0,0
2022-01-01,TKM,Johor,0,0,0
2022-01-01,TKM,Kedah,0,0,0
2022-01-01,TKM,Kelantan,0,0,0
2022-01-01,TKM,Perlis,0,0,0
2022-01-01,TKM,Pulau Pinang,0,0,0
2022-01-01,TKM,Sabah,0,0,0
2022-01-01,TKM,Sarawak,0,0,0
2022-01-01,TKM,Selangor,10,4,6
2022-01-01,TLS,Johor,0,0,0
2022-01-01,TLS,Kedah,0,0,0
2022-01-01,TLS,Perlis,0,0,0
2022-01-01,TLS,Pulau Pinang,0,0,0
2022-01-01,TLS,Sabah,0,0,0
2022-01-01,TLS,Sarawak,0,0,0
2022-01-01,TLS,Selangor,13,7,6
2022-01-01,TON,Johor,0,0,0
2022-01-01,TON,Pulau Pinang,0,0,0
2022-01-01,TON,Sarawak,0,0,0
2022-01-01,TON,Selangor,0,0,0
2022-01-01,TTO,Johor,0,0,0
2022-01-01,TTO,Kedah,0,0,0
2022-01-01,TTO,Pahang,0,0,0
2022-01-01,TTO,Pulau Pinang,0,0,0
2022-01-01,TTO,Sabah,0,0,0
2022-01-01,TTO,Sarawak,0,0,0
2022-01-01,TTO,Selangor,7,5,2
2022-01-01,TUN,Johor,0,0,0
2022-01-01,TUN,Kedah,0,0,0
2022-01-01,TUN,Kelantan,0,0,0
2022-01-01,TUN,Melaka,0,0,0
2022-01-01,TUN,Perak,0,0,0
2022-01-01,TUN,Perlis,0,0,0
2022-01-01,TUN,Pulau Pinang,0,0,0
2022-01-01,TUN,Sabah,0,0,0
2022-01-01,TUN,Sarawak,0,0,0
2022-01-01,TUN,Selangor,24,15,9
2022-01-01,TUN,W.P. Labuan,0,0,0
2022-01-01,TUR,Johor,9,9,0
2022-01-01,TUR,Kedah,0,0,0
2022-01-01,TUR,Kelantan,0,0,0
2022-01-01,TUR,Melaka,0,0,0
2022-01-01,TUR,Negeri Sembilan,0,0,0
2022-01-01,TUR,Pahang,0,0,0
2022-01-01,TUR,Perak,0,0,0
2022-01-01,TUR,Perlis,0,0,0
2022-01-01,TUR,Pulau Pinang,0,0,0
2022-01-01,TUR,Sabah,0,0,0
2022-01-01,TUR,Sarawak,0,0,0
2022-01-01,TUR,Selangor,131,92,39
2022-01-01,TUR,W.P. Labuan,0,0,0
2022-01-01,TUV,Selangor,0,0,0
2022-01-01,TWN,Johor,1,1,0
2022-01-01,TWN,Kedah,2,0,2
2022-01-01,TWN,Kelantan,0,0,0
2022-01-01,TWN,Melaka,0,0,0
2022-01-01,TWN,Negeri Sembilan,0,0,0
2022-01-01,TWN,Pahang,0,0,0
2022-01-01,TWN,Perak,0,0,0
2022-01-01,TWN,Perlis,0,0,0
2022-01-01,TWN,Pulau Pinang,26,13,13
2022-01-01,TWN,Sabah,1,1,0
2022-01-01,TWN,Sarawak,3,2,1
2022-01-01,TWN,Selangor,205,117,88
2022-01-01,TWN,W.P. Labuan,0,0,0
2022-01-01,TZA,Johor,0,0,0
2022-01-01,TZA,Kedah,0,0,0
2022-01-01,TZA,Perak,0,0,0
2022-01-01,TZA,Perlis,0,0,0
2022-01-01,TZA,Pulau Pinang,0,0,0
2022-01-01,TZA,Sabah,0,0,0
2022-01-01,TZA,Sarawak,0,0,0
2022-01-01,TZA,Selangor,41,20,21
2022-01-01,UGA,Johor,0,0,0
2022-01-01,UGA,Kedah,0,0,0
2022-01-01,UGA,Perak,0,0,0
2022-01-01,UGA,Perlis,0,0,0
2022-01-01,UGA,Pulau Pinang,0,0,0
2022-01-01,UGA,Sabah,0,0,0
2022-01-01,UGA,Sarawak,0,0,0
2022-01-01,UGA,Selangor,17,7,10
2022-01-01,UKR,Johor,17,17,0
2022-01-01,UKR,Kedah,2,0,2
2022-01-01,UKR,Kelantan,0,0,0
2022-01-01,UKR,Melaka,0,0,0
2022-01-01,UKR,Negeri Sembilan,0,0,0
2022-01-01,UKR,Pahang,0,0,0
2022-01-01,UKR,Perak,0,0,0
2022-01-01,UKR,Perlis,0,0,0
2022-01-01,UKR,Pulau Pinang,2,2,0
2022-01-01,UKR,Sabah,0,0,0
2022-01-01,UKR,Sarawak,1,1,0
2022-01-01,UKR,Selangor,81,62,19
2022-01-01,UKR,W.P. Labuan,0,0,0
2022-01-01,URY,Johor,0,0,0
2022-01-01,URY,Kedah,0,0,0
2022-01-01,URY,Kelantan,0,0,0
2022-01-01,URY,Perak,0,0,0
2022-01-01,URY,Perlis,0,0,0
2022-01-01,URY,Pulau Pinang,0,0,0
2022-01-01,URY,Sabah,0,0,0
2022-01-01,URY,Sarawak,0,0,0
2022-01-01,URY,Selangor,0,0,0
2022-01-01,URY,W.P. Labuan,0,0,0
2022-01-01,USA,Johor,3,2,1
2022-01-01,USA,Kedah,33,20,13
2022-01-01,USA,Kelantan,0,0,0
2022-01-01,USA,Melaka,0,0,0
2022-01-01,USA,Negeri Sembilan,0,0,0
2022-01-01,USA,Pahang,0,0,0
2022-01-01,USA,Perak,1,0,1
2022-01-01,USA,Perlis,0,0,0
2022-01-01,USA,Pulau Pinang,10,7,3
2022-01-01,USA,Sabah,1,0,1
2022-01-01,USA,Sarawak,3,1,2
2022-01-01,USA,Selangor,1045,635,410
2022-01-01,USA,Terengganu,0,0,0
2022-01-01,USA,W.P. Labuan,0,0,0
2022-01-01,UZB,Johor,0,0,0
2022-01-01,UZB,Kedah,0,0,0
2022-01-01,UZB,Kelantan,0,0,0
2022-01-01,UZB,Perak,0,0,0
2022-01-01,UZB,Perlis,0,0,0
2022-01-01,UZB,Pulau Pinang,0,0,0
2022-01-01,UZB,Sabah,0,0,0
2022-01-01,UZB,Sarawak,0,0,0
2022-01-01,UZB,Selangor,45,27,18
2022-01-01,VAT,Johor,0,0,0
2022-01-01,VAT,Sarawak,0,0,0
2022-01-01,VAT,Selangor,0,0,0
2022-01-01,VCT,Johor,0,0,0
2022-01-01,VCT,Kedah,0,0,0
2022-01-01,VCT,Pulau Pinang,0,0,0
2022-01-01,VCT,Sarawak,0,0,0
2022-01-01,VCT,Selangor,0,0,0
2022-01-01,VEN,Johor,0,0,0
2022-01-01,VEN,Kedah,0,0,0
2022-01-01,VEN,Kelantan,0,0,0
2022-01-01,VEN,Melaka,0,0,0
2022-01-01,VEN,Perak,0,0,0
2022-01-01,VEN,Perlis,0,0,0
2022-01-01,VEN,Pulau Pinang,0,0,0
2022-01-01,VEN,Sabah,0,0,0
2022-01-01,VEN,Sarawak,0,0,0
2022-01-01,VEN,Selangor,19,9,10
2022-01-01,VEN,W.P. Labuan,0,0,0
2022-01-01,VNM,Johor,12,9,3
2022-01-01,VNM,Kedah,11,2,9
2022-01-01,VNM,Kelantan,2,0,2
2022-01-01,VNM,Melaka,0,0,0
2022-01-01,VNM,Negeri Sembilan,0,0,0
2022-01-01,VNM,Pahang,0,0,0
2022-01-01,VNM,Perak,0,0,0
2022-01-01,VNM,Perlis,0,0,0
2022-01-01,VNM,Pulau Pinang,2,1,1
2022-01-01,VNM,Sabah,1,0,1
2022-01-01,VNM,Sarawak,3,0,3
2022-01-01,VNM,Selangor,255,55,200
2022-01-01,VNM,Terengganu,0,0,0
2022-01-01,VNM,W.P. Labuan,2,2,0
2022-01-01,VUT,Johor,0,0,0
2022-01-01,VUT,Kedah,0,0,0
2022-01-01,VUT,Pulau Pinang,0,0,0
2022-01-01,VUT,Sabah,0,0,0
2022-01-01,VUT,Sarawak,0,0,0
2022-01-01,VUT,Selangor,1,1,0
2022-01-01,WSM,Johor,0,0,0
2022-01-01,WSM,Sarawak,0,0,0
2022-01-01,WSM,Selangor,0,0,0
2022-01-01,XXX,Johor,0,0,0
2022-01-01,XXX,Kedah,0,0,0
2022-01-01,XXX,Kelantan,0,0,0
2022-01-01,XXX,Melaka,0,0,0
2022-01-01,XXX,Pahang,0,0,0
2022-01-01,XXX,Perak,0,0,0
2022-01-01,XXX,Perlis,0,0,0
2022-01-01,XXX,Pulau Pinang,0,0,0
2022-01-01,XXX,Sabah,0,0,0
2022-01-01,XXX,Sarawak,0,0,0
2022-01-01,XXX,Selangor,69,47,22
2022-01-01,XXX,W.P. Labuan,0,0,0
2022-01-01,YEM,Johor,0,0,0
2022-01-01,YEM,Kedah,1,1,0
2022-01-01,YEM,Kelantan,0,0,0
2022-01-01,YEM,Melaka,0,0,0
2022-01-01,YEM,Pahang,0,0,0
2022-01-01,YEM,Perak,0,0,0
2022-01-01,YEM,Perlis,0,0,0
2022-01-01,YEM,Pulau Pinang,0,0,0
2022-01-01,YEM,Sabah,0,0,0
2022-01-01,YEM,Sarawak,0,0,0
2022-01-01,YEM,Selangor,315,215,100
2022-01-01,YEM,W.P. Labuan,0,0,0
2022-01-01,ZAF,Johor,0,0,0
2022-01-01,ZAF,Kedah,1,1,0
2022-01-01,ZAF,Kelantan,0,0,0
2022-01-01,ZAF,Melaka,0,0,0
2022-01-01,ZAF,Pahang,0,0,0
2022-01-01,ZAF,Perak,0,0,0
2022-01-01,ZAF,Perlis,0,0,0
2022-01-01,ZAF,Pulau Pinang,1,1,0
2022-01-01,ZAF,Sabah,0,0,0
2022-01-01,ZAF,Sarawak,4,3,1
2022-01-01,ZAF,Selangor,102,64,38
2022-01-01,ZAF,Terengganu,0,0,0
2022-01-01,ZAF,W.P. Labuan,0,0,0
2022-01-01,ZAR,Selangor,0,0,0
2022-01-01,ZMB,Johor,0,0,0
2022-01-01,ZMB,Kedah,0,0,0
2022-01-01,ZMB,Perak,0,0,0
2022-01-01,ZMB,Perlis,0,0,0
2022-01-01,ZMB,Pulau Pinang,0,0,0
2022-01-01,ZMB,Sabah,0,0,0
2022-01-01,ZMB,Sarawak,0,0,0
2022-01-01,ZMB,Selangor,8,5,3
2022-01-01,ZWE,Johor,0,0,0
2022-01-01,ZWE,Kedah,0,0,0
2022-01-01,ZWE,Kelantan,0,0,0
2022-01-01,ZWE,Perak,0,0,0
2022-01-01,ZWE,Perlis,0,0,0
2022-01-01,ZWE,Pulau Pinang,0,0,0
2022-01-01,ZWE,Sabah,0,0,0
2022-01-01,ZWE,Sarawak,0,0,0
2022-01-01,ZWE,Selangor,25,9,16
2022-02-01,ABW,Kedah,0,0,0
2022-02-01,ABW,Pulau Pinang,0,0,0
2022-02-01,AFG,Johor,0,0,0
2022-02-01,AFG,Kedah,0,0,0
2022-02-01,AFG,Perlis,0,0,0
2022-02-01,AFG,Pulau Pinang,0,0,0
2022-02-01,AFG,Sarawak,0,0,0
2022-02-01,AFG,Selangor,76,53,23
2022-02-01,AGO,Johor,0,0,0
2022-02-01,AGO,Kedah,0,0,0
2022-02-01,AGO,Sabah,0,0,0
2022-02-01,AGO,Selangor,0,0,0
2022-02-01,AIA,Selangor,0,0,0
2022-02-01,ALB,Johor,0,0,0
2022-02-01,ALB,Kedah,0,0,0
2022-02-01,ALB,Perak,0,0,0
2022-02-01,ALB,Perlis,0,0,0
2022-02-01,ALB,Pulau Pinang,0,0,0
2022-02-01,ALB,Sabah,0,0,0
2022-02-01,ALB,Sarawak,0,0,0
2022-02-01,ALB,Selangor,3,2,1
2022-02-01,AND,Johor,0,0,0
2022-02-01,AND,Kedah,0,0,0
2022-02-01,AND,Perlis,0,0,0
2022-02-01,AND,Pulau Pinang,0,0,0
2022-02-01,AND,Selangor,0,0,0
2022-02-01,ANT,Selangor,0,0,0
2022-02-01,ARE,Johor,0,0,0
2022-02-01,ARE,Kedah,0,0,0
2022-02-01,ARE,Kelantan,1,1,0
2022-02-01,ARE,Perak,0,0,0
2022-02-01,ARE,Perlis,0,0,0
2022-02-01,ARE,Pulau Pinang,0,0,0
2022-02-01,ARE,Sabah,0,0,0
2022-02-01,ARE,Sarawak,0,0,0
2022-02-01,ARE,Selangor,5,4,1
2022-02-01,ARG,Johor,0,0,0
2022-02-01,ARG,Kedah,0,0,0
2022-02-01,ARG,Kelantan,0,0,0
2022-02-01,ARG,Melaka,0,0,0
2022-02-01,ARG,Perak,0,0,0
2022-02-01,ARG,Perlis,0,0,0
2022-02-01,ARG,Pulau Pinang,0,0,0
2022-02-01,ARG,Sabah,0,0,0
2022-02-01,ARG,Sarawak,0,0,0
2022-02-01,ARG,Selangor,19,13,6
2022-02-01,ARG,W.P. Labuan,0,0,0
2022-02-01,ARM,Johor,0,0,0
2022-02-01,ARM,Kedah,0,0,0
2022-02-01,ARM,Kelantan,0,0,0
2022-02-01,ARM,Perak,0,0,0
2022-02-01,ARM,Perlis,0,0,0
2022-02-01,ARM,Pulau Pinang,0,0,0
2022-02-01,ARM,Sabah,0,0,0
2022-02-01,ARM,Sarawak,0,0,0
2022-02-01,ARM,Selangor,1,0,1
2022-02-01,ATA,Selangor,0,0,0
2022-02-01,ATG,Johor,0,0,0
2022-02-01,ATG,Kedah,0,0,0
2022-02-01,ATG,Pulau Pinang,0,0,0
2022-02-01,ATG,Sarawak,0,0,0
2022-02-01,ATG,Selangor,5,2,3
2022-02-01,AUS,Johor,0,0,0
2022-02-01,AUS,Kedah,68,44,24
2022-02-01,AUS,Kelantan,0,0,0
2022-02-01,AUS,Melaka,0,0,0
2022-02-01,AUS,Negeri Sembilan,0,0,0
2022-02-01,AUS,Pahang,0,0,0
2022-02-01,AUS,Perak,3,0,3
2022-02-01,AUS,Perlis,0,0,0
2022-02-01,AUS,Pulau Pinang,18,7,11
2022-02-01,AUS,Sabah,0,0,0
2022-02-01,AUS,Sarawak,7,4,3
2022-02-01,AUS,Selangor,474,319,155
2022-02-01,AUS,Terengganu,0,0,0
2022-02-01,AUS,W.P. Labuan,0,0,0
2022-02-01,AUT,Johor,0,0,0
2022-02-01,AUT,Kedah,1,1,0
2022-02-01,AUT,Kelantan,0,0,0
2022-02-01,AUT,Melaka,0,0,0
2022-02-01,AUT,Negeri Sembilan,0,0,0
2022-02-01,AUT,Pahang,0,0,0
2022-02-01,AUT,Perak,0,0,0
2022-02-01,AUT,Perlis,0,0,0
2022-02-01,AUT,Pulau Pinang,0,0,0
2022-02-01,AUT,Sabah,0,0,0
2022-02-01,AUT,Sarawak,0,0,0
2022-02-01,AUT,Selangor,45,38,7
2022-02-01,AUT,Terengganu,0,0,0
2022-02-01,AUT,W.P. Labuan,0,0,0
2022-02-01,AZE,Johor,0,0,0
2022-02-01,AZE,Kedah,0,0,0
2022-02-01,AZE,Kelantan,0,0,0
2022-02-01,AZE,Melaka,0,0,0
2022-02-01,AZE,Perlis,0,0,0
2022-02-01,AZE,Pulau Pinang,0,0,0
2022-02-01,AZE,Sabah,0,0,0
2022-02-01,AZE,Sarawak,0,0,0
2022-02-01,AZE,Selangor,3,3,0
2022-02-01,AZE,W.P. Labuan,0,0,0
2022-02-01,BDI,Pulau Pinang,0,0,0
2022-02-01,BDI,Sarawak,0,0,0
2022-02-01,BDI,Selangor,1,1,0
2022-02-01,BEL,Johor,0,0,0
2022-02-01,BEL,Kedah,0,0,0
2022-02-01,BEL,Kelantan,0,0,0
2022-02-01,BEL,Melaka,0,0,0
2022-02-01,BEL,Negeri Sembilan,0,0,0
2022-02-01,BEL,Pahang,0,0,0
2022-02-01,BEL,Perak,0,0,0
2022-02-01,BEL,Perlis,0,0,0
2022-02-01,BEL,Pulau Pinang,1,1,0
2022-02-01,BEL,Sabah,0,0,0
2022-02-01,BEL,Sarawak,1,1,0
2022-02-01,BEL,Selangor,51,36,15
2022-02-01,BEL,W.P. Labuan,0,0,0
2022-02-01,BEN,Johor,0,0,0
2022-02-01,BEN,Kedah,1,1,0
2022-02-01,BEN,Perak,0,0,0
2022-02-01,BEN,Pulau Pinang,0,0,0
2022-02-01,BEN,Sabah,0,0,0
2022-02-01,BEN,Sarawak,0,0,0
2022-02-01,BEN,Selangor,0,0,0
2022-02-01,BFA,Perak,0,0,0
2022-02-01,BFA,Pulau Pinang,0,0,0
2022-02-01,BFA,Selangor,0,0,0
2022-02-01,BGD,Johor,15,13,2
2022-02-01,BGD,Kedah,0,0,0
2022-02-01,BGD,Kelantan,0,0,0
2022-02-01,BGD,Melaka,0,0,0
2022-02-01,BGD,Negeri Sembilan,0,0,0
2022-02-01,BGD,Pahang,0,0,0
2022-02-01,BGD,Perak,0,0,0
2022-02-01,BGD,Perlis,0,0,0
2022-02-01,BGD,Pulau Pinang,2,2,0
2022-02-01,BGD,Sabah,0,0,0
2022-02-01,BGD,Sarawak,0,0,0
2022-02-01,BGD,Selangor,5698,5346,352
2022-02-01,BGD,W.P. Labuan,0,0,0
2022-02-01,BGR,Johor,0,0,0
2022-02-01,BGR,Kedah,0,0,0
2022-02-01,BGR,Kelantan,0,0,0
2022-02-01,BGR,Pahang,0,0,0
2022-02-01,BGR,Perak,0,0,0
2022-02-01,BGR,Perlis,0,0,0
2022-02-01,BGR,Pulau Pinang,0,0,0
2022-02-01,BGR,Sabah,0,0,0
2022-02-01,BGR,Sarawak,0,0,0
2022-02-01,BGR,Selangor,17,14,3
2022-02-01,BGR,W.P. Labuan,0,0,0
2022-02-01,BHR,Johor,0,0,0
2022-02-01,BHR,Kedah,0,0,0
2022-02-01,BHR,Kelantan,0,0,0
2022-02-01,BHR,Perlis,0,0,0
2022-02-01,BHR,Pulau Pinang,0,0,0
2022-02-01,BHR,Sabah,0,0,0
2022-02-01,BHR,Sarawak,0,0,0
2022-02-01,BHR,Selangor,4,4,0
2022-02-01,BHS,Johor,0,0,0
2022-02-01,BHS,Kedah,0,0,0
2022-02-01,BHS,Perak,0,0,0
2022-02-01,BHS,Sabah,0,0,0
2022-02-01,BHS,Sarawak,0,0,0
2022-02-01,BHS,Selangor,0,0,0
2022-02-01,BIH,Johor,0,0,0
2022-02-01,BIH,Kedah,0,0,0
2022-02-01,BIH,Perlis,0,0,0
2022-02-01,BIH,Pulau Pinang,0,0,0
2022-02-01,BIH,Sabah,0,0,0
2022-02-01,BIH,Sarawak,0,0,0
2022-02-01,BIH,Selangor,11,10,1
2022-02-01,BLR,Johor,1,1,0
2022-02-01,BLR,Kedah,0,0,0
2022-02-01,BLR,Kelantan,0,0,0
2022-02-01,BLR,Pahang,0,0,0
2022-02-01,BLR,Perak,0,0,0
2022-02-01,BLR,Perlis,0,0,0
2022-02-01,BLR,Pulau Pinang,0,0,0
2022-02-01,BLR,Sabah,0,0,0
2022-02-01,BLR,Sarawak,0,0,0
2022-02-01,BLR,Selangor,5,3,2
2022-02-01,BLR,W.P. Labuan,0,0,0
2022-02-01,BLZ,Johor,0,0,0
2022-02-01,BLZ,Pulau Pinang,0,0,0
2022-02-01,BLZ,Sarawak,0,0,0
2022-02-01,BLZ,Selangor,0,0,0
2022-02-01,BMU,Selangor,0,0,0
2022-02-01,BOL,Johor,0,0,0
2022-02-01,BOL,Kedah,0,0,0
2022-02-01,BOL,Melaka,0,0,0
2022-02-01,BOL,Perak,0,0,0
2022-02-01,BOL,Perlis,0,0,0
2022-02-01,BOL,Pulau Pinang,0,0,0
2022-02-01,BOL,Sabah,0,0,0
2022-02-01,BOL,Sarawak,0,0,0
2022-02-01,BOL,Selangor,1,1,0
2022-02-01,BRA,Johor,0,0,0
2022-02-01,BRA,Kedah,1,1,0
2022-02-01,BRA,Kelantan,0,0,0
2022-02-01,BRA,Melaka,0,0,0
2022-02-01,BRA,Pahang,0,0,0
2022-02-01,BRA,Perak,0,0,0
2022-02-01,BRA,Perlis,0,0,0
2022-02-01,BRA,Pulau Pinang,0,0,0
2022-02-01,BRA,Sabah,0,0,0
2022-02-01,BRA,Sarawak,0,0,0
2022-02-01,BRA,Selangor,62,42,20
2022-02-01,BRA,W.P. Labuan,0,0,0
2022-02-01,BRB,Johor,0,0,0
2022-02-01,BRB,Kedah,0,0,0
2022-02-01,BRB,Perlis,0,0,0
2022-02-01,BRB,Pulau Pinang,0,0,0
2022-02-01,BRB,Selangor,1,0,1
2022-02-01,BRN,Johor,1,0,1
2022-02-01,BRN,Kedah,0,0,0
2022-02-01,BRN,Kelantan,0,0,0
2022-02-01,BRN,Melaka,0,0,0
2022-02-01,BRN,Pahang,0,0,0
2022-02-01,BRN,Perak,0,0,0
2022-02-01,BRN,Perlis,0,0,0
2022-02-01,BRN,Pulau Pinang,0,0,0
2022-02-01,BRN,Sabah,0,0,0
2022-02-01,BRN,Sarawak,312,299,13
2022-02-01,BRN,Selangor,57,27,30
2022-02-01,BRN,W.P. Labuan,1,1,0
2022-02-01,BTN,Johor,0,0,0
2022-02-01,BTN,Kedah,0,0,0
2022-02-01,BTN,Perak,0,0,0
2022-02-01,BTN,Perlis,0,0,0
2022-02-01,BTN,Pulau Pinang,0,0,0
2022-02-01,BTN,Sabah,0,0,0
2022-02-01,BTN,Sarawak,0,0,0
2022-02-01,BTN,Selangor,1,1,0
2022-02-01,BWA,Johor,0,0,0
2022-02-01,BWA,Kedah,0,0,0
2022-02-01,BWA,Perlis,0,0,0
2022-02-01,BWA,Pulau Pinang,0,0,0
2022-02-01,BWA,Sabah,0,0,0
2022-02-01,BWA,Sarawak,0,0,0
2022-02-01,BWA,Selangor,4,3,1
2022-02-01,CAF,Kedah,0,0,0
2022-02-01,CAF,Selangor,0,0,0
2022-02-01,CAN,Johor,0,0,0
2022-02-01,CAN,Kedah,5,3,2
2022-02-01,CAN,Kelantan,0,0,0
2022-02-01,CAN,Melaka,0,0,0
2022-02-01,CAN,Negeri Sembilan,0,0,0
2022-02-01,CAN,Pahang,0,0,0
2022-02-01,CAN,Perak,0,0,0
2022-02-01,CAN,Perlis,0,0,0
2022-02-01,CAN,Pulau Pinang,0,0,0
2022-02-01,CAN,Sabah,0,0,0
2022-02-01,CAN,Sarawak,3,2,1
2022-02-01,CAN,Selangor,157,114,43
2022-02-01,CAN,Terengganu,0,0,0
2022-02-01,CAN,W.P. Labuan,0,0,0
2022-02-01,CCK,Selangor,0,0,0
2022-02-01,CHE,Johor,0,0,0
2022-02-01,CHE,Kedah,2,1,1
2022-02-01,CHE,Kelantan,0,0,0
2022-02-01,CHE,Melaka,0,0,0
2022-02-01,CHE,Negeri Sembilan,0,0,0
2022-02-01,CHE,Pahang,0,0,0
2022-02-01,CHE,Perak,0,0,0
2022-02-01,CHE,Perlis,0,0,0
2022-02-01,CHE,Pulau Pinang,4,4,0
2022-02-01,CHE,Sabah,0,0,0
2022-02-01,CHE,Sarawak,0,0,0
2022-02-01,CHE,Selangor,54,39,15
2022-02-01,CHE,W.P. Labuan,0,0,0
2022-02-01,CHL,Johor,0,0,0
2022-02-01,CHL,Kedah,0,0,0
2022-02-01,CHL,Kelantan,0,0,0
2022-02-01,CHL,Melaka,0,0,0
2022-02-01,CHL,Pahang,0,0,0
2022-02-01,CHL,Perak,0,0,0
2022-02-01,CHL,Perlis,0,0,0
2022-02-01,CHL,Pulau Pinang,0,0,0
2022-02-01,CHL,Sabah,0,0,0
2022-02-01,CHL,Sarawak,0,0,0
2022-02-01,CHL,Selangor,3,1,2
2022-02-01,CHN,Johor,107,103,4
2022-02-01,CHN,Kedah,5,3,2
2022-02-01,CHN,Kelantan,0,0,0
2022-02-01,CHN,Melaka,0,0,0
2022-02-01,CHN,Pahang,0,0,0
2022-02-01,CHN,Perak,0,0,0
2022-02-01,CHN,Perlis,0,0,0
2022-02-01,CHN,Pulau Pinang,4,1,3
2022-02-01,CHN,Sabah,2,1,1
2022-02-01,CHN,Sarawak,34,31,3
2022-02-01,CHN,Selangor,3033,2127,906
2022-02-01,CHN,Terengganu,0,0,0
2022-02-01,CHN,W.P. Labuan,0,0,0
2022-02-01,CIV,Johor,0,0,0
2022-02-01,CIV,Kedah,0,0,0
2022-02-01,CIV,Pulau Pinang,0,0,0
2022-02-01,CIV,Sabah,0,0,0
2022-02-01,CIV,Sarawak,0,0,0
2022-02-01,CIV,Selangor,8,7,1
2022-02-01,CMR,Johor,0,0,0
2022-02-01,CMR,Kedah,0,0,0
2022-02-01,CMR,Pulau Pinang,0,0,0
2022-02-01,CMR,Sabah,0,0,0
2022-02-01,CMR,Sarawak,0,0,0
2022-02-01,CMR,Selangor,1,0,1
2022-02-01,COD,Johor,0,0,0
2022-02-01,COD,Pulau Pinang,0,0,0
2022-02-01,COD,Sarawak,0,0,0
2022-02-01,COD,Selangor,2,1,1
2022-02-01,COG,Johor,0,0,0
2022-02-01,COG,Kedah,0,0,0
2022-02-01,COG,Selangor,0,0,0
2022-02-01,COK,Selangor,0,0,0
2022-02-01,COL,Johor,0,0,0
2022-02-01,COL,Kedah,0,0,0
2022-02-01,COL,Perak,0,0,0
2022-02-01,COL,Pulau Pinang,0,0,0
2022-02-01,COL,Sabah,0,0,0
2022-02-01,COL,Sarawak,0,0,0
2022-02-01,COL,Selangor,10,2,8
2022-02-01,COL,W.P. Labuan,0,0,0
2022-02-01,COM,Johor,0,0,0
2022-02-01,COM,Kedah,0,0,0
2022-02-01,COM,Selangor,8,2,6
2022-02-01,CPV,Johor,0,0,0
2022-02-01,CPV,Kedah,0,0,0
2022-02-01,CPV,Pulau Pinang,0,0,0
2022-02-01,CPV,Sabah,0,0,0
2022-02-01,CPV,Selangor,0,0,0
2022-02-01,CRI,Johor,0,0,0
2022-02-01,CRI,Kedah,0,0,0
2022-02-01,CRI,Perak,0,0,0
2022-02-01,CRI,Perlis,0,0,0
2022-02-01,CRI,Pulau Pinang,0,0,0
2022-02-01,CRI,Sabah,0,0,0
2022-02-01,CRI,Sarawak,0,0,0
2022-02-01,CRI,Selangor,5,4,1
2022-02-01,CUB,Johor,0,0,0
2022-02-01,CUB,Kedah,0,0,0
2022-02-01,CUB,Perlis,0,0,0
2022-02-01,CUB,Pulau Pinang,0,0,0
2022-02-01,CUB,Sabah,0,0,0
2022-02-01,CUB,Sarawak,0,0,0
2022-02-01,CUB,Selangor,0,0,0
2022-02-01,CYP,Johor,0,0,0
2022-02-01,CYP,Kedah,1,1,0
2022-02-01,CYP,Perak,0,0,0
2022-02-01,CYP,Perlis,0,0,0
2022-02-01,CYP,Pulau Pinang,0,0,0
2022-02-01,CYP,Sabah,0,0,0
2022-02-01,CYP,Sarawak,0,0,0
2022-02-01,CYP,Selangor,7,4,3
2022-02-01,CZE,Johor,0,0,0
2022-02-01,CZE,Kedah,0,0,0
2022-02-01,CZE,Kelantan,4,3,1
2022-02-01,CZE,Melaka,0,0,0
2022-02-01,CZE,Negeri Sembilan,0,0,0
2022-02-01,CZE,Perak,0,0,0
2022-02-01,CZE,Perlis,0,0,0
2022-02-01,CZE,Pulau Pinang,0,0,0
2022-02-01,CZE,Sabah,0,0,0
2022-02-01,CZE,Sarawak,0,0,0
2022-02-01,CZE,Selangor,20,15,5
2022-02-01,CZE,W.P. Labuan,0,0,0
2022-02-01,DEU,Johor,3,3,0
2022-02-01,DEU,Kedah,11,8,3
2022-02-01,DEU,Kelantan,0,0,0
2022-02-01,DEU,Melaka,0,0,0
2022-02-01,DEU,Negeri Sembilan,0,0,0
2022-02-01,DEU,Pahang,0,0,0
2022-02-01,DEU,Perak,0,0,0
2022-02-01,DEU,Perlis,0,0,0
2022-02-01,DEU,Pulau Pinang,15,14,1
2022-02-01,DEU,Sabah,0,0,0
2022-02-01,DEU,Sarawak,0,0,0
2022-02-01,DEU,Selangor,322,266,56
2022-02-01,DEU,Terengganu,0,0,0
2022-02-01,DEU,W.P. Labuan,0,0,0
2022-02-01,DJI,Johor,0,0,0
2022-02-01,DJI,Selangor,3,1,2
2022-02-01,DMA,Johor,0,0,0
2022-02-01,DMA,Kedah,0,0,0
2022-02-01,DMA,Pulau Pinang,0,0,0
2022-02-01,DMA,Sabah,0,0,0
2022-02-01,DMA,Sarawak,0,0,0
2022-02-01,DMA,Selangor,3,3,0
2022-02-01,DMA,W.P. Labuan,0,0,0
2022-02-01,DNK,Johor,1,1,0
2022-02-01,DNK,Kedah,1,0,1
2022-02-01,DNK,Kelantan,0,0,0
2022-02-01,DNK,Melaka,0,0,0
2022-02-01,DNK,Negeri Sembilan,0,0,0
2022-02-01,DNK,Pahang,0,0,0
2022-02-01,DNK,Perak,0,0,0
2022-02-01,DNK,Perlis,0,0,0
2022-02-01,DNK,Pulau Pinang,4,2,2
2022-02-01,DNK,Sabah,0,0,0
2022-02-01,DNK,Sarawak,0,0,0
2022-02-01,DNK,Selangor,53,45,8
2022-02-01,DNK,W.P. Labuan,0,0,0
2022-02-01,DOM,Johor,0,0,0
2022-02-01,DOM,Kedah,0,0,0
2022-02-01,DOM,Perak,0,0,0
2022-02-01,DOM,Perlis,0,0,0
2022-02-01,DOM,Pulau Pinang,0,0,0
2022-02-01,DOM,Sabah,0,0,0
2022-02-01,DOM,Sarawak,0,0,0
2022-02-01,DOM,Selangor,0,0,0
2022-02-01,DZA,Johor,0,0,0
2022-02-01,DZA,Kedah,0,0,0
2022-02-01,DZA,Kelantan,0,0,0
2022-02-01,DZA,Melaka,0,0,0
2022-02-01,DZA,Perak,0,0,0
2022-02-01,DZA,Perlis,0,0,0
2022-02-01,DZA,Pulau Pinang,0,0,0
2022-02-01,DZA,Sabah,0,0,0
2022-02-01,DZA,Sarawak,0,0,0
2022-02-01,DZA,Selangor,47,32,15
2022-02-01,DZA,W.P. Labuan,0,0,0
2022-02-01,ECU,Johor,0,0,0
2022-02-01,ECU,Kedah,0,0,0
2022-02-01,ECU,Perak,0,0,0
2022-02-01,ECU,Perlis,0,0,0
2022-02-01,ECU,Pulau Pinang,0,0,0
2022-02-01,ECU,Sabah,0,0,0
2022-02-01,ECU,Sarawak,0,0,0
2022-02-01,ECU,Selangor,0,0,0
2022-02-01,EGY,Johor,0,0,0
2022-02-01,EGY,Kedah,0,0,0
2022-02-01,EGY,Kelantan,0,0,0
2022-02-01,EGY,Melaka,0,0,0
2022-02-01,EGY,Pahang,0,0,0
2022-02-01,EGY,Perak,0,0,0
2022-02-01,EGY,Perlis,0,0,0
2022-02-01,EGY,Pulau Pinang,0,0,0
2022-02-01,EGY,Sabah,0,0,0
2022-02-01,EGY,Sarawak,0,0,0
2022-02-01,EGY,Selangor,270,210,60
2022-02-01,EGY,Terengganu,0,0,0
2022-02-01,EGY,W.P. Labuan,0,0,0
2022-02-01,ERI,Johor,0,0,0
2022-02-01,ERI,Pulau Pinang,0,0,0
2022-02-01,ERI,Sabah,0,0,0
2022-02-01,ERI,Selangor,3,0,3
2022-02-01,ESP,Johor,0,0,0
2022-02-01,ESP,Kedah,2,2,0
2022-02-01,ESP,Kelantan,1,0,1
2022-02-01,ESP,Melaka,0,0,0
2022-02-01,ESP,Negeri Sembilan,0,0,0
2022-02-01,ESP,Pahang,0,0,0
2022-02-01,ESP,Perak,0,0,0
2022-02-01,ESP,Perlis,0,0,0
2022-02-01,ESP,Pulau Pinang,0,0,0
2022-02-01,ESP,Sabah,0,0,0
2022-02-01,ESP,Sarawak,0,0,0
2022-02-01,ESP,Selangor,131,108,23
2022-02-01,ESP,W.P. Labuan,0,0,0
2022-02-01,EST,Johor,0,0,0
2022-02-01,EST,Kedah,0,0,0
2022-02-01,EST,Kelantan,0,0,0
2022-02-01,EST,Pahang,0,0,0
2022-02-01,EST,Perak,0,0,0
2022-02-01,EST,Perlis,0,0,0
2022-02-01,EST,Pulau Pinang,0,0,0
2022-02-01,EST,Sabah,0,0,0
2022-02-01,EST,Sarawak,0,0,0
2022-02-01,EST,Selangor,4,2,2
2022-02-01,EST,W.P. Labuan,0,0,0
2022-02-01,ETH,Johor,0,0,0
2022-02-01,ETH,Kedah,0,0,0
2022-02-01,ETH,Pulau Pinang,0,0,0
2022-02-01,ETH,Sarawak,0,0,0
2022-02-01,ETH,Selangor,5,5,0
2022-02-01,FIN,Johor,0,0,0
2022-02-01,FIN,Kedah,1,1,0
2022-02-01,FIN,Kelantan,0,0,0
2022-02-01,FIN,Melaka,0,0,0
2022-02-01,FIN,Negeri Sembilan,0,0,0
2022-02-01,FIN,Pahang,0,0,0
2022-02-01,FIN,Perak,0,0,0
2022-02-01,FIN,Perlis,0,0,0
2022-02-01,FIN,Pulau Pinang,0,0,0
2022-02-01,FIN,Sabah,0,0,0
2022-02-01,FIN,Sarawak,0,0,0
2022-02-01,FIN,Selangor,23,19,4
2022-02-01,FIN,W.P. Labuan,0,0,0
2022-02-01,FJI,Johor,0,0,0
2022-02-01,FJI,Kedah,0,0,0
2022-02-01,FJI,Kelantan,0,0,0
2022-02-01,FJI,Perak,0,0,0
2022-02-01,FJI,Perlis,0,0,0
2022-02-01,FJI,Pulau Pinang,0,0,0
2022-02-01,FJI,Sabah,0,0,0
2022-02-01,FJI,Sarawak,0,0,0
2022-02-01,FJI,Selangor,4,3,1
2022-02-01,FRA,Johor,2,2,0
2022-02-01,FRA,Kedah,10,6,4
2022-02-01,FRA,Kelantan,1,1,0
2022-02-01,FRA,Melaka,0,0,0
2022-02-01,FRA,Negeri Sembilan,0,0,0
2022-02-01,FRA,Pahang,0,0,0
2022-02-01,FRA,Perak,0,0,0
2022-02-01,FRA,Perlis,0,0,0
2022-02-01,FRA,Pulau Pinang,1,1,0
2022-02-01,FRA,Sabah,0,0,0
2022-02-01,FRA,Sarawak,0,0,0
2022-02-01,FRA,Selangor,399,277,122
2022-02-01,FRA,Terengganu,0,0,0
2022-02-01,FRA,W.P. Labuan,0,0,0
2022-02-01,FSM,Johor,0,0,0
2022-02-01,FSM,Pulau Pinang,0,0,0
2022-02-01,FSM,Selangor,0,0,0
2022-02-01,GAB,Johor,0,0,0
2022-02-01,GAB,Pulau Pinang,0,0,0
2022-02-01,GAB,Sarawak,0,0,0
2022-02-01,GAB,Selangor,1,0,1
2022-02-01,GBR,Johor,0,0,0
2022-02-01,GBR,Kedah,39,24,15
2022-02-01,GBR,Kelantan,1,0,1
2022-02-01,GBR,Melaka,0,0,0
2022-02-01,GBR,Negeri Sembilan,0,0,0
2022-02-01,GBR,Pahang,0,0,0
2022-02-01,GBR,Perak,1,0,1
2022-02-01,GBR,Perlis,0,0,0
2022-02-01,GBR,Pulau Pinang,19,10,9
2022-02-01,GBR,Sabah,1,1,0
2022-02-01,GBR,Sarawak,3,2,1
2022-02-01,GBR,Selangor,925,642,283
2022-02-01,GBR,Terengganu,0,0,0
2022-02-01,GBR,W.P. Labuan,0,0,0
2022-02-01,GEO,Johor,0,0,0
2022-02-01,GEO,Kedah,0,0,0
2022-02-01,GEO,Melaka,0,0,0
2022-02-01,GEO,Perak,0,0,0
2022-02-01,GEO,Perlis,0,0,0
2022-02-01,GEO,Pulau Pinang,0,0,0
2022-02-01,GEO,Sabah,0,0,0
2022-02-01,GEO,Sarawak,0,0,0
2022-02-01,GEO,Selangor,1,1,0
2022-02-01,GHA,Johor,0,0,0
2022-02-01,GHA,Kedah,0,0,0
2022-02-01,GHA,Kelantan,0,0,0
2022-02-01,GHA,Pulau Pinang,0,0,0
2022-02-01,GHA,Sabah,0,0,0
2022-02-01,GHA,Sarawak,0,0,0
2022-02-01,GHA,Selangor,11,8,3
2022-02-01,GIB,Johor,0,0,0
2022-02-01,GIB,Sarawak,0,0,0
2022-02-01,GIN,Johor,0,0,0
2022-02-01,GIN,Kedah,0,0,0
2022-02-01,GIN,Kelantan,0,0,0
2022-02-01,GIN,Perlis,0,0,0
2022-02-01,GIN,Pulau Pinang,0,0,0
2022-02-01,GIN,Sabah,0,0,0
2022-02-01,GIN,Sarawak,0,0,0
2022-02-01,GIN,Selangor,18,16,2
2022-02-01,GLP,Selangor,0,0,0
2022-02-01,GMB,Johor,0,0,0
2022-02-01,GMB,Kedah,0,0,0
2022-02-01,GMB,Kelantan,0,0,0
2022-02-01,GMB,Pulau Pinang,0,0,0
2022-02-01,GMB,Sabah,0,0,0
2022-02-01,GMB,Sarawak,0,0,0
2022-02-01,GMB,Selangor,3,1,2
2022-02-01,GNB,Johor,0,0,0
2022-02-01,GNB,Selangor,0,0,0
2022-02-01,GNQ,Johor,0,0,0
2022-02-01,GNQ,Selangor,0,0,0
2022-02-01,GRC,Johor,1,1,0
2022-02-01,GRC,Kedah,0,0,0
2022-02-01,GRC,Kelantan,0,0,0
2022-02-01,GRC,Melaka,0,0,0
2022-02-01,GRC,Negeri Sembilan,0,0,0
2022-02-01,GRC,Pahang,0,0,0
2022-02-01,GRC,Perak,0,0,0
2022-02-01,GRC,Perlis,0,0,0
2022-02-01,GRC,Pulau Pinang,0,0,0
2022-02-01,GRC,Sabah,0,0,0
2022-02-01,GRC,Sarawak,0,0,0
2022-02-01,GRC,Selangor,9,9,0
2022-02-01,GRD,Johor,0,0,0
2022-02-01,GRD,Kedah,0,0,0
2022-02-01,GRD,Pulau Pinang,0,0,0
2022-02-01,GRD,Sabah,0,0,0
2022-02-01,GRD,Sarawak,0,0,0
2022-02-01,GRD,Selangor,0,0,0
2022-02-01,GRL,Johor,0,0,0
2022-02-01,GRL,Selangor,0,0,0
2022-02-01,GTM,Johor,0,0,0
2022-02-01,GTM,Kedah,0,0,0
2022-02-01,GTM,Pahang,0,0,0
2022-02-01,GTM,Perak,0,0,0
2022-02-01,GTM,Pulau Pinang,0,0,0
2022-02-01,GTM,Sabah,0,0,0
2022-02-01,GTM,Sarawak,0,0,0
2022-02-01,GTM,Selangor,1,0,1
2022-02-01,GTM,W.P. Labuan,0,0,0
2022-02-01,GUY,Johor,0,0,0
2022-02-01,GUY,Kedah,0,0,0
2022-02-01,GUY,Pulau Pinang,0,0,0
2022-02-01,GUY,Sarawak,0,0,0
2022-02-01,GUY,Selangor,0,0,0
2022-02-01,HKG,Johor,0,0,0
2022-02-01,HKG,Kedah,3,2,1
2022-02-01,HKG,Kelantan,0,0,0
2022-02-01,HKG,Pahang,0,0,0
2022-02-01,HKG,Perak,0,0,0
2022-02-01,HKG,Perlis,0,0,0
2022-02-01,HKG,Pulau Pinang,2,2,0
2022-02-01,HKG,Sabah,0,0,0
2022-02-01,HKG,Sarawak,35,32,3
2022-02-01,HKG,Selangor,1,0,1
2022-02-01,HKG,Terengganu,0,0,0
2022-02-01,HMD,Johor,0,0,0
2022-02-01,HND,Johor,0,0,0
2022-02-01,HND,Kedah,0,0,0
2022-02-01,HND,Perak,0,0,0
2022-02-01,HND,Pulau Pinang,0,0,0
2022-02-01,HND,Sabah,0,0,0
2022-02-01,HND,Sarawak,0,0,0
2022-02-01,HND,Selangor,0,0,0
2022-02-01,HRV,Johor,0,0,0
2022-02-01,HRV,Kedah,0,0,0
2022-02-01,HRV,Kelantan,0,0,0
2022-02-01,HRV,Melaka,0,0,0
2022-02-01,HRV,Pahang,0,0,0
2022-02-01,HRV,Perak,0,0,0
2022-02-01,HRV,Perlis,0,0,0
2022-02-01,HRV,Pulau Pinang,0,0,0
2022-02-01,HRV,Sabah,0,0,0
2022-02-01,HRV,Sarawak,0,0,0
2022-02-01,HRV,Selangor,31,30,1
2022-02-01,HTI,Johor,0,0,0
2022-02-01,HTI,Kedah,0,0,0
2022-02-01,HTI,Kelantan,0,0,0
2022-02-01,HTI,Perak,0,0,0
2022-02-01,HTI,Pulau Pinang,0,0,0
2022-02-01,HTI,Sabah,0,0,0
2022-02-01,HTI,Selangor,1,1,0
2022-02-01,HUN,Johor,1,1,0
2022-02-01,HUN,Kedah,0,0,0
2022-02-01,HUN,Kelantan,0,0,0
2022-02-01,HUN,Pahang,0,0,0
2022-02-01,HUN,Perak,0,0,0
2022-02-01,HUN,Perlis,0,0,0
2022-02-01,HUN,Pulau Pinang,0,0,0
2022-02-01,HUN,Sabah,0,0,0
2022-02-01,HUN,Sarawak,0,0,0
2022-02-01,HUN,Selangor,10,6,4
2022-02-01,HUN,W.P. Labuan,0,0,0
2022-02-01,IDN,Johor,607,259,348
2022-02-01,IDN,Kedah,37,13,24
2022-02-01,IDN,Kelantan,0,0,0
2022-02-01,IDN,Melaka,0,0,0
2022-02-01,IDN,Negeri Sembilan,0,0,0
2022-02-01,IDN,Pahang,0,0,0
2022-02-01,IDN,Perak,0,0,0
2022-02-01,IDN,Perlis,0,0,0
2022-02-01,IDN,Pulau Pinang,13,7,6
2022-02-01,IDN,Sabah,3,1,2
2022-02-01,IDN,Sarawak,245,221,24
2022-02-01,IDN,Selangor,3047,1469,1578
2022-02-01,IDN,Terengganu,0,0,0
2022-02-01,IDN,W.P. Labuan,2,2,0
2022-02-01,IND,Johor,44,42,2
2022-02-01,IND,Kedah,2,2,0
2022-02-01,IND,Kelantan,0,0,0
2022-02-01,IND,Melaka,0,0,0
2022-02-01,IND,Negeri Sembilan,0,0,0
2022-02-01,IND,Pahang,0,0,0
2022-02-01,IND,Perak,0,0,0
2022-02-01,IND,Perlis,0,0,0
2022-02-01,IND,Pulau Pinang,1,0,1
2022-02-01,IND,Sabah,2,2,0
2022-02-01,IND,Sarawak,6,6,0
2022-02-01,IND,Selangor,5140,3707,1433
2022-02-01,IND,Terengganu,0,0,0
2022-02-01,IND,W.P. Labuan,0,0,0
2022-02-01,IOT,Pulau Pinang,0,0,0
2022-02-01,IOT,Selangor,0,0,0
2022-02-01,IRL,Johor,0,0,0
2022-02-01,IRL,Kedah,2,1,1
2022-02-01,IRL,Kelantan,0,0,0
2022-02-01,IRL,Negeri Sembilan,0,0,0
2022-02-01,IRL,Pahang,0,0,0
2022-02-01,IRL,Perak,0,0,0
2022-02-01,IRL,Perlis,0,0,0
2022-02-01,IRL,Pulau Pinang,0,0,0
2022-02-01,IRL,Sabah,0,0,0
2022-02-01,IRL,Sarawak,0,0,0
2022-02-01,IRL,Selangor,65,41,24
2022-02-01,IRL,Terengganu,0,0,0
2022-02-01,IRL,W.P. Labuan,0,0,0
2022-02-01,IRN,Johor,0,0,0
2022-02-01,IRN,Kedah,0,0,0
2022-02-01,IRN,Kelantan,0,0,0
2022-02-01,IRN,Perak,0,0,0
2022-02-01,IRN,Perlis,0,0,0
2022-02-01,IRN,Pulau Pinang,0,0,0
2022-02-01,IRN,Sabah,0,0,0
2022-02-01,IRN,Sarawak,0,0,0
2022-02-01,IRN,Selangor,185,106,79
2022-02-01,IRN,W.P. Labuan,0,0,0
2022-02-01,IRQ,Johor,0,0,0
2022-02-01,IRQ,Kedah,0,0,0
2022-02-01,IRQ,Kelantan,0,0,0
2022-02-01,IRQ,Melaka,0,0,0
2022-02-01,IRQ,Pahang,0,0,0
2022-02-01,IRQ,Perak,0,0,0
2022-02-01,IRQ,Perlis,0,0,0
2022-02-01,IRQ,Pulau Pinang,0,0,0
2022-02-01,IRQ,Sabah,0,0,0
2022-02-01,IRQ,Sarawak,1,1,0
2022-02-01,IRQ,Selangor,174,113,61
2022-02-01,ISL,Johor,0,0,0
2022-02-01,ISL,Kedah,0,0,0
2022-02-01,ISL,Kelantan,0,0,0
2022-02-01,ISL,Perak,0,0,0
2022-02-01,ISL,Perlis,0,0,0
2022-02-01,ISL,Pulau Pinang,0,0,0
2022-02-01,ISL,Sabah,0,0,0
2022-02-01,ISL,Sarawak,0,0,0
2022-02-01,ISL,Selangor,2,2,0
2022-02-01,ISL,W.P. Labuan,0,0,0
2022-02-01,ISR,Pulau Pinang,0,0,0
2022-02-01,ITA,Johor,0,0,0
2022-02-01,ITA,Kedah,1,1,0
2022-02-01,ITA,Kelantan,0,0,0
2022-02-01,ITA,Melaka,0,0,0
2022-02-01,ITA,Negeri Sembilan,0,0,0
2022-02-01,ITA,Pahang,0,0,0
2022-02-01,ITA,Perak,0,0,0
2022-02-01,ITA,Perlis,0,0,0
2022-02-01,ITA,Pulau Pinang,2,2,0
2022-02-01,ITA,Sabah,0,0,0
2022-02-01,ITA,Sarawak,1,1,0
2022-02-01,ITA,Selangor,171,144,27
2022-02-01,ITA,W.P. Labuan,0,0,0
2022-02-01,JAM,Johor,0,0,0
2022-02-01,JAM,Kedah,0,0,0
2022-02-01,JAM,Perak,0,0,0
2022-02-01,JAM,Pulau Pinang,0,0,0
2022-02-01,JAM,Sabah,0,0,0
2022-02-01,JAM,Sarawak,1,1,0
2022-02-01,JAM,Selangor,1,0,1
2022-02-01,JAM,W.P. Labuan,0,0,0
2022-02-01,JOR,Johor,0,0,0
2022-02-01,JOR,Kedah,0,0,0
2022-02-01,JOR,Kelantan,0,0,0
2022-02-01,JOR,Melaka,0,0,0
2022-02-01,JOR,Perlis,0,0,0
2022-02-01,JOR,Pulau Pinang,0,0,0
2022-02-01,JOR,Sabah,0,0,0
2022-02-01,JOR,Sarawak,1,1,0
2022-02-01,JOR,Selangor,78,49,29
2022-02-01,JOR,W.P. Labuan,0,0,0
2022-02-01,JPN,Johor,2,2,0
2022-02-01,JPN,Kedah,8,6,2
2022-02-01,JPN,Kelantan,0,0,0
2022-02-01,JPN,Melaka,0,0,0
2022-02-01,JPN,Negeri Sembilan,0,0,0
2022-02-01,JPN,Pahang,0,0,0
2022-02-01,JPN,Perak,0,0,0
2022-02-01,JPN,Perlis,0,0,0
2022-02-01,JPN,Pulau Pinang,43,28,15
2022-02-01,JPN,Sabah,0,0,0
2022-02-01,JPN,Sarawak,9,8,1
2022-02-01,JPN,Selangor,971,663,308
2022-02-01,JPN,W.P. Labuan,0,0,0
2022-02-01,KAZ,Johor,1,1,0
2022-02-01,KAZ,Kedah,0,0,0
2022-02-01,KAZ,Kelantan,0,0,0
2022-02-01,KAZ,Melaka,0,0,0
2022-02-01,KAZ,Perak,0,0,0
2022-02-01,KAZ,Perlis,0,0,0
2022-02-01,KAZ,Pulau Pinang,0,0,0
2022-02-01,KAZ,Sabah,0,0,0
2022-02-01,KAZ,Sarawak,0,0,0
2022-02-01,KAZ,Selangor,60,35,25
2022-02-01,KAZ,W.P. Labuan,0,0,0
2022-02-01,KEN,Johor,0,0,0
2022-02-01,KEN,Kedah,0,0,0
2022-02-01,KEN,Kelantan,0,0,0
2022-02-01,KEN,Perak,0,0,0
2022-02-01,KEN,Perlis,0,0,0
2022-02-01,KEN,Pulau Pinang,0,0,0
2022-02-01,KEN,Sabah,0,0,0
2022-02-01,KEN,Sarawak,0,0,0
2022-02-01,KEN,Selangor,57,33,24
2022-02-01,KGZ,Johor,0,0,0
2022-02-01,KGZ,Kedah,0,0,0
2022-02-01,KGZ,Kelantan,0,0,0
2022-02-01,KGZ,Perak,0,0,0
2022-02-01,KGZ,Perlis,0,0,0
2022-02-01,KGZ,Pulau Pinang,0,0,0
2022-02-01,KGZ,Sabah,0,0,0
2022-02-01,KGZ,Sarawak,0,0,0
2022-02-01,KGZ,Selangor,19,11,8
2022-02-01,KHM,Johor,0,0,0
2022-02-01,KHM,Kedah,0,0,0
2022-02-01,KHM,Kelantan,0,0,0
2022-02-01,KHM,Melaka,0,0,0
2022-02-01,KHM,Negeri Sembilan,0,0,0
2022-02-01,KHM,Pahang,0,0,0
2022-02-01,KHM,Perak,0,0,0
2022-02-01,KHM,Perlis,0,0,0
2022-02-01,KHM,Pulau Pinang,29,28,1
2022-02-01,KHM,Sabah,0,0,0
2022-02-01,KHM,Sarawak,1,1,0
2022-02-01,KHM,Selangor,138,109,29
2022-02-01,KHM,W.P. Labuan,0,0,0
2022-02-01,KIR,Johor,0,0,0
2022-02-01,KIR,Sabah,0,0,0
2022-02-01,KIR,Selangor,0,0,0
2022-02-01,KNA,Johor,0,0,0
2022-02-01,KNA,Kedah,0,0,0
2022-02-01,KNA,Perlis,0,0,0
2022-02-01,KNA,Pulau Pinang,0,0,0
2022-02-01,KNA,Sabah,0,0,0
2022-02-01,KNA,Selangor,2,2,0
2022-02-01,KNA,W.P. Labuan,0,0,0
2022-02-01,KOR,Johor,4,2,2
2022-02-01,KOR,Kedah,2,1,1
2022-02-01,KOR,Kelantan,0,0,0
2022-02-01,KOR,Melaka,0,0,0
2022-02-01,KOR,Negeri Sembilan,0,0,0
2022-02-01,KOR,Pahang,0,0,0
2022-02-01,KOR,Perak,0,0,0
2022-02-01,KOR,Perlis,0,0,0
2022-02-01,KOR,Pulau Pinang,9,4,5
2022-02-01,KOR,Sabah,0,0,0
2022-02-01,KOR,Sarawak,39,34,5
2022-02-01,KOR,Selangor,837,576,261
2022-02-01,KOR,Terengganu,0,0,0
2022-02-01,KOR,W.P. Labuan,0,0,0
2022-02-01,KWT,Johor,0,0,0
2022-02-01,KWT,Kedah,0,0,0
2022-02-01,KWT,Kelantan,0,0,0
2022-02-01,KWT,Perak,0,0,0
2022-02-01,KWT,Perlis,0,0,0
2022-02-01,KWT,Pulau Pinang,0,0,0
2022-02-01,KWT,Sabah,0,0,0
2022-02-01,KWT,Sarawak,0,0,0
2022-02-01,KWT,Selangor,19,8,11
2022-02-01,KWT,W.P. Labuan,0,0,0
2022-02-01,LAO,Johor,0,0,0
2022-02-01,LAO,Kedah,0,0,0
2022-02-01,LAO,Kelantan,0,0,0
2022-02-01,LAO,Melaka,0,0,0
2022-02-01,LAO,Perak,0,0,0
2022-02-01,LAO,Perlis,0,0,0
2022-02-01,LAO,Pulau Pinang,0,0,0
2022-02-01,LAO,Sabah,0,0,0
2022-02-01,LAO,Sarawak,0,0,0
2022-02-01,LAO,Selangor,42,36,6
2022-02-01,LAO,W.P. Labuan,0,0,0
2022-02-01,LBN,Johor,0,0,0
2022-02-01,LBN,Kedah,0,0,0
2022-02-01,LBN,Kelantan,0,0,0
2022-02-01,LBN,Pahang,0,0,0
2022-02-01,LBN,Perak,0,0,0
2022-02-01,LBN,Perlis,0,0,0
2022-02-01,LBN,Pulau Pinang,0,0,0
2022-02-01,LBN,Sabah,0,0,0
2022-02-01,LBN,Sarawak,0,0,0
2022-02-01,LBN,Selangor,22,15,7
2022-02-01,LBN,W.P. Labuan,0,0,0
2022-02-01,LBR,Johor,0,0,0
2022-02-01,LBR,Kedah,1,1,0
2022-02-01,LBR,Sabah,0,0,0
2022-02-01,LBR,Sarawak,0,0,0
2022-02-01,LBR,Selangor,7,5,2
2022-02-01,LBY,Johor,0,0,0
2022-02-01,LBY,Kedah,0,0,0
2022-02-01,LBY,Perlis,0,0,0
2022-02-01,LBY,Pulau Pinang,0,0,0
2022-02-01,LBY,Sabah,0,0,0
2022-02-01,LBY,Sarawak,0,0,0
2022-02-01,LBY,Selangor,148,108,40
2022-02-01,LCA,Johor,0,0,0
2022-02-01,LCA,Kedah,0,0,0
2022-02-01,LCA,Pulau Pinang,0,0,0
2022-02-01,LCA,Sarawak,0,0,0
2022-02-01,LCA,Selangor,0,0,0
2022-02-01,LIE,Johor,0,0,0
2022-02-01,LIE,Kedah,0,0,0
2022-02-01,LIE,Perlis,0,0,0
2022-02-01,LIE,Pulau Pinang,0,0,0
2022-02-01,LIE,Sabah,0,0,0
2022-02-01,LIE,Sarawak,0,0,0
2022-02-01,LIE,Selangor,1,1,0
2022-02-01,LKA,Johor,1,1,0
2022-02-01,LKA,Kedah,0,0,0
2022-02-01,LKA,Kelantan,0,0,0
2022-02-01,LKA,Melaka,0,0,0
2022-02-01,LKA,Pahang,0,0,0
2022-02-01,LKA,Perak,0,0,0
2022-02-01,LKA,Perlis,0,0,0
2022-02-01,LKA,Pulau Pinang,1,1,0
2022-02-01,LKA,Sabah,0,0,0
2022-02-01,LKA,Sarawak,0,0,0
2022-02-01,LKA,Selangor,369,206,163
2022-02-01,LKA,W.P. Labuan,0,0,0
2022-02-01,LSO,Johor,0,0,0
2022-02-01,LSO,Kedah,0,0,0
2022-02-01,LSO,Pulau Pinang,0,0,0
2022-02-01,LSO,Sarawak,0,0,0
2022-02-01,LSO,Selangor,7,3,4
2022-02-01,LTU,Johor,0,0,0
2022-02-01,LTU,Kedah,1,0,1
2022-02-01,LTU,Kelantan,0,0,0
2022-02-01,LTU,Pahang,0,0,0
2022-02-01,LTU,Perak,0,0,0
2022-02-01,LTU,Perlis,0,0,0
2022-02-01,LTU,Pulau Pinang,0,0,0
2022-02-01,LTU,Sabah,0,0,0
2022-02-01,LTU,Sarawak,0,0,0
2022-02-01,LTU,Selangor,12,12,0
2022-02-01,LTU,W.P. Labuan,0,0,0
2022-02-01,LUX,Johor,0,0,0
2022-02-01,LUX,Kedah,0,0,0
2022-02-01,LUX,Kelantan,0,0,0
2022-02-01,LUX,Perak,0,0,0
2022-02-01,LUX,Perlis,0,0,0
2022-02-01,LUX,Pulau Pinang,0,0,0
2022-02-01,LUX,Sabah,0,0,0
2022-02-01,LUX,Sarawak,0,0,0
2022-02-01,LUX,Selangor,3,2,1
2022-02-01,LVA,Johor,0,0,0
2022-02-01,LVA,Kedah,0,0,0
2022-02-01,LVA,Kelantan,0,0,0
2022-02-01,LVA,Pahang,0,0,0
2022-02-01,LVA,Perak,0,0,0
2022-02-01,LVA,Perlis,0,0,0
2022-02-01,LVA,Pulau Pinang,0,0,0
2022-02-01,LVA,Sabah,0,0,0
2022-02-01,LVA,Sarawak,0,0,0
2022-02-01,LVA,Selangor,6,5,1
2022-02-01,LVA,W.P. Labuan,0,0,0
2022-02-01,MAC,Johor,0,0,0
2022-02-01,MAC,Pahang,0,0,0
2022-02-01,MAC,Perak,0,0,0
2022-02-01,MAC,Selangor,0,0,0
2022-02-01,MAC,W.P. Labuan,0,0,0
2022-02-01,MAR,Johor,0,0,0
2022-02-01,MAR,Kedah,0,0,0
2022-02-01,MAR,Kelantan,0,0,0
2022-02-01,MAR,Melaka,0,0,0
2022-02-01,MAR,Pahang,0,0,0
2022-02-01,MAR,Perak,0,0,0
2022-02-01,MAR,Perlis,0,0,0
2022-02-01,MAR,Pulau Pinang,0,0,0
2022-02-01,MAR,Sabah,0,0,0
2022-02-01,MAR,Sarawak,0,0,0
2022-02-01,MAR,Selangor,32,7,25
2022-02-01,MAR,W.P. Labuan,0,0,0
2022-02-01,MCO,Johor,0,0,0
2022-02-01,MCO,Kedah,0,0,0
2022-02-01,MCO,Sabah,0,0,0
2022-02-01,MCO,Selangor,2,1,1
2022-02-01,MDA,Johor,0,0,0
2022-02-01,MDA,Kedah,0,0,0
2022-02-01,MDA,Kelantan,0,0,0
2022-02-01,MDA,Negeri Sembilan,0,0,0
2022-02-01,MDA,Perlis,0,0,0
2022-02-01,MDA,Pulau Pinang,0,0,0
2022-02-01,MDA,Sabah,0,0,0
2022-02-01,MDA,Sarawak,0,0,0
2022-02-01,MDA,Selangor,1,0,1
2022-02-01,MDG,Johor,0,0,0
2022-02-01,MDG,Kedah,0,0,0
2022-02-01,MDG,Perak,0,0,0
2022-02-01,MDG,Perlis,0,0,0
2022-02-01,MDG,Pulau Pinang,0,0,0
2022-02-01,MDG,Sabah,0,0,0
2022-02-01,MDG,Sarawak,0,0,0
2022-02-01,MDG,Selangor,0,0,0
2022-02-01,MDV,Johor,0,0,0
2022-02-01,MDV,Kedah,41,17,24
2022-02-01,MDV,Kelantan,0,0,0
2022-02-01,MDV,Perak,0,0,0
2022-02-01,MDV,Perlis,0,0,0
2022-02-01,MDV,Pulau Pinang,0,0,0
2022-02-01,MDV,Sabah,0,0,0
2022-02-01,MDV,Sarawak,0,0,0
2022-02-01,MDV,Selangor,212,97,115
2022-02-01,MEX,Johor,0,0,0
2022-02-01,MEX,Kedah,0,0,0
2022-02-01,MEX,Kelantan,0,0,0
2022-02-01,MEX,Pahang,0,0,0
2022-02-01,MEX,Perak,0,0,0
2022-02-01,MEX,Perlis,0,0,0
2022-02-01,MEX,Pulau Pinang,0,0,0
2022-02-01,MEX,Sabah,0,0,0
2022-02-01,MEX,Sarawak,0,0,0
2022-02-01,MEX,Selangor,32,19,13
2022-02-01,MEX,W.P. Labuan,0,0,0
2022-02-01,MHL,Johor,0,0,0
2022-02-01,MHL,Kedah,0,0,0
2022-02-01,MHL,Perak,0,0,0
2022-02-01,MHL,Pulau Pinang,0,0,0
2022-02-01,MHL,Sabah,0,0,0
2022-02-01,MHL,Selangor,0,0,0
2022-02-01,MKD,Johor,0,0,0
2022-02-01,MKD,Kedah,0,0,0
2022-02-01,MKD,Perak,0,0,0
2022-02-01,MKD,Pulau Pinang,0,0,0
2022-02-01,MKD,Sabah,0,0,0
2022-02-01,MKD,Sarawak,0,0,0
2022-02-01,MKD,Selangor,1,1,0
2022-02-01,MLI,Johor,0,0,0
2022-02-01,MLI,Sabah,0,0,0
2022-02-01,MLI,Selangor,3,2,1
2022-02-01,MLT,Johor,0,0,0
2022-02-01,MLT,Kedah,0,0,0
2022-02-01,MLT,Kelantan,0,0,0
2022-02-01,MLT,Perak,0,0,0
2022-02-01,MLT,Perlis,0,0,0
2022-02-01,MLT,Pulau Pinang,0,0,0
2022-02-01,MLT,Sabah,0,0,0
2022-02-01,MLT,Sarawak,0,0,0
2022-02-01,MLT,Selangor,2,2,0
2022-02-01,MLT,W.P. Labuan,0,0,0
2022-02-01,MMR,Johor,26,26,0
2022-02-01,MMR,Kedah,0,0,0
2022-02-01,MMR,Kelantan,0,0,0
2022-02-01,MMR,Negeri Sembilan,0,0,0
2022-02-01,MMR,Pahang,0,0,0
2022-02-01,MMR,Perak,0,0,0
2022-02-01,MMR,Perlis,0,0,0
2022-02-01,MMR,Pulau Pinang,1,0,1
2022-02-01,MMR,Sabah,0,0,0
2022-02-01,MMR,Sarawak,2,0,2
2022-02-01,MMR,Selangor,272,209,63
2022-02-01,MMR,Terengganu,0,0,0
2022-02-01,MMR,W.P. Labuan,0,0,0
2022-02-01,MNE,Johor,0,0,0
2022-02-01,MNE,Kedah,0,0,0
2022-02-01,MNE,Pulau Pinang,0,0,0
2022-02-01,MNE,Sabah,0,0,0
2022-02-01,MNE,Sarawak,0,0,0
2022-02-01,MNE,Selangor,9,9,0
2022-02-01,MNG,Johor,0,0,0
2022-02-01,MNG,Kedah,1,0,1
2022-02-01,MNG,Kelantan,0,0,0
2022-02-01,MNG,Perak,0,0,0
2022-02-01,MNG,Perlis,0,0,0
2022-02-01,MNG,Pulau Pinang,0,0,0
2022-02-01,MNG,Sabah,0,0,0
2022-02-01,MNG,Sarawak,0,0,0
2022-02-01,MNG,Selangor,12,7,5
2022-02-01,MNP,Selangor,0,0,0
2022-02-01,MOZ,Johor,0,0,0
2022-02-01,MOZ,Kedah,0,0,0
2022-02-01,MOZ,Perak,0,0,0
2022-02-01,MOZ,Pulau Pinang,0,0,0
2022-02-01,MOZ,Sabah,0,0,0
2022-02-01,MOZ,Sarawak,0,0,0
2022-02-01,MOZ,Selangor,6,2,4
2022-02-01,MRT,Johor,0,0,0
2022-02-01,MRT,Kedah,0,0,0
2022-02-01,MRT,Pulau Pinang,0,0,0
2022-02-01,MRT,Sabah,0,0,0
2022-02-01,MRT,Sarawak,0,0,0
2022-02-01,MRT,Selangor,7,5,2
2022-02-01,MUS,Johor,0,0,0
2022-02-01,MUS,Kedah,0,0,0
2022-02-01,MUS,Kelantan,0,0,0
2022-02-01,MUS,Pahang,0,0,0
2022-02-01,MUS,Perak,0,0,0
2022-02-01,MUS,Perlis,0,0,0
2022-02-01,MUS,Pulau Pinang,0,0,0
2022-02-01,MUS,Sabah,0,0,0
2022-02-01,MUS,Sarawak,0,0,0
2022-02-01,MUS,Selangor,44,20,24
2022-02-01,MWI,Johor,0,0,0
2022-02-01,MWI,Pulau Pinang,0,0,0
2022-02-01,MWI,Sabah,0,0,0
2022-02-01,MWI,Sarawak,0,0,0
2022-02-01,MWI,Selangor,3,2,1
2022-02-01,MYT,Selangor,0,0,0
2022-02-01,NAM,Johor,0,0,0
2022-02-01,NAM,Kedah,0,0,0
2022-02-01,NAM,Perak,0,0,0
2022-02-01,NAM,Perlis,0,0,0
2022-02-01,NAM,Pulau Pinang,0,0,0
2022-02-01,NAM,Sabah,0,0,0
2022-02-01,NAM,Sarawak,0,0,0
2022-02-01,NAM,Selangor,2,1,1
2022-02-01,NCL,Selangor,0,0,0
2022-02-01,NER,Johor,0,0,0
2022-02-01,NER,Sabah,0,0,0
2022-02-01,NER,Selangor,1,0,1
2022-02-01,NGA,Johor,0,0,0
2022-02-01,NGA,Kedah,0,0,0
2022-02-01,NGA,Perlis,0,0,0
2022-02-01,NGA,Pulau Pinang,0,0,0
2022-02-01,NGA,Sabah,0,0,0
2022-02-01,NGA,Sarawak,0,0,0
2022-02-01,NGA,Selangor,244,209,35
2022-02-01,NIC,Johor,0,0,0
2022-02-01,NIC,Kedah,0,0,0
2022-02-01,NIC,Pulau Pinang,0,0,0
2022-02-01,NIC,Sabah,0,0,0
2022-02-01,NIC,Selangor,0,0,0
2022-02-01,NLD,Johor,2,2,0
2022-02-01,NLD,Kedah,19,11,8
2022-02-01,NLD,Kelantan,0,0,0
2022-02-01,NLD,Melaka,0,0,0
2022-02-01,NLD,Negeri Sembilan,0,0,0
2022-02-01,NLD,Pahang,0,0,0
2022-02-01,NLD,Perak,0,0,0
2022-02-01,NLD,Perlis,0,0,0
2022-02-01,NLD,Pulau Pinang,3,1,2
2022-02-01,NLD,Sabah,0,0,0
2022-02-01,NLD,Sarawak,0,0,0
2022-02-01,NLD,Selangor,185,148,37
2022-02-01,NLD,Terengganu,0,0,0
2022-02-01,NLD,W.P. Labuan,0,0,0
2022-02-01,NOR,Johor,0,0,0
2022-02-01,NOR,Kedah,0,0,0
2022-02-01,NOR,Kelantan,0,0,0
2022-02-01,NOR,Melaka,0,0,0
2022-02-01,NOR,Pahang,0,0,0
2022-02-01,NOR,Perak,0,0,0
2022-02-01,NOR,Perlis,0,0,0
2022-02-01,NOR,Pulau Pinang,0,0,0
2022-02-01,NOR,Sabah,0,0,0
2022-02-01,NOR,Sarawak,0,0,0
2022-02-01,NOR,Selangor,28,23,5
2022-02-01,NOR,W.P. Labuan,0,0,0
2022-02-01,NPL,Johor,0,0,0
2022-02-01,NPL,Kedah,0,0,0
2022-02-01,NPL,Pahang,0,0,0
2022-02-01,NPL,Perak,0,0,0
2022-02-01,NPL,Perlis,0,0,0
2022-02-01,NPL,Pulau Pinang,21,20,1
2022-02-01,NPL,Sabah,0,0,0
2022-02-01,NPL,Sarawak,1,1,0
2022-02-01,NPL,Selangor,576,552,24
2022-02-01,NPL,W.P. Labuan,0,0,0
2022-02-01,NRU,Johor,0,0,0
2022-02-01,NRU,Pulau Pinang,0,0,0
2022-02-01,NRU,Selangor,0,0,0
2022-02-01,NZL,Johor,0,0,0
2022-02-01,NZL,Kedah,12,10,2
2022-02-01,NZL,Kelantan,0,0,0
2022-02-01,NZL,Melaka,0,0,0
2022-02-01,NZL,Negeri Sembilan,0,0,0
2022-02-01,NZL,Pahang,0,0,0
2022-02-01,NZL,Perak,0,0,0
2022-02-01,NZL,Perlis,0,0,0
2022-02-01,NZL,Pulau Pinang,2,1,1
2022-02-01,NZL,Sabah,0,0,0
2022-02-01,NZL,Sarawak,2,2,0
2022-02-01,NZL,Selangor,63,39,24
2022-02-01,NZL,Terengganu,0,0,0
2022-02-01,NZL,W.P. Labuan,0,0,0
2022-02-01,OMN,Johor,0,0,0
2022-02-01,OMN,Kedah,0,0,0
2022-02-01,OMN,Kelantan,0,0,0
2022-02-01,OMN,Melaka,0,0,0
2022-02-01,OMN,Perak,0,0,0
2022-02-01,OMN,Perlis,0,0,0
2022-02-01,OMN,Pulau Pinang,0,0,0
2022-02-01,OMN,Sabah,0,0,0
2022-02-01,OMN,Sarawak,0,0,0
2022-02-01,OMN,Selangor,62,45,17
2022-02-01,PAK,Johor,0,0,0
2022-02-01,PAK,Kedah,0,0,0
2022-02-01,PAK,Kelantan,0,0,0
2022-02-01,PAK,Melaka,0,0,0
2022-02-01,PAK,Negeri Sembilan,0,0,0
2022-02-01,PAK,Pahang,0,0,0
2022-02-01,PAK,Perak,0,0,0
2022-02-01,PAK,Perlis,0,0,0
2022-02-01,PAK,Pulau Pinang,0,0,0
2022-02-01,PAK,Sabah,1,1,0
2022-02-01,PAK,Sarawak,3,3,0
2022-02-01,PAK,Selangor,3094,2779,315
2022-02-01,PAK,W.P. Labuan,0,0,0
2022-02-01,PAN,Johor,0,0,0
2022-02-01,PAN,Kedah,0,0,0
2022-02-01,PAN,Perak,0,0,0
2022-02-01,PAN,Perlis,0,0,0
2022-02-01,PAN,Pulau Pinang,0,0,0
2022-02-01,PAN,Sabah,0,0,0
2022-02-01,PAN,Sarawak,0,0,0
2022-02-01,PAN,Selangor,0,0,0
2022-02-01,PER,Johor,0,0,0
2022-02-01,PER,Kedah,1,1,0
2022-02-01,PER,Kelantan,0,0,0
2022-02-01,PER,Pahang,0,0,0
2022-02-01,PER,Perak,0,0,0
2022-02-01,PER,Perlis,0,0,0
2022-02-01,PER,Pulau Pinang,0,0,0
2022-02-01,PER,Sabah,0,0,0
2022-02-01,PER,Sarawak,0,0,0
2022-02-01,PER,Selangor,2,0,2
2022-02-01,PER,W.P. Labuan,0,0,0
2022-02-01,PHL,Johor,91,87,4
2022-02-01,PHL,Kedah,1,0,1
2022-02-01,PHL,Kelantan,1,1,0
2022-02-01,PHL,Melaka,0,0,0
2022-02-01,PHL,Negeri Sembilan,0,0,0
2022-02-01,PHL,Pahang,0,0,0
2022-02-01,PHL,Perak,0,0,0
2022-02-01,PHL,Perlis,0,0,0
2022-02-01,PHL,Pulau Pinang,6,5,1
2022-02-01,PHL,Sabah,5,2,3
2022-02-01,PHL,Sarawak,20,19,1
2022-02-01,PHL,Selangor,1456,852,604
2022-02-01,PHL,Terengganu,0,0,0
2022-02-01,PHL,W.P. Labuan,14,14,0
2022-02-01,PLW,Johor,0,0,0
2022-02-01,PLW,Pulau Pinang,0,0,0
2022-02-01,PLW,Selangor,0,0,0
2022-02-01,PNG,Johor,0,0,0
2022-02-01,PNG,Kedah,0,0,0
2022-02-01,PNG,Kelantan,0,0,0
2022-02-01,PNG,Perak,0,0,0
2022-02-01,PNG,Pulau Pinang,0,0,0
2022-02-01,PNG,Sabah,0,0,0
2022-02-01,PNG,Sarawak,0,0,0
2022-02-01,PNG,Selangor,2,1,1
2022-02-01,POL,Johor,0,0,0
2022-02-01,POL,Kedah,0,0,0
2022-02-01,POL,Kelantan,0,0,0
2022-02-01,POL,Melaka,0,0,0
2022-02-01,POL,Negeri Sembilan,0,0,0
2022-02-01,POL,Pahang,0,0,0
2022-02-01,POL,Perak,0,0,0
2022-02-01,POL,Perlis,0,0,0
2022-02-01,POL,Pulau Pinang,0,0,0
2022-02-01,POL,Sabah,0,0,0
2022-02-01,POL,Sarawak,0,0,0
2022-02-01,POL,Selangor,62,53,9
2022-02-01,POL,Terengganu,0,0,0
2022-02-01,POL,W.P. Labuan,0,0,0
2022-02-01,PRK,Selangor,0,0,0
2022-02-01,PRT,Johor,0,0,0
2022-02-01,PRT,Kedah,0,0,0
2022-02-01,PRT,Kelantan,0,0,0
2022-02-01,PRT,Melaka,0,0,0
2022-02-01,PRT,Pahang,0,0,0
2022-02-01,PRT,Perak,0,0,0
2022-02-01,PRT,Perlis,0,0,0
2022-02-01,PRT,Pulau Pinang,0,0,0
2022-02-01,PRT,Sabah,0,0,0
2022-02-01,PRT,Sarawak,0,0,0
2022-02-01,PRT,Selangor,35,25,10
2022-02-01,PRT,W.P. Labuan,0,0,0
2022-02-01,PRY,Johor,0,0,0
2022-02-01,PRY,Kedah,0,0,0
2022-02-01,PRY,Perak,0,0,0
2022-02-01,PRY,Perlis,0,0,0
2022-02-01,PRY,Pulau Pinang,0,0,0
2022-02-01,PRY,Sabah,0,0,0
2022-02-01,PRY,Sarawak,0,0,0
2022-02-01,PRY,Selangor,0,0,0
2022-02-01,PSE,Johor,0,0,0
2022-02-01,PSE,Kedah,0,0,0
2022-02-01,PSE,Kelantan,0,0,0
2022-02-01,PSE,Melaka,0,0,0
2022-02-01,PSE,Perak,0,0,0
2022-02-01,PSE,Perlis,0,0,0
2022-02-01,PSE,Pulau Pinang,0,0,0
2022-02-01,PSE,Sabah,0,0,0
2022-02-01,PSE,Sarawak,0,0,0
2022-02-01,PSE,Selangor,53,43,10
2022-02-01,QAT,Johor,0,0,0
2022-02-01,QAT,Kedah,0,0,0
2022-02-01,QAT,Perlis,0,0,0
2022-02-01,QAT,Pulau Pinang,0,0,0
2022-02-01,QAT,Sabah,0,0,0
2022-02-01,QAT,Sarawak,0,0,0
2022-02-01,QAT,Selangor,7,1,6
2022-02-01,REU,Johor,0,0,0
2022-02-01,REU,Sarawak,0,0,0
2022-02-01,ROU,Johor,6,6,0
2022-02-01,ROU,Kedah,4,0,4
2022-02-01,ROU,Kelantan,1,0,1
2022-02-01,ROU,Negeri Sembilan,0,0,0
2022-02-01,ROU,Pahang,0,0,0
2022-02-01,ROU,Perak,0,0,0
2022-02-01,ROU,Perlis,0,0,0
2022-02-01,ROU,Pulau Pinang,0,0,0
2022-02-01,ROU,Sabah,0,0,0
2022-02-01,ROU,Sarawak,0,0,0
2022-02-01,ROU,Selangor,31,26,5
2022-02-01,ROU,W.P. Labuan,0,0,0
2022-02-01,RUS,Johor,7,6,1
2022-02-01,RUS,Kedah,0,0,0
2022-02-01,RUS,Kelantan,0,0,0
2022-02-01,RUS,Melaka,0,0,0
2022-02-01,RUS,Negeri Sembilan,0,0,0
2022-02-01,RUS,Pahang,0,0,0
2022-02-01,RUS,Perak,0,0,0
2022-02-01,RUS,Perlis,0,0,0
2022-02-01,RUS,Pulau Pinang,0,0,0
2022-02-01,RUS,Sabah,1,0,1
2022-02-01,RUS,Sarawak,0,0,0
2022-02-01,RUS,Selangor,104,68,36
2022-02-01,RUS,W.P. Labuan,0,0,0
2022-02-01,RWA,Johor,0,0,0
2022-02-01,RWA,Kedah,0,0,0
2022-02-01,RWA,Pulau Pinang,0,0,0
2022-02-01,RWA,Selangor,0,0,0
2022-02-01,SAU,Johor,0,0,0
2022-02-01,SAU,Kedah,0,0,0
2022-02-01,SAU,Kelantan,0,0,0
2022-02-01,SAU,Melaka,0,0,0
2022-02-01,SAU,Perak,0,0,0
2022-02-01,SAU,Perlis,0,0,0
2022-02-01,SAU,Pulau Pinang,0,0,0
2022-02-01,SAU,Sabah,0,0,0
2022-02-01,SAU,Sarawak,0,0,0
2022-02-01,SAU,Selangor,142,89,53
2022-02-01,SAU,W.P. Labuan,0,0,0
2022-02-01,SDN,Johor,0,0,0
2022-02-01,SDN,Kedah,0,0,0
2022-02-01,SDN,Kelantan,0,0,0
2022-02-01,SDN,Perlis,0,0,0
2022-02-01,SDN,Pulau Pinang,0,0,0
2022-02-01,SDN,Sabah,0,0,0
2022-02-01,SDN,Sarawak,0,0,0
2022-02-01,SDN,Selangor,184,134,50
2022-02-01,SDN,W.P. Labuan,0,0,0
2022-02-01,SEN,Johor,0,0,0
2022-02-01,SEN,Kedah,0,0,0
2022-02-01,SEN,Kelantan,0,0,0
2022-02-01,SEN,Perak,0,0,0
2022-02-01,SEN,Perlis,0,0,0
2022-02-01,SEN,Pulau Pinang,0,0,0
2022-02-01,SEN,Sabah,0,0,0
2022-02-01,SEN,Sarawak,0,0,0
2022-02-01,SEN,Selangor,3,3,0
2022-02-01,SGP,Johor,2230,1240,990
2022-02-01,SGP,Kedah,16,8,8
2022-02-01,SGP,Kelantan,0,0,0
2022-02-01,SGP,Melaka,0,0,0
2022-02-01,SGP,Negeri Sembilan,0,0,0
2022-02-01,SGP,Pahang,0,0,0
2022-02-01,SGP,Perak,7,2,5
2022-02-01,SGP,Perlis,1,1,0
2022-02-01,SGP,Pulau Pinang,15,9,6
2022-02-01,SGP,Sabah,1,1,0
2022-02-01,SGP,Sarawak,28,18,10
2022-02-01,SGP,Selangor,4594,2801,1793
2022-02-01,SGP,Terengganu,0,0,0
2022-02-01,SGP,W.P. Labuan,0,0,0
2022-02-01,SGS,Johor,0,0,0
2022-02-01,SGS,Sabah,0,0,0
2022-02-01,SGS,Selangor,0,0,0
2022-02-01,SHN,Sarawak,0,0,0
2022-02-01,SLB,Johor,0,0,0
2022-02-01,SLB,Perlis,0,0,0
2022-02-01,SLB,Pulau Pinang,0,0,0
2022-02-01,SLB,Sabah,0,0,0
2022-02-01,SLB,Sarawak,0,0,0
2022-02-01,SLB,Selangor,0,0,0
2022-02-01,SLB,W.P. Labuan,0,0,0
2022-02-01,SLE,Johor,0,0,0
2022-02-01,SLE,Kedah,0,0,0
2022-02-01,SLE,Perak,0,0,0
2022-02-01,SLE,Pulau Pinang,0,0,0
2022-02-01,SLE,Sabah,0,0,0
2022-02-01,SLE,Selangor,5,3,2
2022-02-01,SLV,Johor,0,0,0
2022-02-01,SLV,Kedah,0,0,0
2022-02-01,SLV,Perak,0,0,0
2022-02-01,SLV,Perlis,0,0,0
2022-02-01,SLV,Pulau Pinang,0,0,0
2022-02-01,SLV,Sabah,0,0,0
2022-02-01,SLV,Selangor,1,0,1
2022-02-01,SLV,W.P. Labuan,0,0,0
2022-02-01,SMR,Johor,0,0,0
2022-02-01,SMR,Selangor,2,2,0
2022-02-01,SOM,Johor,0,0,0
2022-02-01,SOM,Kedah,0,0,0
2022-02-01,SOM,Kelantan,0,0,0
2022-02-01,SOM,Perlis,0,0,0
2022-02-01,SOM,Sabah,0,0,0
2022-02-01,SOM,Sarawak,0,0,0
2022-02-01,SOM,Selangor,54,31,23
2022-02-01,SRB,Johor,0,0,0
2022-02-01,SRB,Kedah,0,0,0
2022-02-01,SRB,Kelantan,0,0,0
2022-02-01,SRB,Pahang,0,0,0
2022-02-01,SRB,Perak,0,0,0
2022-02-01,SRB,Perlis,0,0,0
2022-02-01,SRB,Pulau Pinang,0,0,0
2022-02-01,SRB,Sabah,0,0,0
2022-02-01,SRB,Sarawak,0,0,0
2022-02-01,SRB,Selangor,5,3,2
2022-02-01,SSD,Johor,0,0,0
2022-02-01,SSD,Kedah,0,0,0
2022-02-01,SSD,Sarawak,0,0,0
2022-02-01,SSD,Selangor,2,1,1
2022-02-01,SSD,W.P. Labuan,0,0,0
2022-02-01,STP,Selangor,0,0,0
2022-02-01,SUR,Johor,0,0,0
2022-02-01,SUR,Kedah,0,0,0
2022-02-01,SUR,Kelantan,0,0,0
2022-02-01,SUR,Perak,0,0,0
2022-02-01,SUR,Perlis,0,0,0
2022-02-01,SUR,Pulau Pinang,0,0,0
2022-02-01,SUR,Sabah,0,0,0
2022-02-01,SUR,Sarawak,0,0,0
2022-02-01,SUR,Selangor,0,0,0
2022-02-01,SVK,Johor,0,0,0
2022-02-01,SVK,Kedah,0,0,0
2022-02-01,SVK,Kelantan,0,0,0
2022-02-01,SVK,Negeri Sembilan,0,0,0
2022-02-01,SVK,Pahang,0,0,0
2022-02-01,SVK,Perak,0,0,0
2022-02-01,SVK,Perlis,0,0,0
2022-02-01,SVK,Pulau Pinang,0,0,0
2022-02-01,SVK,Sabah,0,0,0
2022-02-01,SVK,Sarawak,0,0,0
2022-02-01,SVK,Selangor,13,10,3
2022-02-01,SVK,W.P. Labuan,0,0,0
2022-02-01,SVN,Johor,0,0,0
2022-02-01,SVN,Kedah,0,0,0
2022-02-01,SVN,Kelantan,0,0,0
2022-02-01,SVN,Perak,0,0,0
2022-02-01,SVN,Perlis,0,0,0
2022-02-01,SVN,Pulau Pinang,0,0,0
2022-02-01,SVN,Sabah,0,0,0
2022-02-01,SVN,Sarawak,0,0,0
2022-02-01,SVN,Selangor,8,5,3
2022-02-01,SVN,W.P. Labuan,0,0,0
2022-02-01,SWE,Johor,0,0,0
2022-02-01,SWE,Kedah,1,1,0
2022-02-01,SWE,Kelantan,0,0,0
2022-02-01,SWE,Melaka,0,0,0
2022-02-01,SWE,Negeri Sembilan,0,0,0
2022-02-01,SWE,Pahang,0,0,0
2022-02-01,SWE,Perak,0,0,0
2022-02-01,SWE,Perlis,0,0,0
2022-02-01,SWE,Pulau Pinang,0,0,0
2022-02-01,SWE,Sabah,0,0,0
2022-02-01,SWE,Sarawak,0,0,0
2022-02-01,SWE,Selangor,70,52,18
2022-02-01,SWE,W.P. Labuan,0,0,0
2022-02-01,SWZ,Johor,0,0,0
2022-02-01,SWZ,Kedah,0,0,0
2022-02-01,SWZ,Pulau Pinang,0,0,0
2022-02-01,SWZ,Sabah,0,0,0
2022-02-01,SWZ,Selangor,2,0,2
2022-02-01,SYC,Johor,0,0,0
2022-02-01,SYC,Kedah,0,0,0
2022-02-01,SYC,Pulau Pinang,0,0,0
2022-02-01,SYC,Sabah,0,0,0
2022-02-01,SYC,Sarawak,0,0,0
2022-02-01,SYC,Selangor,6,1,5
2022-02-01,SYR,Johor,0,0,0
2022-02-01,SYR,Kedah,0,0,0
2022-02-01,SYR,Kelantan,0,0,0
2022-02-01,SYR,Pahang,0,0,0
2022-02-01,SYR,Perlis,0,0,0
2022-02-01,SYR,Pulau Pinang,0,0,0
2022-02-01,SYR,Sabah,0,0,0
2022-02-01,SYR,Sarawak,1,1,0
2022-02-01,SYR,Selangor,146,105,41
2022-02-01,SYR,W.P. Labuan,0,0,0
2022-02-01,TCA,Perlis,0,0,0
2022-02-01,TCD,Johor,0,0,0
2022-02-01,TCD,Kedah,0,0,0
2022-02-01,TCD,Perlis,0,0,0
2022-02-01,TCD,Selangor,4,3,1
2022-02-01,TGO,Johor,0,0,0
2022-02-01,TGO,Perak,0,0,0
2022-02-01,TGO,Pulau Pinang,0,0,0
2022-02-01,TGO,Selangor,1,1,0
2022-02-01,THA,Johor,55,55,0
2022-02-01,THA,Kedah,16556,16500,56
2022-02-01,THA,Kelantan,5,0,5
2022-02-01,THA,Melaka,0,0,0
2022-02-01,THA,Negeri Sembilan,0,0,0
2022-02-01,THA,Pahang,0,0,0
2022-02-01,THA,Perak,0,0,0
2022-02-01,THA,Perlis,8532,8415,117
2022-02-01,THA,Pulau Pinang,187,182,5
2022-02-01,THA,Sabah,1,0,1
2022-02-01,THA,Sarawak,9,9,0
2022-02-01,THA,Selangor,931,520,411
2022-02-01,THA,Terengganu,0,0,0
2022-02-01,THA,W.P. Labuan,0,0,0
2022-02-01,TJK,Johor,0,0,0
2022-02-01,TJK,Kedah,0,0,0
2022-02-01,TJK,Perlis,0,0,0
2022-02-01,TJK,Pulau Pinang,0,0,0
2022-02-01,TJK,Sabah,0,0,0
2022-02-01,TJK,Selangor,4,2,2
2022-02-01,TKL,Selangor,0,0,0
2022-02-01,TKM,Johor,0,0,0
2022-02-01,TKM,Kedah,0,0,0
2022-02-01,TKM,Kelantan,0,0,0
2022-02-01,TKM,Perlis,0,0,0
2022-02-01,TKM,Pulau Pinang,0,0,0
2022-02-01,TKM,Sabah,0,0,0
2022-02-01,TKM,Sarawak,0,0,0
2022-02-01,TKM,Selangor,6,2,4
2022-02-01,TLS,Johor,0,0,0
2022-02-01,TLS,Kedah,0,0,0
2022-02-01,TLS,Perlis,0,0,0
2022-02-01,TLS,Pulau Pinang,0,0,0
2022-02-01,TLS,Sabah,0,0,0
2022-02-01,TLS,Sarawak,0,0,0
2022-02-01,TLS,Selangor,8,6,2
2022-02-01,TON,Johor,0,0,0
2022-02-01,TON,Pulau Pinang,0,0,0
2022-02-01,TON,Sarawak,0,0,0
2022-02-01,TON,Selangor,0,0,0
2022-02-01,TTO,Johor,0,0,0
2022-02-01,TTO,Kedah,0,0,0
2022-02-01,TTO,Pahang,0,0,0
2022-02-01,TTO,Pulau Pinang,0,0,0
2022-02-01,TTO,Sabah,0,0,0
2022-02-01,TTO,Sarawak,0,0,0
2022-02-01,TTO,Selangor,1,1,0
2022-02-01,TUN,Johor,0,0,0
2022-02-01,TUN,Kedah,0,0,0
2022-02-01,TUN,Kelantan,0,0,0
2022-02-01,TUN,Melaka,0,0,0
2022-02-01,TUN,Perak,0,0,0
2022-02-01,TUN,Perlis,0,0,0
2022-02-01,TUN,Pulau Pinang,0,0,0
2022-02-01,TUN,Sabah,0,0,0
2022-02-01,TUN,Sarawak,0,0,0
2022-02-01,TUN,Selangor,19,13,6
2022-02-01,TUN,W.P. Labuan,0,0,0
2022-02-01,TUR,Johor,12,12,0
2022-02-01,TUR,Kedah,0,0,0
2022-02-01,TUR,Kelantan,0,0,0
2022-02-01,TUR,Melaka,0,0,0
2022-02-01,TUR,Negeri Sembilan,0,0,0
2022-02-01,TUR,Pahang,0,0,0
2022-02-01,TUR,Perak,0,0,0
2022-02-01,TUR,Perlis,0,0,0
2022-02-01,TUR,Pulau Pinang,0,0,0
2022-02-01,TUR,Sabah,1,1,0
2022-02-01,TUR,Sarawak,0,0,0
2022-02-01,TUR,Selangor,74,62,12
2022-02-01,TUR,W.P. Labuan,0,0,0
2022-02-01,TUV,Selangor,0,0,0
2022-02-01,TWN,Johor,4,1,3
2022-02-01,TWN,Kedah,4,3,1
2022-02-01,TWN,Kelantan,0,0,0
2022-02-01,TWN,Melaka,0,0,0
2022-02-01,TWN,Negeri Sembilan,0,0,0
2022-02-01,TWN,Pahang,0,0,0
2022-02-01,TWN,Perak,0,0,0
2022-02-01,TWN,Perlis,0,0,0
2022-02-01,TWN,Pulau Pinang,50,41,9
2022-02-01,TWN,Sabah,0,0,0
2022-02-01,TWN,Sarawak,4,4,0
2022-02-01,TWN,Selangor,279,169,110
2022-02-01,TWN,W.P. Labuan,0,0,0
2022-02-01,TZA,Johor,0,0,0
2022-02-01,TZA,Kedah,0,0,0
2022-02-01,TZA,Perak,0,0,0
2022-02-01,TZA,Perlis,0,0,0
2022-02-01,TZA,Pulau Pinang,0,0,0
2022-02-01,TZA,Sabah,0,0,0
2022-02-01,TZA,Sarawak,0,0,0
2022-02-01,TZA,Selangor,22,13,9
2022-02-01,UGA,Johor,0,0,0
2022-02-01,UGA,Kedah,0,0,0
2022-02-01,UGA,Perak,0,0,0
2022-02-01,UGA,Perlis,0,0,0
2022-02-01,UGA,Pulau Pinang,0,0,0
2022-02-01,UGA,Sabah,0,0,0
2022-02-01,UGA,Sarawak,0,0,0
2022-02-01,UGA,Selangor,12,7,5
2022-02-01,UKR,Johor,8,8,0
2022-02-01,UKR,Kedah,0,0,0
2022-02-01,UKR,Kelantan,0,0,0
2022-02-01,UKR,Melaka,0,0,0
2022-02-01,UKR,Negeri Sembilan,0,0,0
2022-02-01,UKR,Pahang,0,0,0
2022-02-01,UKR,Perak,0,0,0
2022-02-01,UKR,Perlis,0,0,0
2022-02-01,UKR,Pulau Pinang,0,0,0
2022-02-01,UKR,Sabah,0,0,0
2022-02-01,UKR,Sarawak,0,0,0
2022-02-01,UKR,Selangor,69,61,8
2022-02-01,UKR,W.P. Labuan,0,0,0
2022-02-01,URY,Johor,0,0,0
2022-02-01,URY,Kedah,0,0,0
2022-02-01,URY,Kelantan,0,0,0
2022-02-01,URY,Perak,0,0,0
2022-02-01,URY,Perlis,0,0,0
2022-02-01,URY,Pulau Pinang,0,0,0
2022-02-01,URY,Sabah,0,0,0
2022-02-01,URY,Sarawak,0,0,0
2022-02-01,URY,Selangor,1,0,1
2022-02-01,URY,W.P. Labuan,0,0,0
2022-02-01,USA,Johor,1,1,0
2022-02-01,USA,Kedah,26,16,10
2022-02-01,USA,Kelantan,0,0,0
2022-02-01,USA,Melaka,0,0,0
2022-02-01,USA,Negeri Sembilan,0,0,0
2022-02-01,USA,Pahang,0,0,0
2022-02-01,USA,Perak,2,1,1
2022-02-01,USA,Perlis,0,0,0
2022-02-01,USA,Pulau Pinang,16,12,4
2022-02-01,USA,Sabah,0,0,0
2022-02-01,USA,Sarawak,5,4,1
2022-02-01,USA,Selangor,642,424,218
2022-02-01,USA,Terengganu,0,0,0
2022-02-01,USA,W.P. Labuan,0,0,0
2022-02-01,UZB,Johor,0,0,0
2022-02-01,UZB,Kedah,0,0,0
2022-02-01,UZB,Kelantan,0,0,0
2022-02-01,UZB,Perak,0,0,0
2022-02-01,UZB,Perlis,0,0,0
2022-02-01,UZB,Pulau Pinang,0,0,0
2022-02-01,UZB,Sabah,0,0,0
2022-02-01,UZB,Sarawak,0,0,0
2022-02-01,UZB,Selangor,39,26,13
2022-02-01,VAT,Johor,0,0,0
2022-02-01,VAT,Sarawak,0,0,0
2022-02-01,VAT,Selangor,1,1,0
2022-02-01,VCT,Johor,0,0,0
2022-02-01,VCT,Kedah,0,0,0
2022-02-01,VCT,Pulau Pinang,0,0,0
2022-02-01,VCT,Sarawak,0,0,0
2022-02-01,VCT,Selangor,0,0,0
2022-02-01,VEN,Johor,0,0,0
2022-02-01,VEN,Kedah,0,0,0
2022-02-01,VEN,Kelantan,0,0,0
2022-02-01,VEN,Melaka,0,0,0
2022-02-01,VEN,Perak,0,0,0
2022-02-01,VEN,Perlis,0,0,0
2022-02-01,VEN,Pulau Pinang,0,0,0
2022-02-01,VEN,Sabah,0,0,0
2022-02-01,VEN,Sarawak,0,0,0
2022-02-01,VEN,Selangor,6,4,2
2022-02-01,VEN,W.P. Labuan,0,0,0
2022-02-01,VNM,Johor,3,0,3
2022-02-01,VNM,Kedah,29,12,17
2022-02-01,VNM,Kelantan,0,0,0
2022-02-01,VNM,Melaka,0,0,0
2022-02-01,VNM,Negeri Sembilan,0,0,0
2022-02-01,VNM,Pahang,0,0,0
2022-02-01,VNM,Perak,0,0,0
2022-02-01,VNM,Perlis,0,0,0
2022-02-01,VNM,Pulau Pinang,2,2,0
2022-02-01,VNM,Sabah,0,0,0
2022-02-01,VNM,Sarawak,2,0,2
2022-02-01,VNM,Selangor,495,136,359
2022-02-01,VNM,Terengganu,0,0,0
2022-02-01,VNM,W.P. Labuan,0,0,0
2022-02-01,VUT,Johor,0,0,0
2022-02-01,VUT,Kedah,0,0,0
2022-02-01,VUT,Pulau Pinang,0,0,0
2022-02-01,VUT,Sabah,0,0,0
2022-02-01,VUT,Sarawak,0,0,0
2022-02-01,VUT,Selangor,4,4,0
2022-02-01,WSM,Johor,0,0,0
2022-02-01,WSM,Sarawak,0,0,0
2022-02-01,WSM,Selangor,0,0,0
2022-02-01,XXX,Johor,0,0,0
2022-02-01,XXX,Kedah,0,0,0
2022-02-01,XXX,Kelantan,0,0,0
2022-02-01,XXX,Melaka,0,0,0
2022-02-01,XXX,Pahang,0,0,0
2022-02-01,XXX,Perak,0,0,0
2022-02-01,XXX,Perlis,0,0,0
2022-02-01,XXX,Pulau Pinang,0,0,0
2022-02-01,XXX,Sabah,0,0,0
2022-02-01,XXX,Sarawak,0,0,0
2022-02-01,XXX,Selangor,29,19,10
2022-02-01,XXX,W.P. Labuan,0,0,0
2022-02-01,YEM,Johor,0,0,0
2022-02-01,YEM,Kedah,1,1,0
2022-02-01,YEM,Kelantan,0,0,0
2022-02-01,YEM,Melaka,0,0,0
2022-02-01,YEM,Pahang,0,0,0
2022-02-01,YEM,Perak,0,0,0
2022-02-01,YEM,Perlis,0,0,0
2022-02-01,YEM,Pulau Pinang,0,0,0
2022-02-01,YEM,Sabah,0,0,0
2022-02-01,YEM,Sarawak,1,1,0
2022-02-01,YEM,Selangor,374,258,116
2022-02-01,YEM,W.P. Labuan,0,0,0
2022-02-01,ZAF,Johor,0,0,0
2022-02-01,ZAF,Kedah,2,1,1
2022-02-01,ZAF,Kelantan,0,0,0
2022-02-01,ZAF,Melaka,0,0,0
2022-02-01,ZAF,Pahang,0,0,0
2022-02-01,ZAF,Perak,0,0,0
2022-02-01,ZAF,Perlis,0,0,0
2022-02-01,ZAF,Pulau Pinang,0,0,0
2022-02-01,ZAF,Sabah,0,0,0
2022-02-01,ZAF,Sarawak,0,0,0
2022-02-01,ZAF,Selangor,69,41,28
2022-02-01,ZAF,Terengganu,0,0,0
2022-02-01,ZAF,W.P. Labuan,0,0,0
2022-02-01,ZAR,Selangor,0,0,0
2022-02-01,ZMB,Johor,0,0,0
2022-02-01,ZMB,Kedah,0,0,0
2022-02-01,ZMB,Perak,0,0,0
2022-02-01,ZMB,Perlis,0,0,0
2022-02-01,ZMB,Pulau Pinang,0,0,0
2022-02-01,ZMB,Sabah,0,0,0
2022-02-01,ZMB,Sarawak,1,0,1
2022-02-01,ZMB,Selangor,23,11,12
2022-02-01,ZWE,Johor,0,0,0
2022-02-01,ZWE,Kedah,0,0,0
2022-02-01,ZWE,Kelantan,0,0,0
2022-02-01,ZWE,Perak,0,0,0
2022-02-01,ZWE,Perlis,0,0,0
2022-02-01,ZWE,Pulau Pinang,0,0,0
2022-02-01,ZWE,Sabah,0,0,0
2022-02-01,ZWE,Sarawak,0,0,0
2022-02-01,ZWE,Selangor,44,19,25
2022-03-01,ABW,Kedah,0,0,0
2022-03-01,ABW,Pulau Pinang,0,0,0
2022-03-01,AFG,Johor,0,0,0
2022-03-01,AFG,Kedah,0,0,0
2022-03-01,AFG,Perlis,0,0,0
2022-03-01,AFG,Pulau Pinang,0,0,0
2022-03-01,AFG,Sarawak,0,0,0
2022-03-01,AFG,Selangor,94,64,30
2022-03-01,AGO,Johor,0,0,0
2022-03-01,AGO,Kedah,0,0,0
2022-03-01,AGO,Sabah,0,0,0
2022-03-01,AGO,Selangor,0,0,0
2022-03-01,AIA,Selangor,0,0,0
2022-03-01,ALB,Johor,0,0,0
2022-03-01,ALB,Kedah,0,0,0
2022-03-01,ALB,Perak,0,0,0
2022-03-01,ALB,Perlis,0,0,0
2022-03-01,ALB,Pulau Pinang,0,0,0
2022-03-01,ALB,Sabah,0,0,0
2022-03-01,ALB,Sarawak,0,0,0
2022-03-01,ALB,Selangor,3,2,1
2022-03-01,AND,Johor,0,0,0
2022-03-01,AND,Kedah,0,0,0
2022-03-01,AND,Perlis,0,0,0
2022-03-01,AND,Pulau Pinang,0,0,0
2022-03-01,AND,Selangor,0,0,0
2022-03-01,ANT,Selangor,0,0,0
2022-03-01,ARE,Johor,0,0,0
2022-03-01,ARE,Kedah,0,0,0
2022-03-01,ARE,Kelantan,0,0,0
2022-03-01,ARE,Perak,0,0,0
2022-03-01,ARE,Perlis,0,0,0
2022-03-01,ARE,Pulau Pinang,0,0,0
2022-03-01,ARE,Sabah,0,0,0
2022-03-01,ARE,Sarawak,0,0,0
2022-03-01,ARE,Selangor,34,19,15
2022-03-01,ARG,Johor,0,0,0
2022-03-01,ARG,Kedah,0,0,0
2022-03-01,ARG,Kelantan,0,0,0
2022-03-01,ARG,Melaka,0,0,0
2022-03-01,ARG,Perak,0,0,0
2022-03-01,ARG,Perlis,0,0,0
2022-03-01,ARG,Pulau Pinang,0,0,0
2022-03-01,ARG,Sabah,0,0,0
2022-03-01,ARG,Sarawak,0,0,0
2022-03-01,ARG,Selangor,25,15,10
2022-03-01,ARG,W.P. Labuan,0,0,0
2022-03-01,ARM,Johor,0,0,0
2022-03-01,ARM,Kedah,0,0,0
2022-03-01,ARM,Kelantan,0,0,0
2022-03-01,ARM,Perak,0,0,0
2022-03-01,ARM,Perlis,0,0,0
2022-03-01,ARM,Pulau Pinang,0,0,0
2022-03-01,ARM,Sabah,0,0,0
2022-03-01,ARM,Sarawak,0,0,0
2022-03-01,ARM,Selangor,2,0,2
2022-03-01,ATA,Selangor,0,0,0
2022-03-01,ATG,Johor,0,0,0
2022-03-01,ATG,Kedah,0,0,0
2022-03-01,ATG,Pulau Pinang,0,0,0
2022-03-01,ATG,Sarawak,0,0,0
2022-03-01,ATG,Selangor,6,4,2
2022-03-01,AUS,Johor,5,5,0
2022-03-01,AUS,Kedah,59,32,27
2022-03-01,AUS,Kelantan,0,0,0
2022-03-01,AUS,Melaka,0,0,0
2022-03-01,AUS,Negeri Sembilan,0,0,0
2022-03-01,AUS,Pahang,0,0,0
2022-03-01,AUS,Perak,2,1,1
2022-03-01,AUS,Perlis,0,0,0
2022-03-01,AUS,Pulau Pinang,26,21,5
2022-03-01,AUS,Sabah,1,0,1
2022-03-01,AUS,Sarawak,3,2,1
2022-03-01,AUS,Selangor,738,492,246
2022-03-01,AUS,Terengganu,0,0,0
2022-03-01,AUS,W.P. Labuan,0,0,0
2022-03-01,AUT,Johor,0,0,0
2022-03-01,AUT,Kedah,2,2,0
2022-03-01,AUT,Kelantan,0,0,0
2022-03-01,AUT,Melaka,0,0,0
2022-03-01,AUT,Negeri Sembilan,0,0,0
2022-03-01,AUT,Pahang,0,0,0
2022-03-01,AUT,Perak,0,0,0
2022-03-01,AUT,Perlis,0,0,0
2022-03-01,AUT,Pulau Pinang,2,1,1
2022-03-01,AUT,Sabah,0,0,0
2022-03-01,AUT,Sarawak,0,0,0
2022-03-01,AUT,Selangor,80,73,7
2022-03-01,AUT,Terengganu,0,0,0
2022-03-01,AUT,W.P. Labuan,0,0,0
2022-03-01,AZE,Johor,0,0,0
2022-03-01,AZE,Kedah,0,0,0
2022-03-01,AZE,Kelantan,0,0,0
2022-03-01,AZE,Melaka,0,0,0
2022-03-01,AZE,Perlis,0,0,0
2022-03-01,AZE,Pulau Pinang,0,0,0
2022-03-01,AZE,Sabah,0,0,0
2022-03-01,AZE,Sarawak,0,0,0
2022-03-01,AZE,Selangor,12,10,2
2022-03-01,AZE,W.P. Labuan,0,0,0
2022-03-01,BDI,Pulau Pinang,0,0,0
2022-03-01,BDI,Sarawak,0,0,0
2022-03-01,BDI,Selangor,0,0,0
2022-03-01,BEL,Johor,1,1,0
2022-03-01,BEL,Kedah,0,0,0
2022-03-01,BEL,Kelantan,0,0,0
2022-03-01,BEL,Melaka,0,0,0
2022-03-01,BEL,Negeri Sembilan,0,0,0
2022-03-01,BEL,Pahang,0,0,0
2022-03-01,BEL,Perak,0,0,0
2022-03-01,BEL,Perlis,0,0,0
2022-03-01,BEL,Pulau Pinang,1,1,0
2022-03-01,BEL,Sabah,0,0,0
2022-03-01,BEL,Sarawak,0,0,0
2022-03-01,BEL,Selangor,83,58,25
2022-03-01,BEL,W.P. Labuan,0,0,0
2022-03-01,BEN,Johor,0,0,0
2022-03-01,BEN,Kedah,0,0,0
2022-03-01,BEN,Perak,0,0,0
2022-03-01,BEN,Pulau Pinang,0,0,0
2022-03-01,BEN,Sabah,0,0,0
2022-03-01,BEN,Sarawak,0,0,0
2022-03-01,BEN,Selangor,1,0,1
2022-03-01,BFA,Perak,0,0,0
2022-03-01,BFA,Pulau Pinang,0,0,0
2022-03-01,BFA,Selangor,1,1,0
2022-03-01,BGD,Johor,22,19,3
2022-03-01,BGD,Kedah,0,0,0
2022-03-01,BGD,Kelantan,0,0,0
2022-03-01,BGD,Melaka,0,0,0
2022-03-01,BGD,Negeri Sembilan,0,0,0
2022-03-01,BGD,Pahang,0,0,0
2022-03-01,BGD,Perak,0,0,0
2022-03-01,BGD,Perlis,0,0,0
2022-03-01,BGD,Pulau Pinang,5,5,0
2022-03-01,BGD,Sabah,0,0,0
2022-03-01,BGD,Sarawak,0,0,0
2022-03-01,BGD,Selangor,8928,8566,362
2022-03-01,BGD,W.P. Labuan,0,0,0
2022-03-01,BGR,Johor,0,0,0
2022-03-01,BGR,Kedah,0,0,0
2022-03-01,BGR,Kelantan,0,0,0
2022-03-01,BGR,Pahang,0,0,0
2022-03-01,BGR,Perak,0,0,0
2022-03-01,BGR,Perlis,0,0,0
2022-03-01,BGR,Pulau Pinang,0,0,0
2022-03-01,BGR,Sabah,0,0,0
2022-03-01,BGR,Sarawak,0,0,0
2022-03-01,BGR,Selangor,35,31,4
2022-03-01,BGR,W.P. Labuan,0,0,0
2022-03-01,BHR,Johor,0,0,0
2022-03-01,BHR,Kedah,0,0,0
2022-03-01,BHR,Kelantan,0,0,0
2022-03-01,BHR,Perlis,0,0,0
2022-03-01,BHR,Pulau Pinang,0,0,0
2022-03-01,BHR,Sabah,0,0,0
2022-03-01,BHR,Sarawak,0,0,0
2022-03-01,BHR,Selangor,6,4,2
2022-03-01,BHS,Johor,0,0,0
2022-03-01,BHS,Kedah,0,0,0
2022-03-01,BHS,Perak,0,0,0
2022-03-01,BHS,Sabah,0,0,0
2022-03-01,BHS,Sarawak,0,0,0
2022-03-01,BHS,Selangor,1,1,0
2022-03-01,BIH,Johor,0,0,0
2022-03-01,BIH,Kedah,0,0,0
2022-03-01,BIH,Perlis,0,0,0
2022-03-01,BIH,Pulau Pinang,0,0,0
2022-03-01,BIH,Sabah,0,0,0
2022-03-01,BIH,Sarawak,0,0,0
2022-03-01,BIH,Selangor,19,9,10
2022-03-01,BLR,Johor,1,1,0
2022-03-01,BLR,Kedah,0,0,0
2022-03-01,BLR,Kelantan,0,0,0
2022-03-01,BLR,Pahang,0,0,0
2022-03-01,BLR,Perak,0,0,0
2022-03-01,BLR,Perlis,0,0,0
2022-03-01,BLR,Pulau Pinang,1,0,1
2022-03-01,BLR,Sabah,0,0,0
2022-03-01,BLR,Sarawak,0,0,0
2022-03-01,BLR,Selangor,12,7,5
2022-03-01,BLR,W.P. Labuan,0,0,0
2022-03-01,BLZ,Johor,0,0,0
2022-03-01,BLZ,Pulau Pinang,0,0,0
2022-03-01,BLZ,Sarawak,0,0,0
2022-03-01,BLZ,Selangor,0,0,0
2022-03-01,BMU,Selangor,0,0,0
2022-03-01,BOL,Johor,0,0,0
2022-03-01,BOL,Kedah,0,0,0
2022-03-01,BOL,Melaka,0,0,0
2022-03-01,BOL,Perak,0,0,0
2022-03-01,BOL,Perlis,0,0,0
2022-03-01,BOL,Pulau Pinang,0,0,0
2022-03-01,BOL,Sabah,0,0,0
2022-03-01,BOL,Sarawak,0,0,0
2022-03-01,BOL,Selangor,1,1,0
2022-03-01,BRA,Johor,0,0,0
2022-03-01,BRA,Kedah,0,0,0
2022-03-01,BRA,Kelantan,0,0,0
2022-03-01,BRA,Melaka,0,0,0
2022-03-01,BRA,Pahang,0,0,0
2022-03-01,BRA,Perak,0,0,0
2022-03-01,BRA,Perlis,0,0,0
2022-03-01,BRA,Pulau Pinang,1,1,0
2022-03-01,BRA,Sabah,0,0,0
2022-03-01,BRA,Sarawak,1,1,0
2022-03-01,BRA,Selangor,64,40,24
2022-03-01,BRA,W.P. Labuan,0,0,0
2022-03-01,BRB,Johor,0,0,0
2022-03-01,BRB,Kedah,0,0,0
2022-03-01,BRB,Perlis,0,0,0
2022-03-01,BRB,Pulau Pinang,0,0,0
2022-03-01,BRB,Selangor,2,1,1
2022-03-01,BRN,Johor,0,0,0
2022-03-01,BRN,Kedah,0,0,0
2022-03-01,BRN,Kelantan,0,0,0
2022-03-01,BRN,Melaka,0,0,0
2022-03-01,BRN,Pahang,0,0,0
2022-03-01,BRN,Perak,0,0,0
2022-03-01,BRN,Perlis,0,0,0
2022-03-01,BRN,Pulau Pinang,0,0,0
2022-03-01,BRN,Sabah,0,0,0
2022-03-01,BRN,Sarawak,391,386,5
2022-03-01,BRN,Selangor,129,76,53
2022-03-01,BRN,W.P. Labuan,2,2,0
2022-03-01,BTN,Johor,0,0,0
2022-03-01,BTN,Kedah,0,0,0
2022-03-01,BTN,Perak,0,0,0
2022-03-01,BTN,Perlis,0,0,0
2022-03-01,BTN,Pulau Pinang,0,0,0
2022-03-01,BTN,Sabah,0,0,0
2022-03-01,BTN,Sarawak,0,0,0
2022-03-01,BTN,Selangor,4,3,1
2022-03-01,BWA,Johor,0,0,0
2022-03-01,BWA,Kedah,0,0,0
2022-03-01,BWA,Perlis,0,0,0
2022-03-01,BWA,Pulau Pinang,0,0,0
2022-03-01,BWA,Sabah,0,0,0
2022-03-01,BWA,Sarawak,0,0,0
2022-03-01,BWA,Selangor,2,1,1
2022-03-01,CAF,Kedah,0,0,0
2022-03-01,CAF,Selangor,0,0,0
2022-03-01,CAN,Johor,0,0,0
2022-03-01,CAN,Kedah,15,10,5
2022-03-01,CAN,Kelantan,0,0,0
2022-03-01,CAN,Melaka,0,0,0
2022-03-01,CAN,Negeri Sembilan,0,0,0
2022-03-01,CAN,Pahang,0,0,0
2022-03-01,CAN,Perak,0,0,0
2022-03-01,CAN,Perlis,0,0,0
2022-03-01,CAN,Pulau Pinang,9,5,4
2022-03-01,CAN,Sabah,1,1,0
2022-03-01,CAN,Sarawak,1,1,0
2022-03-01,CAN,Selangor,249,161,88
2022-03-01,CAN,Terengganu,0,0,0
2022-03-01,CAN,W.P. Labuan,0,0,0
2022-03-01,CCK,Selangor,0,0,0
2022-03-01,CHE,Johor,0,0,0
2022-03-01,CHE,Kedah,3,3,0
2022-03-01,CHE,Kelantan,0,0,0
2022-03-01,CHE,Melaka,0,0,0
2022-03-01,CHE,Negeri Sembilan,0,0,0
2022-03-01,CHE,Pahang,0,0,0
2022-03-01,CHE,Perak,0,0,0
2022-03-01,CHE,Perlis,0,0,0
2022-03-01,CHE,Pulau Pinang,5,3,2
2022-03-01,CHE,Sabah,1,1,0
2022-03-01,CHE,Sarawak,0,0,0
2022-03-01,CHE,Selangor,80,63,17
2022-03-01,CHE,W.P. Labuan,0,0,0
2022-03-01,CHL,Johor,0,0,0
2022-03-01,CHL,Kedah,0,0,0
2022-03-01,CHL,Kelantan,0,0,0
2022-03-01,CHL,Melaka,0,0,0
2022-03-01,CHL,Pahang,0,0,0
2022-03-01,CHL,Perak,0,0,0
2022-03-01,CHL,Perlis,0,0,0
2022-03-01,CHL,Pulau Pinang,0,0,0
2022-03-01,CHL,Sabah,0,0,0
2022-03-01,CHL,Sarawak,0,0,0
2022-03-01,CHL,Selangor,9,6,3
2022-03-01,CHN,Johor,254,240,14
2022-03-01,CHN,Kedah,14,8,6
2022-03-01,CHN,Kelantan,0,0,0
2022-03-01,CHN,Melaka,0,0,0
2022-03-01,CHN,Pahang,0,0,0
2022-03-01,CHN,Perak,0,0,0
2022-03-01,CHN,Perlis,0,0,0
2022-03-01,CHN,Pulau Pinang,16,9,7
2022-03-01,CHN,Sabah,2,2,0
2022-03-01,CHN,Sarawak,38,38,0
2022-03-01,CHN,Selangor,3088,2200,888
2022-03-01,CHN,Terengganu,0,0,0
2022-03-01,CHN,W.P. Labuan,0,0,0
2022-03-01,CIV,Johor,0,0,0
2022-03-01,CIV,Kedah,0,0,0
2022-03-01,CIV,Pulau Pinang,0,0,0
2022-03-01,CIV,Sabah,0,0,0
2022-03-01,CIV,Sarawak,0,0,0
2022-03-01,CIV,Selangor,0,0,0
2022-03-01,CMR,Johor,0,0,0
2022-03-01,CMR,Kedah,0,0,0
2022-03-01,CMR,Pulau Pinang,0,0,0
2022-03-01,CMR,Sabah,0,0,0
2022-03-01,CMR,Sarawak,0,0,0
2022-03-01,CMR,Selangor,6,6,0
2022-03-01,COD,Johor,0,0,0
2022-03-01,COD,Pulau Pinang,0,0,0
2022-03-01,COD,Sarawak,0,0,0
2022-03-01,COD,Selangor,2,1,1
2022-03-01,COG,Johor,0,0,0
2022-03-01,COG,Kedah,0,0,0
2022-03-01,COG,Selangor,0,0,0
2022-03-01,COK,Selangor,0,0,0
2022-03-01,COL,Johor,0,0,0
2022-03-01,COL,Kedah,0,0,0
2022-03-01,COL,Perak,0,0,0
2022-03-01,COL,Pulau Pinang,0,0,0
2022-03-01,COL,Sabah,0,0,0
2022-03-01,COL,Sarawak,0,0,0
2022-03-01,COL,Selangor,14,10,4
2022-03-01,COL,W.P. Labuan,0,0,0
2022-03-01,COM,Johor,0,0,0
2022-03-01,COM,Kedah,0,0,0
2022-03-01,COM,Selangor,9,8,1
2022-03-01,CPV,Johor,0,0,0
2022-03-01,CPV,Kedah,0,0,0
2022-03-01,CPV,Pulau Pinang,0,0,0
2022-03-01,CPV,Sabah,0,0,0
2022-03-01,CPV,Selangor,0,0,0
2022-03-01,CRI,Johor,0,0,0
2022-03-01,CRI,Kedah,0,0,0
2022-03-01,CRI,Perak,0,0,0
2022-03-01,CRI,Perlis,0,0,0
2022-03-01,CRI,Pulau Pinang,0,0,0
2022-03-01,CRI,Sabah,0,0,0
2022-03-01,CRI,Sarawak,0,0,0
2022-03-01,CRI,Selangor,4,4,0
2022-03-01,CUB,Johor,0,0,0
2022-03-01,CUB,Kedah,0,0,0
2022-03-01,CUB,Perlis,0,0,0
2022-03-01,CUB,Pulau Pinang,0,0,0
2022-03-01,CUB,Sabah,0,0,0
2022-03-01,CUB,Sarawak,0,0,0
2022-03-01,CUB,Selangor,0,0,0
2022-03-01,CYP,Johor,0,0,0
2022-03-01,CYP,Kedah,0,0,0
2022-03-01,CYP,Perak,0,0,0
2022-03-01,CYP,Perlis,0,0,0
2022-03-01,CYP,Pulau Pinang,0,0,0
2022-03-01,CYP,Sabah,0,0,0
2022-03-01,CYP,Sarawak,0,0,0
2022-03-01,CYP,Selangor,3,2,1
2022-03-01,CZE,Johor,0,0,0
2022-03-01,CZE,Kedah,0,0,0
2022-03-01,CZE,Kelantan,1,0,1
2022-03-01,CZE,Melaka,0,0,0
2022-03-01,CZE,Negeri Sembilan,0,0,0
2022-03-01,CZE,Perak,0,0,0
2022-03-01,CZE,Perlis,0,0,0
2022-03-01,CZE,Pulau Pinang,0,0,0
2022-03-01,CZE,Sabah,0,0,0
2022-03-01,CZE,Sarawak,0,0,0
2022-03-01,CZE,Selangor,38,30,8
2022-03-01,CZE,W.P. Labuan,0,0,0
2022-03-01,DEU,Johor,3,2,1
2022-03-01,DEU,Kedah,14,11,3
2022-03-01,DEU,Kelantan,0,0,0
2022-03-01,DEU,Melaka,0,0,0
2022-03-01,DEU,Negeri Sembilan,0,0,0
2022-03-01,DEU,Pahang,0,0,0
2022-03-01,DEU,Perak,0,0,0
2022-03-01,DEU,Perlis,0,0,0
2022-03-01,DEU,Pulau Pinang,19,14,5
2022-03-01,DEU,Sabah,0,0,0
2022-03-01,DEU,Sarawak,0,0,0
2022-03-01,DEU,Selangor,476,374,102
2022-03-01,DEU,Terengganu,0,0,0
2022-03-01,DEU,W.P. Labuan,0,0,0
2022-03-01,DJI,Johor,0,0,0
2022-03-01,DJI,Selangor,10,6,4
2022-03-01,DMA,Johor,0,0,0
2022-03-01,DMA,Kedah,0,0,0
2022-03-01,DMA,Pulau Pinang,0,0,0
2022-03-01,DMA,Sabah,0,0,0
2022-03-01,DMA,Sarawak,0,0,0
2022-03-01,DMA,Selangor,5,4,1
2022-03-01,DMA,W.P. Labuan,0,0,0
2022-03-01,DNK,Johor,3,3,0
2022-03-01,DNK,Kedah,4,3,1
2022-03-01,DNK,Kelantan,0,0,0
2022-03-01,DNK,Melaka,0,0,0
2022-03-01,DNK,Negeri Sembilan,0,0,0
2022-03-01,DNK,Pahang,0,0,0
2022-03-01,DNK,Perak,0,0,0
2022-03-01,DNK,Perlis,0,0,0
2022-03-01,DNK,Pulau Pinang,5,3,2
2022-03-01,DNK,Sabah,1,0,1
2022-03-01,DNK,Sarawak,0,0,0
2022-03-01,DNK,Selangor,93,71,22
2022-03-01,DNK,W.P. Labuan,0,0,0
2022-03-01,DOM,Johor,0,0,0
2022-03-01,DOM,Kedah,0,0,0
2022-03-01,DOM,Perak,0,0,0
2022-03-01,DOM,Perlis,0,0,0
2022-03-01,DOM,Pulau Pinang,0,0,0
2022-03-01,DOM,Sabah,0,0,0
2022-03-01,DOM,Sarawak,0,0,0
2022-03-01,DOM,Selangor,0,0,0
2022-03-01,DZA,Johor,0,0,0
2022-03-01,DZA,Kedah,0,0,0
2022-03-01,DZA,Kelantan,0,0,0
2022-03-01,DZA,Melaka,0,0,0
2022-03-01,DZA,Perak,0,0,0
2022-03-01,DZA,Perlis,0,0,0
2022-03-01,DZA,Pulau Pinang,0,0,0
2022-03-01,DZA,Sabah,0,0,0
2022-03-01,DZA,Sarawak,0,0,0
2022-03-01,DZA,Selangor,54,36,18
2022-03-01,DZA,W.P. Labuan,0,0,0
2022-03-01,ECU,Johor,0,0,0
2022-03-01,ECU,Kedah,0,0,0
2022-03-01,ECU,Perak,0,0,0
2022-03-01,ECU,Perlis,0,0,0
2022-03-01,ECU,Pulau Pinang,0,0,0
2022-03-01,ECU,Sabah,0,0,0
2022-03-01,ECU,Sarawak,0,0,0
2022-03-01,ECU,Selangor,2,1,1
2022-03-01,EGY,Johor,1,1,0
2022-03-01,EGY,Kedah,0,0,0
2022-03-01,EGY,Kelantan,0,0,0
2022-03-01,EGY,Melaka,0,0,0
2022-03-01,EGY,Pahang,0,0,0
2022-03-01,EGY,Perak,0,0,0
2022-03-01,EGY,Perlis,0,0,0
2022-03-01,EGY,Pulau Pinang,0,0,0
2022-03-01,EGY,Sabah,0,0,0
2022-03-01,EGY,Sarawak,0,0,0
2022-03-01,EGY,Selangor,233,176,57
2022-03-01,EGY,Terengganu,0,0,0
2022-03-01,EGY,W.P. Labuan,0,0,0
2022-03-01,ERI,Johor,0,0,0
2022-03-01,ERI,Pulau Pinang,0,0,0
2022-03-01,ERI,Sabah,0,0,0
2022-03-01,ERI,Selangor,5,4,1
2022-03-01,ESP,Johor,0,0,0
2022-03-01,ESP,Kedah,3,1,2
2022-03-01,ESP,Kelantan,0,0,0
2022-03-01,ESP,Melaka,0,0,0
2022-03-01,ESP,Negeri Sembilan,0,0,0
2022-03-01,ESP,Pahang,0,0,0
2022-03-01,ESP,Perak,0,0,0
2022-03-01,ESP,Perlis,0,0,0
2022-03-01,ESP,Pulau Pinang,1,0,1
2022-03-01,ESP,Sabah,0,0,0
2022-03-01,ESP,Sarawak,0,0,0
2022-03-01,ESP,Selangor,117,87,30
2022-03-01,ESP,W.P. Labuan,0,0,0
2022-03-01,EST,Johor,0,0,0
2022-03-01,EST,Kedah,0,0,0
2022-03-01,EST,Kelantan,0,0,0
2022-03-01,EST,Pahang,0,0,0
2022-03-01,EST,Perak,0,0,0
2022-03-01,EST,Perlis,0,0,0
2022-03-01,EST,Pulau Pinang,0,0,0
2022-03-01,EST,Sabah,0,0,0
2022-03-01,EST,Sarawak,0,0,0
2022-03-01,EST,Selangor,9,8,1
2022-03-01,EST,W.P. Labuan,0,0,0
2022-03-01,ETH,Johor,1,1,0
2022-03-01,ETH,Kedah,0,0,0
2022-03-01,ETH,Pulau Pinang,0,0,0
2022-03-01,ETH,Sarawak,0,0,0
2022-03-01,ETH,Selangor,12,7,5
2022-03-01,FIN,Johor,0,0,0
2022-03-01,FIN,Kedah,0,0,0
2022-03-01,FIN,Kelantan,0,0,0
2022-03-01,FIN,Melaka,0,0,0
2022-03-01,FIN,Negeri Sembilan,0,0,0
2022-03-01,FIN,Pahang,0,0,0
2022-03-01,FIN,Perak,0,0,0
2022-03-01,FIN,Perlis,0,0,0
2022-03-01,FIN,Pulau Pinang,1,0,1
2022-03-01,FIN,Sabah,0,0,0
2022-03-01,FIN,Sarawak,0,0,0
2022-03-01,FIN,Selangor,58,35,23
2022-03-01,FIN,W.P. Labuan,0,0,0
2022-03-01,FJI,Johor,0,0,0
2022-03-01,FJI,Kedah,1,0,1
2022-03-01,FJI,Kelantan,0,0,0
2022-03-01,FJI,Perak,0,0,0
2022-03-01,FJI,Perlis,0,0,0
2022-03-01,FJI,Pulau Pinang,0,0,0
2022-03-01,FJI,Sabah,0,0,0
2022-03-01,FJI,Sarawak,0,0,0
2022-03-01,FJI,Selangor,2,1,1
2022-03-01,FRA,Johor,5,5,0
2022-03-01,FRA,Kedah,6,4,2
2022-03-01,FRA,Kelantan,0,0,0
2022-03-01,FRA,Melaka,0,0,0
2022-03-01,FRA,Negeri Sembilan,0,0,0
2022-03-01,FRA,Pahang,0,0,0
2022-03-01,FRA,Perak,0,0,0
2022-03-01,FRA,Perlis,0,0,0
2022-03-01,FRA,Pulau Pinang,14,10,4
2022-03-01,FRA,Sabah,0,0,0
2022-03-01,FRA,Sarawak,0,0,0
2022-03-01,FRA,Selangor,605,450,155
2022-03-01,FRA,Terengganu,0,0,0
2022-03-01,FRA,W.P. Labuan,0,0,0
2022-03-01,FSM,Johor,0,0,0
2022-03-01,FSM,Pulau Pinang,0,0,0
2022-03-01,FSM,Selangor,0,0,0
2022-03-01,GAB,Johor,0,0,0
2022-03-01,GAB,Pulau Pinang,0,0,0
2022-03-01,GAB,Sarawak,0,0,0
2022-03-01,GAB,Selangor,1,0,1
2022-03-01,GBR,Johor,7,6,1
2022-03-01,GBR,Kedah,38,20,18
2022-03-01,GBR,Kelantan,0,0,0
2022-03-01,GBR,Melaka,0,0,0
2022-03-01,GBR,Negeri Sembilan,0,0,0
2022-03-01,GBR,Pahang,0,0,0
2022-03-01,GBR,Perak,0,0,0
2022-03-01,GBR,Perlis,0,0,0
2022-03-01,GBR,Pulau Pinang,48,40,8
2022-03-01,GBR,Sabah,0,0,0
2022-03-01,GBR,Sarawak,4,3,1
2022-03-01,GBR,Selangor,1260,924,336
2022-03-01,GBR,Terengganu,0,0,0
2022-03-01,GBR,W.P. Labuan,0,0,0
2022-03-01,GEO,Johor,0,0,0
2022-03-01,GEO,Kedah,0,0,0
2022-03-01,GEO,Melaka,0,0,0
2022-03-01,GEO,Perak,0,0,0
2022-03-01,GEO,Perlis,0,0,0
2022-03-01,GEO,Pulau Pinang,0,0,0
2022-03-01,GEO,Sabah,0,0,0
2022-03-01,GEO,Sarawak,0,0,0
2022-03-01,GEO,Selangor,14,14,0
2022-03-01,GHA,Johor,0,0,0
2022-03-01,GHA,Kedah,0,0,0
2022-03-01,GHA,Kelantan,0,0,0
2022-03-01,GHA,Pulau Pinang,0,0,0
2022-03-01,GHA,Sabah,0,0,0
2022-03-01,GHA,Sarawak,0,0,0
2022-03-01,GHA,Selangor,5,4,1
2022-03-01,GIB,Johor,0,0,0
2022-03-01,GIB,Sarawak,0,0,0
2022-03-01,GIN,Johor,0,0,0
2022-03-01,GIN,Kedah,0,0,0
2022-03-01,GIN,Kelantan,0,0,0
2022-03-01,GIN,Perlis,0,0,0
2022-03-01,GIN,Pulau Pinang,0,0,0
2022-03-01,GIN,Sabah,0,0,0
2022-03-01,GIN,Sarawak,0,0,0
2022-03-01,GIN,Selangor,11,8,3
2022-03-01,GLP,Selangor,0,0,0
2022-03-01,GMB,Johor,0,0,0
2022-03-01,GMB,Kedah,0,0,0
2022-03-01,GMB,Kelantan,0,0,0
2022-03-01,GMB,Pulau Pinang,0,0,0
2022-03-01,GMB,Sabah,0,0,0
2022-03-01,GMB,Sarawak,0,0,0
2022-03-01,GMB,Selangor,10,3,7
2022-03-01,GNB,Johor,0,0,0
2022-03-01,GNB,Selangor,1,1,0
2022-03-01,GNQ,Johor,0,0,0
2022-03-01,GNQ,Selangor,0,0,0
2022-03-01,GRC,Johor,2,2,0
2022-03-01,GRC,Kedah,2,1,1
2022-03-01,GRC,Kelantan,0,0,0
2022-03-01,GRC,Melaka,0,0,0
2022-03-01,GRC,Negeri Sembilan,0,0,0
2022-03-01,GRC,Pahang,0,0,0
2022-03-01,GRC,Perak,0,0,0
2022-03-01,GRC,Perlis,0,0,0
2022-03-01,GRC,Pulau Pinang,0,0,0
2022-03-01,GRC,Sabah,0,0,0
2022-03-01,GRC,Sarawak,0,0,0
2022-03-01,GRC,Selangor,22,19,3
2022-03-01,GRD,Johor,0,0,0
2022-03-01,GRD,Kedah,0,0,0
2022-03-01,GRD,Pulau Pinang,0,0,0
2022-03-01,GRD,Sabah,0,0,0
2022-03-01,GRD,Sarawak,0,0,0
2022-03-01,GRD,Selangor,4,3,1
2022-03-01,GRL,Johor,0,0,0
2022-03-01,GRL,Selangor,0,0,0
2022-03-01,GTM,Johor,0,0,0
2022-03-01,GTM,Kedah,0,0,0
2022-03-01,GTM,Pahang,0,0,0
2022-03-01,GTM,Perak,0,0,0
2022-03-01,GTM,Pulau Pinang,0,0,0
2022-03-01,GTM,Sabah,0,0,0
2022-03-01,GTM,Sarawak,0,0,0
2022-03-01,GTM,Selangor,2,1,1
2022-03-01,GTM,W.P. Labuan,0,0,0
2022-03-01,GUY,Johor,0,0,0
2022-03-01,GUY,Kedah,0,0,0
2022-03-01,GUY,Pulau Pinang,0,0,0
2022-03-01,GUY,Sarawak,0,0,0
2022-03-01,GUY,Selangor,0,0,0
2022-03-01,HKG,Johor,0,0,0
2022-03-01,HKG,Kedah,18,8,10
2022-03-01,HKG,Kelantan,0,0,0
2022-03-01,HKG,Pahang,0,0,0
2022-03-01,HKG,Perak,0,0,0
2022-03-01,HKG,Perlis,0,0,0
2022-03-01,HKG,Pulau Pinang,4,0,4
2022-03-01,HKG,Sabah,0,0,0
2022-03-01,HKG,Sarawak,26,25,1
2022-03-01,HKG,Selangor,2,0,2
2022-03-01,HKG,Terengganu,0,0,0
2022-03-01,HMD,Johor,0,0,0
2022-03-01,HND,Johor,0,0,0
2022-03-01,HND,Kedah,0,0,0
2022-03-01,HND,Perak,0,0,0
2022-03-01,HND,Pulau Pinang,0,0,0
2022-03-01,HND,Sabah,0,0,0
2022-03-01,HND,Sarawak,0,0,0
2022-03-01,HND,Selangor,0,0,0
2022-03-01,HRV,Johor,3,3,0
2022-03-01,HRV,Kedah,0,0,0
2022-03-01,HRV,Kelantan,0,0,0
2022-03-01,HRV,Melaka,0,0,0
2022-03-01,HRV,Pahang,0,0,0
2022-03-01,HRV,Perak,0,0,0
2022-03-01,HRV,Perlis,0,0,0
2022-03-01,HRV,Pulau Pinang,0,0,0
2022-03-01,HRV,Sabah,0,0,0
2022-03-01,HRV,Sarawak,0,0,0
2022-03-01,HRV,Selangor,33,29,4
2022-03-01,HTI,Johor,0,0,0
2022-03-01,HTI,Kedah,0,0,0
2022-03-01,HTI,Kelantan,0,0,0
2022-03-01,HTI,Perak,0,0,0
2022-03-01,HTI,Pulau Pinang,0,0,0
2022-03-01,HTI,Sabah,0,0,0
2022-03-01,HTI,Selangor,0,0,0
2022-03-01,HUN,Johor,0,0,0
2022-03-01,HUN,Kedah,0,0,0
2022-03-01,HUN,Kelantan,0,0,0
2022-03-01,HUN,Pahang,0,0,0
2022-03-01,HUN,Perak,0,0,0
2022-03-01,HUN,Perlis,0,0,0
2022-03-01,HUN,Pulau Pinang,0,0,0
2022-03-01,HUN,Sabah,0,0,0
2022-03-01,HUN,Sarawak,0,0,0
2022-03-01,HUN,Selangor,11,6,5
2022-03-01,HUN,W.P. Labuan,0,0,0
2022-03-01,IDN,Johor,628,444,184
2022-03-01,IDN,Kedah,44,18,26
2022-03-01,IDN,Kelantan,1,1,0
2022-03-01,IDN,Melaka,13,0,13
2022-03-01,IDN,Negeri Sembilan,0,0,0
2022-03-01,IDN,Pahang,0,0,0
2022-03-01,IDN,Perak,0,0,0
2022-03-01,IDN,Perlis,0,0,0
2022-03-01,IDN,Pulau Pinang,49,21,28
2022-03-01,IDN,Sabah,6,1,5
2022-03-01,IDN,Sarawak,331,307,24
2022-03-01,IDN,Selangor,5438,2088,3350
2022-03-01,IDN,Terengganu,0,0,0
2022-03-01,IDN,W.P. Labuan,1,1,0
2022-03-01,IND,Johor,99,98,1
2022-03-01,IND,Kedah,3,3,0
2022-03-01,IND,Kelantan,0,0,0
2022-03-01,IND,Melaka,0,0,0
2022-03-01,IND,Negeri Sembilan,0,0,0
2022-03-01,IND,Pahang,0,0,0
2022-03-01,IND,Perak,0,0,0
2022-03-01,IND,Perlis,0,0,0
2022-03-01,IND,Pulau Pinang,22,17,5
2022-03-01,IND,Sabah,4,4,0
2022-03-01,IND,Sarawak,6,5,1
2022-03-01,IND,Selangor,4248,3182,1066
2022-03-01,IND,Terengganu,0,0,0
2022-03-01,IND,W.P. Labuan,0,0,0
2022-03-01,IOT,Pulau Pinang,0,0,0
2022-03-01,IOT,Selangor,0,0,0
2022-03-01,IRL,Johor,0,0,0
2022-03-01,IRL,Kedah,2,2,0
2022-03-01,IRL,Kelantan,0,0,0
2022-03-01,IRL,Negeri Sembilan,0,0,0
2022-03-01,IRL,Pahang,0,0,0
2022-03-01,IRL,Perak,0,0,0
2022-03-01,IRL,Perlis,0,0,0
2022-03-01,IRL,Pulau Pinang,0,0,0
2022-03-01,IRL,Sabah,0,0,0
2022-03-01,IRL,Sarawak,0,0,0
2022-03-01,IRL,Selangor,71,52,19
2022-03-01,IRL,Terengganu,0,0,0
2022-03-01,IRL,W.P. Labuan,0,0,0
2022-03-01,IRN,Johor,0,0,0
2022-03-01,IRN,Kedah,0,0,0
2022-03-01,IRN,Kelantan,0,0,0
2022-03-01,IRN,Perak,0,0,0
2022-03-01,IRN,Perlis,0,0,0
2022-03-01,IRN,Pulau Pinang,0,0,0
2022-03-01,IRN,Sabah,0,0,0
2022-03-01,IRN,Sarawak,0,0,0
2022-03-01,IRN,Selangor,217,121,96
2022-03-01,IRN,W.P. Labuan,0,0,0
2022-03-01,IRQ,Johor,0,0,0
2022-03-01,IRQ,Kedah,0,0,0
2022-03-01,IRQ,Kelantan,0,0,0
2022-03-01,IRQ,Melaka,0,0,0
2022-03-01,IRQ,Pahang,0,0,0
2022-03-01,IRQ,Perak,0,0,0
2022-03-01,IRQ,Perlis,0,0,0
2022-03-01,IRQ,Pulau Pinang,0,0,0
2022-03-01,IRQ,Sabah,0,0,0
2022-03-01,IRQ,Sarawak,0,0,0
2022-03-01,IRQ,Selangor,228,151,77
2022-03-01,ISL,Johor,0,0,0
2022-03-01,ISL,Kedah,0,0,0
2022-03-01,ISL,Kelantan,0,0,0
2022-03-01,ISL,Perak,0,0,0
2022-03-01,ISL,Perlis,0,0,0
2022-03-01,ISL,Pulau Pinang,0,0,0
2022-03-01,ISL,Sabah,0,0,0
2022-03-01,ISL,Sarawak,0,0,0
2022-03-01,ISL,Selangor,1,0,1
2022-03-01,ISL,W.P. Labuan,0,0,0
2022-03-01,ISR,Pulau Pinang,0,0,0
2022-03-01,ITA,Johor,1,1,0
2022-03-01,ITA,Kedah,7,5,2
2022-03-01,ITA,Kelantan,0,0,0
2022-03-01,ITA,Melaka,0,0,0
2022-03-01,ITA,Negeri Sembilan,0,0,0
2022-03-01,ITA,Pahang,0,0,0
2022-03-01,ITA,Perak,0,0,0
2022-03-01,ITA,Perlis,0,0,0
2022-03-01,ITA,Pulau Pinang,4,4,0
2022-03-01,ITA,Sabah,0,0,0
2022-03-01,ITA,Sarawak,1,1,0
2022-03-01,ITA,Selangor,212,168,44
2022-03-01,ITA,W.P. Labuan,0,0,0
2022-03-01,JAM,Johor,0,0,0
2022-03-01,JAM,Kedah,0,0,0
2022-03-01,JAM,Perak,0,0,0
2022-03-01,JAM,Pulau Pinang,0,0,0
2022-03-01,JAM,Sabah,0,0,0
2022-03-01,JAM,Sarawak,0,0,0
2022-03-01,JAM,Selangor,2,1,1
2022-03-01,JAM,W.P. Labuan,0,0,0
2022-03-01,JOR,Johor,0,0,0
2022-03-01,JOR,Kedah,0,0,0
2022-03-01,JOR,Kelantan,0,0,0
2022-03-01,JOR,Melaka,0,0,0
2022-03-01,JOR,Perlis,0,0,0
2022-03-01,JOR,Pulau Pinang,0,0,0
2022-03-01,JOR,Sabah,0,0,0
2022-03-01,JOR,Sarawak,0,0,0
2022-03-01,JOR,Selangor,71,51,20
2022-03-01,JOR,W.P. Labuan,0,0,0
2022-03-01,JPN,Johor,6,3,3
2022-03-01,JPN,Kedah,8,2,6
2022-03-01,JPN,Kelantan,0,0,0
2022-03-01,JPN,Melaka,0,0,0
2022-03-01,JPN,Negeri Sembilan,0,0,0
2022-03-01,JPN,Pahang,0,0,0
2022-03-01,JPN,Perak,0,0,0
2022-03-01,JPN,Perlis,0,0,0
2022-03-01,JPN,Pulau Pinang,50,29,21
2022-03-01,JPN,Sabah,1,0,1
2022-03-01,JPN,Sarawak,17,14,3
2022-03-01,JPN,Selangor,1082,736,346
2022-03-01,JPN,W.P. Labuan,0,0,0
2022-03-01,KAZ,Johor,0,0,0
2022-03-01,KAZ,Kedah,0,0,0
2022-03-01,KAZ,Kelantan,0,0,0
2022-03-01,KAZ,Melaka,0,0,0
2022-03-01,KAZ,Perak,0,0,0
2022-03-01,KAZ,Perlis,0,0,0
2022-03-01,KAZ,Pulau Pinang,0,0,0
2022-03-01,KAZ,Sabah,0,0,0
2022-03-01,KAZ,Sarawak,0,0,0
2022-03-01,KAZ,Selangor,40,18,22
2022-03-01,KAZ,W.P. Labuan,0,0,0
2022-03-01,KEN,Johor,0,0,0
2022-03-01,KEN,Kedah,0,0,0
2022-03-01,KEN,Kelantan,0,0,0
2022-03-01,KEN,Perak,0,0,0
2022-03-01,KEN,Perlis,0,0,0
2022-03-01,KEN,Pulau Pinang,0,0,0
2022-03-01,KEN,Sabah,0,0,0
2022-03-01,KEN,Sarawak,0,0,0
2022-03-01,KEN,Selangor,46,19,27
2022-03-01,KGZ,Johor,0,0,0
2022-03-01,KGZ,Kedah,0,0,0
2022-03-01,KGZ,Kelantan,0,0,0
2022-03-01,KGZ,Perak,0,0,0
2022-03-01,KGZ,Perlis,0,0,0
2022-03-01,KGZ,Pulau Pinang,0,0,0
2022-03-01,KGZ,Sabah,0,0,0
2022-03-01,KGZ,Sarawak,0,0,0
2022-03-01,KGZ,Selangor,25,17,8
2022-03-01,KHM,Johor,1,0,1
2022-03-01,KHM,Kedah,0,0,0
2022-03-01,KHM,Kelantan,0,0,0
2022-03-01,KHM,Melaka,0,0,0
2022-03-01,KHM,Negeri Sembilan,0,0,0
2022-03-01,KHM,Pahang,0,0,0
2022-03-01,KHM,Perak,0,0,0
2022-03-01,KHM,Perlis,0,0,0
2022-03-01,KHM,Pulau Pinang,0,0,0
2022-03-01,KHM,Sabah,0,0,0
2022-03-01,KHM,Sarawak,0,0,0
2022-03-01,KHM,Selangor,212,173,39
2022-03-01,KHM,W.P. Labuan,0,0,0
2022-03-01,KIR,Johor,0,0,0
2022-03-01,KIR,Sabah,0,0,0
2022-03-01,KIR,Selangor,0,0,0
2022-03-01,KNA,Johor,0,0,0
2022-03-01,KNA,Kedah,0,0,0
2022-03-01,KNA,Perlis,0,0,0
2022-03-01,KNA,Pulau Pinang,0,0,0
2022-03-01,KNA,Sabah,0,0,0
2022-03-01,KNA,Selangor,2,2,0
2022-03-01,KNA,W.P. Labuan,0,0,0
2022-03-01,KOR,Johor,3,2,1
2022-03-01,KOR,Kedah,7,4,3
2022-03-01,KOR,Kelantan,0,0,0
2022-03-01,KOR,Melaka,0,0,0
2022-03-01,KOR,Negeri Sembilan,0,0,0
2022-03-01,KOR,Pahang,0,0,0
2022-03-01,KOR,Perak,0,0,0
2022-03-01,KOR,Perlis,0,0,0
2022-03-01,KOR,Pulau Pinang,15,11,4
2022-03-01,KOR,Sabah,5,2,3
2022-03-01,KOR,Sarawak,32,26,6
2022-03-01,KOR,Selangor,949,656,293
2022-03-01,KOR,Terengganu,0,0,0
2022-03-01,KOR,W.P. Labuan,0,0,0
2022-03-01,KWT,Johor,0,0,0
2022-03-01,KWT,Kedah,0,0,0
2022-03-01,KWT,Kelantan,0,0,0
2022-03-01,KWT,Perak,0,0,0
2022-03-01,KWT,Perlis,0,0,0
2022-03-01,KWT,Pulau Pinang,0,0,0
2022-03-01,KWT,Sabah,0,0,0
2022-03-01,KWT,Sarawak,0,0,0
2022-03-01,KWT,Selangor,19,12,7
2022-03-01,KWT,W.P. Labuan,0,0,0
2022-03-01,LAO,Johor,0,0,0
2022-03-01,LAO,Kedah,0,0,0
2022-03-01,LAO,Kelantan,0,0,0
2022-03-01,LAO,Melaka,0,0,0
2022-03-01,LAO,Perak,0,0,0
2022-03-01,LAO,Perlis,0,0,0
2022-03-01,LAO,Pulau Pinang,0,0,0
2022-03-01,LAO,Sabah,0,0,0
2022-03-01,LAO,Sarawak,0,0,0
2022-03-01,LAO,Selangor,117,114,3
2022-03-01,LAO,W.P. Labuan,0,0,0
2022-03-01,LBN,Johor,0,0,0
2022-03-01,LBN,Kedah,1,0,1
2022-03-01,LBN,Kelantan,0,0,0
2022-03-01,LBN,Pahang,0,0,0
2022-03-01,LBN,Perak,0,0,0
2022-03-01,LBN,Perlis,0,0,0
2022-03-01,LBN,Pulau Pinang,0,0,0
2022-03-01,LBN,Sabah,0,0,0
2022-03-01,LBN,Sarawak,0,0,0
2022-03-01,LBN,Selangor,23,17,6
2022-03-01,LBN,W.P. Labuan,0,0,0
2022-03-01,LBR,Johor,0,0,0
2022-03-01,LBR,Kedah,0,0,0
2022-03-01,LBR,Sabah,0,0,0
2022-03-01,LBR,Sarawak,0,0,0
2022-03-01,LBR,Selangor,2,2,0
2022-03-01,LBY,Johor,0,0,0
2022-03-01,LBY,Kedah,0,0,0
2022-03-01,LBY,Perlis,0,0,0
2022-03-01,LBY,Pulau Pinang,0,0,0
2022-03-01,LBY,Sabah,0,0,0
2022-03-01,LBY,Sarawak,0,0,0
2022-03-01,LBY,Selangor,188,122,66
2022-03-01,LCA,Johor,0,0,0
2022-03-01,LCA,Kedah,0,0,0
2022-03-01,LCA,Pulau Pinang,0,0,0
2022-03-01,LCA,Sarawak,0,0,0
2022-03-01,LCA,Selangor,1,1,0
2022-03-01,LIE,Johor,0,0,0
2022-03-01,LIE,Kedah,0,0,0
2022-03-01,LIE,Perlis,0,0,0
2022-03-01,LIE,Pulau Pinang,0,0,0
2022-03-01,LIE,Sabah,0,0,0
2022-03-01,LIE,Sarawak,0,0,0
2022-03-01,LIE,Selangor,0,0,0
2022-03-01,LKA,Johor,3,3,0
2022-03-01,LKA,Kedah,2,2,0
2022-03-01,LKA,Kelantan,0,0,0
2022-03-01,LKA,Melaka,0,0,0
2022-03-01,LKA,Pahang,0,0,0
2022-03-01,LKA,Perak,0,0,0
2022-03-01,LKA,Perlis,0,0,0
2022-03-01,LKA,Pulau Pinang,0,0,0
2022-03-01,LKA,Sabah,0,0,0
2022-03-01,LKA,Sarawak,2,1,1
2022-03-01,LKA,Selangor,353,203,150
2022-03-01,LKA,W.P. Labuan,0,0,0
2022-03-01,LSO,Johor,0,0,0
2022-03-01,LSO,Kedah,0,0,0
2022-03-01,LSO,Pulau Pinang,0,0,0
2022-03-01,LSO,Sarawak,0,0,0
2022-03-01,LSO,Selangor,4,1,3
2022-03-01,LTU,Johor,0,0,0
2022-03-01,LTU,Kedah,0,0,0
2022-03-01,LTU,Kelantan,0,0,0
2022-03-01,LTU,Pahang,0,0,0
2022-03-01,LTU,Perak,0,0,0
2022-03-01,LTU,Perlis,0,0,0
2022-03-01,LTU,Pulau Pinang,0,0,0
2022-03-01,LTU,Sabah,0,0,0
2022-03-01,LTU,Sarawak,0,0,0
2022-03-01,LTU,Selangor,19,13,6
2022-03-01,LTU,W.P. Labuan,0,0,0
2022-03-01,LUX,Johor,0,0,0
2022-03-01,LUX,Kedah,0,0,0
2022-03-01,LUX,Kelantan,0,0,0
2022-03-01,LUX,Perak,0,0,0
2022-03-01,LUX,Perlis,0,0,0
2022-03-01,LUX,Pulau Pinang,0,0,0
2022-03-01,LUX,Sabah,0,0,0
2022-03-01,LUX,Sarawak,0,0,0
2022-03-01,LUX,Selangor,1,1,0
2022-03-01,LVA,Johor,0,0,0
2022-03-01,LVA,Kedah,0,0,0
2022-03-01,LVA,Kelantan,0,0,0
2022-03-01,LVA,Pahang,0,0,0
2022-03-01,LVA,Perak,0,0,0
2022-03-01,LVA,Perlis,0,0,0
2022-03-01,LVA,Pulau Pinang,0,0,0
2022-03-01,LVA,Sabah,0,0,0
2022-03-01,LVA,Sarawak,0,0,0
2022-03-01,LVA,Selangor,3,2,1
2022-03-01,LVA,W.P. Labuan,0,0,0
2022-03-01,MAC,Johor,0,0,0
2022-03-01,MAC,Pahang,0,0,0
2022-03-01,MAC,Perak,0,0,0
2022-03-01,MAC,Selangor,0,0,0
2022-03-01,MAC,W.P. Labuan,0,0,0
2022-03-01,MAR,Johor,0,0,0
2022-03-01,MAR,Kedah,0,0,0
2022-03-01,MAR,Kelantan,0,0,0
2022-03-01,MAR,Melaka,0,0,0
2022-03-01,MAR,Pahang,0,0,0
2022-03-01,MAR,Perak,0,0,0
2022-03-01,MAR,Perlis,0,0,0
2022-03-01,MAR,Pulau Pinang,0,0,0
2022-03-01,MAR,Sabah,0,0,0
2022-03-01,MAR,Sarawak,0,0,0
2022-03-01,MAR,Selangor,37,16,21
2022-03-01,MAR,W.P. Labuan,0,0,0
2022-03-01,MCO,Johor,0,0,0
2022-03-01,MCO,Kedah,0,0,0
2022-03-01,MCO,Sabah,0,0,0
2022-03-01,MCO,Selangor,0,0,0
2022-03-01,MDA,Johor,0,0,0
2022-03-01,MDA,Kedah,0,0,0
2022-03-01,MDA,Kelantan,0,0,0
2022-03-01,MDA,Negeri Sembilan,0,0,0
2022-03-01,MDA,Perlis,0,0,0
2022-03-01,MDA,Pulau Pinang,0,0,0
2022-03-01,MDA,Sabah,0,0,0
2022-03-01,MDA,Sarawak,0,0,0
2022-03-01,MDA,Selangor,0,0,0
2022-03-01,MDG,Johor,0,0,0
2022-03-01,MDG,Kedah,0,0,0
2022-03-01,MDG,Perak,0,0,0
2022-03-01,MDG,Perlis,0,0,0
2022-03-01,MDG,Pulau Pinang,0,0,0
2022-03-01,MDG,Sabah,0,0,0
2022-03-01,MDG,Sarawak,0,0,0
2022-03-01,MDG,Selangor,1,1,0
2022-03-01,MDV,Johor,0,0,0
2022-03-01,MDV,Kedah,26,14,12
2022-03-01,MDV,Kelantan,0,0,0
2022-03-01,MDV,Perak,0,0,0
2022-03-01,MDV,Perlis,0,0,0
2022-03-01,MDV,Pulau Pinang,0,0,0
2022-03-01,MDV,Sabah,0,0,0
2022-03-01,MDV,Sarawak,0,0,0
2022-03-01,MDV,Selangor,211,115,96
2022-03-01,MEX,Johor,0,0,0
2022-03-01,MEX,Kedah,0,0,0
2022-03-01,MEX,Kelantan,0,0,0
2022-03-01,MEX,Pahang,0,0,0
2022-03-01,MEX,Perak,0,0,0
2022-03-01,MEX,Perlis,0,0,0
2022-03-01,MEX,Pulau Pinang,0,0,0
2022-03-01,MEX,Sabah,0,0,0
2022-03-01,MEX,Sarawak,0,0,0
2022-03-01,MEX,Selangor,24,14,10
2022-03-01,MEX,W.P. Labuan,0,0,0
2022-03-01,MHL,Johor,0,0,0
2022-03-01,MHL,Kedah,0,0,0
2022-03-01,MHL,Perak,0,0,0
2022-03-01,MHL,Pulau Pinang,0,0,0
2022-03-01,MHL,Sabah,0,0,0
2022-03-01,MHL,Selangor,0,0,0
2022-03-01,MKD,Johor,0,0,0
2022-03-01,MKD,Kedah,0,0,0
2022-03-01,MKD,Perak,0,0,0
2022-03-01,MKD,Pulau Pinang,0,0,0
2022-03-01,MKD,Sabah,0,0,0
2022-03-01,MKD,Sarawak,0,0,0
2022-03-01,MKD,Selangor,1,0,1
2022-03-01,MLI,Johor,0,0,0
2022-03-01,MLI,Sabah,0,0,0
2022-03-01,MLI,Selangor,2,1,1
2022-03-01,MLT,Johor,0,0,0
2022-03-01,MLT,Kedah,0,0,0
2022-03-01,MLT,Kelantan,0,0,0
2022-03-01,MLT,Perak,0,0,0
2022-03-01,MLT,Perlis,0,0,0
2022-03-01,MLT,Pulau Pinang,0,0,0
2022-03-01,MLT,Sabah,0,0,0
2022-03-01,MLT,Sarawak,0,0,0
2022-03-01,MLT,Selangor,1,0,1
2022-03-01,MLT,W.P. Labuan,0,0,0
2022-03-01,MMR,Johor,24,23,1
2022-03-01,MMR,Kedah,0,0,0
2022-03-01,MMR,Kelantan,0,0,0
2022-03-01,MMR,Negeri Sembilan,0,0,0
2022-03-01,MMR,Pahang,0,0,0
2022-03-01,MMR,Perak,0,0,0
2022-03-01,MMR,Perlis,0,0,0
2022-03-01,MMR,Pulau Pinang,1,1,0
2022-03-01,MMR,Sabah,0,0,0
2022-03-01,MMR,Sarawak,0,0,0
2022-03-01,MMR,Selangor,425,348,77
2022-03-01,MMR,Terengganu,0,0,0
2022-03-01,MMR,W.P. Labuan,0,0,0
2022-03-01,MNE,Johor,0,0,0
2022-03-01,MNE,Kedah,0,0,0
2022-03-01,MNE,Pulau Pinang,0,0,0
2022-03-01,MNE,Sabah,0,0,0
2022-03-01,MNE,Sarawak,0,0,0
2022-03-01,MNE,Selangor,5,4,1
2022-03-01,MNG,Johor,0,0,0
2022-03-01,MNG,Kedah,0,0,0
2022-03-01,MNG,Kelantan,0,0,0
2022-03-01,MNG,Perak,0,0,0
2022-03-01,MNG,Perlis,0,0,0
2022-03-01,MNG,Pulau Pinang,0,0,0
2022-03-01,MNG,Sabah,0,0,0
2022-03-01,MNG,Sarawak,0,0,0
2022-03-01,MNG,Selangor,14,3,11
2022-03-01,MNP,Selangor,0,0,0
2022-03-01,MOZ,Johor,0,0,0
2022-03-01,MOZ,Kedah,0,0,0
2022-03-01,MOZ,Perak,0,0,0
2022-03-01,MOZ,Pulau Pinang,0,0,0
2022-03-01,MOZ,Sabah,0,0,0
2022-03-01,MOZ,Sarawak,0,0,0
2022-03-01,MOZ,Selangor,12,5,7
2022-03-01,MRT,Johor,0,0,0
2022-03-01,MRT,Kedah,0,0,0
2022-03-01,MRT,Pulau Pinang,0,0,0
2022-03-01,MRT,Sabah,0,0,0
2022-03-01,MRT,Sarawak,0,0,0
2022-03-01,MRT,Selangor,2,2,0
2022-03-01,MUS,Johor,0,0,0
2022-03-01,MUS,Kedah,0,0,0
2022-03-01,MUS,Kelantan,0,0,0
2022-03-01,MUS,Pahang,0,0,0
2022-03-01,MUS,Perak,0,0,0
2022-03-01,MUS,Perlis,0,0,0
2022-03-01,MUS,Pulau Pinang,0,0,0
2022-03-01,MUS,Sabah,0,0,0
2022-03-01,MUS,Sarawak,0,0,0
2022-03-01,MUS,Selangor,43,25,18
2022-03-01,MWI,Johor,0,0,0
2022-03-01,MWI,Pulau Pinang,0,0,0
2022-03-01,MWI,Sabah,0,0,0
2022-03-01,MWI,Sarawak,0,0,0
2022-03-01,MWI,Selangor,7,4,3
2022-03-01,MYT,Selangor,0,0,0
2022-03-01,NAM,Johor,0,0,0
2022-03-01,NAM,Kedah,0,0,0
2022-03-01,NAM,Perak,0,0,0
2022-03-01,NAM,Perlis,0,0,0
2022-03-01,NAM,Pulau Pinang,0,0,0
2022-03-01,NAM,Sabah,0,0,0
2022-03-01,NAM,Sarawak,0,0,0
2022-03-01,NAM,Selangor,1,1,0
2022-03-01,NCL,Selangor,0,0,0
2022-03-01,NER,Johor,0,0,0
2022-03-01,NER,Sabah,0,0,0
2022-03-01,NER,Selangor,0,0,0
2022-03-01,NGA,Johor,0,0,0
2022-03-01,NGA,Kedah,0,0,0
2022-03-01,NGA,Perlis,0,0,0
2022-03-01,NGA,Pulau Pinang,1,1,0
2022-03-01,NGA,Sabah,0,0,0
2022-03-01,NGA,Sarawak,0,0,0
2022-03-01,NGA,Selangor,290,234,56
2022-03-01,NIC,Johor,0,0,0
2022-03-01,NIC,Kedah,0,0,0
2022-03-01,NIC,Pulau Pinang,0,0,0
2022-03-01,NIC,Sabah,0,0,0
2022-03-01,NIC,Selangor,2,2,0
2022-03-01,NLD,Johor,1,1,0
2022-03-01,NLD,Kedah,6,3,3
2022-03-01,NLD,Kelantan,0,0,0
2022-03-01,NLD,Melaka,0,0,0
2022-03-01,NLD,Negeri Sembilan,0,0,0
2022-03-01,NLD,Pahang,0,0,0
2022-03-01,NLD,Perak,0,0,0
2022-03-01,NLD,Perlis,0,0,0
2022-03-01,NLD,Pulau Pinang,4,2,2
2022-03-01,NLD,Sabah,0,0,0
2022-03-01,NLD,Sarawak,1,1,0
2022-03-01,NLD,Selangor,252,198,54
2022-03-01,NLD,Terengganu,0,0,0
2022-03-01,NLD,W.P. Labuan,0,0,0
2022-03-01,NOR,Johor,0,0,0
2022-03-01,NOR,Kedah,0,0,0
2022-03-01,NOR,Kelantan,0,0,0
2022-03-01,NOR,Melaka,0,0,0
2022-03-01,NOR,Pahang,0,0,0
2022-03-01,NOR,Perak,0,0,0
2022-03-01,NOR,Perlis,0,0,0
2022-03-01,NOR,Pulau Pinang,5,2,3
2022-03-01,NOR,Sabah,0,0,0
2022-03-01,NOR,Sarawak,0,0,0
2022-03-01,NOR,Selangor,50,44,6
2022-03-01,NOR,W.P. Labuan,0,0,0
2022-03-01,NPL,Johor,0,0,0
2022-03-01,NPL,Kedah,0,0,0
2022-03-01,NPL,Pahang,0,0,0
2022-03-01,NPL,Perak,0,0,0
2022-03-01,NPL,Perlis,0,0,0
2022-03-01,NPL,Pulau Pinang,3,3,0
2022-03-01,NPL,Sabah,0,0,0
2022-03-01,NPL,Sarawak,0,0,0
2022-03-01,NPL,Selangor,830,809,21
2022-03-01,NPL,W.P. Labuan,0,0,0
2022-03-01,NRU,Johor,0,0,0
2022-03-01,NRU,Pulau Pinang,0,0,0
2022-03-01,NRU,Selangor,0,0,0
2022-03-01,NZL,Johor,0,0,0
2022-03-01,NZL,Kedah,11,7,4
2022-03-01,NZL,Kelantan,0,0,0
2022-03-01,NZL,Melaka,0,0,0
2022-03-01,NZL,Negeri Sembilan,0,0,0
2022-03-01,NZL,Pahang,0,0,0
2022-03-01,NZL,Perak,0,0,0
2022-03-01,NZL,Perlis,0,0,0
2022-03-01,NZL,Pulau Pinang,10,7,3
2022-03-01,NZL,Sabah,0,0,0
2022-03-01,NZL,Sarawak,0,0,0
2022-03-01,NZL,Selangor,91,62,29
2022-03-01,NZL,Terengganu,0,0,0
2022-03-01,NZL,W.P. Labuan,0,0,0
2022-03-01,OMN,Johor,0,0,0
2022-03-01,OMN,Kedah,0,0,0
2022-03-01,OMN,Kelantan,0,0,0
2022-03-01,OMN,Melaka,0,0,0
2022-03-01,OMN,Perak,0,0,0
2022-03-01,OMN,Perlis,0,0,0
2022-03-01,OMN,Pulau Pinang,0,0,0
2022-03-01,OMN,Sabah,0,0,0
2022-03-01,OMN,Sarawak,0,0,0
2022-03-01,OMN,Selangor,74,62,12
2022-03-01,PAK,Johor,0,0,0
2022-03-01,PAK,Kedah,0,0,0
2022-03-01,PAK,Kelantan,0,0,0
2022-03-01,PAK,Melaka,0,0,0
2022-03-01,PAK,Negeri Sembilan,0,0,0
2022-03-01,PAK,Pahang,0,0,0
2022-03-01,PAK,Perak,0,0,0
2022-03-01,PAK,Perlis,0,0,0
2022-03-01,PAK,Pulau Pinang,0,0,0
2022-03-01,PAK,Sabah,0,0,0
2022-03-01,PAK,Sarawak,1,1,0
2022-03-01,PAK,Selangor,3137,2815,322
2022-03-01,PAK,W.P. Labuan,0,0,0
2022-03-01,PAN,Johor,0,0,0
2022-03-01,PAN,Kedah,0,0,0
2022-03-01,PAN,Perak,0,0,0
2022-03-01,PAN,Perlis,0,0,0
2022-03-01,PAN,Pulau Pinang,0,0,0
2022-03-01,PAN,Sabah,0,0,0
2022-03-01,PAN,Sarawak,0,0,0
2022-03-01,PAN,Selangor,1,1,0
2022-03-01,PER,Johor,0,0,0
2022-03-01,PER,Kedah,0,0,0
2022-03-01,PER,Kelantan,0,0,0
2022-03-01,PER,Pahang,0,0,0
2022-03-01,PER,Perak,0,0,0
2022-03-01,PER,Perlis,0,0,0
2022-03-01,PER,Pulau Pinang,0,0,0
2022-03-01,PER,Sabah,0,0,0
2022-03-01,PER,Sarawak,0,0,0
2022-03-01,PER,Selangor,5,4,1
2022-03-01,PER,W.P. Labuan,0,0,0
2022-03-01,PHL,Johor,223,212,11
2022-03-01,PHL,Kedah,6,0,6
2022-03-01,PHL,Kelantan,0,0,0
2022-03-01,PHL,Melaka,0,0,0
2022-03-01,PHL,Negeri Sembilan,0,0,0
2022-03-01,PHL,Pahang,0,0,0
2022-03-01,PHL,Perak,0,0,0
2022-03-01,PHL,Perlis,0,0,0
2022-03-01,PHL,Pulau Pinang,22,7,15
2022-03-01,PHL,Sabah,2,1,1
2022-03-01,PHL,Sarawak,23,20,3
2022-03-01,PHL,Selangor,1594,927,667
2022-03-01,PHL,Terengganu,0,0,0
2022-03-01,PHL,W.P. Labuan,8,8,0
2022-03-01,PLW,Johor,0,0,0
2022-03-01,PLW,Pulau Pinang,0,0,0
2022-03-01,PLW,Selangor,0,0,0
2022-03-01,PNG,Johor,0,0,0
2022-03-01,PNG,Kedah,0,0,0
2022-03-01,PNG,Kelantan,0,0,0
2022-03-01,PNG,Perak,0,0,0
2022-03-01,PNG,Pulau Pinang,0,0,0
2022-03-01,PNG,Sabah,0,0,0
2022-03-01,PNG,Sarawak,0,0,0
2022-03-01,PNG,Selangor,3,3,0
2022-03-01,POL,Johor,1,1,0
2022-03-01,POL,Kedah,3,0,3
2022-03-01,POL,Kelantan,0,0,0
2022-03-01,POL,Melaka,0,0,0
2022-03-01,POL,Negeri Sembilan,0,0,0
2022-03-01,POL,Pahang,0,0,0
2022-03-01,POL,Perak,0,0,0
2022-03-01,POL,Perlis,0,0,0
2022-03-01,POL,Pulau Pinang,1,1,0
2022-03-01,POL,Sabah,0,0,0
2022-03-01,POL,Sarawak,1,1,0
2022-03-01,POL,Selangor,64,47,17
2022-03-01,POL,Terengganu,0,0,0
2022-03-01,POL,W.P. Labuan,0,0,0
2022-03-01,PRK,Selangor,0,0,0
2022-03-01,PRT,Johor,0,0,0
2022-03-01,PRT,Kedah,1,1,0
2022-03-01,PRT,Kelantan,0,0,0
2022-03-01,PRT,Melaka,0,0,0
2022-03-01,PRT,Pahang,0,0,0
2022-03-01,PRT,Perak,0,0,0
2022-03-01,PRT,Perlis,0,0,0
2022-03-01,PRT,Pulau Pinang,1,1,0
2022-03-01,PRT,Sabah,0,0,0
2022-03-01,PRT,Sarawak,0,0,0
2022-03-01,PRT,Selangor,40,25,15
2022-03-01,PRT,W.P. Labuan,0,0,0
2022-03-01,PRY,Johor,0,0,0
2022-03-01,PRY,Kedah,0,0,0
2022-03-01,PRY,Perak,0,0,0
2022-03-01,PRY,Perlis,0,0,0
2022-03-01,PRY,Pulau Pinang,0,0,0
2022-03-01,PRY,Sabah,0,0,0
2022-03-01,PRY,Sarawak,0,0,0
2022-03-01,PRY,Selangor,1,0,1
2022-03-01,PSE,Johor,0,0,0
2022-03-01,PSE,Kedah,0,0,0
2022-03-01,PSE,Kelantan,0,0,0
2022-03-01,PSE,Melaka,0,0,0
2022-03-01,PSE,Perak,0,0,0
2022-03-01,PSE,Perlis,0,0,0
2022-03-01,PSE,Pulau Pinang,0,0,0
2022-03-01,PSE,Sabah,0,0,0
2022-03-01,PSE,Sarawak,0,0,0
2022-03-01,PSE,Selangor,76,55,21
2022-03-01,QAT,Johor,0,0,0
2022-03-01,QAT,Kedah,0,0,0
2022-03-01,QAT,Perlis,0,0,0
2022-03-01,QAT,Pulau Pinang,0,0,0
2022-03-01,QAT,Sabah,0,0,0
2022-03-01,QAT,Sarawak,0,0,0
2022-03-01,QAT,Selangor,14,14,0
2022-03-01,REU,Johor,0,0,0
2022-03-01,REU,Sarawak,0,0,0
2022-03-01,ROU,Johor,2,2,0
2022-03-01,ROU,Kedah,1,0,1
2022-03-01,ROU,Kelantan,0,0,0
2022-03-01,ROU,Negeri Sembilan,0,0,0
2022-03-01,ROU,Pahang,0,0,0
2022-03-01,ROU,Perak,0,0,0
2022-03-01,ROU,Perlis,0,0,0
2022-03-01,ROU,Pulau Pinang,0,0,0
2022-03-01,ROU,Sabah,0,0,0
2022-03-01,ROU,Sarawak,0,0,0
2022-03-01,ROU,Selangor,33,27,6
2022-03-01,ROU,W.P. Labuan,0,0,0
2022-03-01,RUS,Johor,5,5,0
2022-03-01,RUS,Kedah,3,2,1
2022-03-01,RUS,Kelantan,0,0,0
2022-03-01,RUS,Melaka,0,0,0
2022-03-01,RUS,Negeri Sembilan,0,0,0
2022-03-01,RUS,Pahang,0,0,0
2022-03-01,RUS,Perak,0,0,0
2022-03-01,RUS,Perlis,0,0,0
2022-03-01,RUS,Pulau Pinang,1,0,1
2022-03-01,RUS,Sabah,0,0,0
2022-03-01,RUS,Sarawak,0,0,0
2022-03-01,RUS,Selangor,218,137,81
2022-03-01,RUS,W.P. Labuan,0,0,0
2022-03-01,RWA,Johor,0,0,0
2022-03-01,RWA,Kedah,0,0,0
2022-03-01,RWA,Pulau Pinang,0,0,0
2022-03-01,RWA,Selangor,4,3,1
2022-03-01,SAU,Johor,0,0,0
2022-03-01,SAU,Kedah,0,0,0
2022-03-01,SAU,Kelantan,0,0,0
2022-03-01,SAU,Melaka,0,0,0
2022-03-01,SAU,Perak,0,0,0
2022-03-01,SAU,Perlis,0,0,0
2022-03-01,SAU,Pulau Pinang,0,0,0
2022-03-01,SAU,Sabah,0,0,0
2022-03-01,SAU,Sarawak,0,0,0
2022-03-01,SAU,Selangor,318,212,106
2022-03-01,SAU,W.P. Labuan,0,0,0
2022-03-01,SDN,Johor,0,0,0
2022-03-01,SDN,Kedah,1,1,0
2022-03-01,SDN,Kelantan,0,0,0
2022-03-01,SDN,Perlis,0,0,0
2022-03-01,SDN,Pulau Pinang,0,0,0
2022-03-01,SDN,Sabah,0,0,0
2022-03-01,SDN,Sarawak,0,0,0
2022-03-01,SDN,Selangor,217,131,86
2022-03-01,SDN,W.P. Labuan,1,1,0
2022-03-01,SEN,Johor,0,0,0
2022-03-01,SEN,Kedah,0,0,0
2022-03-01,SEN,Kelantan,0,0,0
2022-03-01,SEN,Perak,0,0,0
2022-03-01,SEN,Perlis,0,0,0
2022-03-01,SEN,Pulau Pinang,0,0,0
2022-03-01,SEN,Sabah,0,0,0
2022-03-01,SEN,Sarawak,0,0,0
2022-03-01,SEN,Selangor,11,7,4
2022-03-01,SGP,Johor,6932,3759,3173
2022-03-01,SGP,Kedah,23,11,12
2022-03-01,SGP,Kelantan,0,0,0
2022-03-01,SGP,Melaka,0,0,0
2022-03-01,SGP,Negeri Sembilan,0,0,0
2022-03-01,SGP,Pahang,0,0,0
2022-03-01,SGP,Perak,6,5,1
2022-03-01,SGP,Perlis,0,0,0
2022-03-01,SGP,Pulau Pinang,1061,555,506
2022-03-01,SGP,Sabah,2,1,1
2022-03-01,SGP,Sarawak,39,19,20
2022-03-01,SGP,Selangor,8282,4891,3391
2022-03-01,SGP,Terengganu,0,0,0
2022-03-01,SGP,W.P. Labuan,0,0,0
2022-03-01,SGS,Johor,0,0,0
2022-03-01,SGS,Sabah,0,0,0
2022-03-01,SGS,Selangor,0,0,0
2022-03-01,SHN,Sarawak,0,0,0
2022-03-01,SLB,Johor,0,0,0
2022-03-01,SLB,Perlis,0,0,0
2022-03-01,SLB,Pulau Pinang,0,0,0
2022-03-01,SLB,Sabah,0,0,0
2022-03-01,SLB,Sarawak,0,0,0
2022-03-01,SLB,Selangor,2,0,2
2022-03-01,SLB,W.P. Labuan,0,0,0
2022-03-01,SLE,Johor,0,0,0
2022-03-01,SLE,Kedah,0,0,0
2022-03-01,SLE,Perak,0,0,0
2022-03-01,SLE,Pulau Pinang,0,0,0
2022-03-01,SLE,Sabah,0,0,0
2022-03-01,SLE,Selangor,1,1,0
2022-03-01,SLV,Johor,0,0,0
2022-03-01,SLV,Kedah,0,0,0
2022-03-01,SLV,Perak,0,0,0
2022-03-01,SLV,Perlis,0,0,0
2022-03-01,SLV,Pulau Pinang,0,0,0
2022-03-01,SLV,Sabah,0,0,0
2022-03-01,SLV,Selangor,0,0,0
2022-03-01,SLV,W.P. Labuan,0,0,0
2022-03-01,SMR,Johor,0,0,0
2022-03-01,SMR,Selangor,0,0,0
2022-03-01,SOM,Johor,0,0,0
2022-03-01,SOM,Kedah,0,0,0
2022-03-01,SOM,Kelantan,0,0,0
2022-03-01,SOM,Perlis,0,0,0
2022-03-01,SOM,Sabah,0,0,0
2022-03-01,SOM,Sarawak,0,0,0
2022-03-01,SOM,Selangor,94,70,24
2022-03-01,SRB,Johor,0,0,0
2022-03-01,SRB,Kedah,0,0,0
2022-03-01,SRB,Kelantan,0,0,0
2022-03-01,SRB,Pahang,0,0,0
2022-03-01,SRB,Perak,0,0,0
2022-03-01,SRB,Perlis,0,0,0
2022-03-01,SRB,Pulau Pinang,0,0,0
2022-03-01,SRB,Sabah,0,0,0
2022-03-01,SRB,Sarawak,0,0,0
2022-03-01,SRB,Selangor,14,11,3
2022-03-01,SSD,Johor,0,0,0
2022-03-01,SSD,Kedah,0,0,0
2022-03-01,SSD,Sarawak,0,0,0
2022-03-01,SSD,Selangor,7,1,6
2022-03-01,SSD,W.P. Labuan,0,0,0
2022-03-01,STP,Selangor,0,0,0
2022-03-01,SUR,Johor,0,0,0
2022-03-01,SUR,Kedah,0,0,0
2022-03-01,SUR,Kelantan,0,0,0
2022-03-01,SUR,Perak,0,0,0
2022-03-01,SUR,Perlis,0,0,0
2022-03-01,SUR,Pulau Pinang,0,0,0
2022-03-01,SUR,Sabah,0,0,0
2022-03-01,SUR,Sarawak,0,0,0
2022-03-01,SUR,Selangor,0,0,0
2022-03-01,SVK,Johor,0,0,0
2022-03-01,SVK,Kedah,0,0,0
2022-03-01,SVK,Kelantan,0,0,0
2022-03-01,SVK,Negeri Sembilan,0,0,0
2022-03-01,SVK,Pahang,0,0,0
2022-03-01,SVK,Perak,0,0,0
2022-03-01,SVK,Perlis,0,0,0
2022-03-01,SVK,Pulau Pinang,0,0,0
2022-03-01,SVK,Sabah,0,0,0
2022-03-01,SVK,Sarawak,0,0,0
2022-03-01,SVK,Selangor,44,25,19
2022-03-01,SVK,W.P. Labuan,0,0,0
2022-03-01,SVN,Johor,0,0,0
2022-03-01,SVN,Kedah,0,0,0
2022-03-01,SVN,Kelantan,0,0,0
2022-03-01,SVN,Perak,0,0,0
2022-03-01,SVN,Perlis,0,0,0
2022-03-01,SVN,Pulau Pinang,0,0,0
2022-03-01,SVN,Sabah,0,0,0
2022-03-01,SVN,Sarawak,0,0,0
2022-03-01,SVN,Selangor,3,2,1
2022-03-01,SVN,W.P. Labuan,0,0,0
2022-03-01,SWE,Johor,0,0,0
2022-03-01,SWE,Kedah,0,0,0
2022-03-01,SWE,Kelantan,0,0,0
2022-03-01,SWE,Melaka,0,0,0
2022-03-01,SWE,Negeri Sembilan,0,0,0
2022-03-01,SWE,Pahang,0,0,0
2022-03-01,SWE,Perak,0,0,0
2022-03-01,SWE,Perlis,0,0,0
2022-03-01,SWE,Pulau Pinang,0,0,0
2022-03-01,SWE,Sabah,0,0,0
2022-03-01,SWE,Sarawak,0,0,0
2022-03-01,SWE,Selangor,92,72,20
2022-03-01,SWE,W.P. Labuan,0,0,0
2022-03-01,SWZ,Johor,0,0,0
2022-03-01,SWZ,Kedah,0,0,0
2022-03-01,SWZ,Pulau Pinang,0,0,0
2022-03-01,SWZ,Sabah,0,0,0
2022-03-01,SWZ,Selangor,15,5,10
2022-03-01,SYC,Johor,0,0,0
2022-03-01,SYC,Kedah,0,0,0
2022-03-01,SYC,Pulau Pinang,0,0,0
2022-03-01,SYC,Sabah,0,0,0
2022-03-01,SYC,Sarawak,1,1,0
2022-03-01,SYC,Selangor,17,4,13
2022-03-01,SYR,Johor,0,0,0
2022-03-01,SYR,Kedah,0,0,0
2022-03-01,SYR,Kelantan,0,0,0
2022-03-01,SYR,Pahang,0,0,0
2022-03-01,SYR,Perlis,0,0,0
2022-03-01,SYR,Pulau Pinang,0,0,0
2022-03-01,SYR,Sabah,0,0,0
2022-03-01,SYR,Sarawak,0,0,0
2022-03-01,SYR,Selangor,132,81,51
2022-03-01,SYR,W.P. Labuan,0,0,0
2022-03-01,TCA,Perlis,0,0,0
2022-03-01,TCD,Johor,0,0,0
2022-03-01,TCD,Kedah,0,0,0
2022-03-01,TCD,Perlis,0,0,0
2022-03-01,TCD,Selangor,10,9,1
2022-03-01,TGO,Johor,0,0,0
2022-03-01,TGO,Perak,0,0,0
2022-03-01,TGO,Pulau Pinang,0,0,0
2022-03-01,TGO,Selangor,1,1,0
2022-03-01,THA,Johor,69,67,2
2022-03-01,THA,Kedah,19836,19768,68
2022-03-01,THA,Kelantan,12,12,0
2022-03-01,THA,Melaka,0,0,0
2022-03-01,THA,Negeri Sembilan,0,0,0
2022-03-01,THA,Pahang,0,0,0
2022-03-01,THA,Perak,0,0,0
2022-03-01,THA,Perlis,10164,10007,157
2022-03-01,THA,Pulau Pinang,97,92,5
2022-03-01,THA,Sabah,2,0,2
2022-03-01,THA,Sarawak,20,20,0
2022-03-01,THA,Selangor,927,414,513
2022-03-01,THA,Terengganu,0,0,0
2022-03-01,THA,W.P. Labuan,0,0,0
2022-03-01,TJK,Johor,0,0,0
2022-03-01,TJK,Kedah,0,0,0
2022-03-01,TJK,Perlis,0,0,0
2022-03-01,TJK,Pulau Pinang,0,0,0
2022-03-01,TJK,Sabah,0,0,0
2022-03-01,TJK,Selangor,3,2,1
2022-03-01,TKL,Selangor,0,0,0
2022-03-01,TKM,Johor,0,0,0
2022-03-01,TKM,Kedah,0,0,0
2022-03-01,TKM,Kelantan,0,0,0
2022-03-01,TKM,Perlis,0,0,0
2022-03-01,TKM,Pulau Pinang,0,0,0
2022-03-01,TKM,Sabah,0,0,0
2022-03-01,TKM,Sarawak,0,0,0
2022-03-01,TKM,Selangor,10,5,5
2022-03-01,TLS,Johor,0,0,0
2022-03-01,TLS,Kedah,0,0,0
2022-03-01,TLS,Perlis,0,0,0
2022-03-01,TLS,Pulau Pinang,0,0,0
2022-03-01,TLS,Sabah,0,0,0
2022-03-01,TLS,Sarawak,0,0,0
2022-03-01,TLS,Selangor,23,10,13
2022-03-01,TON,Johor,0,0,0
2022-03-01,TON,Pulau Pinang,0,0,0
2022-03-01,TON,Sarawak,0,0,0
2022-03-01,TON,Selangor,1,1,0
2022-03-01,TTO,Johor,0,0,0
2022-03-01,TTO,Kedah,0,0,0
2022-03-01,TTO,Pahang,0,0,0
2022-03-01,TTO,Pulau Pinang,0,0,0
2022-03-01,TTO,Sabah,0,0,0
2022-03-01,TTO,Sarawak,0,0,0
2022-03-01,TTO,Selangor,5,4,1
2022-03-01,TUN,Johor,0,0,0
2022-03-01,TUN,Kedah,0,0,0
2022-03-01,TUN,Kelantan,0,0,0
2022-03-01,TUN,Melaka,0,0,0
2022-03-01,TUN,Perak,0,0,0
2022-03-01,TUN,Perlis,0,0,0
2022-03-01,TUN,Pulau Pinang,0,0,0
2022-03-01,TUN,Sabah,1,1,0
2022-03-01,TUN,Sarawak,0,0,0
2022-03-01,TUN,Selangor,19,5,14
2022-03-01,TUN,W.P. Labuan,0,0,0
2022-03-01,TUR,Johor,6,4,2
2022-03-01,TUR,Kedah,2,2,0
2022-03-01,TUR,Kelantan,0,0,0
2022-03-01,TUR,Melaka,0,0,0
2022-03-01,TUR,Negeri Sembilan,0,0,0
2022-03-01,TUR,Pahang,0,0,0
2022-03-01,TUR,Perak,0,0,0
2022-03-01,TUR,Perlis,0,0,0
2022-03-01,TUR,Pulau Pinang,0,0,0
2022-03-01,TUR,Sabah,0,0,0
2022-03-01,TUR,Sarawak,0,0,0
2022-03-01,TUR,Selangor,270,212,58
2022-03-01,TUR,W.P. Labuan,0,0,0
2022-03-01,TUV,Selangor,0,0,0
2022-03-01,TWN,Johor,6,4,2
2022-03-01,TWN,Kedah,4,3,1
2022-03-01,TWN,Kelantan,0,0,0
2022-03-01,TWN,Melaka,0,0,0
2022-03-01,TWN,Negeri Sembilan,0,0,0
2022-03-01,TWN,Pahang,0,0,0
2022-03-01,TWN,Perak,0,0,0
2022-03-01,TWN,Perlis,0,0,0
2022-03-01,TWN,Pulau Pinang,36,28,8
2022-03-01,TWN,Sabah,0,0,0
2022-03-01,TWN,Sarawak,1,1,0
2022-03-01,TWN,Selangor,228,137,91
2022-03-01,TWN,W.P. Labuan,0,0,0
2022-03-01,TZA,Johor,0,0,0
2022-03-01,TZA,Kedah,0,0,0
2022-03-01,TZA,Perak,0,0,0
2022-03-01,TZA,Perlis,0,0,0
2022-03-01,TZA,Pulau Pinang,0,0,0
2022-03-01,TZA,Sabah,0,0,0
2022-03-01,TZA,Sarawak,0,0,0
2022-03-01,TZA,Selangor,43,26,17
2022-03-01,UGA,Johor,0,0,0
2022-03-01,UGA,Kedah,0,0,0
2022-03-01,UGA,Perak,0,0,0
2022-03-01,UGA,Perlis,0,0,0
2022-03-01,UGA,Pulau Pinang,0,0,0
2022-03-01,UGA,Sabah,0,0,0
2022-03-01,UGA,Sarawak,0,0,0
2022-03-01,UGA,Selangor,20,17,3
2022-03-01,UKR,Johor,11,11,0
2022-03-01,UKR,Kedah,0,0,0
2022-03-01,UKR,Kelantan,0,0,0
2022-03-01,UKR,Melaka,0,0,0
2022-03-01,UKR,Negeri Sembilan,0,0,0
2022-03-01,UKR,Pahang,0,0,0
2022-03-01,UKR,Perak,0,0,0
2022-03-01,UKR,Perlis,0,0,0
2022-03-01,UKR,Pulau Pinang,0,0,0
2022-03-01,UKR,Sabah,0,0,0
2022-03-01,UKR,Sarawak,1,1,0
2022-03-01,UKR,Selangor,40,20,20
2022-03-01,UKR,W.P. Labuan,0,0,0
2022-03-01,URY,Johor,0,0,0
2022-03-01,URY,Kedah,0,0,0
2022-03-01,URY,Kelantan,0,0,0
2022-03-01,URY,Perak,0,0,0
2022-03-01,URY,Perlis,0,0,0
2022-03-01,URY,Pulau Pinang,0,0,0
2022-03-01,URY,Sabah,0,0,0
2022-03-01,URY,Sarawak,0,0,0
2022-03-01,URY,Selangor,1,1,0
2022-03-01,URY,W.P. Labuan,0,0,0
2022-03-01,USA,Johor,4,2,2
2022-03-01,USA,Kedah,37,22,15
2022-03-01,USA,Kelantan,0,0,0
2022-03-01,USA,Melaka,0,0,0
2022-03-01,USA,Negeri Sembilan,0,0,0
2022-03-01,USA,Pahang,0,0,0
2022-03-01,USA,Perak,0,0,0
2022-03-01,USA,Perlis,0,0,0
2022-03-01,USA,Pulau Pinang,58,35,23
2022-03-01,USA,Sabah,1,1,0
2022-03-01,USA,Sarawak,4,4,0
2022-03-01,USA,Selangor,823,569,254
2022-03-01,USA,Terengganu,0,0,0
2022-03-01,USA,W.P. Labuan,0,0,0
2022-03-01,UZB,Johor,0,0,0
2022-03-01,UZB,Kedah,0,0,0
2022-03-01,UZB,Kelantan,0,0,0
2022-03-01,UZB,Perak,0,0,0
2022-03-01,UZB,Perlis,0,0,0
2022-03-01,UZB,Pulau Pinang,0,0,0
2022-03-01,UZB,Sabah,0,0,0
2022-03-01,UZB,Sarawak,1,1,0
2022-03-01,UZB,Selangor,23,19,4
2022-03-01,VAT,Johor,0,0,0
2022-03-01,VAT,Sarawak,0,0,0
2022-03-01,VAT,Selangor,0,0,0
2022-03-01,VCT,Johor,0,0,0
2022-03-01,VCT,Kedah,0,0,0
2022-03-01,VCT,Pulau Pinang,0,0,0
2022-03-01,VCT,Sarawak,0,0,0
2022-03-01,VCT,Selangor,0,0,0
2022-03-01,VEN,Johor,0,0,0
2022-03-01,VEN,Kedah,0,0,0
2022-03-01,VEN,Kelantan,0,0,0
2022-03-01,VEN,Melaka,0,0,0
2022-03-01,VEN,Perak,0,0,0
2022-03-01,VEN,Perlis,0,0,0
2022-03-01,VEN,Pulau Pinang,0,0,0
2022-03-01,VEN,Sabah,0,0,0
2022-03-01,VEN,Sarawak,0,0,0
2022-03-01,VEN,Selangor,14,10,4
2022-03-01,VEN,W.P. Labuan,0,0,0
2022-03-01,VNM,Johor,5,0,5
2022-03-01,VNM,Kedah,62,6,56
2022-03-01,VNM,Kelantan,0,0,0
2022-03-01,VNM,Melaka,0,0,0
2022-03-01,VNM,Negeri Sembilan,0,0,0
2022-03-01,VNM,Pahang,0,0,0
2022-03-01,VNM,Perak,0,0,0
2022-03-01,VNM,Perlis,0,0,0
2022-03-01,VNM,Pulau Pinang,18,4,14
2022-03-01,VNM,Sabah,0,0,0
2022-03-01,VNM,Sarawak,4,0,4
2022-03-01,VNM,Selangor,774,235,539
2022-03-01,VNM,Terengganu,0,0,0
2022-03-01,VNM,W.P. Labuan,0,0,0
2022-03-01,VUT,Johor,0,0,0
2022-03-01,VUT,Kedah,0,0,0
2022-03-01,VUT,Pulau Pinang,0,0,0
2022-03-01,VUT,Sabah,0,0,0
2022-03-01,VUT,Sarawak,0,0,0
2022-03-01,VUT,Selangor,3,3,0
2022-03-01,WSM,Johor,0,0,0
2022-03-01,WSM,Sarawak,0,0,0
2022-03-01,WSM,Selangor,0,0,0
2022-03-01,XXX,Johor,0,0,0
2022-03-01,XXX,Kedah,0,0,0
2022-03-01,XXX,Kelantan,0,0,0
2022-03-01,XXX,Melaka,0,0,0
2022-03-01,XXX,Pahang,0,0,0
2022-03-01,XXX,Perak,0,0,0
2022-03-01,XXX,Perlis,0,0,0
2022-03-01,XXX,Pulau Pinang,1,1,0
2022-03-01,XXX,Sabah,0,0,0
2022-03-01,XXX,Sarawak,0,0,0
2022-03-01,XXX,Selangor,59,38,21
2022-03-01,XXX,W.P. Labuan,0,0,0
2022-03-01,YEM,Johor,0,0,0
2022-03-01,YEM,Kedah,1,1,0
2022-03-01,YEM,Kelantan,0,0,0
2022-03-01,YEM,Melaka,0,0,0
2022-03-01,YEM,Pahang,0,0,0
2022-03-01,YEM,Perak,0,0,0
2022-03-01,YEM,Perlis,0,0,0
2022-03-01,YEM,Pulau Pinang,0,0,0
2022-03-01,YEM,Sabah,0,0,0
2022-03-01,YEM,Sarawak,0,0,0
2022-03-01,YEM,Selangor,359,258,101
2022-03-01,YEM,W.P. Labuan,0,0,0
2022-03-01,ZAF,Johor,0,0,0
2022-03-01,ZAF,Kedah,1,0,1
2022-03-01,ZAF,Kelantan,0,0,0
2022-03-01,ZAF,Melaka,0,0,0
2022-03-01,ZAF,Pahang,0,0,0
2022-03-01,ZAF,Perak,0,0,0
2022-03-01,ZAF,Perlis,0,0,0
2022-03-01,ZAF,Pulau Pinang,1,0,1
2022-03-01,ZAF,Sabah,0,0,0
2022-03-01,ZAF,Sarawak,0,0,0
2022-03-01,ZAF,Selangor,95,64,31
2022-03-01,ZAF,Terengganu,0,0,0
2022-03-01,ZAF,W.P. Labuan,0,0,0
2022-03-01,ZAR,Selangor,0,0,0
2022-03-01,ZMB,Johor,0,0,0
2022-03-01,ZMB,Kedah,0,0,0
2022-03-01,ZMB,Perak,0,0,0
2022-03-01,ZMB,Perlis,0,0,0
2022-03-01,ZMB,Pulau Pinang,0,0,0
2022-03-01,ZMB,Sabah,0,0,0
2022-03-01,ZMB,Sarawak,0,0,0
2022-03-01,ZMB,Selangor,24,13,11
2022-03-01,ZWE,Johor,0,0,0
2022-03-01,ZWE,Kedah,0,0,0
2022-03-01,ZWE,Kelantan,0,0,0
2022-03-01,ZWE,Perak,0,0,0
2022-03-01,ZWE,Perlis,0,0,0
2022-03-01,ZWE,Pulau Pinang,0,0,0
2022-03-01,ZWE,Sabah,0,0,0
2022-03-01,ZWE,Sarawak,0,0,0
2022-03-01,ZWE,Selangor,26,8,18
2022-04-01,ABW,Kedah,1,0,1
2022-04-01,ABW,Pulau Pinang,0,0,0
2022-04-01,AFG,Johor,0,0,0
2022-04-01,AFG,Kedah,0,0,0
2022-04-01,AFG,Perlis,0,0,0
2022-04-01,AFG,Pulau Pinang,0,0,0
2022-04-01,AFG,Sarawak,0,0,0
2022-04-01,AFG,Selangor,103,78,25
2022-04-01,AGO,Johor,0,0,0
2022-04-01,AGO,Kedah,0,0,0
2022-04-01,AGO,Sabah,0,0,0
2022-04-01,AGO,Selangor,3,2,1
2022-04-01,AIA,Selangor,0,0,0
2022-04-01,ALB,Johor,3,2,1
2022-04-01,ALB,Kedah,0,0,0
2022-04-01,ALB,Perak,0,0,0
2022-04-01,ALB,Perlis,0,0,0
2022-04-01,ALB,Pulau Pinang,0,0,0
2022-04-01,ALB,Sabah,0,0,0
2022-04-01,ALB,Sarawak,0,0,0
2022-04-01,ALB,Selangor,16,9,7
2022-04-01,AND,Johor,0,0,0
2022-04-01,AND,Kedah,0,0,0
2022-04-01,AND,Perlis,0,0,0
2022-04-01,AND,Pulau Pinang,0,0,0
2022-04-01,AND,Selangor,2,2,0
2022-04-01,ANT,Selangor,0,0,0
2022-04-01,ARE,Johor,4,3,1
2022-04-01,ARE,Kedah,0,0,0
2022-04-01,ARE,Kelantan,0,0,0
2022-04-01,ARE,Perak,0,0,0
2022-04-01,ARE,Perlis,0,0,0
2022-04-01,ARE,Pulau Pinang,0,0,0
2022-04-01,ARE,Sabah,0,0,0
2022-04-01,ARE,Sarawak,0,0,0
2022-04-01,ARE,Selangor,61,35,26
2022-04-01,ARG,Johor,20,20,0
2022-04-01,ARG,Kedah,0,0,0
2022-04-01,ARG,Kelantan,0,0,0
2022-04-01,ARG,Melaka,0,0,0
2022-04-01,ARG,Perak,0,0,0
2022-04-01,ARG,Perlis,0,0,0
2022-04-01,ARG,Pulau Pinang,0,0,0
2022-04-01,ARG,Sabah,0,0,0
2022-04-01,ARG,Sarawak,1,1,0
2022-04-01,ARG,Selangor,79,51,28
2022-04-01,ARG,W.P. Labuan,0,0,0
2022-04-01,ARM,Johor,4,2,2
2022-04-01,ARM,Kedah,0,0,0
2022-04-01,ARM,Kelantan,0,0,0
2022-04-01,ARM,Perak,0,0,0
2022-04-01,ARM,Perlis,0,0,0
2022-04-01,ARM,Pulau Pinang,0,0,0
2022-04-01,ARM,Sabah,0,0,0
2022-04-01,ARM,Sarawak,0,0,0
2022-04-01,ARM,Selangor,6,1,5
2022-04-01,ATA,Selangor,1,0,1
2022-04-01,ATG,Johor,0,0,0
2022-04-01,ATG,Kedah,0,0,0
2022-04-01,ATG,Pulau Pinang,0,0,0
2022-04-01,ATG,Sarawak,0,0,0
2022-04-01,ATG,Selangor,7,5,2
2022-04-01,AUS,Johor,1385,872,513
2022-04-01,AUS,Kedah,180,104,76
2022-04-01,AUS,Kelantan,0,0,0
2022-04-01,AUS,Melaka,0,0,0
2022-04-01,AUS,Negeri Sembilan,0,0,0
2022-04-01,AUS,Pahang,1,1,0
2022-04-01,AUS,Perak,58,29,29
2022-04-01,AUS,Perlis,0,0,0
2022-04-01,AUS,Pulau Pinang,507,288,219
2022-04-01,AUS,Sabah,38,19,19
2022-04-01,AUS,Sarawak,72,38,34
2022-04-01,AUS,Selangor,4906,2956,1950
2022-04-01,AUS,Terengganu,1,1,0
2022-04-01,AUS,W.P. Labuan,0,0,0
2022-04-01,AUT,Johor,61,36,25
2022-04-01,AUT,Kedah,8,4,4
2022-04-01,AUT,Kelantan,0,0,0
2022-04-01,AUT,Melaka,0,0,0
2022-04-01,AUT,Negeri Sembilan,0,0,0
2022-04-01,AUT,Pahang,0,0,0
2022-04-01,AUT,Perak,1,0,1
2022-04-01,AUT,Perlis,0,0,0
2022-04-01,AUT,Pulau Pinang,19,17,2
2022-04-01,AUT,Sabah,7,4,3
2022-04-01,AUT,Sarawak,2,2,0
2022-04-01,AUT,Selangor,236,168,68
2022-04-01,AUT,Terengganu,0,0,0
2022-04-01,AUT,W.P. Labuan,0,0,0
2022-04-01,AZE,Johor,2,2,0
2022-04-01,AZE,Kedah,0,0,0
2022-04-01,AZE,Kelantan,0,0,0
2022-04-01,AZE,Melaka,0,0,0
2022-04-01,AZE,Perlis,0,0,0
2022-04-01,AZE,Pulau Pinang,0,0,0
2022-04-01,AZE,Sabah,0,0,0
2022-04-01,AZE,Sarawak,0,0,0
2022-04-01,AZE,Selangor,19,14,5
2022-04-01,AZE,W.P. Labuan,0,0,0
2022-04-01,BDI,Pulau Pinang,0,0,0
2022-04-01,BDI,Sarawak,0,0,0
2022-04-01,BDI,Selangor,6,3,3
2022-04-01,BEL,Johor,67,49,18
2022-04-01,BEL,Kedah,6,1,5
2022-04-01,BEL,Kelantan,0,0,0
2022-04-01,BEL,Melaka,0,0,0
2022-04-01,BEL,Negeri Sembilan,0,0,0
2022-04-01,BEL,Pahang,0,0,0
2022-04-01,BEL,Perak,1,1,0
2022-04-01,BEL,Perlis,0,0,0
2022-04-01,BEL,Pulau Pinang,19,13,6
2022-04-01,BEL,Sabah,5,2,3
2022-04-01,BEL,Sarawak,1,1,0
2022-04-01,BEL,Selangor,228,156,72
2022-04-01,BEL,W.P. Labuan,0,0,0
2022-04-01,BEN,Johor,0,0,0
2022-04-01,BEN,Kedah,0,0,0
2022-04-01,BEN,Perak,0,0,0
2022-04-01,BEN,Pulau Pinang,0,0,0
2022-04-01,BEN,Sabah,0,0,0
2022-04-01,BEN,Sarawak,0,0,0
2022-04-01,BEN,Selangor,1,1,0
2022-04-01,BFA,Perak,0,0,0
2022-04-01,BFA,Pulau Pinang,0,0,0
2022-04-01,BFA,Selangor,0,0,0
2022-04-01,BGD,Johor,289,247,42
2022-04-01,BGD,Kedah,0,0,0
2022-04-01,BGD,Kelantan,0,0,0
2022-04-01,BGD,Melaka,0,0,0
2022-04-01,BGD,Negeri Sembilan,0,0,0
2022-04-01,BGD,Pahang,0,0,0
2022-04-01,BGD,Perak,0,0,0
2022-04-01,BGD,Perlis,0,0,0
2022-04-01,BGD,Pulau Pinang,7,7,0
2022-04-01,BGD,Sabah,0,0,0
2022-04-01,BGD,Sarawak,2,2,0
2022-04-01,BGD,Selangor,8825,8242,583
2022-04-01,BGD,W.P. Labuan,0,0,0
2022-04-01,BGR,Johor,25,19,6
2022-04-01,BGR,Kedah,4,2,2
2022-04-01,BGR,Kelantan,0,0,0
2022-04-01,BGR,Pahang,0,0,0
2022-04-01,BGR,Perak,0,0,0
2022-04-01,BGR,Perlis,0,0,0
2022-04-01,BGR,Pulau Pinang,2,1,1
2022-04-01,BGR,Sabah,0,0,0
2022-04-01,BGR,Sarawak,0,0,0
2022-04-01,BGR,Selangor,45,29,16
2022-04-01,BGR,W.P. Labuan,0,0,0
2022-04-01,BHR,Johor,0,0,0
2022-04-01,BHR,Kedah,0,0,0
2022-04-01,BHR,Kelantan,0,0,0
2022-04-01,BHR,Perlis,0,0,0
2022-04-01,BHR,Pulau Pinang,0,0,0
2022-04-01,BHR,Sabah,0,0,0
2022-04-01,BHR,Sarawak,0,0,0
2022-04-01,BHR,Selangor,17,13,4
2022-04-01,BHS,Johor,0,0,0
2022-04-01,BHS,Kedah,0,0,0
2022-04-01,BHS,Perak,0,0,0
2022-04-01,BHS,Sabah,0,0,0
2022-04-01,BHS,Sarawak,0,0,0
2022-04-01,BHS,Selangor,2,0,2
2022-04-01,BIH,Johor,1,1,0
2022-04-01,BIH,Kedah,0,0,0
2022-04-01,BIH,Perlis,0,0,0
2022-04-01,BIH,Pulau Pinang,0,0,0
2022-04-01,BIH,Sabah,0,0,0
2022-04-01,BIH,Sarawak,0,0,0
2022-04-01,BIH,Selangor,23,12,11
2022-04-01,BLR,Johor,5,1,4
2022-04-01,BLR,Kedah,2,0,2
2022-04-01,BLR,Kelantan,0,0,0
2022-04-01,BLR,Pahang,0,0,0
2022-04-01,BLR,Perak,0,0,0
2022-04-01,BLR,Perlis,0,0,0
2022-04-01,BLR,Pulau Pinang,1,1,0
2022-04-01,BLR,Sabah,0,0,0
2022-04-01,BLR,Sarawak,0,0,0
2022-04-01,BLR,Selangor,45,24,21
2022-04-01,BLR,W.P. Labuan,0,0,0
2022-04-01,BLZ,Johor,0,0,0
2022-04-01,BLZ,Pulau Pinang,0,0,0
2022-04-01,BLZ,Sarawak,0,0,0
2022-04-01,BLZ,Selangor,2,1,1
2022-04-01,BMU,Selangor,0,0,0
2022-04-01,BOL,Johor,0,0,0
2022-04-01,BOL,Kedah,0,0,0
2022-04-01,BOL,Melaka,0,0,0
2022-04-01,BOL,Perak,0,0,0
2022-04-01,BOL,Perlis,0,0,0
2022-04-01,BOL,Pulau Pinang,0,0,0
2022-04-01,BOL,Sabah,0,0,0
2022-04-01,BOL,Sarawak,0,0,0
2022-04-01,BOL,Selangor,2,1,1
2022-04-01,BRA,Johor,113,62,51
2022-04-01,BRA,Kedah,15,5,10
2022-04-01,BRA,Kelantan,0,0,0
2022-04-01,BRA,Melaka,0,0,0
2022-04-01,BRA,Pahang,0,0,0
2022-04-01,BRA,Perak,0,0,0
2022-04-01,BRA,Perlis,0,0,0
2022-04-01,BRA,Pulau Pinang,7,4,3
2022-04-01,BRA,Sabah,3,1,2
2022-04-01,BRA,Sarawak,0,0,0
2022-04-01,BRA,Selangor,223,130,93
2022-04-01,BRA,W.P. Labuan,0,0,0
2022-04-01,BRB,Johor,0,0,0
2022-04-01,BRB,Kedah,0,0,0
2022-04-01,BRB,Perlis,0,0,0
2022-04-01,BRB,Pulau Pinang,0,0,0
2022-04-01,BRB,Selangor,2,1,1
2022-04-01,BRN,Johor,36,20,16
2022-04-01,BRN,Kedah,0,0,0
2022-04-01,BRN,Kelantan,0,0,0
2022-04-01,BRN,Melaka,0,0,0
2022-04-01,BRN,Pahang,0,0,0
2022-04-01,BRN,Perak,0,0,0
2022-04-01,BRN,Perlis,0,0,0
2022-04-01,BRN,Pulau Pinang,0,0,0
2022-04-01,BRN,Sabah,1,0,1
2022-04-01,BRN,Sarawak,593,553,40
2022-04-01,BRN,Selangor,605,325,280
2022-04-01,BRN,W.P. Labuan,12,9,3
2022-04-01,BTN,Johor,0,0,0
2022-04-01,BTN,Kedah,0,0,0
2022-04-01,BTN,Perak,0,0,0
2022-04-01,BTN,Perlis,0,0,0
2022-04-01,BTN,Pulau Pinang,0,0,0
2022-04-01,BTN,Sabah,0,0,0
2022-04-01,BTN,Sarawak,0,0,0
2022-04-01,BTN,Selangor,3,1,2
2022-04-01,BWA,Johor,0,0,0
2022-04-01,BWA,Kedah,0,0,0
2022-04-01,BWA,Perlis,0,0,0
2022-04-01,BWA,Pulau Pinang,0,0,0
2022-04-01,BWA,Sabah,0,0,0
2022-04-01,BWA,Sarawak,0,0,0
2022-04-01,BWA,Selangor,4,1,3
2022-04-01,CAF,Kedah,0,0,0
2022-04-01,CAF,Selangor,0,0,0
2022-04-01,CAN,Johor,423,266,157
2022-04-01,CAN,Kedah,22,11,11
2022-04-01,CAN,Kelantan,0,0,0
2022-04-01,CAN,Melaka,0,0,0
2022-04-01,CAN,Negeri Sembilan,0,0,0
2022-04-01,CAN,Pahang,0,0,0
2022-04-01,CAN,Perak,3,2,1
2022-04-01,CAN,Perlis,0,0,0
2022-04-01,CAN,Pulau Pinang,74,44,30
2022-04-01,CAN,Sabah,10,5,5
2022-04-01,CAN,Sarawak,11,8,3
2022-04-01,CAN,Selangor,1066,665,401
2022-04-01,CAN,Terengganu,0,0,0
2022-04-01,CAN,W.P. Labuan,0,0,0
2022-04-01,CCK,Selangor,0,0,0
2022-04-01,CHE,Johor,121,80,41
2022-04-01,CHE,Kedah,11,6,5
2022-04-01,CHE,Kelantan,0,0,0
2022-04-01,CHE,Melaka,0,0,0
2022-04-01,CHE,Negeri Sembilan,0,0,0
2022-04-01,CHE,Pahang,0,0,0
2022-04-01,CHE,Perak,2,2,0
2022-04-01,CHE,Perlis,0,0,0
2022-04-01,CHE,Pulau Pinang,41,29,12
2022-04-01,CHE,Sabah,4,3,1
2022-04-01,CHE,Sarawak,5,1,4
2022-04-01,CHE,Selangor,385,245,140
2022-04-01,CHE,W.P. Labuan,0,0,0
2022-04-01,CHL,Johor,7,5,2
2022-04-01,CHL,Kedah,0,0,0
2022-04-01,CHL,Kelantan,0,0,0
2022-04-01,CHL,Melaka,0,0,0
2022-04-01,CHL,Pahang,0,0,0
2022-04-01,CHL,Perak,0,0,0
2022-04-01,CHL,Perlis,0,0,0
2022-04-01,CHL,Pulau Pinang,0,0,0
2022-04-01,CHL,Sabah,0,0,0
2022-04-01,CHL,Sarawak,0,0,0
2022-04-01,CHL,Selangor,39,30,9
2022-04-01,CHN,Johor,3993,1819,2174
2022-04-01,CHN,Kedah,39,19,20
2022-04-01,CHN,Kelantan,0,0,0
2022-04-01,CHN,Melaka,0,0,0
2022-04-01,CHN,Pahang,5,0,5
2022-04-01,CHN,Perak,23,14,9
2022-04-01,CHN,Perlis,0,0,0
2022-04-01,CHN,Pulau Pinang,170,72,98
2022-04-01,CHN,Sabah,51,21,30
2022-04-01,CHN,Sarawak,63,50,13
2022-04-01,CHN,Selangor,5200,3512,1688
2022-04-01,CHN,Terengganu,0,0,0
2022-04-01,CHN,W.P. Labuan,1,0,1
2022-04-01,CIV,Johor,0,0,0
2022-04-01,CIV,Kedah,0,0,0
2022-04-01,CIV,Pulau Pinang,0,0,0
2022-04-01,CIV,Sabah,0,0,0
2022-04-01,CIV,Sarawak,0,0,0
2022-04-01,CIV,Selangor,3,0,3
2022-04-01,CMR,Johor,0,0,0
2022-04-01,CMR,Kedah,0,0,0
2022-04-01,CMR,Pulau Pinang,1,1,0
2022-04-01,CMR,Sabah,0,0,0
2022-04-01,CMR,Sarawak,0,0,0
2022-04-01,CMR,Selangor,7,5,2
2022-04-01,COD,Johor,0,0,0
2022-04-01,COD,Pulau Pinang,0,0,0
2022-04-01,COD,Sarawak,0,0,0
2022-04-01,COD,Selangor,2,2,0
2022-04-01,COG,Johor,0,0,0
2022-04-01,COG,Kedah,0,0,0
2022-04-01,COG,Selangor,1,1,0
2022-04-01,COK,Selangor,0,0,0
2022-04-01,COL,Johor,15,4,11
2022-04-01,COL,Kedah,0,0,0
2022-04-01,COL,Perak,0,0,0
2022-04-01,COL,Pulau Pinang,3,1,2
2022-04-01,COL,Sabah,0,0,0
2022-04-01,COL,Sarawak,0,0,0
2022-04-01,COL,Selangor,34,17,17
2022-04-01,COL,W.P. Labuan,0,0,0
2022-04-01,COM,Johor,0,0,0
2022-04-01,COM,Kedah,0,0,0
2022-04-01,COM,Selangor,13,6,7
2022-04-01,CPV,Johor,0,0,0
2022-04-01,CPV,Kedah,0,0,0
2022-04-01,CPV,Pulau Pinang,0,0,0
2022-04-01,CPV,Sabah,0,0,0
2022-04-01,CPV,Selangor,2,0,2
2022-04-01,CRI,Johor,2,1,1
2022-04-01,CRI,Kedah,0,0,0
2022-04-01,CRI,Perak,0,0,0
2022-04-01,CRI,Perlis,0,0,0
2022-04-01,CRI,Pulau Pinang,1,0,1
2022-04-01,CRI,Sabah,0,0,0
2022-04-01,CRI,Sarawak,0,0,0
2022-04-01,CRI,Selangor,18,9,9
2022-04-01,CUB,Johor,0,0,0
2022-04-01,CUB,Kedah,0,0,0
2022-04-01,CUB,Perlis,0,0,0
2022-04-01,CUB,Pulau Pinang,0,0,0
2022-04-01,CUB,Sabah,0,0,0
2022-04-01,CUB,Sarawak,0,0,0
2022-04-01,CUB,Selangor,5,4,1
2022-04-01,CYP,Johor,5,4,1
2022-04-01,CYP,Kedah,0,0,0
2022-04-01,CYP,Perak,0,0,0
2022-04-01,CYP,Perlis,0,0,0
2022-04-01,CYP,Pulau Pinang,1,1,0
2022-04-01,CYP,Sabah,0,0,0
2022-04-01,CYP,Sarawak,0,0,0
2022-04-01,CYP,Selangor,7,6,1
2022-04-01,CZE,Johor,40,27,13
2022-04-01,CZE,Kedah,9,7,2
2022-04-01,CZE,Kelantan,0,0,0
2022-04-01,CZE,Melaka,0,0,0
2022-04-01,CZE,Negeri Sembilan,0,0,0
2022-04-01,CZE,Perak,0,0,0
2022-04-01,CZE,Perlis,0,0,0
2022-04-01,CZE,Pulau Pinang,10,5,5
2022-04-01,CZE,Sabah,1,0,1
2022-04-01,CZE,Sarawak,0,0,0
2022-04-01,CZE,Selangor,95,63,32
2022-04-01,CZE,W.P. Labuan,0,0,0
2022-04-01,DEU,Johor,645,472,173
2022-04-01,DEU,Kedah,60,36,24
2022-04-01,DEU,Kelantan,0,0,0
2022-04-01,DEU,Melaka,0,0,0
2022-04-01,DEU,Negeri Sembilan,2,1,1
2022-04-01,DEU,Pahang,0,0,0
2022-04-01,DEU,Perak,8,6,2
2022-04-01,DEU,Perlis,0,0,0
2022-04-01,DEU,Pulau Pinang,205,139,66
2022-04-01,DEU,Sabah,39,24,15
2022-04-01,DEU,Sarawak,11,9,2
2022-04-01,DEU,Selangor,1826,1326,500
2022-04-01,DEU,Terengganu,0,0,0
2022-04-01,DEU,W.P. Labuan,0,0,0
2022-04-01,DJI,Johor,0,0,0
2022-04-01,DJI,Selangor,6,3,3
2022-04-01,DMA,Johor,0,0,0
2022-04-01,DMA,Kedah,0,0,0
2022-04-01,DMA,Pulau Pinang,0,0,0
2022-04-01,DMA,Sabah,0,0,0
2022-04-01,DMA,Sarawak,0,0,0
2022-04-01,DMA,Selangor,14,11,3
2022-04-01,DMA,W.P. Labuan,0,0,0
2022-04-01,DNK,Johor,97,67,30
2022-04-01,DNK,Kedah,18,14,4
2022-04-01,DNK,Kelantan,0,0,0
2022-04-01,DNK,Melaka,0,0,0
2022-04-01,DNK,Negeri Sembilan,0,0,0
2022-04-01,DNK,Pahang,0,0,0
2022-04-01,DNK,Perak,1,1,0
2022-04-01,DNK,Perlis,0,0,0
2022-04-01,DNK,Pulau Pinang,28,20,8
2022-04-01,DNK,Sabah,0,0,0
2022-04-01,DNK,Sarawak,2,2,0
2022-04-01,DNK,Selangor,373,254,119
2022-04-01,DNK,W.P. Labuan,0,0,0
2022-04-01,DOM,Johor,0,0,0
2022-04-01,DOM,Kedah,0,0,0
2022-04-01,DOM,Perak,0,0,0
2022-04-01,DOM,Perlis,0,0,0
2022-04-01,DOM,Pulau Pinang,0,0,0
2022-04-01,DOM,Sabah,0,0,0
2022-04-01,DOM,Sarawak,0,0,0
2022-04-01,DOM,Selangor,0,0,0
2022-04-01,DZA,Johor,5,5,0
2022-04-01,DZA,Kedah,2,2,0
2022-04-01,DZA,Kelantan,0,0,0
2022-04-01,DZA,Melaka,0,0,0
2022-04-01,DZA,Perak,0,0,0
2022-04-01,DZA,Perlis,0,0,0
2022-04-01,DZA,Pulau Pinang,0,0,0
2022-04-01,DZA,Sabah,0,0,0
2022-04-01,DZA,Sarawak,0,0,0
2022-04-01,DZA,Selangor,112,80,32
2022-04-01,DZA,W.P. Labuan,0,0,0
2022-04-01,ECU,Johor,5,1,4
2022-04-01,ECU,Kedah,0,0,0
2022-04-01,ECU,Perak,0,0,0
2022-04-01,ECU,Perlis,0,0,0
2022-04-01,ECU,Pulau Pinang,0,0,0
2022-04-01,ECU,Sabah,0,0,0
2022-04-01,ECU,Sarawak,0,0,0
2022-04-01,ECU,Selangor,23,15,8
2022-04-01,EGY,Johor,37,35,2
2022-04-01,EGY,Kedah,1,1,0
2022-04-01,EGY,Kelantan,0,0,0
2022-04-01,EGY,Melaka,0,0,0
2022-04-01,EGY,Pahang,0,0,0
2022-04-01,EGY,Perak,0,0,0
2022-04-01,EGY,Perlis,0,0,0
2022-04-01,EGY,Pulau Pinang,2,2,0
2022-04-01,EGY,Sabah,0,0,0
2022-04-01,EGY,Sarawak,0,0,0
2022-04-01,EGY,Selangor,608,420,188
2022-04-01,EGY,Terengganu,0,0,0
2022-04-01,EGY,W.P. Labuan,0,0,0
2022-04-01,ERI,Johor,0,0,0
2022-04-01,ERI,Pulau Pinang,0,0,0
2022-04-01,ERI,Sabah,0,0,0
2022-04-01,ERI,Selangor,9,6,3
2022-04-01,ESP,Johor,115,68,47
2022-04-01,ESP,Kedah,17,9,8
2022-04-01,ESP,Kelantan,0,0,0
2022-04-01,ESP,Melaka,0,0,0
2022-04-01,ESP,Negeri Sembilan,0,0,0
2022-04-01,ESP,Pahang,0,0,0
2022-04-01,ESP,Perak,0,0,0
2022-04-01,ESP,Perlis,0,0,0
2022-04-01,ESP,Pulau Pinang,7,4,3
2022-04-01,ESP,Sabah,2,0,2
2022-04-01,ESP,Sarawak,2,0,2
2022-04-01,ESP,Selangor,456,285,171
2022-04-01,ESP,W.P. Labuan,0,0,0
2022-04-01,EST,Johor,5,2,3
2022-04-01,EST,Kedah,0,0,0
2022-04-01,EST,Kelantan,0,0,0
2022-04-01,EST,Pahang,0,0,0
2022-04-01,EST,Perak,0,0,0
2022-04-01,EST,Perlis,0,0,0
2022-04-01,EST,Pulau Pinang,2,2,0
2022-04-01,EST,Sabah,0,0,0
2022-04-01,EST,Sarawak,1,1,0
2022-04-01,EST,Selangor,24,12,12
2022-04-01,EST,W.P. Labuan,0,0,0
2022-04-01,ETH,Johor,0,0,0
2022-04-01,ETH,Kedah,0,0,0
2022-04-01,ETH,Pulau Pinang,0,0,0
2022-04-01,ETH,Sarawak,0,0,0
2022-04-01,ETH,Selangor,6,4,2
2022-04-01,FIN,Johor,92,59,33
2022-04-01,FIN,Kedah,6,3,3
2022-04-01,FIN,Kelantan,0,0,0
2022-04-01,FIN,Melaka,0,0,0
2022-04-01,FIN,Negeri Sembilan,0,0,0
2022-04-01,FIN,Pahang,0,0,0
2022-04-01,FIN,Perak,0,0,0
2022-04-01,FIN,Perlis,0,0,0
2022-04-01,FIN,Pulau Pinang,6,3,3
2022-04-01,FIN,Sabah,3,0,3
2022-04-01,FIN,Sarawak,0,0,0
2022-04-01,FIN,Selangor,170,115,55
2022-04-01,FIN,W.P. Labuan,0,0,0
2022-04-01,FJI,Johor,6,2,4
2022-04-01,FJI,Kedah,1,0,1
2022-04-01,FJI,Kelantan,0,0,0
2022-04-01,FJI,Perak,0,0,0
2022-04-01,FJI,Perlis,0,0,0
2022-04-01,FJI,Pulau Pinang,0,0,0
2022-04-01,FJI,Sabah,0,0,0
2022-04-01,FJI,Sarawak,1,0,1
2022-04-01,FJI,Selangor,21,11,10
2022-04-01,FRA,Johor,956,602,354
2022-04-01,FRA,Kedah,74,45,29
2022-04-01,FRA,Kelantan,0,0,0
2022-04-01,FRA,Melaka,0,0,0
2022-04-01,FRA,Negeri Sembilan,0,0,0
2022-04-01,FRA,Pahang,0,0,0
2022-04-01,FRA,Perak,4,2,2
2022-04-01,FRA,Perlis,2,2,0
2022-04-01,FRA,Pulau Pinang,151,93,58
2022-04-01,FRA,Sabah,32,18,14
2022-04-01,FRA,Sarawak,11,8,3
2022-04-01,FRA,Selangor,1898,1268,630
2022-04-01,FRA,Terengganu,0,0,0
2022-04-01,FRA,W.P. Labuan,1,1,0
2022-04-01,FSM,Johor,0,0,0
2022-04-01,FSM,Pulau Pinang,0,0,0
2022-04-01,FSM,Selangor,0,0,0
2022-04-01,GAB,Johor,4,0,4
2022-04-01,GAB,Pulau Pinang,0,0,0
2022-04-01,GAB,Sarawak,0,0,0
2022-04-01,GAB,Selangor,4,1,3
2022-04-01,GBR,Johor,1787,1174,613
2022-04-01,GBR,Kedah,194,107,87
2022-04-01,GBR,Kelantan,0,0,0
2022-04-01,GBR,Melaka,0,0,0
2022-04-01,GBR,Negeri Sembilan,0,0,0
2022-04-01,GBR,Pahang,3,3,0
2022-04-01,GBR,Perak,12,8,4
2022-04-01,GBR,Perlis,1,1,0
2022-04-01,GBR,Pulau Pinang,434,241,193
2022-04-01,GBR,Sabah,61,35,26
2022-04-01,GBR,Sarawak,26,21,5
2022-04-01,GBR,Selangor,5778,3741,2037
2022-04-01,GBR,Terengganu,1,1,0
2022-04-01,GBR,W.P. Labuan,0,0,0
2022-04-01,GEO,Johor,3,1,2
2022-04-01,GEO,Kedah,0,0,0
2022-04-01,GEO,Melaka,0,0,0
2022-04-01,GEO,Perak,0,0,0
2022-04-01,GEO,Perlis,0,0,0
2022-04-01,GEO,Pulau Pinang,0,0,0
2022-04-01,GEO,Sabah,0,0,0
2022-04-01,GEO,Sarawak,0,0,0
2022-04-01,GEO,Selangor,9,7,2
2022-04-01,GHA,Johor,3,0,3
2022-04-01,GHA,Kedah,0,0,0
2022-04-01,GHA,Kelantan,0,0,0
2022-04-01,GHA,Pulau Pinang,0,0,0
2022-04-01,GHA,Sabah,0,0,0
2022-04-01,GHA,Sarawak,0,0,0
2022-04-01,GHA,Selangor,13,11,2
2022-04-01,GIB,Johor,0,0,0
2022-04-01,GIB,Sarawak,0,0,0
2022-04-01,GIN,Johor,0,0,0
2022-04-01,GIN,Kedah,0,0,0
2022-04-01,GIN,Kelantan,0,0,0
2022-04-01,GIN,Perlis,0,0,0
2022-04-01,GIN,Pulau Pinang,0,0,0
2022-04-01,GIN,Sabah,0,0,0
2022-04-01,GIN,Sarawak,0,0,0
2022-04-01,GIN,Selangor,14,10,4
2022-04-01,GLP,Selangor,0,0,0
2022-04-01,GMB,Johor,0,0,0
2022-04-01,GMB,Kedah,0,0,0
2022-04-01,GMB,Kelantan,0,0,0
2022-04-01,GMB,Pulau Pinang,0,0,0
2022-04-01,GMB,Sabah,0,0,0
2022-04-01,GMB,Sarawak,0,0,0
2022-04-01,GMB,Selangor,13,5,8
2022-04-01,GNB,Johor,0,0,0
2022-04-01,GNB,Selangor,0,0,0
2022-04-01,GNQ,Johor,0,0,0
2022-04-01,GNQ,Selangor,0,0,0
2022-04-01,GRC,Johor,22,16,6
2022-04-01,GRC,Kedah,3,2,1
2022-04-01,GRC,Kelantan,0,0,0
2022-04-01,GRC,Melaka,0,0,0
2022-04-01,GRC,Negeri Sembilan,0,0,0
2022-04-01,GRC,Pahang,0,0,0
2022-04-01,GRC,Perak,0,0,0
2022-04-01,GRC,Perlis,0,0,0
2022-04-01,GRC,Pulau Pinang,1,1,0
2022-04-01,GRC,Sabah,0,0,0
2022-04-01,GRC,Sarawak,0,0,0
2022-04-01,GRC,Selangor,59,48,11
2022-04-01,GRD,Johor,4,3,1
2022-04-01,GRD,Kedah,0,0,0
2022-04-01,GRD,Pulau Pinang,0,0,0
2022-04-01,GRD,Sabah,0,0,0
2022-04-01,GRD,Sarawak,0,0,0
2022-04-01,GRD,Selangor,6,5,1
2022-04-01,GRL,Johor,0,0,0
2022-04-01,GRL,Selangor,0,0,0
2022-04-01,GTM,Johor,0,0,0
2022-04-01,GTM,Kedah,0,0,0
2022-04-01,GTM,Pahang,0,0,0
2022-04-01,GTM,Perak,0,0,0
2022-04-01,GTM,Pulau Pinang,0,0,0
2022-04-01,GTM,Sabah,0,0,0
2022-04-01,GTM,Sarawak,0,0,0
2022-04-01,GTM,Selangor,7,5,2
2022-04-01,GTM,W.P. Labuan,0,0,0
2022-04-01,GUY,Johor,0,0,0
2022-04-01,GUY,Kedah,0,0,0
2022-04-01,GUY,Pulau Pinang,0,0,0
2022-04-01,GUY,Sarawak,0,0,0
2022-04-01,GUY,Selangor,0,0,0
2022-04-01,HKG,Johor,2,2,0
2022-04-01,HKG,Kedah,12,3,9
2022-04-01,HKG,Kelantan,0,0,0
2022-04-01,HKG,Pahang,0,0,0
2022-04-01,HKG,Perak,3,1,2
2022-04-01,HKG,Perlis,0,0,0
2022-04-01,HKG,Pulau Pinang,60,32,28
2022-04-01,HKG,Sabah,3,1,2
2022-04-01,HKG,Sarawak,24,15,9
2022-04-01,HKG,Selangor,5,4,1
2022-04-01,HKG,Terengganu,0,0,0
2022-04-01,HMD,Johor,0,0,0
2022-04-01,HND,Johor,3,2,1
2022-04-01,HND,Kedah,0,0,0
2022-04-01,HND,Perak,0,0,0
2022-04-01,HND,Pulau Pinang,0,0,0
2022-04-01,HND,Sabah,0,0,0
2022-04-01,HND,Sarawak,0,0,0
2022-04-01,HND,Selangor,10,6,4
2022-04-01,HRV,Johor,8,6,2
2022-04-01,HRV,Kedah,0,0,0
2022-04-01,HRV,Kelantan,0,0,0
2022-04-01,HRV,Melaka,0,0,0
2022-04-01,HRV,Pahang,0,0,0
2022-04-01,HRV,Perak,0,0,0
2022-04-01,HRV,Perlis,0,0,0
2022-04-01,HRV,Pulau Pinang,2,0,2
2022-04-01,HRV,Sabah,0,0,0
2022-04-01,HRV,Sarawak,0,0,0
2022-04-01,HRV,Selangor,48,34,14
2022-04-01,HTI,Johor,0,0,0
2022-04-01,HTI,Kedah,0,0,0
2022-04-01,HTI,Kelantan,0,0,0
2022-04-01,HTI,Perak,0,0,0
2022-04-01,HTI,Pulau Pinang,0,0,0
2022-04-01,HTI,Sabah,0,0,0
2022-04-01,HTI,Selangor,0,0,0
2022-04-01,HUN,Johor,36,20,16
2022-04-01,HUN,Kedah,5,3,2
2022-04-01,HUN,Kelantan,0,0,0
2022-04-01,HUN,Pahang,0,0,0
2022-04-01,HUN,Perak,0,0,0
2022-04-01,HUN,Perlis,0,0,0
2022-04-01,HUN,Pulau Pinang,1,0,1
2022-04-01,HUN,Sabah,10,5,5
2022-04-01,HUN,Sarawak,2,2,0
2022-04-01,HUN,Selangor,73,40,33
2022-04-01,HUN,W.P. Labuan,0,0,0
2022-04-01,IDN,Johor,13063,4386,8677
2022-04-01,IDN,Kedah,33,17,16
2022-04-01,IDN,Kelantan,0,0,0
2022-04-01,IDN,Melaka,10,10,0
2022-04-01,IDN,Negeri Sembilan,0,0,0
2022-04-01,IDN,Pahang,9,9,0
2022-04-01,IDN,Perak,16,4,12
2022-04-01,IDN,Perlis,0,0,0
2022-04-01,IDN,Pulau Pinang,2382,999,1383
2022-04-01,IDN,Sabah,953,516,437
2022-04-01,IDN,Sarawak,1670,1087,583
2022-04-01,IDN,Selangor,17630,8318,9312
2022-04-01,IDN,Terengganu,0,0,0
2022-04-01,IDN,W.P. Labuan,10,9,1
2022-04-01,IND,Johor,2938,2074,864
2022-04-01,IND,Kedah,87,44,43
2022-04-01,IND,Kelantan,0,0,0
2022-04-01,IND,Melaka,0,0,0
2022-04-01,IND,Negeri Sembilan,0,0,0
2022-04-01,IND,Pahang,0,0,0
2022-04-01,IND,Perak,9,7,2
2022-04-01,IND,Perlis,0,0,0
2022-04-01,IND,Pulau Pinang,180,125,55
2022-04-01,IND,Sabah,64,34,30
2022-04-01,IND,Sarawak,13,10,3
2022-04-01,IND,Selangor,13641,9834,3807
2022-04-01,IND,Terengganu,0,0,0
2022-04-01,IND,W.P. Labuan,1,1,0
2022-04-01,IOT,Pulau Pinang,0,0,0
2022-04-01,IOT,Selangor,0,0,0
2022-04-01,IRL,Johor,109,81,28
2022-04-01,IRL,Kedah,7,2,5
2022-04-01,IRL,Kelantan,0,0,0
2022-04-01,IRL,Negeri Sembilan,0,0,0
2022-04-01,IRL,Pahang,0,0,0
2022-04-01,IRL,Perak,1,0,1
2022-04-01,IRL,Perlis,0,0,0
2022-04-01,IRL,Pulau Pinang,37,28,9
2022-04-01,IRL,Sabah,4,2,2
2022-04-01,IRL,Sarawak,0,0,0
2022-04-01,IRL,Selangor,371,250,121
2022-04-01,IRL,Terengganu,0,0,0
2022-04-01,IRL,W.P. Labuan,0,0,0
2022-04-01,IRN,Johor,25,17,8
2022-04-01,IRN,Kedah,0,0,0
2022-04-01,IRN,Kelantan,0,0,0
2022-04-01,IRN,Perak,0,0,0
2022-04-01,IRN,Perlis,0,0,0
2022-04-01,IRN,Pulau Pinang,1,1,0
2022-04-01,IRN,Sabah,0,0,0
2022-04-01,IRN,Sarawak,0,0,0
2022-04-01,IRN,Selangor,704,396,308
2022-04-01,IRN,W.P. Labuan,0,0,0
2022-04-01,IRQ,Johor,4,4,0
2022-04-01,IRQ,Kedah,0,0,0
2022-04-01,IRQ,Kelantan,0,0,0
2022-04-01,IRQ,Melaka,0,0,0
2022-04-01,IRQ,Pahang,0,0,0
2022-04-01,IRQ,Perak,0,0,0
2022-04-01,IRQ,Perlis,0,0,0
2022-04-01,IRQ,Pulau Pinang,0,0,0
2022-04-01,IRQ,Sabah,0,0,0
2022-04-01,IRQ,Sarawak,0,0,0
2022-04-01,IRQ,Selangor,443,296,147
2022-04-01,ISL,Johor,1,0,1
2022-04-01,ISL,Kedah,0,0,0
2022-04-01,ISL,Kelantan,0,0,0
2022-04-01,ISL,Perak,0,0,0
2022-04-01,ISL,Perlis,0,0,0
2022-04-01,ISL,Pulau Pinang,5,4,1
2022-04-01,ISL,Sabah,0,0,0
2022-04-01,ISL,Sarawak,0,0,0
2022-04-01,ISL,Selangor,7,4,3
2022-04-01,ISL,W.P. Labuan,0,0,0
2022-04-01,ISR,Pulau Pinang,0,0,0
2022-04-01,ITA,Johor,250,162,88
2022-04-01,ITA,Kedah,10,5,5
2022-04-01,ITA,Kelantan,0,0,0
2022-04-01,ITA,Melaka,0,0,0
2022-04-01,ITA,Negeri Sembilan,0,0,0
2022-04-01,ITA,Pahang,0,0,0
2022-04-01,ITA,Perak,1,0,1
2022-04-01,ITA,Perlis,0,0,0
2022-04-01,ITA,Pulau Pinang,33,29,4
2022-04-01,ITA,Sabah,4,3,1
2022-04-01,ITA,Sarawak,3,3,0
2022-04-01,ITA,Selangor,551,433,118
2022-04-01,ITA,W.P. Labuan,0,0,0
2022-04-01,JAM,Johor,0,0,0
2022-04-01,JAM,Kedah,0,0,0
2022-04-01,JAM,Perak,0,0,0
2022-04-01,JAM,Pulau Pinang,2,0,2
2022-04-01,JAM,Sabah,0,0,0
2022-04-01,JAM,Sarawak,0,0,0
2022-04-01,JAM,Selangor,2,1,1
2022-04-01,JAM,W.P. Labuan,0,0,0
2022-04-01,JOR,Johor,5,3,2
2022-04-01,JOR,Kedah,0,0,0
2022-04-01,JOR,Kelantan,0,0,0
2022-04-01,JOR,Melaka,0,0,0
2022-04-01,JOR,Perlis,0,0,0
2022-04-01,JOR,Pulau Pinang,0,0,0
2022-04-01,JOR,Sabah,0,0,0
2022-04-01,JOR,Sarawak,0,0,0
2022-04-01,JOR,Selangor,286,179,107
2022-04-01,JOR,W.P. Labuan,0,0,0
2022-04-01,JPN,Johor,1387,964,423
2022-04-01,JPN,Kedah,17,8,9
2022-04-01,JPN,Kelantan,0,0,0
2022-04-01,JPN,Melaka,0,0,0
2022-04-01,JPN,Negeri Sembilan,0,0,0
2022-04-01,JPN,Pahang,0,0,0
2022-04-01,JPN,Perak,1,1,0
2022-04-01,JPN,Perlis,0,0,0
2022-04-01,JPN,Pulau Pinang,228,148,80
2022-04-01,JPN,Sabah,41,23,18
2022-04-01,JPN,Sarawak,8,5,3
2022-04-01,JPN,Selangor,3673,2445,1228
2022-04-01,JPN,W.P. Labuan,0,0,0
2022-04-01,KAZ,Johor,14,6,8
2022-04-01,KAZ,Kedah,1,0,1
2022-04-01,KAZ,Kelantan,0,0,0
2022-04-01,KAZ,Melaka,0,0,0
2022-04-01,KAZ,Perak,0,0,0
2022-04-01,KAZ,Perlis,0,0,0
2022-04-01,KAZ,Pulau Pinang,2,2,0
2022-04-01,KAZ,Sabah,0,0,0
2022-04-01,KAZ,Sarawak,1,0,1
2022-04-01,KAZ,Selangor,173,69,104
2022-04-01,KAZ,W.P. Labuan,0,0,0
2022-04-01,KEN,Johor,5,4,1
2022-04-01,KEN,Kedah,1,0,1
2022-04-01,KEN,Kelantan,0,0,0
2022-04-01,KEN,Perak,0,0,0
2022-04-01,KEN,Perlis,0,0,0
2022-04-01,KEN,Pulau Pinang,0,0,0
2022-04-01,KEN,Sabah,1,0,1
2022-04-01,KEN,Sarawak,0,0,0
2022-04-01,KEN,Selangor,111,57,54
2022-04-01,KGZ,Johor,3,1,2
2022-04-01,KGZ,Kedah,0,0,0
2022-04-01,KGZ,Kelantan,0,0,0
2022-04-01,KGZ,Perak,0,0,0
2022-04-01,KGZ,Perlis,0,0,0
2022-04-01,KGZ,Pulau Pinang,0,0,0
2022-04-01,KGZ,Sabah,0,0,0
2022-04-01,KGZ,Sarawak,0,0,0
2022-04-01,KGZ,Selangor,108,70,38
2022-04-01,KHM,Johor,41,17,24
2022-04-01,KHM,Kedah,2,2,0
2022-04-01,KHM,Kelantan,0,0,0
2022-04-01,KHM,Melaka,6,0,6
2022-04-01,KHM,Negeri Sembilan,0,0,0
2022-04-01,KHM,Pahang,0,0,0
2022-04-01,KHM,Perak,0,0,0
2022-04-01,KHM,Perlis,0,0,0
2022-04-01,KHM,Pulau Pinang,7,4,3
2022-04-01,KHM,Sabah,0,0,0
2022-04-01,KHM,Sarawak,0,0,0
2022-04-01,KHM,Selangor,942,600,342
2022-04-01,KHM,W.P. Labuan,0,0,0
2022-04-01,KIR,Johor,0,0,0
2022-04-01,KIR,Sabah,0,0,0
2022-04-01,KIR,Selangor,0,0,0
2022-04-01,KNA,Johor,10,8,2
2022-04-01,KNA,Kedah,0,0,0
2022-04-01,KNA,Perlis,0,0,0
2022-04-01,KNA,Pulau Pinang,0,0,0
2022-04-01,KNA,Sabah,0,0,0
2022-04-01,KNA,Selangor,19,13,6
2022-04-01,KNA,W.P. Labuan,0,0,0
2022-04-01,KOR,Johor,2176,1330,846
2022-04-01,KOR,Kedah,21,7,14
2022-04-01,KOR,Kelantan,0,0,0
2022-04-01,KOR,Melaka,0,0,0
2022-04-01,KOR,Negeri Sembilan,0,0,0
2022-04-01,KOR,Pahang,0,0,0
2022-04-01,KOR,Perak,2,2,0
2022-04-01,KOR,Perlis,0,0,0
2022-04-01,KOR,Pulau Pinang,78,46,32
2022-04-01,KOR,Sabah,30,13,17
2022-04-01,KOR,Sarawak,35,30,5
2022-04-01,KOR,Selangor,3246,2236,1010
2022-04-01,KOR,Terengganu,0,0,0
2022-04-01,KOR,W.P. Labuan,0,0,0
2022-04-01,KWT,Johor,0,0,0
2022-04-01,KWT,Kedah,0,0,0
2022-04-01,KWT,Kelantan,0,0,0
2022-04-01,KWT,Perak,0,0,0
2022-04-01,KWT,Perlis,0,0,0
2022-04-01,KWT,Pulau Pinang,0,0,0
2022-04-01,KWT,Sabah,0,0,0
2022-04-01,KWT,Sarawak,0,0,0
2022-04-01,KWT,Selangor,89,48,41
2022-04-01,KWT,W.P. Labuan,0,0,0
2022-04-01,LAO,Johor,6,0,6
2022-04-01,LAO,Kedah,16,3,13
2022-04-01,LAO,Kelantan,0,0,0
2022-04-01,LAO,Melaka,0,0,0
2022-04-01,LAO,Perak,0,0,0
2022-04-01,LAO,Perlis,0,0,0
2022-04-01,LAO,Pulau Pinang,1,0,1
2022-04-01,LAO,Sabah,0,0,0
2022-04-01,LAO,Sarawak,0,0,0
2022-04-01,LAO,Selangor,270,248,22
2022-04-01,LAO,W.P. Labuan,0,0,0
2022-04-01,LBN,Johor,5,3,2
2022-04-01,LBN,Kedah,1,1,0
2022-04-01,LBN,Kelantan,0,0,0
2022-04-01,LBN,Pahang,0,0,0
2022-04-01,LBN,Perak,0,0,0
2022-04-01,LBN,Perlis,0,0,0
2022-04-01,LBN,Pulau Pinang,5,1,4
2022-04-01,LBN,Sabah,0,0,0
2022-04-01,LBN,Sarawak,0,0,0
2022-04-01,LBN,Selangor,91,57,34
2022-04-01,LBN,W.P. Labuan,0,0,0
2022-04-01,LBR,Johor,0,0,0
2022-04-01,LBR,Kedah,0,0,0
2022-04-01,LBR,Sabah,0,0,0
2022-04-01,LBR,Sarawak,0,0,0
2022-04-01,LBR,Selangor,0,0,0
2022-04-01,LBY,Johor,0,0,0
2022-04-01,LBY,Kedah,0,0,0
2022-04-01,LBY,Perlis,0,0,0
2022-04-01,LBY,Pulau Pinang,0,0,0
2022-04-01,LBY,Sabah,0,0,0
2022-04-01,LBY,Sarawak,0,0,0
2022-04-01,LBY,Selangor,133,84,49
2022-04-01,LCA,Johor,2,2,0
2022-04-01,LCA,Kedah,0,0,0
2022-04-01,LCA,Pulau Pinang,0,0,0
2022-04-01,LCA,Sarawak,0,0,0
2022-04-01,LCA,Selangor,1,1,0
2022-04-01,LIE,Johor,0,0,0
2022-04-01,LIE,Kedah,0,0,0
2022-04-01,LIE,Perlis,0,0,0
2022-04-01,LIE,Pulau Pinang,0,0,0
2022-04-01,LIE,Sabah,0,0,0
2022-04-01,LIE,Sarawak,0,0,0
2022-04-01,LIE,Selangor,1,1,0
2022-04-01,LKA,Johor,189,132,57
2022-04-01,LKA,Kedah,0,0,0
2022-04-01,LKA,Kelantan,0,0,0
2022-04-01,LKA,Melaka,0,0,0
2022-04-01,LKA,Pahang,0,0,0
2022-04-01,LKA,Perak,0,0,0
2022-04-01,LKA,Perlis,0,0,0
2022-04-01,LKA,Pulau Pinang,4,3,1
2022-04-01,LKA,Sabah,0,0,0
2022-04-01,LKA,Sarawak,1,0,1
2022-04-01,LKA,Selangor,1035,605,430
2022-04-01,LKA,W.P. Labuan,0,0,0
2022-04-01,LSO,Johor,0,0,0
2022-04-01,LSO,Kedah,0,0,0
2022-04-01,LSO,Pulau Pinang,0,0,0
2022-04-01,LSO,Sarawak,0,0,0
2022-04-01,LSO,Selangor,5,0,5
2022-04-01,LTU,Johor,5,4,1
2022-04-01,LTU,Kedah,2,0,2
2022-04-01,LTU,Kelantan,0,0,0
2022-04-01,LTU,Pahang,0,0,0
2022-04-01,LTU,Perak,0,0,0
2022-04-01,LTU,Perlis,0,0,0
2022-04-01,LTU,Pulau Pinang,0,0,0
2022-04-01,LTU,Sabah,0,0,0
2022-04-01,LTU,Sarawak,2,1,1
2022-04-01,LTU,Selangor,54,28,26
2022-04-01,LTU,W.P. Labuan,0,0,0
2022-04-01,LUX,Johor,2,1,1
2022-04-01,LUX,Kedah,0,0,0
2022-04-01,LUX,Kelantan,0,0,0
2022-04-01,LUX,Perak,0,0,0
2022-04-01,LUX,Perlis,0,0,0
2022-04-01,LUX,Pulau Pinang,1,1,0
2022-04-01,LUX,Sabah,0,0,0
2022-04-01,LUX,Sarawak,0,0,0
2022-04-01,LUX,Selangor,10,8,2
2022-04-01,LVA,Johor,4,1,3
2022-04-01,LVA,Kedah,1,1,0
2022-04-01,LVA,Kelantan,0,0,0
2022-04-01,LVA,Pahang,0,0,0
2022-04-01,LVA,Perak,0,0,0
2022-04-01,LVA,Perlis,0,0,0
2022-04-01,LVA,Pulau Pinang,2,0,2
2022-04-01,LVA,Sabah,1,0,1
2022-04-01,LVA,Sarawak,0,0,0
2022-04-01,LVA,Selangor,24,13,11
2022-04-01,LVA,W.P. Labuan,0,0,0
2022-04-01,MAC,Johor,0,0,0
2022-04-01,MAC,Pahang,0,0,0
2022-04-01,MAC,Perak,0,0,0
2022-04-01,MAC,Selangor,0,0,0
2022-04-01,MAC,W.P. Labuan,0,0,0
2022-04-01,MAR,Johor,26,15,11
2022-04-01,MAR,Kedah,1,1,0
2022-04-01,MAR,Kelantan,0,0,0
2022-04-01,MAR,Melaka,0,0,0
2022-04-01,MAR,Pahang,0,0,0
2022-04-01,MAR,Perak,0,0,0
2022-04-01,MAR,Perlis,0,0,0
2022-04-01,MAR,Pulau Pinang,1,1,0
2022-04-01,MAR,Sabah,0,0,0
2022-04-01,MAR,Sarawak,0,0,0
2022-04-01,MAR,Selangor,108,46,62
2022-04-01,MAR,W.P. Labuan,0,0,0
2022-04-01,MCO,Johor,0,0,0
2022-04-01,MCO,Kedah,0,0,0
2022-04-01,MCO,Sabah,0,0,0
2022-04-01,MCO,Selangor,0,0,0
2022-04-01,MDA,Johor,0,0,0
2022-04-01,MDA,Kedah,0,0,0
2022-04-01,MDA,Kelantan,0,0,0
2022-04-01,MDA,Negeri Sembilan,0,0,0
2022-04-01,MDA,Perlis,0,0,0
2022-04-01,MDA,Pulau Pinang,0,0,0
2022-04-01,MDA,Sabah,0,0,0
2022-04-01,MDA,Sarawak,0,0,0
2022-04-01,MDA,Selangor,12,3,9
2022-04-01,MDG,Johor,0,0,0
2022-04-01,MDG,Kedah,0,0,0
2022-04-01,MDG,Perak,0,0,0
2022-04-01,MDG,Perlis,0,0,0
2022-04-01,MDG,Pulau Pinang,0,0,0
2022-04-01,MDG,Sabah,0,0,0
2022-04-01,MDG,Sarawak,0,0,0
2022-04-01,MDG,Selangor,3,1,2
2022-04-01,MDV,Johor,32,24,8
2022-04-01,MDV,Kedah,1,1,0
2022-04-01,MDV,Kelantan,0,0,0
2022-04-01,MDV,Perak,0,0,0
2022-04-01,MDV,Perlis,0,0,0
2022-04-01,MDV,Pulau Pinang,0,0,0
2022-04-01,MDV,Sabah,0,0,0
2022-04-01,MDV,Sarawak,0,0,0
2022-04-01,MDV,Selangor,1020,535,485
2022-04-01,MEX,Johor,34,20,14
2022-04-01,MEX,Kedah,2,1,1
2022-04-01,MEX,Kelantan,0,0,0
2022-04-01,MEX,Pahang,0,0,0
2022-04-01,MEX,Perak,0,0,0
2022-04-01,MEX,Perlis,0,0,0
2022-04-01,MEX,Pulau Pinang,9,7,2
2022-04-01,MEX,Sabah,4,3,1
2022-04-01,MEX,Sarawak,1,1,0
2022-04-01,MEX,Selangor,115,71,44
2022-04-01,MEX,W.P. Labuan,0,0,0
2022-04-01,MHL,Johor,2,2,0
2022-04-01,MHL,Kedah,0,0,0
2022-04-01,MHL,Perak,0,0,0
2022-04-01,MHL,Pulau Pinang,0,0,0
2022-04-01,MHL,Sabah,0,0,0
2022-04-01,MHL,Selangor,0,0,0
2022-04-01,MKD,Johor,1,0,1
2022-04-01,MKD,Kedah,0,0,0
2022-04-01,MKD,Perak,0,0,0
2022-04-01,MKD,Pulau Pinang,2,2,0
2022-04-01,MKD,Sabah,0,0,0
2022-04-01,MKD,Sarawak,0,0,0
2022-04-01,MKD,Selangor,7,2,5
2022-04-01,MLI,Johor,0,0,0
2022-04-01,MLI,Sabah,0,0,0
2022-04-01,MLI,Selangor,2,2,0
2022-04-01,MLT,Johor,1,1,0
2022-04-01,MLT,Kedah,0,0,0
2022-04-01,MLT,Kelantan,0,0,0
2022-04-01,MLT,Perak,0,0,0
2022-04-01,MLT,Perlis,0,0,0
2022-04-01,MLT,Pulau Pinang,0,0,0
2022-04-01,MLT,Sabah,0,0,0
2022-04-01,MLT,Sarawak,0,0,0
2022-04-01,MLT,Selangor,10,7,3
2022-04-01,MLT,W.P. Labuan,0,0,0
2022-04-01,MMR,Johor,542,164,378
2022-04-01,MMR,Kedah,3,2,1
2022-04-01,MMR,Kelantan,0,0,0
2022-04-01,MMR,Negeri Sembilan,0,0,0
2022-04-01,MMR,Pahang,0,0,0
2022-04-01,MMR,Perak,2,1,1
2022-04-01,MMR,Perlis,0,0,0
2022-04-01,MMR,Pulau Pinang,14,2,12
2022-04-01,MMR,Sabah,3,1,2
2022-04-01,MMR,Sarawak,3,1,2
2022-04-01,MMR,Selangor,634,410,224
2022-04-01,MMR,Terengganu,0,0,0
2022-04-01,MMR,W.P. Labuan,0,0,0
2022-04-01,MNE,Johor,0,0,0
2022-04-01,MNE,Kedah,0,0,0
2022-04-01,MNE,Pulau Pinang,0,0,0
2022-04-01,MNE,Sabah,0,0,0
2022-04-01,MNE,Sarawak,0,0,0
2022-04-01,MNE,Selangor,4,3,1
2022-04-01,MNG,Johor,14,5,9
2022-04-01,MNG,Kedah,0,0,0
2022-04-01,MNG,Kelantan,0,0,0
2022-04-01,MNG,Perak,1,0,1
2022-04-01,MNG,Perlis,0,0,0
2022-04-01,MNG,Pulau Pinang,0,0,0
2022-04-01,MNG,Sabah,0,0,0
2022-04-01,MNG,Sarawak,0,0,0
2022-04-01,MNG,Selangor,73,27,46
2022-04-01,MNP,Selangor,0,0,0
2022-04-01,MOZ,Johor,0,0,0
2022-04-01,MOZ,Kedah,0,0,0
2022-04-01,MOZ,Perak,0,0,0
2022-04-01,MOZ,Pulau Pinang,0,0,0
2022-04-01,MOZ,Sabah,0,0,0
2022-04-01,MOZ,Sarawak,0,0,0
2022-04-01,MOZ,Selangor,9,7,2
2022-04-01,MRT,Johor,0,0,0
2022-04-01,MRT,Kedah,0,0,0
2022-04-01,MRT,Pulau Pinang,0,0,0
2022-04-01,MRT,Sabah,0,0,0
2022-04-01,MRT,Sarawak,0,0,0
2022-04-01,MRT,Selangor,9,9,0
2022-04-01,MUS,Johor,21,9,12
2022-04-01,MUS,Kedah,0,0,0
2022-04-01,MUS,Kelantan,0,0,0
2022-04-01,MUS,Pahang,0,0,0
2022-04-01,MUS,Perak,0,0,0
2022-04-01,MUS,Perlis,0,0,0
2022-04-01,MUS,Pulau Pinang,0,0,0
2022-04-01,MUS,Sabah,0,0,0
2022-04-01,MUS,Sarawak,0,0,0
2022-04-01,MUS,Selangor,73,40,33
2022-04-01,MWI,Johor,0,0,0
2022-04-01,MWI,Pulau Pinang,0,0,0
2022-04-01,MWI,Sabah,0,0,0
2022-04-01,MWI,Sarawak,0,0,0
2022-04-01,MWI,Selangor,4,3,1
2022-04-01,MYT,Selangor,0,0,0
2022-04-01,NAM,Johor,0,0,0
2022-04-01,NAM,Kedah,0,0,0
2022-04-01,NAM,Perak,0,0,0
2022-04-01,NAM,Perlis,0,0,0
2022-04-01,NAM,Pulau Pinang,0,0,0
2022-04-01,NAM,Sabah,0,0,0
2022-04-01,NAM,Sarawak,0,0,0
2022-04-01,NAM,Selangor,8,4,4
2022-04-01,NCL,Selangor,0,0,0
2022-04-01,NER,Johor,0,0,0
2022-04-01,NER,Sabah,0,0,0
2022-04-01,NER,Selangor,3,3,0
2022-04-01,NGA,Johor,10,6,4
2022-04-01,NGA,Kedah,0,0,0
2022-04-01,NGA,Perlis,0,0,0
2022-04-01,NGA,Pulau Pinang,2,2,0
2022-04-01,NGA,Sabah,0,0,0
2022-04-01,NGA,Sarawak,2,2,0
2022-04-01,NGA,Selangor,249,192,57
2022-04-01,NIC,Johor,1,0,1
2022-04-01,NIC,Kedah,0,0,0
2022-04-01,NIC,Pulau Pinang,0,0,0
2022-04-01,NIC,Sabah,0,0,0
2022-04-01,NIC,Selangor,4,1,3
2022-04-01,NLD,Johor,316,217,99
2022-04-01,NLD,Kedah,34,21,13
2022-04-01,NLD,Kelantan,0,0,0
2022-04-01,NLD,Melaka,0,0,0
2022-04-01,NLD,Negeri Sembilan,0,0,0
2022-04-01,NLD,Pahang,0,0,0
2022-04-01,NLD,Perak,0,0,0
2022-04-01,NLD,Perlis,2,2,0
2022-04-01,NLD,Pulau Pinang,65,48,17
2022-04-01,NLD,Sabah,8,6,2
2022-04-01,NLD,Sarawak,6,5,1
2022-04-01,NLD,Selangor,1164,783,381
2022-04-01,NLD,Terengganu,0,0,0
2022-04-01,NLD,W.P. Labuan,0,0,0
2022-04-01,NOR,Johor,65,44,21
2022-04-01,NOR,Kedah,1,1,0
2022-04-01,NOR,Kelantan,0,0,0
2022-04-01,NOR,Melaka,0,0,0
2022-04-01,NOR,Pahang,0,0,0
2022-04-01,NOR,Perak,0,0,0
2022-04-01,NOR,Perlis,0,0,0
2022-04-01,NOR,Pulau Pinang,9,5,4
2022-04-01,NOR,Sabah,0,0,0
2022-04-01,NOR,Sarawak,0,0,0
2022-04-01,NOR,Selangor,309,178,131
2022-04-01,NOR,W.P. Labuan,0,0,0
2022-04-01,NPL,Johor,18,16,2
2022-04-01,NPL,Kedah,2,1,1
2022-04-01,NPL,Pahang,0,0,0
2022-04-01,NPL,Perak,0,0,0
2022-04-01,NPL,Perlis,0,0,0
2022-04-01,NPL,Pulau Pinang,1,1,0
2022-04-01,NPL,Sabah,0,0,0
2022-04-01,NPL,Sarawak,0,0,0
2022-04-01,NPL,Selangor,2635,2464,171
2022-04-01,NPL,W.P. Labuan,0,0,0
2022-04-01,NRU,Johor,0,0,0
2022-04-01,NRU,Pulau Pinang,0,0,0
2022-04-01,NRU,Selangor,0,0,0
2022-04-01,NZL,Johor,177,119,58
2022-04-01,NZL,Kedah,15,9,6
2022-04-01,NZL,Kelantan,0,0,0
2022-04-01,NZL,Melaka,0,0,0
2022-04-01,NZL,Negeri Sembilan,0,0,0
2022-04-01,NZL,Pahang,0,0,0
2022-04-01,NZL,Perak,5,1,4
2022-04-01,NZL,Perlis,0,0,0
2022-04-01,NZL,Pulau Pinang,53,33,20
2022-04-01,NZL,Sabah,5,2,3
2022-04-01,NZL,Sarawak,12,10,2
2022-04-01,NZL,Selangor,502,316,186
2022-04-01,NZL,Terengganu,0,0,0
2022-04-01,NZL,W.P. Labuan,0,0,0
2022-04-01,OMN,Johor,0,0,0
2022-04-01,OMN,Kedah,0,0,0
2022-04-01,OMN,Kelantan,0,0,0
2022-04-01,OMN,Melaka,0,0,0
2022-04-01,OMN,Perak,0,0,0
2022-04-01,OMN,Perlis,0,0,0
2022-04-01,OMN,Pulau Pinang,0,0,0
2022-04-01,OMN,Sabah,0,0,0
2022-04-01,OMN,Sarawak,0,0,0
2022-04-01,OMN,Selangor,149,88,61
2022-04-01,PAK,Johor,140,119,21
2022-04-01,PAK,Kedah,22,16,6
2022-04-01,PAK,Kelantan,0,0,0
2022-04-01,PAK,Melaka,0,0,0
2022-04-01,PAK,Negeri Sembilan,0,0,0
2022-04-01,PAK,Pahang,0,0,0
2022-04-01,PAK,Perak,0,0,0
2022-04-01,PAK,Perlis,0,0,0
2022-04-01,PAK,Pulau Pinang,2,2,0
2022-04-01,PAK,Sabah,0,0,0
2022-04-01,PAK,Sarawak,1,1,0
2022-04-01,PAK,Selangor,3638,3113,525
2022-04-01,PAK,W.P. Labuan,0,0,0
2022-04-01,PAN,Johor,2,1,1
2022-04-01,PAN,Kedah,0,0,0
2022-04-01,PAN,Perak,0,0,0
2022-04-01,PAN,Perlis,0,0,0
2022-04-01,PAN,Pulau Pinang,0,0,0
2022-04-01,PAN,Sabah,0,0,0
2022-04-01,PAN,Sarawak,0,0,0
2022-04-01,PAN,Selangor,4,3,1
2022-04-01,PER,Johor,8,5,3
2022-04-01,PER,Kedah,0,0,0
2022-04-01,PER,Kelantan,0,0,0
2022-04-01,PER,Pahang,0,0,0
2022-04-01,PER,Perak,0,0,0
2022-04-01,PER,Perlis,0,0,0
2022-04-01,PER,Pulau Pinang,5,2,3
2022-04-01,PER,Sabah,0,0,0
2022-04-01,PER,Sarawak,0,0,0
2022-04-01,PER,Selangor,34,22,12
2022-04-01,PER,W.P. Labuan,0,0,0
2022-04-01,PHL,Johor,3228,845,2383
2022-04-01,PHL,Kedah,25,6,19
2022-04-01,PHL,Kelantan,0,0,0
2022-04-01,PHL,Melaka,0,0,0
2022-04-01,PHL,Negeri Sembilan,0,0,0
2022-04-01,PHL,Pahang,2,2,0
2022-04-01,PHL,Perak,7,4,3
2022-04-01,PHL,Perlis,0,0,0
2022-04-01,PHL,Pulau Pinang,108,49,59
2022-04-01,PHL,Sabah,9,4,5
2022-04-01,PHL,Sarawak,41,35,6
2022-04-01,PHL,Selangor,3792,1739,2053
2022-04-01,PHL,Terengganu,0,0,0
2022-04-01,PHL,W.P. Labuan,6,2,4
2022-04-01,PLW,Johor,0,0,0
2022-04-01,PLW,Pulau Pinang,0,0,0
2022-04-01,PLW,Selangor,0,0,0
2022-04-01,PNG,Johor,2,1,1
2022-04-01,PNG,Kedah,0,0,0
2022-04-01,PNG,Kelantan,0,0,0
2022-04-01,PNG,Perak,0,0,0
2022-04-01,PNG,Pulau Pinang,1,1,0
2022-04-01,PNG,Sabah,0,0,0
2022-04-01,PNG,Sarawak,1,0,1
2022-04-01,PNG,Selangor,8,7,1
2022-04-01,POL,Johor,93,57,36
2022-04-01,POL,Kedah,6,2,4
2022-04-01,POL,Kelantan,0,0,0
2022-04-01,POL,Melaka,0,0,0
2022-04-01,POL,Negeri Sembilan,0,0,0
2022-04-01,POL,Pahang,0,0,0
2022-04-01,POL,Perak,0,0,0
2022-04-01,POL,Perlis,0,0,0
2022-04-01,POL,Pulau Pinang,11,5,6
2022-04-01,POL,Sabah,1,1,0
2022-04-01,POL,Sarawak,0,0,0
2022-04-01,POL,Selangor,209,133,76
2022-04-01,POL,Terengganu,0,0,0
2022-04-01,POL,W.P. Labuan,0,0,0
2022-04-01,PRK,Selangor,0,0,0
2022-04-01,PRT,Johor,79,48,31
2022-04-01,PRT,Kedah,13,9,4
2022-04-01,PRT,Kelantan,0,0,0
2022-04-01,PRT,Melaka,0,0,0
2022-04-01,PRT,Pahang,0,0,0
2022-04-01,PRT,Perak,0,0,0
2022-04-01,PRT,Perlis,0,0,0
2022-04-01,PRT,Pulau Pinang,14,5,9
2022-04-01,PRT,Sabah,1,0,1
2022-04-01,PRT,Sarawak,0,0,0
2022-04-01,PRT,Selangor,184,121,63
2022-04-01,PRT,W.P. Labuan,0,0,0
2022-04-01,PRY,Johor,1,0,1
2022-04-01,PRY,Kedah,0,0,0
2022-04-01,PRY,Perak,0,0,0
2022-04-01,PRY,Perlis,0,0,0
2022-04-01,PRY,Pulau Pinang,0,0,0
2022-04-01,PRY,Sabah,0,0,0
2022-04-01,PRY,Sarawak,0,0,0
2022-04-01,PRY,Selangor,3,1,2
2022-04-01,PSE,Johor,4,4,0
2022-04-01,PSE,Kedah,0,0,0
2022-04-01,PSE,Kelantan,0,0,0
2022-04-01,PSE,Melaka,0,0,0
2022-04-01,PSE,Perak,0,0,0
2022-04-01,PSE,Perlis,0,0,0
2022-04-01,PSE,Pulau Pinang,0,0,0
2022-04-01,PSE,Sabah,0,0,0
2022-04-01,PSE,Sarawak,0,0,0
2022-04-01,PSE,Selangor,142,111,31
2022-04-01,QAT,Johor,0,0,0
2022-04-01,QAT,Kedah,0,0,0
2022-04-01,QAT,Perlis,0,0,0
2022-04-01,QAT,Pulau Pinang,0,0,0
2022-04-01,QAT,Sabah,0,0,0
2022-04-01,QAT,Sarawak,0,0,0
2022-04-01,QAT,Selangor,21,13,8
2022-04-01,REU,Johor,0,0,0
2022-04-01,REU,Sarawak,0,0,0
2022-04-01,ROU,Johor,30,17,13
2022-04-01,ROU,Kedah,1,0,1
2022-04-01,ROU,Kelantan,0,0,0
2022-04-01,ROU,Negeri Sembilan,0,0,0
2022-04-01,ROU,Pahang,0,0,0
2022-04-01,ROU,Perak,0,0,0
2022-04-01,ROU,Perlis,0,0,0
2022-04-01,ROU,Pulau Pinang,3,1,2
2022-04-01,ROU,Sabah,0,0,0
2022-04-01,ROU,Sarawak,1,1,0
2022-04-01,ROU,Selangor,126,73,53
2022-04-01,ROU,W.P. Labuan,0,0,0
2022-04-01,RUS,Johor,102,58,44
2022-04-01,RUS,Kedah,26,15,11
2022-04-01,RUS,Kelantan,0,0,0
2022-04-01,RUS,Melaka,0,0,0
2022-04-01,RUS,Negeri Sembilan,0,0,0
2022-04-01,RUS,Pahang,0,0,0
2022-04-01,RUS,Perak,0,0,0
2022-04-01,RUS,Perlis,0,0,0
2022-04-01,RUS,Pulau Pinang,13,6,7
2022-04-01,RUS,Sabah,3,1,2
2022-04-01,RUS,Sarawak,1,1,0
2022-04-01,RUS,Selangor,674,377,297
2022-04-01,RUS,W.P. Labuan,0,0,0
2022-04-01,RWA,Johor,2,1,1
2022-04-01,RWA,Kedah,0,0,0
2022-04-01,RWA,Pulau Pinang,0,0,0
2022-04-01,RWA,Selangor,3,2,1
2022-04-01,SAU,Johor,36,22,14
2022-04-01,SAU,Kedah,0,0,0
2022-04-01,SAU,Kelantan,0,0,0
2022-04-01,SAU,Melaka,0,0,0
2022-04-01,SAU,Perak,0,0,0
2022-04-01,SAU,Perlis,0,0,0
2022-04-01,SAU,Pulau Pinang,0,0,0
2022-04-01,SAU,Sabah,0,0,0
2022-04-01,SAU,Sarawak,0,0,0
2022-04-01,SAU,Selangor,812,455,357
2022-04-01,SAU,W.P. Labuan,0,0,0
2022-04-01,SDN,Johor,1,1,0
2022-04-01,SDN,Kedah,0,0,0
2022-04-01,SDN,Kelantan,0,0,0
2022-04-01,SDN,Perlis,0,0,0
2022-04-01,SDN,Pulau Pinang,0,0,0
2022-04-01,SDN,Sabah,0,0,0
2022-04-01,SDN,Sarawak,0,0,0
2022-04-01,SDN,Selangor,298,203,95
2022-04-01,SDN,W.P. Labuan,0,0,0
2022-04-01,SEN,Johor,0,0,0
2022-04-01,SEN,Kedah,0,0,0
2022-04-01,SEN,Kelantan,0,0,0
2022-04-01,SEN,Perak,0,0,0
2022-04-01,SEN,Perlis,0,0,0
2022-04-01,SEN,Pulau Pinang,0,0,0
2022-04-01,SEN,Sabah,0,0,0
2022-04-01,SEN,Sarawak,0,0,0
2022-04-01,SEN,Selangor,6,2,4
2022-04-01,SGP,Johor,394144,249335,144809
2022-04-01,SGP,Kedah,175,82,93
2022-04-01,SGP,Kelantan,0,0,0
2022-04-01,SGP,Melaka,0,0,0
2022-04-01,SGP,Negeri Sembilan,0,0,0
2022-04-01,SGP,Pahang,16,14,2
2022-04-01,SGP,Perak,1058,486,572
2022-04-01,SGP,Perlis,1,1,0
2022-04-01,SGP,Pulau Pinang,4202,2328,1874
2022-04-01,SGP,Sabah,282,165,117
2022-04-01,SGP,Sarawak,378,201,177
2022-04-01,SGP,Selangor,11595,6702,4893
2022-04-01,SGP,Terengganu,0,0,0
2022-04-01,SGP,W.P. Labuan,0,0,0
2022-04-01,SGS,Johor,0,0,0
2022-04-01,SGS,Sabah,0,0,0
2022-04-01,SGS,Selangor,0,0,0
2022-04-01,SHN,Sarawak,0,0,0
2022-04-01,SLB,Johor,0,0,0
2022-04-01,SLB,Perlis,0,0,0
2022-04-01,SLB,Pulau Pinang,0,0,0
2022-04-01,SLB,Sabah,0,0,0
2022-04-01,SLB,Sarawak,0,0,0
2022-04-01,SLB,Selangor,1,0,1
2022-04-01,SLB,W.P. Labuan,0,0,0
2022-04-01,SLE,Johor,0,0,0
2022-04-01,SLE,Kedah,0,0,0
2022-04-01,SLE,Perak,0,0,0
2022-04-01,SLE,Pulau Pinang,0,0,0
2022-04-01,SLE,Sabah,0,0,0
2022-04-01,SLE,Selangor,9,5,4
2022-04-01,SLV,Johor,0,0,0
2022-04-01,SLV,Kedah,0,0,0
2022-04-01,SLV,Perak,0,0,0
2022-04-01,SLV,Perlis,0,0,0
2022-04-01,SLV,Pulau Pinang,1,1,0
2022-04-01,SLV,Sabah,0,0,0
2022-04-01,SLV,Selangor,0,0,0
2022-04-01,SLV,W.P. Labuan,0,0,0
2022-04-01,SMR,Johor,0,0,0
2022-04-01,SMR,Selangor,0,0,0
2022-04-01,SOM,Johor,0,0,0
2022-04-01,SOM,Kedah,0,0,0
2022-04-01,SOM,Kelantan,0,0,0
2022-04-01,SOM,Perlis,0,0,0
2022-04-01,SOM,Sabah,0,0,0
2022-04-01,SOM,Sarawak,0,0,0
2022-04-01,SOM,Selangor,121,84,37
2022-04-01,SRB,Johor,1,0,1
2022-04-01,SRB,Kedah,0,0,0
2022-04-01,SRB,Kelantan,0,0,0
2022-04-01,SRB,Pahang,1,1,0
2022-04-01,SRB,Perak,0,0,0
2022-04-01,SRB,Perlis,0,0,0
2022-04-01,SRB,Pulau Pinang,0,0,0
2022-04-01,SRB,Sabah,0,0,0
2022-04-01,SRB,Sarawak,0,0,0
2022-04-01,SRB,Selangor,12,5,7
2022-04-01,SSD,Johor,0,0,0
2022-04-01,SSD,Kedah,0,0,0
2022-04-01,SSD,Sarawak,0,0,0
2022-04-01,SSD,Selangor,23,13,10
2022-04-01,SSD,W.P. Labuan,0,0,0
2022-04-01,STP,Selangor,2,2,0
2022-04-01,SUR,Johor,0,0,0
2022-04-01,SUR,Kedah,0,0,0
2022-04-01,SUR,Kelantan,0,0,0
2022-04-01,SUR,Perak,0,0,0
2022-04-01,SUR,Perlis,0,0,0
2022-04-01,SUR,Pulau Pinang,0,0,0
2022-04-01,SUR,Sabah,0,0,0
2022-04-01,SUR,Sarawak,0,0,0
2022-04-01,SUR,Selangor,1,1,0
2022-04-01,SVK,Johor,7,5,2
2022-04-01,SVK,Kedah,1,0,1
2022-04-01,SVK,Kelantan,0,0,0
2022-04-01,SVK,Negeri Sembilan,0,0,0
2022-04-01,SVK,Pahang,0,0,0
2022-04-01,SVK,Perak,0,0,0
2022-04-01,SVK,Perlis,0,0,0
2022-04-01,SVK,Pulau Pinang,8,7,1
2022-04-01,SVK,Sabah,0,0,0
2022-04-01,SVK,Sarawak,0,0,0
2022-04-01,SVK,Selangor,64,39,25
2022-04-01,SVK,W.P. Labuan,0,0,0
2022-04-01,SVN,Johor,7,3,4
2022-04-01,SVN,Kedah,0,0,0
2022-04-01,SVN,Kelantan,0,0,0
2022-04-01,SVN,Perak,0,0,0
2022-04-01,SVN,Perlis,0,0,0
2022-04-01,SVN,Pulau Pinang,0,0,0
2022-04-01,SVN,Sabah,0,0,0
2022-04-01,SVN,Sarawak,0,0,0
2022-04-01,SVN,Selangor,17,13,4
2022-04-01,SVN,W.P. Labuan,0,0,0
2022-04-01,SWE,Johor,123,75,48
2022-04-01,SWE,Kedah,4,4,0
2022-04-01,SWE,Kelantan,0,0,0
2022-04-01,SWE,Melaka,0,0,0
2022-04-01,SWE,Negeri Sembilan,0,0,0
2022-04-01,SWE,Pahang,0,0,0
2022-04-01,SWE,Perak,1,1,0
2022-04-01,SWE,Perlis,1,1,0
2022-04-01,SWE,Pulau Pinang,20,16,4
2022-04-01,SWE,Sabah,1,1,0
2022-04-01,SWE,Sarawak,1,1,0
2022-04-01,SWE,Selangor,392,256,136
2022-04-01,SWE,W.P. Labuan,0,0,0
2022-04-01,SWZ,Johor,0,0,0
2022-04-01,SWZ,Kedah,0,0,0
2022-04-01,SWZ,Pulau Pinang,0,0,0
2022-04-01,SWZ,Sabah,0,0,0
2022-04-01,SWZ,Selangor,3,2,1
2022-04-01,SYC,Johor,0,0,0
2022-04-01,SYC,Kedah,0,0,0
2022-04-01,SYC,Pulau Pinang,0,0,0
2022-04-01,SYC,Sabah,0,0,0
2022-04-01,SYC,Sarawak,0,0,0
2022-04-01,SYC,Selangor,42,18,24
2022-04-01,SYR,Johor,3,1,2
2022-04-01,SYR,Kedah,0,0,0
2022-04-01,SYR,Kelantan,0,0,0
2022-04-01,SYR,Pahang,0,0,0
2022-04-01,SYR,Perlis,0,0,0
2022-04-01,SYR,Pulau Pinang,0,0,0
2022-04-01,SYR,Sabah,0,0,0
2022-04-01,SYR,Sarawak,0,0,0
2022-04-01,SYR,Selangor,352,222,130
2022-04-01,SYR,W.P. Labuan,0,0,0
2022-04-01,TCA,Perlis,0,0,0
2022-04-01,TCD,Johor,0,0,0
2022-04-01,TCD,Kedah,0,0,0
2022-04-01,TCD,Perlis,0,0,0
2022-04-01,TCD,Selangor,13,9,4
2022-04-01,TGO,Johor,3,3,0
2022-04-01,TGO,Perak,0,0,0
2022-04-01,TGO,Pulau Pinang,0,0,0
2022-04-01,TGO,Selangor,0,0,0
2022-04-01,THA,Johor,890,143,747
2022-04-01,THA,Kedah,19821,17791,2030
2022-04-01,THA,Kelantan,6,5,1
2022-04-01,THA,Melaka,0,0,0
2022-04-01,THA,Negeri Sembilan,0,0,0
2022-04-01,THA,Pahang,2,0,2
2022-04-01,THA,Perak,1,0,1
2022-04-01,THA,Perlis,10082,9807,275
2022-04-01,THA,Pulau Pinang,131,59,72
2022-04-01,THA,Sabah,5,4,1
2022-04-01,THA,Sarawak,13,10,3
2022-04-01,THA,Selangor,2718,920,1798
2022-04-01,THA,Terengganu,0,0,0
2022-04-01,THA,W.P. Labuan,0,0,0
2022-04-01,TJK,Johor,0,0,0
2022-04-01,TJK,Kedah,0,0,0
2022-04-01,TJK,Perlis,0,0,0
2022-04-01,TJK,Pulau Pinang,0,0,0
2022-04-01,TJK,Sabah,0,0,0
2022-04-01,TJK,Selangor,14,9,5
2022-04-01,TKL,Selangor,0,0,0
2022-04-01,TKM,Johor,1,0,1
2022-04-01,TKM,Kedah,0,0,0
2022-04-01,TKM,Kelantan,0,0,0
2022-04-01,TKM,Perlis,0,0,0
2022-04-01,TKM,Pulau Pinang,0,0,0
2022-04-01,TKM,Sabah,0,0,0
2022-04-01,TKM,Sarawak,0,0,0
2022-04-01,TKM,Selangor,18,9,9
2022-04-01,TLS,Johor,0,0,0
2022-04-01,TLS,Kedah,0,0,0
2022-04-01,TLS,Perlis,0,0,0
2022-04-01,TLS,Pulau Pinang,1,0,1
2022-04-01,TLS,Sabah,0,0,0
2022-04-01,TLS,Sarawak,0,0,0
2022-04-01,TLS,Selangor,99,73,26
2022-04-01,TON,Johor,0,0,0
2022-04-01,TON,Pulau Pinang,0,0,0
2022-04-01,TON,Sarawak,0,0,0
2022-04-01,TON,Selangor,13,6,7
2022-04-01,TTO,Johor,3,3,0
2022-04-01,TTO,Kedah,0,0,0
2022-04-01,TTO,Pahang,0,0,0
2022-04-01,TTO,Pulau Pinang,0,0,0
2022-04-01,TTO,Sabah,0,0,0
2022-04-01,TTO,Sarawak,0,0,0
2022-04-01,TTO,Selangor,13,8,5
2022-04-01,TUN,Johor,5,2,3
2022-04-01,TUN,Kedah,0,0,0
2022-04-01,TUN,Kelantan,0,0,0
2022-04-01,TUN,Melaka,0,0,0
2022-04-01,TUN,Perak,0,0,0
2022-04-01,TUN,Perlis,0,0,0
2022-04-01,TUN,Pulau Pinang,0,0,0
2022-04-01,TUN,Sabah,0,0,0
2022-04-01,TUN,Sarawak,0,0,0
2022-04-01,TUN,Selangor,72,46,26
2022-04-01,TUN,W.P. Labuan,0,0,0
2022-04-01,TUR,Johor,68,48,20
2022-04-01,TUR,Kedah,6,3,3
2022-04-01,TUR,Kelantan,0,0,0
2022-04-01,TUR,Melaka,0,0,0
2022-04-01,TUR,Negeri Sembilan,3,3,0
2022-04-01,TUR,Pahang,0,0,0
2022-04-01,TUR,Perak,1,1,0
2022-04-01,TUR,Perlis,0,0,0
2022-04-01,TUR,Pulau Pinang,16,9,7
2022-04-01,TUR,Sabah,0,0,0
2022-04-01,TUR,Sarawak,1,0,1
2022-04-01,TUR,Selangor,362,283,79
2022-04-01,TUR,W.P. Labuan,0,0,0
2022-04-01,TUV,Selangor,0,0,0
2022-04-01,TWN,Johor,891,363,528
2022-04-01,TWN,Kedah,12,6,6
2022-04-01,TWN,Kelantan,0,0,0
2022-04-01,TWN,Melaka,0,0,0
2022-04-01,TWN,Negeri Sembilan,0,0,0
2022-04-01,TWN,Pahang,0,0,0
2022-04-01,TWN,Perak,4,2,2
2022-04-01,TWN,Perlis,0,0,0
2022-04-01,TWN,Pulau Pinang,164,115,49
2022-04-01,TWN,Sabah,3,2,1
2022-04-01,TWN,Sarawak,15,14,1
2022-04-01,TWN,Selangor,781,484,297
2022-04-01,TWN,W.P. Labuan,0,0,0
2022-04-01,TZA,Johor,2,2,0
2022-04-01,TZA,Kedah,0,0,0
2022-04-01,TZA,Perak,0,0,0
2022-04-01,TZA,Perlis,0,0,0
2022-04-01,TZA,Pulau Pinang,0,0,0
2022-04-01,TZA,Sabah,0,0,0
2022-04-01,TZA,Sarawak,0,0,0
2022-04-01,TZA,Selangor,44,20,24
2022-04-01,UGA,Johor,0,0,0
2022-04-01,UGA,Kedah,0,0,0
2022-04-01,UGA,Perak,0,0,0
2022-04-01,UGA,Perlis,0,0,0
2022-04-01,UGA,Pulau Pinang,0,0,0
2022-04-01,UGA,Sabah,0,0,0
2022-04-01,UGA,Sarawak,0,0,0
2022-04-01,UGA,Selangor,24,14,10
2022-04-01,UKR,Johor,34,20,14
2022-04-01,UKR,Kedah,2,0,2
2022-04-01,UKR,Kelantan,0,0,0
2022-04-01,UKR,Melaka,0,0,0
2022-04-01,UKR,Negeri Sembilan,0,0,0
2022-04-01,UKR,Pahang,0,0,0
2022-04-01,UKR,Perak,0,0,0
2022-04-01,UKR,Perlis,0,0,0
2022-04-01,UKR,Pulau Pinang,4,1,3
2022-04-01,UKR,Sabah,0,0,0
2022-04-01,UKR,Sarawak,0,0,0
2022-04-01,UKR,Selangor,166,76,90
2022-04-01,UKR,W.P. Labuan,0,0,0
2022-04-01,URY,Johor,10,5,5
2022-04-01,URY,Kedah,0,0,0
2022-04-01,URY,Kelantan,0,0,0
2022-04-01,URY,Perak,0,0,0
2022-04-01,URY,Perlis,0,0,0
2022-04-01,URY,Pulau Pinang,0,0,0
2022-04-01,URY,Sabah,0,0,0
2022-04-01,URY,Sarawak,0,0,0
2022-04-01,URY,Selangor,8,3,5
2022-04-01,URY,W.P. Labuan,0,0,0
2022-04-01,USA,Johor,1105,724,381
2022-04-01,USA,Kedah,103,54,49
2022-04-01,USA,Kelantan,2,2,0
2022-04-01,USA,Melaka,0,0,0
2022-04-01,USA,Negeri Sembilan,1,1,0
2022-04-01,USA,Pahang,2,1,1
2022-04-01,USA,Perak,13,8,5
2022-04-01,USA,Perlis,0,0,0
2022-04-01,USA,Pulau Pinang,471,321,150
2022-04-01,USA,Sabah,32,17,15
2022-04-01,USA,Sarawak,24,16,8
2022-04-01,USA,Selangor,3296,2105,1191
2022-04-01,USA,Terengganu,0,0,0
2022-04-01,USA,W.P. Labuan,0,0,0
2022-04-01,UZB,Johor,18,4,14
2022-04-01,UZB,Kedah,0,0,0
2022-04-01,UZB,Kelantan,0,0,0
2022-04-01,UZB,Perak,0,0,0
2022-04-01,UZB,Perlis,0,0,0
2022-04-01,UZB,Pulau Pinang,1,0,1
2022-04-01,UZB,Sabah,0,0,0
2022-04-01,UZB,Sarawak,0,0,0
2022-04-01,UZB,Selangor,92,52,40
2022-04-01,VAT,Johor,0,0,0
2022-04-01,VAT,Sarawak,0,0,0
2022-04-01,VAT,Selangor,0,0,0
2022-04-01,VCT,Johor,0,0,0
2022-04-01,VCT,Kedah,0,0,0
2022-04-01,VCT,Pulau Pinang,0,0,0
2022-04-01,VCT,Sarawak,0,0,0
2022-04-01,VCT,Selangor,0,0,0
2022-04-01,VEN,Johor,3,0,3
2022-04-01,VEN,Kedah,0,0,0
2022-04-01,VEN,Kelantan,0,0,0
2022-04-01,VEN,Melaka,0,0,0
2022-04-01,VEN,Perak,0,0,0
2022-04-01,VEN,Perlis,0,0,0
2022-04-01,VEN,Pulau Pinang,2,0,2
2022-04-01,VEN,Sabah,0,0,0
2022-04-01,VEN,Sarawak,0,0,0
2022-04-01,VEN,Selangor,18,13,5
2022-04-01,VEN,W.P. Labuan,0,0,0
2022-04-01,VNM,Johor,2487,659,1828
2022-04-01,VNM,Kedah,3,1,2
2022-04-01,VNM,Kelantan,0,0,0
2022-04-01,VNM,Melaka,0,0,0
2022-04-01,VNM,Negeri Sembilan,0,0,0
2022-04-01,VNM,Pahang,0,0,0
2022-04-01,VNM,Perak,1,0,1
2022-04-01,VNM,Perlis,0,0,0
2022-04-01,VNM,Pulau Pinang,389,104,285
2022-04-01,VNM,Sabah,3,1,2
2022-04-01,VNM,Sarawak,13,6,7
2022-04-01,VNM,Selangor,4837,1612,3225
2022-04-01,VNM,Terengganu,0,0,0
2022-04-01,VNM,W.P. Labuan,0,0,0
2022-04-01,VUT,Johor,5,5,0
2022-04-01,VUT,Kedah,0,0,0
2022-04-01,VUT,Pulau Pinang,0,0,0
2022-04-01,VUT,Sabah,0,0,0
2022-04-01,VUT,Sarawak,0,0,0
2022-04-01,VUT,Selangor,8,8,0
2022-04-01,WSM,Johor,0,0,0
2022-04-01,WSM,Sarawak,0,0,0
2022-04-01,WSM,Selangor,0,0,0
2022-04-01,XXX,Johor,44,28,16
2022-04-01,XXX,Kedah,2,2,0
2022-04-01,XXX,Kelantan,0,0,0
2022-04-01,XXX,Melaka,0,0,0
2022-04-01,XXX,Pahang,0,0,0
2022-04-01,XXX,Perak,0,0,0
2022-04-01,XXX,Perlis,0,0,0
2022-04-01,XXX,Pulau Pinang,10,8,2
2022-04-01,XXX,Sabah,1,1,0
2022-04-01,XXX,Sarawak,0,0,0
2022-04-01,XXX,Selangor,120,64,56
2022-04-01,XXX,W.P. Labuan,0,0,0
2022-04-01,YEM,Johor,25,15,10
2022-04-01,YEM,Kedah,0,0,0
2022-04-01,YEM,Kelantan,0,0,0
2022-04-01,YEM,Melaka,0,0,0
2022-04-01,YEM,Pahang,0,0,0
2022-04-01,YEM,Perak,0,0,0
2022-04-01,YEM,Perlis,0,0,0
2022-04-01,YEM,Pulau Pinang,0,0,0
2022-04-01,YEM,Sabah,0,0,0
2022-04-01,YEM,Sarawak,0,0,0
2022-04-01,YEM,Selangor,695,482,213
2022-04-01,YEM,W.P. Labuan,0,0,0
2022-04-01,ZAF,Johor,102,62,40
2022-04-01,ZAF,Kedah,7,4,3
2022-04-01,ZAF,Kelantan,0,0,0
2022-04-01,ZAF,Melaka,0,0,0
2022-04-01,ZAF,Pahang,0,0,0
2022-04-01,ZAF,Perak,1,1,0
2022-04-01,ZAF,Perlis,0,0,0
2022-04-01,ZAF,Pulau Pinang,21,12,9
2022-04-01,ZAF,Sabah,3,2,1
2022-04-01,ZAF,Sarawak,5,5,0
2022-04-01,ZAF,Selangor,386,231,155
2022-04-01,ZAF,Terengganu,0,0,0
2022-04-01,ZAF,W.P. Labuan,0,0,0
2022-04-01,ZAR,Selangor,0,0,0
2022-04-01,ZMB,Johor,0,0,0
2022-04-01,ZMB,Kedah,0,0,0
2022-04-01,ZMB,Perak,0,0,0
2022-04-01,ZMB,Perlis,0,0,0
2022-04-01,ZMB,Pulau Pinang,0,0,0
2022-04-01,ZMB,Sabah,1,1,0
2022-04-01,ZMB,Sarawak,0,0,0
2022-04-01,ZMB,Selangor,13,8,5
2022-04-01,ZWE,Johor,2,1,1
2022-04-01,ZWE,Kedah,0,0,0
2022-04-01,ZWE,Kelantan,0,0,0
2022-04-01,ZWE,Perak,0,0,0
2022-04-01,ZWE,Perlis,0,0,0
2022-04-01,ZWE,Pulau Pinang,0,0,0
2022-04-01,ZWE,Sabah,0,0,0
2022-04-01,ZWE,Sarawak,0,0,0
2022-04-01,ZWE,Selangor,51,26,25
2022-05-01,ABW,Kedah,0,0,0
2022-05-01,ABW,Pulau Pinang,0,0,0
2022-05-01,AFG,Johor,1,1,0
2022-05-01,AFG,Kedah,0,0,0
2022-05-01,AFG,Perlis,0,0,0
2022-05-01,AFG,Pulau Pinang,0,0,0
2022-05-01,AFG,Sarawak,0,0,0
2022-05-01,AFG,Selangor,126,93,33
2022-05-01,AGO,Johor,0,0,0
2022-05-01,AGO,Kedah,0,0,0
2022-05-01,AGO,Sabah,0,0,0
2022-05-01,AGO,Selangor,2,2,0
2022-05-01,AIA,Selangor,0,0,0
2022-05-01,ALB,Johor,2,2,0
2022-05-01,ALB,Kedah,0,0,0
2022-05-01,ALB,Perak,0,0,0
2022-05-01,ALB,Perlis,1,1,0
2022-05-01,ALB,Pulau Pinang,0,0,0
2022-05-01,ALB,Sabah,0,0,0
2022-05-01,ALB,Sarawak,0,0,0
2022-05-01,ALB,Selangor,17,12,5
2022-05-01,AND,Johor,0,0,0
2022-05-01,AND,Kedah,0,0,0
2022-05-01,AND,Perlis,0,0,0
2022-05-01,AND,Pulau Pinang,0,0,0
2022-05-01,AND,Selangor,2,1,1
2022-05-01,ANT,Selangor,0,0,0
2022-05-01,ARE,Johor,11,9,2
2022-05-01,ARE,Kedah,0,0,0
2022-05-01,ARE,Kelantan,0,0,0
2022-05-01,ARE,Perak,0,0,0
2022-05-01,ARE,Perlis,0,0,0
2022-05-01,ARE,Pulau Pinang,0,0,0
2022-05-01,ARE,Sabah,0,0,0
2022-05-01,ARE,Sarawak,0,0,0
2022-05-01,ARE,Selangor,219,149,70
2022-05-01,ARG,Johor,36,23,13
2022-05-01,ARG,Kedah,4,3,1
2022-05-01,ARG,Kelantan,0,0,0
2022-05-01,ARG,Melaka,0,0,0
2022-05-01,ARG,Perak,1,1,0
2022-05-01,ARG,Perlis,6,4,2
2022-05-01,ARG,Pulau Pinang,3,1,2
2022-05-01,ARG,Sabah,1,0,1
2022-05-01,ARG,Sarawak,0,0,0
2022-05-01,ARG,Selangor,121,73,48
2022-05-01,ARG,W.P. Labuan,0,0,0
2022-05-01,ARM,Johor,1,1,0
2022-05-01,ARM,Kedah,0,0,0
2022-05-01,ARM,Kelantan,0,0,0
2022-05-01,ARM,Perak,0,0,0
2022-05-01,ARM,Perlis,0,0,0
2022-05-01,ARM,Pulau Pinang,0,0,0
2022-05-01,ARM,Sabah,0,0,0
2022-05-01,ARM,Sarawak,0,0,0
2022-05-01,ARM,Selangor,10,3,7
2022-05-01,ATA,Selangor,1,1,0
2022-05-01,ATG,Johor,0,0,0
2022-05-01,ATG,Kedah,2,2,0
2022-05-01,ATG,Pulau Pinang,0,0,0
2022-05-01,ATG,Sarawak,0,0,0
2022-05-01,ATG,Selangor,3,3,0
2022-05-01,AUS,Johor,2184,1440,744
2022-05-01,AUS,Kedah,140,87,53
2022-05-01,AUS,Kelantan,0,0,0
2022-05-01,AUS,Melaka,0,0,0
2022-05-01,AUS,Negeri Sembilan,0,0,0
2022-05-01,AUS,Pahang,1,1,0
2022-05-01,AUS,Perak,64,39,25
2022-05-01,AUS,Perlis,10,10,0
2022-05-01,AUS,Pulau Pinang,640,368,272
2022-05-01,AUS,Sabah,144,79,65
2022-05-01,AUS,Sarawak,145,83,62
2022-05-01,AUS,Selangor,6141,3970,2171
2022-05-01,AUS,Terengganu,0,0,0
2022-05-01,AUS,W.P. Labuan,0,0,0
2022-05-01,AUT,Johor,78,52,26
2022-05-01,AUT,Kedah,6,6,0
2022-05-01,AUT,Kelantan,0,0,0
2022-05-01,AUT,Melaka,0,0,0
2022-05-01,AUT,Negeri Sembilan,1,1,0
2022-05-01,AUT,Pahang,0,0,0
2022-05-01,AUT,Perak,2,2,0
2022-05-01,AUT,Perlis,3,1,2
2022-05-01,AUT,Pulau Pinang,36,29,7
2022-05-01,AUT,Sabah,3,3,0
2022-05-01,AUT,Sarawak,3,2,1
2022-05-01,AUT,Selangor,306,214,92
2022-05-01,AUT,Terengganu,0,0,0
2022-05-01,AUT,W.P. Labuan,0,0,0
2022-05-01,AZE,Johor,1,0,1
2022-05-01,AZE,Kedah,1,0,1
2022-05-01,AZE,Kelantan,0,0,0
2022-05-01,AZE,Melaka,0,0,0
2022-05-01,AZE,Perlis,0,0,0
2022-05-01,AZE,Pulau Pinang,0,0,0
2022-05-01,AZE,Sabah,0,0,0
2022-05-01,AZE,Sarawak,0,0,0
2022-05-01,AZE,Selangor,31,20,11
2022-05-01,AZE,W.P. Labuan,0,0,0
2022-05-01,BDI,Pulau Pinang,0,0,0
2022-05-01,BDI,Sarawak,0,0,0
2022-05-01,BDI,Selangor,0,0,0
2022-05-01,BEL,Johor,148,110,38
2022-05-01,BEL,Kedah,10,8,2
2022-05-01,BEL,Kelantan,0,0,0
2022-05-01,BEL,Melaka,0,0,0
2022-05-01,BEL,Negeri Sembilan,0,0,0
2022-05-01,BEL,Pahang,0,0,0
2022-05-01,BEL,Perak,3,3,0
2022-05-01,BEL,Perlis,3,2,1
2022-05-01,BEL,Pulau Pinang,22,14,8
2022-05-01,BEL,Sabah,3,2,1
2022-05-01,BEL,Sarawak,0,0,0
2022-05-01,BEL,Selangor,356,256,100
2022-05-01,BEL,W.P. Labuan,0,0,0
2022-05-01,BEN,Johor,0,0,0
2022-05-01,BEN,Kedah,0,0,0
2022-05-01,BEN,Perak,0,0,0
2022-05-01,BEN,Pulau Pinang,0,0,0
2022-05-01,BEN,Sabah,0,0,0
2022-05-01,BEN,Sarawak,0,0,0
2022-05-01,BEN,Selangor,0,0,0
2022-05-01,BFA,Perak,0,0,0
2022-05-01,BFA,Pulau Pinang,0,0,0
2022-05-01,BFA,Selangor,1,0,1
2022-05-01,BGD,Johor,645,535,110
2022-05-01,BGD,Kedah,5,3,2
2022-05-01,BGD,Kelantan,0,0,0
2022-05-01,BGD,Melaka,0,0,0
2022-05-01,BGD,Negeri Sembilan,0,0,0
2022-05-01,BGD,Pahang,0,0,0
2022-05-01,BGD,Perak,0,0,0
2022-05-01,BGD,Perlis,2,2,0
2022-05-01,BGD,Pulau Pinang,40,33,7
2022-05-01,BGD,Sabah,0,0,0
2022-05-01,BGD,Sarawak,5,5,0
2022-05-01,BGD,Selangor,12646,11636,1010
2022-05-01,BGD,W.P. Labuan,0,0,0
2022-05-01,BGR,Johor,21,9,12
2022-05-01,BGR,Kedah,8,4,4
2022-05-01,BGR,Kelantan,0,0,0
2022-05-01,BGR,Pahang,0,0,0
2022-05-01,BGR,Perak,0,0,0
2022-05-01,BGR,Perlis,0,0,0
2022-05-01,BGR,Pulau Pinang,3,1,2
2022-05-01,BGR,Sabah,0,0,0
2022-05-01,BGR,Sarawak,0,0,0
2022-05-01,BGR,Selangor,69,47,22
2022-05-01,BGR,W.P. Labuan,0,0,0
2022-05-01,BHR,Johor,1,0,1
2022-05-01,BHR,Kedah,0,0,0
2022-05-01,BHR,Kelantan,0,0,0
2022-05-01,BHR,Perlis,0,0,0
2022-05-01,BHR,Pulau Pinang,0,0,0
2022-05-01,BHR,Sabah,0,0,0
2022-05-01,BHR,Sarawak,0,0,0
2022-05-01,BHR,Selangor,86,51,35
2022-05-01,BHS,Johor,1,0,1
2022-05-01,BHS,Kedah,0,0,0
2022-05-01,BHS,Perak,0,0,0
2022-05-01,BHS,Sabah,0,0,0
2022-05-01,BHS,Sarawak,0,0,0
2022-05-01,BHS,Selangor,2,1,1
2022-05-01,BIH,Johor,3,3,0
2022-05-01,BIH,Kedah,0,0,0
2022-05-01,BIH,Perlis,0,0,0
2022-05-01,BIH,Pulau Pinang,0,0,0
2022-05-01,BIH,Sabah,0,0,0
2022-05-01,BIH,Sarawak,0,0,0
2022-05-01,BIH,Selangor,25,16,9
2022-05-01,BLR,Johor,8,5,3
2022-05-01,BLR,Kedah,0,0,0
2022-05-01,BLR,Kelantan,0,0,0
2022-05-01,BLR,Pahang,0,0,0
2022-05-01,BLR,Perak,0,0,0
2022-05-01,BLR,Perlis,1,0,1
2022-05-01,BLR,Pulau Pinang,8,5,3
2022-05-01,BLR,Sabah,2,1,1
2022-05-01,BLR,Sarawak,1,1,0
2022-05-01,BLR,Selangor,59,28,31
2022-05-01,BLR,W.P. Labuan,0,0,0
2022-05-01,BLZ,Johor,0,0,0
2022-05-01,BLZ,Pulau Pinang,0,0,0
2022-05-01,BLZ,Sarawak,0,0,0
2022-05-01,BLZ,Selangor,1,1,0
2022-05-01,BMU,Selangor,0,0,0
2022-05-01,BOL,Johor,0,0,0
2022-05-01,BOL,Kedah,0,0,0
2022-05-01,BOL,Melaka,0,0,0
2022-05-01,BOL,Perak,0,0,0
2022-05-01,BOL,Perlis,0,0,0
2022-05-01,BOL,Pulau Pinang,4,3,1
2022-05-01,BOL,Sabah,0,0,0
2022-05-01,BOL,Sarawak,0,0,0
2022-05-01,BOL,Selangor,21,13,8
2022-05-01,BRA,Johor,174,88,86
2022-05-01,BRA,Kedah,15,6,9
2022-05-01,BRA,Kelantan,1,1,0
2022-05-01,BRA,Melaka,0,0,0
2022-05-01,BRA,Pahang,0,0,0
2022-05-01,BRA,Perak,1,1,0
2022-05-01,BRA,Perlis,2,0,2
2022-05-01,BRA,Pulau Pinang,6,5,1
2022-05-01,BRA,Sabah,5,1,4
2022-05-01,BRA,Sarawak,1,1,0
2022-05-01,BRA,Selangor,365,217,148
2022-05-01,BRA,W.P. Labuan,0,0,0
2022-05-01,BRB,Johor,0,0,0
2022-05-01,BRB,Kedah,0,0,0
2022-05-01,BRB,Perlis,0,0,0
2022-05-01,BRB,Pulau Pinang,0,0,0
2022-05-01,BRB,Selangor,0,0,0
2022-05-01,BRN,Johor,104,59,45
2022-05-01,BRN,Kedah,5,3,2
2022-05-01,BRN,Kelantan,0,0,0
2022-05-01,BRN,Melaka,0,0,0
2022-05-01,BRN,Pahang,0,0,0
2022-05-01,BRN,Perak,0,0,0
2022-05-01,BRN,Perlis,0,0,0
2022-05-01,BRN,Pulau Pinang,5,3,2
2022-05-01,BRN,Sabah,318,172,146
2022-05-01,BRN,Sarawak,861,684,177
2022-05-01,BRN,Selangor,1777,974,803
2022-05-01,BRN,W.P. Labuan,24,17,7
2022-05-01,BTN,Johor,1,1,0
2022-05-01,BTN,Kedah,0,0,0
2022-05-01,BTN,Perak,0,0,0
2022-05-01,BTN,Perlis,0,0,0
2022-05-01,BTN,Pulau Pinang,0,0,0
2022-05-01,BTN,Sabah,0,0,0
2022-05-01,BTN,Sarawak,0,0,0
2022-05-01,BTN,Selangor,20,6,14
2022-05-01,BWA,Johor,1,0,1
2022-05-01,BWA,Kedah,1,1,0
2022-05-01,BWA,Perlis,0,0,0
2022-05-01,BWA,Pulau Pinang,0,0,0
2022-05-01,BWA,Sabah,0,0,0
2022-05-01,BWA,Sarawak,0,0,0
2022-05-01,BWA,Selangor,20,13,7
2022-05-01,CAF,Kedah,0,0,0
2022-05-01,CAF,Selangor,0,0,0
2022-05-01,CAN,Johor,569,353,216
2022-05-01,CAN,Kedah,48,27,21
2022-05-01,CAN,Kelantan,1,1,0
2022-05-01,CAN,Melaka,1,1,0
2022-05-01,CAN,Negeri Sembilan,0,0,0
2022-05-01,CAN,Pahang,0,0,0
2022-05-01,CAN,Perak,3,3,0
2022-05-01,CAN,Perlis,6,5,1
2022-05-01,CAN,Pulau Pinang,113,67,46
2022-05-01,CAN,Sabah,26,14,12
2022-05-01,CAN,Sarawak,22,8,14
2022-05-01,CAN,Selangor,1552,961,591
2022-05-01,CAN,Terengganu,0,0,0
2022-05-01,CAN,W.P. Labuan,0,0,0
2022-05-01,CCK,Selangor,0,0,0
2022-05-01,CHE,Johor,234,158,76
2022-05-01,CHE,Kedah,28,16,12
2022-05-01,CHE,Kelantan,0,0,0
2022-05-01,CHE,Melaka,0,0,0
2022-05-01,CHE,Negeri Sembilan,0,0,0
2022-05-01,CHE,Pahang,1,0,1
2022-05-01,CHE,Perak,2,2,0
2022-05-01,CHE,Perlis,1,1,0
2022-05-01,CHE,Pulau Pinang,38,27,11
2022-05-01,CHE,Sabah,7,5,2
2022-05-01,CHE,Sarawak,11,7,4
2022-05-01,CHE,Selangor,451,300,151
2022-05-01,CHE,W.P. Labuan,0,0,0
2022-05-01,CHL,Johor,17,8,9
2022-05-01,CHL,Kedah,5,2,3
2022-05-01,CHL,Kelantan,0,0,0
2022-05-01,CHL,Melaka,0,0,0
2022-05-01,CHL,Pahang,0,0,0
2022-05-01,CHL,Perak,0,0,0
2022-05-01,CHL,Perlis,2,2,0
2022-05-01,CHL,Pulau Pinang,2,2,0
2022-05-01,CHL,Sabah,0,0,0
2022-05-01,CHL,Sarawak,0,0,0
2022-05-01,CHL,Selangor,69,38,31
2022-05-01,CHN,Johor,8874,3776,5098
2022-05-01,CHN,Kedah,121,48,73
2022-05-01,CHN,Kelantan,1,0,1
2022-05-01,CHN,Melaka,1,1,0
2022-05-01,CHN,Pahang,3,1,2
2022-05-01,CHN,Perak,38,20,18
2022-05-01,CHN,Perlis,1,0,1
2022-05-01,CHN,Pulau Pinang,405,202,203
2022-05-01,CHN,Sabah,128,59,69
2022-05-01,CHN,Sarawak,79,46,33
2022-05-01,CHN,Selangor,6684,4288,2396
2022-05-01,CHN,Terengganu,0,0,0
2022-05-01,CHN,W.P. Labuan,0,0,0
2022-05-01,CIV,Johor,0,0,0
2022-05-01,CIV,Kedah,0,0,0
2022-05-01,CIV,Pulau Pinang,0,0,0
2022-05-01,CIV,Sabah,1,0,1
2022-05-01,CIV,Sarawak,0,0,0
2022-05-01,CIV,Selangor,7,5,2
2022-05-01,CMR,Johor,1,1,0
2022-05-01,CMR,Kedah,0,0,0
2022-05-01,CMR,Pulau Pinang,0,0,0
2022-05-01,CMR,Sabah,0,0,0
2022-05-01,CMR,Sarawak,1,0,1
2022-05-01,CMR,Selangor,7,4,3
2022-05-01,COD,Johor,0,0,0
2022-05-01,COD,Pulau Pinang,0,0,0
2022-05-01,COD,Sarawak,0,0,0
2022-05-01,COD,Selangor,6,5,1
2022-05-01,COG,Johor,0,0,0
2022-05-01,COG,Kedah,0,0,0
2022-05-01,COG,Selangor,0,0,0
2022-05-01,COK,Selangor,0,0,0
2022-05-01,COL,Johor,21,11,10
2022-05-01,COL,Kedah,3,1,2
2022-05-01,COL,Perak,2,1,1
2022-05-01,COL,Pulau Pinang,2,0,2
2022-05-01,COL,Sabah,0,0,0
2022-05-01,COL,Sarawak,0,0,0
2022-05-01,COL,Selangor,99,54,45
2022-05-01,COL,W.P. Labuan,0,0,0
2022-05-01,COM,Johor,0,0,0
2022-05-01,COM,Kedah,0,0,0
2022-05-01,COM,Selangor,6,5,1
2022-05-01,CPV,Johor,0,0,0
2022-05-01,CPV,Kedah,0,0,0
2022-05-01,CPV,Pulau Pinang,0,0,0
2022-05-01,CPV,Sabah,0,0,0
2022-05-01,CPV,Selangor,3,2,1
2022-05-01,CRI,Johor,3,2,1
2022-05-01,CRI,Kedah,2,1,1
2022-05-01,CRI,Perak,0,0,0
2022-05-01,CRI,Perlis,1,1,0
2022-05-01,CRI,Pulau Pinang,2,0,2
2022-05-01,CRI,Sabah,0,0,0
2022-05-01,CRI,Sarawak,0,0,0
2022-05-01,CRI,Selangor,25,20,5
2022-05-01,CUB,Johor,2,2,0
2022-05-01,CUB,Kedah,0,0,0
2022-05-01,CUB,Perlis,0,0,0
2022-05-01,CUB,Pulau Pinang,0,0,0
2022-05-01,CUB,Sabah,0,0,0
2022-05-01,CUB,Sarawak,0,0,0
2022-05-01,CUB,Selangor,12,7,5
2022-05-01,CYP,Johor,8,8,0
2022-05-01,CYP,Kedah,3,1,2
2022-05-01,CYP,Perak,0,0,0
2022-05-01,CYP,Perlis,0,0,0
2022-05-01,CYP,Pulau Pinang,4,3,1
2022-05-01,CYP,Sabah,0,0,0
2022-05-01,CYP,Sarawak,0,0,0
2022-05-01,CYP,Selangor,27,18,9
2022-05-01,CZE,Johor,27,20,7
2022-05-01,CZE,Kedah,6,3,3
2022-05-01,CZE,Kelantan,1,1,0
2022-05-01,CZE,Melaka,0,0,0
2022-05-01,CZE,Negeri Sembilan,0,0,0
2022-05-01,CZE,Perak,0,0,0
2022-05-01,CZE,Perlis,0,0,0
2022-05-01,CZE,Pulau Pinang,1,0,1
2022-05-01,CZE,Sabah,0,0,0
2022-05-01,CZE,Sarawak,0,0,0
2022-05-01,CZE,Selangor,122,83,39
2022-05-01,CZE,W.P. Labuan,0,0,0
2022-05-01,DEU,Johor,973,665,308
2022-05-01,DEU,Kedah,97,59,38
2022-05-01,DEU,Kelantan,2,1,1
2022-05-01,DEU,Melaka,1,1,0
2022-05-01,DEU,Negeri Sembilan,0,0,0
2022-05-01,DEU,Pahang,0,0,0
2022-05-01,DEU,Perak,12,7,5
2022-05-01,DEU,Perlis,27,18,9
2022-05-01,DEU,Pulau Pinang,283,208,75
2022-05-01,DEU,Sabah,36,22,14
2022-05-01,DEU,Sarawak,57,36,21
2022-05-01,DEU,Selangor,2906,1989,917
2022-05-01,DEU,Terengganu,0,0,0
2022-05-01,DEU,W.P. Labuan,0,0,0
2022-05-01,DJI,Johor,0,0,0
2022-05-01,DJI,Selangor,6,3,3
2022-05-01,DMA,Johor,6,4,2
2022-05-01,DMA,Kedah,0,0,0
2022-05-01,DMA,Pulau Pinang,0,0,0
2022-05-01,DMA,Sabah,0,0,0
2022-05-01,DMA,Sarawak,0,0,0
2022-05-01,DMA,Selangor,21,17,4
2022-05-01,DMA,W.P. Labuan,0,0,0
2022-05-01,DNK,Johor,150,94,56
2022-05-01,DNK,Kedah,17,10,7
2022-05-01,DNK,Kelantan,0,0,0
2022-05-01,DNK,Melaka,0,0,0
2022-05-01,DNK,Negeri Sembilan,0,0,0
2022-05-01,DNK,Pahang,0,0,0
2022-05-01,DNK,Perak,0,0,0
2022-05-01,DNK,Perlis,0,0,0
2022-05-01,DNK,Pulau Pinang,25,16,9
2022-05-01,DNK,Sabah,4,2,2
2022-05-01,DNK,Sarawak,2,2,0
2022-05-01,DNK,Selangor,422,288,134
2022-05-01,DNK,W.P. Labuan,0,0,0
2022-05-01,DOM,Johor,2,1,1
2022-05-01,DOM,Kedah,0,0,0
2022-05-01,DOM,Perak,0,0,0
2022-05-01,DOM,Perlis,0,0,0
2022-05-01,DOM,Pulau Pinang,1,0,1
2022-05-01,DOM,Sabah,0,0,0
2022-05-01,DOM,Sarawak,0,0,0
2022-05-01,DOM,Selangor,11,3,8
2022-05-01,DZA,Johor,27,24,3
2022-05-01,DZA,Kedah,0,0,0
2022-05-01,DZA,Kelantan,0,0,0
2022-05-01,DZA,Melaka,1,1,0
2022-05-01,DZA,Perak,0,0,0
2022-05-01,DZA,Perlis,0,0,0
2022-05-01,DZA,Pulau Pinang,1,0,1
2022-05-01,DZA,Sabah,0,0,0
2022-05-01,DZA,Sarawak,0,0,0
2022-05-01,DZA,Selangor,196,133,63
2022-05-01,DZA,W.P. Labuan,0,0,0
2022-05-01,ECU,Johor,5,3,2
2022-05-01,ECU,Kedah,1,0,1
2022-05-01,ECU,Perak,0,0,0
2022-05-01,ECU,Perlis,0,0,0
2022-05-01,ECU,Pulau Pinang,3,1,2
2022-05-01,ECU,Sabah,0,0,0
2022-05-01,ECU,Sarawak,0,0,0
2022-05-01,ECU,Selangor,22,10,12
2022-05-01,EGY,Johor,147,109,38
2022-05-01,EGY,Kedah,2,2,0
2022-05-01,EGY,Kelantan,0,0,0
2022-05-01,EGY,Melaka,0,0,0
2022-05-01,EGY,Pahang,0,0,0
2022-05-01,EGY,Perak,0,0,0
2022-05-01,EGY,Perlis,1,1,0
2022-05-01,EGY,Pulau Pinang,0,0,0
2022-05-01,EGY,Sabah,4,4,0
2022-05-01,EGY,Sarawak,2,2,0
2022-05-01,EGY,Selangor,1110,776,334
2022-05-01,EGY,Terengganu,0,0,0
2022-05-01,EGY,W.P. Labuan,0,0,0
2022-05-01,ERI,Johor,0,0,0
2022-05-01,ERI,Pulau Pinang,0,0,0
2022-05-01,ERI,Sabah,0,0,0
2022-05-01,ERI,Selangor,9,3,6
2022-05-01,ESP,Johor,230,145,85
2022-05-01,ESP,Kedah,10,8,2
2022-05-01,ESP,Kelantan,0,0,0
2022-05-01,ESP,Melaka,0,0,0
2022-05-01,ESP,Negeri Sembilan,0,0,0
2022-05-01,ESP,Pahang,0,0,0
2022-05-01,ESP,Perak,1,1,0
2022-05-01,ESP,Perlis,0,0,0
2022-05-01,ESP,Pulau Pinang,27,18,9
2022-05-01,ESP,Sabah,13,11,2
2022-05-01,ESP,Sarawak,3,2,1
2022-05-01,ESP,Selangor,712,467,245
2022-05-01,ESP,W.P. Labuan,0,0,0
2022-05-01,EST,Johor,10,7,3
2022-05-01,EST,Kedah,1,1,0
2022-05-01,EST,Kelantan,0,0,0
2022-05-01,EST,Pahang,0,0,0
2022-05-01,EST,Perak,0,0,0
2022-05-01,EST,Perlis,0,0,0
2022-05-01,EST,Pulau Pinang,2,0,2
2022-05-01,EST,Sabah,1,1,0
2022-05-01,EST,Sarawak,0,0,0
2022-05-01,EST,Selangor,36,22,14
2022-05-01,EST,W.P. Labuan,0,0,0
2022-05-01,ETH,Johor,1,0,1
2022-05-01,ETH,Kedah,0,0,0
2022-05-01,ETH,Pulau Pinang,0,0,0
2022-05-01,ETH,Sarawak,0,0,0
2022-05-01,ETH,Selangor,25,23,2
2022-05-01,FIN,Johor,153,97,56
2022-05-01,FIN,Kedah,11,4,7
2022-05-01,FIN,Kelantan,0,0,0
2022-05-01,FIN,Melaka,0,0,0
2022-05-01,FIN,Negeri Sembilan,0,0,0
2022-05-01,FIN,Pahang,0,0,0
2022-05-01,FIN,Perak,0,0,0
2022-05-01,FIN,Perlis,0,0,0
2022-05-01,FIN,Pulau Pinang,6,3,3
2022-05-01,FIN,Sabah,7,5,2
2022-05-01,FIN,Sarawak,1,0,1
2022-05-01,FIN,Selangor,200,136,64
2022-05-01,FIN,W.P. Labuan,0,0,0
2022-05-01,FJI,Johor,8,3,5
2022-05-01,FJI,Kedah,0,0,0
2022-05-01,FJI,Kelantan,0,0,0
2022-05-01,FJI,Perak,0,0,0
2022-05-01,FJI,Perlis,0,0,0
2022-05-01,FJI,Pulau Pinang,0,0,0
2022-05-01,FJI,Sabah,0,0,0
2022-05-01,FJI,Sarawak,0,0,0
2022-05-01,FJI,Selangor,27,16,11
2022-05-01,FRA,Johor,1290,804,486
2022-05-01,FRA,Kedah,129,73,56
2022-05-01,FRA,Kelantan,1,0,1
2022-05-01,FRA,Melaka,0,0,0
2022-05-01,FRA,Negeri Sembilan,4,2,2
2022-05-01,FRA,Pahang,0,0,0
2022-05-01,FRA,Perak,9,5,4
2022-05-01,FRA,Perlis,15,6,9
2022-05-01,FRA,Pulau Pinang,169,104,65
2022-05-01,FRA,Sabah,60,39,21
2022-05-01,FRA,Sarawak,12,9,3
2022-05-01,FRA,Selangor,3278,2103,1175
2022-05-01,FRA,Terengganu,0,0,0
2022-05-01,FRA,W.P. Labuan,0,0,0
2022-05-01,FSM,Johor,0,0,0
2022-05-01,FSM,Pulau Pinang,0,0,0
2022-05-01,FSM,Selangor,0,0,0
2022-05-01,GAB,Johor,0,0,0
2022-05-01,GAB,Pulau Pinang,0,0,0
2022-05-01,GAB,Sarawak,0,0,0
2022-05-01,GAB,Selangor,1,1,0
2022-05-01,GBR,Johor,2686,1794,892
2022-05-01,GBR,Kedah,219,124,95
2022-05-01,GBR,Kelantan,1,1,0
2022-05-01,GBR,Melaka,1,0,1
2022-05-01,GBR,Negeri Sembilan,0,0,0
2022-05-01,GBR,Pahang,7,7,0
2022-05-01,GBR,Perak,32,16,16
2022-05-01,GBR,Perlis,23,16,7
2022-05-01,GBR,Pulau Pinang,479,313,166
2022-05-01,GBR,Sabah,262,149,113
2022-05-01,GBR,Sarawak,88,53,35
2022-05-01,GBR,Selangor,7316,4837,2479
2022-05-01,GBR,Terengganu,0,0,0
2022-05-01,GBR,W.P. Labuan,0,0,0
2022-05-01,GEO,Johor,0,0,0
2022-05-01,GEO,Kedah,2,1,1
2022-05-01,GEO,Melaka,0,0,0
2022-05-01,GEO,Perak,0,0,0
2022-05-01,GEO,Perlis,0,0,0
2022-05-01,GEO,Pulau Pinang,0,0,0
2022-05-01,GEO,Sabah,0,0,0
2022-05-01,GEO,Sarawak,0,0,0
2022-05-01,GEO,Selangor,24,10,14
2022-05-01,GHA,Johor,1,1,0
2022-05-01,GHA,Kedah,0,0,0
2022-05-01,GHA,Kelantan,0,0,0
2022-05-01,GHA,Pulau Pinang,0,0,0
2022-05-01,GHA,Sabah,0,0,0
2022-05-01,GHA,Sarawak,0,0,0
2022-05-01,GHA,Selangor,19,14,5
2022-05-01,GIB,Johor,0,0,0
2022-05-01,GIB,Sarawak,0,0,0
2022-05-01,GIN,Johor,0,0,0
2022-05-01,GIN,Kedah,0,0,0
2022-05-01,GIN,Kelantan,0,0,0
2022-05-01,GIN,Perlis,0,0,0
2022-05-01,GIN,Pulau Pinang,0,0,0
2022-05-01,GIN,Sabah,0,0,0
2022-05-01,GIN,Sarawak,0,0,0
2022-05-01,GIN,Selangor,30,19,11
2022-05-01,GLP,Selangor,0,0,0
2022-05-01,GMB,Johor,2,1,1
2022-05-01,GMB,Kedah,0,0,0
2022-05-01,GMB,Kelantan,0,0,0
2022-05-01,GMB,Pulau Pinang,0,0,0
2022-05-01,GMB,Sabah,0,0,0
2022-05-01,GMB,Sarawak,0,0,0
2022-05-01,GMB,Selangor,7,5,2
2022-05-01,GNB,Johor,0,0,0
2022-05-01,GNB,Selangor,0,0,0
2022-05-01,GNQ,Johor,0,0,0
2022-05-01,GNQ,Selangor,0,0,0
2022-05-01,GRC,Johor,13,11,2
2022-05-01,GRC,Kedah,2,1,1
2022-05-01,GRC,Kelantan,0,0,0
2022-05-01,GRC,Melaka,0,0,0
2022-05-01,GRC,Negeri Sembilan,0,0,0
2022-05-01,GRC,Pahang,0,0,0
2022-05-01,GRC,Perak,0,0,0
2022-05-01,GRC,Perlis,0,0,0
2022-05-01,GRC,Pulau Pinang,3,2,1
2022-05-01,GRC,Sabah,0,0,0
2022-05-01,GRC,Sarawak,1,0,1
2022-05-01,GRC,Selangor,85,67,18
2022-05-01,GRD,Johor,4,4,0
2022-05-01,GRD,Kedah,0,0,0
2022-05-01,GRD,Pulau Pinang,0,0,0
2022-05-01,GRD,Sabah,0,0,0
2022-05-01,GRD,Sarawak,0,0,0
2022-05-01,GRD,Selangor,3,1,2
2022-05-01,GRL,Johor,0,0,0
2022-05-01,GRL,Selangor,0,0,0
2022-05-01,GTM,Johor,3,0,3
2022-05-01,GTM,Kedah,0,0,0
2022-05-01,GTM,Pahang,0,0,0
2022-05-01,GTM,Perak,0,0,0
2022-05-01,GTM,Pulau Pinang,3,1,2
2022-05-01,GTM,Sabah,0,0,0
2022-05-01,GTM,Sarawak,0,0,0
2022-05-01,GTM,Selangor,8,1,7
2022-05-01,GTM,W.P. Labuan,0,0,0
2022-05-01,GUY,Johor,0,0,0
2022-05-01,GUY,Kedah,0,0,0
2022-05-01,GUY,Pulau Pinang,0,0,0
2022-05-01,GUY,Sarawak,0,0,0
2022-05-01,GUY,Selangor,1,1,0
2022-05-01,HKG,Johor,9,5,4
2022-05-01,HKG,Kedah,5,1,4
2022-05-01,HKG,Kelantan,0,0,0
2022-05-01,HKG,Pahang,0,0,0
2022-05-01,HKG,Perak,7,5,2
2022-05-01,HKG,Perlis,0,0,0
2022-05-01,HKG,Pulau Pinang,150,93,57
2022-05-01,HKG,Sabah,36,17,19
2022-05-01,HKG,Sarawak,47,25,22
2022-05-01,HKG,Selangor,1,1,0
2022-05-01,HKG,Terengganu,0,0,0
2022-05-01,HMD,Johor,0,0,0
2022-05-01,HND,Johor,3,2,1
2022-05-01,HND,Kedah,0,0,0
2022-05-01,HND,Perak,0,0,0
2022-05-01,HND,Pulau Pinang,0,0,0
2022-05-01,HND,Sabah,0,0,0
2022-05-01,HND,Sarawak,0,0,0
2022-05-01,HND,Selangor,2,0,2
2022-05-01,HRV,Johor,13,12,1
2022-05-01,HRV,Kedah,0,0,0
2022-05-01,HRV,Kelantan,0,0,0
2022-05-01,HRV,Melaka,0,0,0
2022-05-01,HRV,Pahang,0,0,0
2022-05-01,HRV,Perak,0,0,0
2022-05-01,HRV,Perlis,0,0,0
2022-05-01,HRV,Pulau Pinang,1,1,0
2022-05-01,HRV,Sabah,0,0,0
2022-05-01,HRV,Sarawak,1,1,0
2022-05-01,HRV,Selangor,73,61,12
2022-05-01,HTI,Johor,0,0,0
2022-05-01,HTI,Kedah,0,0,0
2022-05-01,HTI,Kelantan,0,0,0
2022-05-01,HTI,Perak,0,0,0
2022-05-01,HTI,Pulau Pinang,0,0,0
2022-05-01,HTI,Sabah,0,0,0
2022-05-01,HTI,Selangor,7,2,5
2022-05-01,HUN,Johor,72,55,17
2022-05-01,HUN,Kedah,7,3,4
2022-05-01,HUN,Kelantan,0,0,0
2022-05-01,HUN,Pahang,0,0,0
2022-05-01,HUN,Perak,0,0,0
2022-05-01,HUN,Perlis,0,0,0
2022-05-01,HUN,Pulau Pinang,3,3,0
2022-05-01,HUN,Sabah,3,2,1
2022-05-01,HUN,Sarawak,2,2,0
2022-05-01,HUN,Selangor,110,65,45
2022-05-01,HUN,W.P. Labuan,0,0,0
2022-05-01,IDN,Johor,33449,15578,17871
2022-05-01,IDN,Kedah,170,65,105
2022-05-01,IDN,Kelantan,7,2,5
2022-05-01,IDN,Melaka,2968,1349,1619
2022-05-01,IDN,Negeri Sembilan,2772,1802,970
2022-05-01,IDN,Pahang,8,6,2
2022-05-01,IDN,Perak,29,4,25
2022-05-01,IDN,Perlis,35,24,11
2022-05-01,IDN,Pulau Pinang,9946,4185,5761
2022-05-01,IDN,Sabah,2035,966,1069
2022-05-01,IDN,Sarawak,12522,8386,4136
2022-05-01,IDN,Selangor,45170,21148,24022
2022-05-01,IDN,Terengganu,0,0,0
2022-05-01,IDN,W.P. Labuan,2,2,0
2022-05-01,IND,Johor,6606,4593,2013
2022-05-01,IND,Kedah,618,412,206
2022-05-01,IND,Kelantan,1,1,0
2022-05-01,IND,Melaka,0,0,0
2022-05-01,IND,Negeri Sembilan,0,0,0
2022-05-01,IND,Pahang,2,2,0
2022-05-01,IND,Perak,20,14,6
2022-05-01,IND,Perlis,106,90,16
2022-05-01,IND,Pulau Pinang,345,243,102
2022-05-01,IND,Sabah,80,54,26
2022-05-01,IND,Sarawak,31,28,3
2022-05-01,IND,Selangor,27249,19319,7930
2022-05-01,IND,Terengganu,0,0,0
2022-05-01,IND,W.P. Labuan,0,0,0
2022-05-01,IOT,Pulau Pinang,0,0,0
2022-05-01,IOT,Selangor,0,0,0
2022-05-01,IRL,Johor,209,153,56
2022-05-01,IRL,Kedah,16,9,7
2022-05-01,IRL,Kelantan,0,0,0
2022-05-01,IRL,Negeri Sembilan,0,0,0
2022-05-01,IRL,Pahang,0,0,0
2022-05-01,IRL,Perak,1,0,1
2022-05-01,IRL,Perlis,3,2,1
2022-05-01,IRL,Pulau Pinang,25,17,8
2022-05-01,IRL,Sabah,6,4,2
2022-05-01,IRL,Sarawak,8,3,5
2022-05-01,IRL,Selangor,451,278,173
2022-05-01,IRL,Terengganu,0,0,0
2022-05-01,IRL,W.P. Labuan,0,0,0
2022-05-01,IRN,Johor,98,57,41
2022-05-01,IRN,Kedah,1,1,0
2022-05-01,IRN,Kelantan,0,0,0
2022-05-01,IRN,Perak,1,1,0
2022-05-01,IRN,Perlis,2,1,1
2022-05-01,IRN,Pulau Pinang,3,1,2
2022-05-01,IRN,Sabah,2,1,1
2022-05-01,IRN,Sarawak,0,0,0
2022-05-01,IRN,Selangor,842,486,356
2022-05-01,IRN,W.P. Labuan,0,0,0
2022-05-01,IRQ,Johor,7,5,2
2022-05-01,IRQ,Kedah,0,0,0
2022-05-01,IRQ,Kelantan,0,0,0
2022-05-01,IRQ,Melaka,0,0,0
2022-05-01,IRQ,Pahang,0,0,0
2022-05-01,IRQ,Perak,0,0,0
2022-05-01,IRQ,Perlis,0,0,0
2022-05-01,IRQ,Pulau Pinang,0,0,0
2022-05-01,IRQ,Sabah,0,0,0
2022-05-01,IRQ,Sarawak,0,0,0
2022-05-01,IRQ,Selangor,543,373,170
2022-05-01,ISL,Johor,29,9,20
2022-05-01,ISL,Kedah,0,0,0
2022-05-01,ISL,Kelantan,0,0,0
2022-05-01,ISL,Perak,0,0,0
2022-05-01,ISL,Perlis,0,0,0
2022-05-01,ISL,Pulau Pinang,0,0,0
2022-05-01,ISL,Sabah,0,0,0
2022-05-01,ISL,Sarawak,0,0,0
2022-05-01,ISL,Selangor,5,2,3
2022-05-01,ISL,W.P. Labuan,0,0,0
2022-05-01,ISR,Pulau Pinang,4,2,2
2022-05-01,ITA,Johor,274,208,66
2022-05-01,ITA,Kedah,28,18,10
2022-05-01,ITA,Kelantan,0,0,0
2022-05-01,ITA,Melaka,0,0,0
2022-05-01,ITA,Negeri Sembilan,0,0,0
2022-05-01,ITA,Pahang,1,1,0
2022-05-01,ITA,Perak,2,2,0
2022-05-01,ITA,Perlis,1,1,0
2022-05-01,ITA,Pulau Pinang,38,33,5
2022-05-01,ITA,Sabah,9,6,3
2022-05-01,ITA,Sarawak,5,5,0
2022-05-01,ITA,Selangor,955,696,259
2022-05-01,ITA,W.P. Labuan,0,0,0
2022-05-01,JAM,Johor,0,0,0
2022-05-01,JAM,Kedah,0,0,0
2022-05-01,JAM,Perak,0,0,0
2022-05-01,JAM,Pulau Pinang,0,0,0
2022-05-01,JAM,Sabah,0,0,0
2022-05-01,JAM,Sarawak,0,0,0
2022-05-01,JAM,Selangor,1,1,0
2022-05-01,JAM,W.P. Labuan,0,0,0
2022-05-01,JOR,Johor,15,6,9
2022-05-01,JOR,Kedah,8,4,4
2022-05-01,JOR,Kelantan,0,0,0
2022-05-01,JOR,Melaka,0,0,0
2022-05-01,JOR,Perlis,0,0,0
2022-05-01,JOR,Pulau Pinang,8,5,3
2022-05-01,JOR,Sabah,0,0,0
2022-05-01,JOR,Sarawak,0,0,0
2022-05-01,JOR,Selangor,517,326,191
2022-05-01,JOR,W.P. Labuan,0,0,0
2022-05-01,JPN,Johor,3507,2424,1083
2022-05-01,JPN,Kedah,69,41,28
2022-05-01,JPN,Kelantan,0,0,0
2022-05-01,JPN,Melaka,0,0,0
2022-05-01,JPN,Negeri Sembilan,0,0,0
2022-05-01,JPN,Pahang,0,0,0
2022-05-01,JPN,Perak,7,5,2
2022-05-01,JPN,Perlis,0,0,0
2022-05-01,JPN,Pulau Pinang,365,273,92
2022-05-01,JPN,Sabah,73,42,31
2022-05-01,JPN,Sarawak,34,23,11
2022-05-01,JPN,Selangor,5015,3676,1339
2022-05-01,JPN,W.P. Labuan,0,0,0
2022-05-01,KAZ,Johor,11,8,3
2022-05-01,KAZ,Kedah,0,0,0
2022-05-01,KAZ,Kelantan,0,0,0
2022-05-01,KAZ,Melaka,0,0,0
2022-05-01,KAZ,Perak,0,0,0
2022-05-01,KAZ,Perlis,0,0,0
2022-05-01,KAZ,Pulau Pinang,0,0,0
2022-05-01,KAZ,Sabah,2,1,1
2022-05-01,KAZ,Sarawak,1,0,1
2022-05-01,KAZ,Selangor,195,75,120
2022-05-01,KAZ,W.P. Labuan,0,0,0
2022-05-01,KEN,Johor,41,19,22
2022-05-01,KEN,Kedah,6,2,4
2022-05-01,KEN,Kelantan,0,0,0
2022-05-01,KEN,Perak,0,0,0
2022-05-01,KEN,Perlis,0,0,0
2022-05-01,KEN,Pulau Pinang,1,0,1
2022-05-01,KEN,Sabah,0,0,0
2022-05-01,KEN,Sarawak,1,1,0
2022-05-01,KEN,Selangor,133,75,58
2022-05-01,KGZ,Johor,13,5,8
2022-05-01,KGZ,Kedah,0,0,0
2022-05-01,KGZ,Kelantan,0,0,0
2022-05-01,KGZ,Perak,0,0,0
2022-05-01,KGZ,Perlis,0,0,0
2022-05-01,KGZ,Pulau Pinang,0,0,0
2022-05-01,KGZ,Sabah,0,0,0
2022-05-01,KGZ,Sarawak,0,0,0
2022-05-01,KGZ,Selangor,152,93,59
2022-05-01,KHM,Johor,153,70,83
2022-05-01,KHM,Kedah,345,299,46
2022-05-01,KHM,Kelantan,6,6,0
2022-05-01,KHM,Melaka,0,0,0
2022-05-01,KHM,Negeri Sembilan,0,0,0
2022-05-01,KHM,Pahang,0,0,0
2022-05-01,KHM,Perak,1,1,0
2022-05-01,KHM,Perlis,151,108,43
2022-05-01,KHM,Pulau Pinang,30,20,10
2022-05-01,KHM,Sabah,0,0,0
2022-05-01,KHM,Sarawak,2,1,1
2022-05-01,KHM,Selangor,2022,1203,819
2022-05-01,KHM,W.P. Labuan,0,0,0
2022-05-01,KIR,Johor,0,0,0
2022-05-01,KIR,Sabah,0,0,0
2022-05-01,KIR,Selangor,0,0,0
2022-05-01,KNA,Johor,15,13,2
2022-05-01,KNA,Kedah,0,0,0
2022-05-01,KNA,Perlis,0,0,0
2022-05-01,KNA,Pulau Pinang,0,0,0
2022-05-01,KNA,Sabah,1,0,1
2022-05-01,KNA,Selangor,42,28,14
2022-05-01,KNA,W.P. Labuan,0,0,0
2022-05-01,KOR,Johor,5302,3243,2059
2022-05-01,KOR,Kedah,40,18,22
2022-05-01,KOR,Kelantan,0,0,0
2022-05-01,KOR,Melaka,1,1,0
2022-05-01,KOR,Negeri Sembilan,0,0,0
2022-05-01,KOR,Pahang,0,0,0
2022-05-01,KOR,Perak,6,4,2
2022-05-01,KOR,Perlis,7,5,2
2022-05-01,KOR,Pulau Pinang,154,98,56
2022-05-01,KOR,Sabah,382,191,191
2022-05-01,KOR,Sarawak,55,41,14
2022-05-01,KOR,Selangor,3906,2610,1296
2022-05-01,KOR,Terengganu,0,0,0
2022-05-01,KOR,W.P. Labuan,0,0,0
2022-05-01,KWT,Johor,21,10,11
2022-05-01,KWT,Kedah,1,0,1
2022-05-01,KWT,Kelantan,0,0,0
2022-05-01,KWT,Perak,0,0,0
2022-05-01,KWT,Perlis,0,0,0
2022-05-01,KWT,Pulau Pinang,2,0,2
2022-05-01,KWT,Sabah,0,0,0
2022-05-01,KWT,Sarawak,0,0,0
2022-05-01,KWT,Selangor,167,109,58
2022-05-01,KWT,W.P. Labuan,0,0,0
2022-05-01,LAO,Johor,8,1,7
2022-05-01,LAO,Kedah,188,57,131
2022-05-01,LAO,Kelantan,2,0,2
2022-05-01,LAO,Melaka,0,0,0
2022-05-01,LAO,Perak,0,0,0
2022-05-01,LAO,Perlis,2,1,1
2022-05-01,LAO,Pulau Pinang,3,2,1
2022-05-01,LAO,Sabah,1,0,1
2022-05-01,LAO,Sarawak,0,0,0
2022-05-01,LAO,Selangor,239,186,53
2022-05-01,LAO,W.P. Labuan,0,0,0
2022-05-01,LBN,Johor,10,6,4
2022-05-01,LBN,Kedah,6,4,2
2022-05-01,LBN,Kelantan,0,0,0
2022-05-01,LBN,Pahang,0,0,0
2022-05-01,LBN,Perak,0,0,0
2022-05-01,LBN,Perlis,0,0,0
2022-05-01,LBN,Pulau Pinang,3,1,2
2022-05-01,LBN,Sabah,0,0,0
2022-05-01,LBN,Sarawak,0,0,0
2022-05-01,LBN,Selangor,146,99,47
2022-05-01,LBN,W.P. Labuan,0,0,0
2022-05-01,LBR,Johor,0,0,0
2022-05-01,LBR,Kedah,0,0,0
2022-05-01,LBR,Sabah,0,0,0
2022-05-01,LBR,Sarawak,0,0,0
2022-05-01,LBR,Selangor,3,1,2
2022-05-01,LBY,Johor,1,1,0
2022-05-01,LBY,Kedah,0,0,0
2022-05-01,LBY,Perlis,0,0,0
2022-05-01,LBY,Pulau Pinang,0,0,0
2022-05-01,LBY,Sabah,0,0,0
2022-05-01,LBY,Sarawak,0,0,0
2022-05-01,LBY,Selangor,239,169,70
2022-05-01,LCA,Johor,2,2,0
2022-05-01,LCA,Kedah,0,0,0
2022-05-01,LCA,Pulau Pinang,0,0,0
2022-05-01,LCA,Sarawak,0,0,0
2022-05-01,LCA,Selangor,3,3,0
2022-05-01,LIE,Johor,0,0,0
2022-05-01,LIE,Kedah,0,0,0
2022-05-01,LIE,Perlis,0,0,0
2022-05-01,LIE,Pulau Pinang,1,1,0
2022-05-01,LIE,Sabah,0,0,0
2022-05-01,LIE,Sarawak,0,0,0
2022-05-01,LIE,Selangor,6,3,3
2022-05-01,LKA,Johor,361,241,120
2022-05-01,LKA,Kedah,3,2,1
2022-05-01,LKA,Kelantan,0,0,0
2022-05-01,LKA,Melaka,0,0,0
2022-05-01,LKA,Pahang,0,0,0
2022-05-01,LKA,Perak,0,0,0
2022-05-01,LKA,Perlis,0,0,0
2022-05-01,LKA,Pulau Pinang,17,13,4
2022-05-01,LKA,Sabah,0,0,0
2022-05-01,LKA,Sarawak,4,4,0
2022-05-01,LKA,Selangor,1797,1119,678
2022-05-01,LKA,W.P. Labuan,0,0,0
2022-05-01,LSO,Johor,0,0,0
2022-05-01,LSO,Kedah,0,0,0
2022-05-01,LSO,Pulau Pinang,0,0,0
2022-05-01,LSO,Sarawak,0,0,0
2022-05-01,LSO,Selangor,6,3,3
2022-05-01,LTU,Johor,13,4,9
2022-05-01,LTU,Kedah,4,3,1
2022-05-01,LTU,Kelantan,0,0,0
2022-05-01,LTU,Pahang,1,0,1
2022-05-01,LTU,Perak,0,0,0
2022-05-01,LTU,Perlis,0,0,0
2022-05-01,LTU,Pulau Pinang,4,2,2
2022-05-01,LTU,Sabah,5,5,0
2022-05-01,LTU,Sarawak,0,0,0
2022-05-01,LTU,Selangor,73,42,31
2022-05-01,LTU,W.P. Labuan,0,0,0
2022-05-01,LUX,Johor,1,1,0
2022-05-01,LUX,Kedah,0,0,0
2022-05-01,LUX,Kelantan,0,0,0
2022-05-01,LUX,Perak,0,0,0
2022-05-01,LUX,Perlis,1,1,0
2022-05-01,LUX,Pulau Pinang,1,1,0
2022-05-01,LUX,Sabah,0,0,0
2022-05-01,LUX,Sarawak,0,0,0
2022-05-01,LUX,Selangor,12,11,1
2022-05-01,LVA,Johor,6,3,3
2022-05-01,LVA,Kedah,3,2,1
2022-05-01,LVA,Kelantan,0,0,0
2022-05-01,LVA,Pahang,0,0,0
2022-05-01,LVA,Perak,0,0,0
2022-05-01,LVA,Perlis,0,0,0
2022-05-01,LVA,Pulau Pinang,0,0,0
2022-05-01,LVA,Sabah,2,1,1
2022-05-01,LVA,Sarawak,0,0,0
2022-05-01,LVA,Selangor,28,16,12
2022-05-01,LVA,W.P. Labuan,0,0,0
2022-05-01,MAC,Johor,1,0,1
2022-05-01,MAC,Pahang,0,0,0
2022-05-01,MAC,Perak,0,0,0
2022-05-01,MAC,Selangor,0,0,0
2022-05-01,MAC,W.P. Labuan,0,0,0
2022-05-01,MAR,Johor,40,24,16
2022-05-01,MAR,Kedah,3,2,1
2022-05-01,MAR,Kelantan,1,1,0
2022-05-01,MAR,Melaka,0,0,0
2022-05-01,MAR,Pahang,0,0,0
2022-05-01,MAR,Perak,0,0,0
2022-05-01,MAR,Perlis,0,0,0
2022-05-01,MAR,Pulau Pinang,0,0,0
2022-05-01,MAR,Sabah,1,1,0
2022-05-01,MAR,Sarawak,0,0,0
2022-05-01,MAR,Selangor,354,152,202
2022-05-01,MAR,W.P. Labuan,0,0,0
2022-05-01,MCO,Johor,1,1,0
2022-05-01,MCO,Kedah,0,0,0
2022-05-01,MCO,Sabah,0,0,0
2022-05-01,MCO,Selangor,5,1,4
2022-05-01,MDA,Johor,0,0,0
2022-05-01,MDA,Kedah,0,0,0
2022-05-01,MDA,Kelantan,0,0,0
2022-05-01,MDA,Negeri Sembilan,0,0,0
2022-05-01,MDA,Perlis,0,0,0
2022-05-01,MDA,Pulau Pinang,0,0,0
2022-05-01,MDA,Sabah,0,0,0
2022-05-01,MDA,Sarawak,0,0,0
2022-05-01,MDA,Selangor,12,5,7
2022-05-01,MDG,Johor,2,1,1
2022-05-01,MDG,Kedah,0,0,0
2022-05-01,MDG,Perak,0,0,0
2022-05-01,MDG,Perlis,0,0,0
2022-05-01,MDG,Pulau Pinang,0,0,0
2022-05-01,MDG,Sabah,0,0,0
2022-05-01,MDG,Sarawak,0,0,0
2022-05-01,MDG,Selangor,4,2,2
2022-05-01,MDV,Johor,89,68,21
2022-05-01,MDV,Kedah,9,6,3
2022-05-01,MDV,Kelantan,0,0,0
2022-05-01,MDV,Perak,1,0,1
2022-05-01,MDV,Perlis,0,0,0
2022-05-01,MDV,Pulau Pinang,6,2,4
2022-05-01,MDV,Sabah,6,2,4
2022-05-01,MDV,Sarawak,1,1,0
2022-05-01,MDV,Selangor,1500,770,730
2022-05-01,MEX,Johor,41,24,17
2022-05-01,MEX,Kedah,8,5,3
2022-05-01,MEX,Kelantan,0,0,0
2022-05-01,MEX,Pahang,0,0,0
2022-05-01,MEX,Perak,0,0,0
2022-05-01,MEX,Perlis,0,0,0
2022-05-01,MEX,Pulau Pinang,35,29,6
2022-05-01,MEX,Sabah,1,0,1
2022-05-01,MEX,Sarawak,0,0,0
2022-05-01,MEX,Selangor,168,96,72
2022-05-01,MEX,W.P. Labuan,0,0,0
2022-05-01,MHL,Johor,0,0,0
2022-05-01,MHL,Kedah,0,0,0
2022-05-01,MHL,Perak,0,0,0
2022-05-01,MHL,Pulau Pinang,0,0,0
2022-05-01,MHL,Sabah,0,0,0
2022-05-01,MHL,Selangor,0,0,0
2022-05-01,MKD,Johor,1,0,1
2022-05-01,MKD,Kedah,4,2,2
2022-05-01,MKD,Perak,0,0,0
2022-05-01,MKD,Pulau Pinang,0,0,0
2022-05-01,MKD,Sabah,0,0,0
2022-05-01,MKD,Sarawak,0,0,0
2022-05-01,MKD,Selangor,7,2,5
2022-05-01,MLI,Johor,0,0,0
2022-05-01,MLI,Sabah,0,0,0
2022-05-01,MLI,Selangor,0,0,0
2022-05-01,MLT,Johor,8,4,4
2022-05-01,MLT,Kedah,0,0,0
2022-05-01,MLT,Kelantan,0,0,0
2022-05-01,MLT,Perak,0,0,0
2022-05-01,MLT,Perlis,0,0,0
2022-05-01,MLT,Pulau Pinang,3,3,0
2022-05-01,MLT,Sabah,0,0,0
2022-05-01,MLT,Sarawak,0,0,0
2022-05-01,MLT,Selangor,19,13,6
2022-05-01,MLT,W.P. Labuan,0,0,0
2022-05-01,MMR,Johor,1485,525,960
2022-05-01,MMR,Kedah,4,1,3
2022-05-01,MMR,Kelantan,0,0,0
2022-05-01,MMR,Negeri Sembilan,0,0,0
2022-05-01,MMR,Pahang,0,0,0
2022-05-01,MMR,Perak,6,2,4
2022-05-01,MMR,Perlis,1,0,1
2022-05-01,MMR,Pulau Pinang,31,15,16
2022-05-01,MMR,Sabah,5,4,1
2022-05-01,MMR,Sarawak,7,3,4
2022-05-01,MMR,Selangor,1553,943,610
2022-05-01,MMR,Terengganu,0,0,0
2022-05-01,MMR,W.P. Labuan,0,0,0
2022-05-01,MNE,Johor,0,0,0
2022-05-01,MNE,Kedah,0,0,0
2022-05-01,MNE,Pulau Pinang,0,0,0
2022-05-01,MNE,Sabah,0,0,0
2022-05-01,MNE,Sarawak,0,0,0
2022-05-01,MNE,Selangor,8,7,1
2022-05-01,MNG,Johor,32,10,22
2022-05-01,MNG,Kedah,3,1,2
2022-05-01,MNG,Kelantan,0,0,0
2022-05-01,MNG,Perak,0,0,0
2022-05-01,MNG,Perlis,0,0,0
2022-05-01,MNG,Pulau Pinang,2,0,2
2022-05-01,MNG,Sabah,0,0,0
2022-05-01,MNG,Sarawak,0,0,0
2022-05-01,MNG,Selangor,112,56,56
2022-05-01,MNP,Selangor,0,0,0
2022-05-01,MOZ,Johor,0,0,0
2022-05-01,MOZ,Kedah,0,0,0
2022-05-01,MOZ,Perak,0,0,0
2022-05-01,MOZ,Pulau Pinang,0,0,0
2022-05-01,MOZ,Sabah,0,0,0
2022-05-01,MOZ,Sarawak,0,0,0
2022-05-01,MOZ,Selangor,10,6,4
2022-05-01,MRT,Johor,0,0,0
2022-05-01,MRT,Kedah,0,0,0
2022-05-01,MRT,Pulau Pinang,0,0,0
2022-05-01,MRT,Sabah,0,0,0
2022-05-01,MRT,Sarawak,0,0,0
2022-05-01,MRT,Selangor,17,14,3
2022-05-01,MUS,Johor,29,17,12
2022-05-01,MUS,Kedah,2,1,1
2022-05-01,MUS,Kelantan,0,0,0
2022-05-01,MUS,Pahang,0,0,0
2022-05-01,MUS,Perak,0,0,0
2022-05-01,MUS,Perlis,0,0,0
2022-05-01,MUS,Pulau Pinang,2,2,0
2022-05-01,MUS,Sabah,0,0,0
2022-05-01,MUS,Sarawak,0,0,0
2022-05-01,MUS,Selangor,140,74,66
2022-05-01,MWI,Johor,0,0,0
2022-05-01,MWI,Pulau Pinang,0,0,0
2022-05-01,MWI,Sabah,0,0,0
2022-05-01,MWI,Sarawak,0,0,0
2022-05-01,MWI,Selangor,7,4,3
2022-05-01,MYT,Selangor,0,0,0
2022-05-01,NAM,Johor,0,0,0
2022-05-01,NAM,Kedah,0,0,0
2022-05-01,NAM,Perak,0,0,0
2022-05-01,NAM,Perlis,0,0,0
2022-05-01,NAM,Pulau Pinang,0,0,0
2022-05-01,NAM,Sabah,0,0,0
2022-05-01,NAM,Sarawak,0,0,0
2022-05-01,NAM,Selangor,8,3,5
2022-05-01,NCL,Selangor,0,0,0
2022-05-01,NER,Johor,2,2,0
2022-05-01,NER,Sabah,0,0,0
2022-05-01,NER,Selangor,0,0,0
2022-05-01,NGA,Johor,17,14,3
2022-05-01,NGA,Kedah,0,0,0
2022-05-01,NGA,Perlis,0,0,0
2022-05-01,NGA,Pulau Pinang,0,0,0
2022-05-01,NGA,Sabah,0,0,0
2022-05-01,NGA,Sarawak,2,2,0
2022-05-01,NGA,Selangor,283,249,34
2022-05-01,NIC,Johor,1,0,1
2022-05-01,NIC,Kedah,0,0,0
2022-05-01,NIC,Pulau Pinang,1,1,0
2022-05-01,NIC,Sabah,0,0,0
2022-05-01,NIC,Selangor,3,2,1
2022-05-01,NLD,Johor,595,393,202
2022-05-01,NLD,Kedah,42,25,17
2022-05-01,NLD,Kelantan,0,0,0
2022-05-01,NLD,Melaka,0,0,0
2022-05-01,NLD,Negeri Sembilan,0,0,0
2022-05-01,NLD,Pahang,1,1,0
2022-05-01,NLD,Perak,0,0,0
2022-05-01,NLD,Perlis,14,8,6
2022-05-01,NLD,Pulau Pinang,94,63,31
2022-05-01,NLD,Sabah,18,12,6
2022-05-01,NLD,Sarawak,11,8,3
2022-05-01,NLD,Selangor,1498,1030,468
2022-05-01,NLD,Terengganu,0,0,0
2022-05-01,NLD,W.P. Labuan,0,0,0
2022-05-01,NOR,Johor,88,60,28
2022-05-01,NOR,Kedah,7,2,5
2022-05-01,NOR,Kelantan,0,0,0
2022-05-01,NOR,Melaka,0,0,0
2022-05-01,NOR,Pahang,0,0,0
2022-05-01,NOR,Perak,1,1,0
2022-05-01,NOR,Perlis,2,1,1
2022-05-01,NOR,Pulau Pinang,4,2,2
2022-05-01,NOR,Sabah,9,5,4
2022-05-01,NOR,Sarawak,2,1,1
2022-05-01,NOR,Selangor,266,188,78
2022-05-01,NOR,W.P. Labuan,0,0,0
2022-05-01,NPL,Johor,418,382,36
2022-05-01,NPL,Kedah,0,0,0
2022-05-01,NPL,Pahang,0,0,0
2022-05-01,NPL,Perak,0,0,0
2022-05-01,NPL,Perlis,0,0,0
2022-05-01,NPL,Pulau Pinang,6,5,1
2022-05-01,NPL,Sabah,6,4,2
2022-05-01,NPL,Sarawak,2,1,1
2022-05-01,NPL,Selangor,5458,5047,411
2022-05-01,NPL,W.P. Labuan,0,0,0
2022-05-01,NRU,Johor,0,0,0
2022-05-01,NRU,Pulau Pinang,0,0,0
2022-05-01,NRU,Selangor,0,0,0
2022-05-01,NZL,Johor,312,200,112
2022-05-01,NZL,Kedah,36,21,15
2022-05-01,NZL,Kelantan,0,0,0
2022-05-01,NZL,Melaka,0,0,0
2022-05-01,NZL,Negeri Sembilan,0,0,0
2022-05-01,NZL,Pahang,0,0,0
2022-05-01,NZL,Perak,4,2,2
2022-05-01,NZL,Perlis,0,0,0
2022-05-01,NZL,Pulau Pinang,66,32,34
2022-05-01,NZL,Sabah,18,11,7
2022-05-01,NZL,Sarawak,11,7,4
2022-05-01,NZL,Selangor,682,455,227
2022-05-01,NZL,Terengganu,0,0,0
2022-05-01,NZL,W.P. Labuan,0,0,0
2022-05-01,OMN,Johor,4,4,0
2022-05-01,OMN,Kedah,6,4,2
2022-05-01,OMN,Kelantan,0,0,0
2022-05-01,OMN,Melaka,0,0,0
2022-05-01,OMN,Perak,0,0,0
2022-05-01,OMN,Perlis,0,0,0
2022-05-01,OMN,Pulau Pinang,0,0,0
2022-05-01,OMN,Sabah,0,0,0
2022-05-01,OMN,Sarawak,1,1,0
2022-05-01,OMN,Selangor,490,313,177
2022-05-01,PAK,Johor,266,207,59
2022-05-01,PAK,Kedah,17,15,2
2022-05-01,PAK,Kelantan,6,6,0
2022-05-01,PAK,Melaka,0,0,0
2022-05-01,PAK,Negeri Sembilan,0,0,0
2022-05-01,PAK,Pahang,0,0,0
2022-05-01,PAK,Perak,5,5,0
2022-05-01,PAK,Perlis,19,18,1
2022-05-01,PAK,Pulau Pinang,16,14,2
2022-05-01,PAK,Sabah,2,2,0
2022-05-01,PAK,Sarawak,8,8,0
2022-05-01,PAK,Selangor,5582,4561,1021
2022-05-01,PAK,W.P. Labuan,0,0,0
2022-05-01,PAN,Johor,5,3,2
2022-05-01,PAN,Kedah,0,0,0
2022-05-01,PAN,Perak,0,0,0
2022-05-01,PAN,Perlis,0,0,0
2022-05-01,PAN,Pulau Pinang,0,0,0
2022-05-01,PAN,Sabah,0,0,0
2022-05-01,PAN,Sarawak,0,0,0
2022-05-01,PAN,Selangor,3,3,0
2022-05-01,PER,Johor,22,13,9
2022-05-01,PER,Kedah,2,1,1
2022-05-01,PER,Kelantan,0,0,0
2022-05-01,PER,Pahang,0,0,0
2022-05-01,PER,Perak,0,0,0
2022-05-01,PER,Perlis,0,0,0
2022-05-01,PER,Pulau Pinang,0,0,0
2022-05-01,PER,Sabah,0,0,0
2022-05-01,PER,Sarawak,0,0,0
2022-05-01,PER,Selangor,39,21,18
2022-05-01,PER,W.P. Labuan,0,0,0
2022-05-01,PHL,Johor,7206,2109,5097
2022-05-01,PHL,Kedah,50,16,34
2022-05-01,PHL,Kelantan,1,1,0
2022-05-01,PHL,Melaka,0,0,0
2022-05-01,PHL,Negeri Sembilan,0,0,0
2022-05-01,PHL,Pahang,4,4,0
2022-05-01,PHL,Perak,18,6,12
2022-05-01,PHL,Perlis,10,4,6
2022-05-01,PHL,Pulau Pinang,262,108,154
2022-05-01,PHL,Sabah,102,28,74
2022-05-01,PHL,Sarawak,68,33,35
2022-05-01,PHL,Selangor,6349,2706,3643
2022-05-01,PHL,Terengganu,0,0,0
2022-05-01,PHL,W.P. Labuan,2,2,0
2022-05-01,PLW,Johor,1,1,0
2022-05-01,PLW,Pulau Pinang,0,0,0
2022-05-01,PLW,Selangor,1,0,1
2022-05-01,PNG,Johor,6,5,1
2022-05-01,PNG,Kedah,0,0,0
2022-05-01,PNG,Kelantan,0,0,0
2022-05-01,PNG,Perak,0,0,0
2022-05-01,PNG,Pulau Pinang,1,0,1
2022-05-01,PNG,Sabah,0,0,0
2022-05-01,PNG,Sarawak,0,0,0
2022-05-01,PNG,Selangor,33,24,9
2022-05-01,POL,Johor,109,71,38
2022-05-01,POL,Kedah,10,7,3
2022-05-01,POL,Kelantan,0,0,0
2022-05-01,POL,Melaka,0,0,0
2022-05-01,POL,Negeri Sembilan,0,0,0
2022-05-01,POL,Pahang,0,0,0
2022-05-01,POL,Perak,1,0,1
2022-05-01,POL,Perlis,0,0,0
2022-05-01,POL,Pulau Pinang,27,15,12
2022-05-01,POL,Sabah,14,7,7
2022-05-01,POL,Sarawak,9,6,3
2022-05-01,POL,Selangor,339,219,120
2022-05-01,POL,Terengganu,0,0,0
2022-05-01,POL,W.P. Labuan,0,0,0
2022-05-01,PRK,Selangor,0,0,0
2022-05-01,PRT,Johor,83,49,34
2022-05-01,PRT,Kedah,5,2,3
2022-05-01,PRT,Kelantan,0,0,0
2022-05-01,PRT,Melaka,0,0,0
2022-05-01,PRT,Pahang,0,0,0
2022-05-01,PRT,Perak,0,0,0
2022-05-01,PRT,Perlis,2,1,1
2022-05-01,PRT,Pulau Pinang,9,5,4
2022-05-01,PRT,Sabah,2,0,2
2022-05-01,PRT,Sarawak,2,1,1
2022-05-01,PRT,Selangor,271,190,81
2022-05-01,PRT,W.P. Labuan,0,0,0
2022-05-01,PRY,Johor,1,0,1
2022-05-01,PRY,Kedah,0,0,0
2022-05-01,PRY,Perak,0,0,0
2022-05-01,PRY,Perlis,0,0,0
2022-05-01,PRY,Pulau Pinang,0,0,0
2022-05-01,PRY,Sabah,0,0,0
2022-05-01,PRY,Sarawak,0,0,0
2022-05-01,PRY,Selangor,4,2,2
2022-05-01,PSE,Johor,2,2,0
2022-05-01,PSE,Kedah,1,1,0
2022-05-01,PSE,Kelantan,0,0,0
2022-05-01,PSE,Melaka,0,0,0
2022-05-01,PSE,Perak,0,0,0
2022-05-01,PSE,Perlis,1,1,0
2022-05-01,PSE,Pulau Pinang,0,0,0
2022-05-01,PSE,Sabah,0,0,0
2022-05-01,PSE,Sarawak,0,0,0
2022-05-01,PSE,Selangor,266,179,87
2022-05-01,QAT,Johor,16,9,7
2022-05-01,QAT,Kedah,0,0,0
2022-05-01,QAT,Perlis,0,0,0
2022-05-01,QAT,Pulau Pinang,0,0,0
2022-05-01,QAT,Sabah,0,0,0
2022-05-01,QAT,Sarawak,0,0,0
2022-05-01,QAT,Selangor,80,48,32
2022-05-01,REU,Johor,0,0,0
2022-05-01,REU,Sarawak,0,0,0
2022-05-01,ROU,Johor,61,31,30
2022-05-01,ROU,Kedah,1,0,1
2022-05-01,ROU,Kelantan,0,0,0
2022-05-01,ROU,Negeri Sembilan,0,0,0
2022-05-01,ROU,Pahang,0,0,0
2022-05-01,ROU,Perak,1,0,1
2022-05-01,ROU,Perlis,0,0,0
2022-05-01,ROU,Pulau Pinang,5,4,1
2022-05-01,ROU,Sabah,2,2,0
2022-05-01,ROU,Sarawak,2,1,1
2022-05-01,ROU,Selangor,185,112,73
2022-05-01,ROU,W.P. Labuan,0,0,0
2022-05-01,RUS,Johor,237,139,98
2022-05-01,RUS,Kedah,31,20,11
2022-05-01,RUS,Kelantan,0,0,0
2022-05-01,RUS,Melaka,0,0,0
2022-05-01,RUS,Negeri Sembilan,0,0,0
2022-05-01,RUS,Pahang,0,0,0
2022-05-01,RUS,Perak,0,0,0
2022-05-01,RUS,Perlis,5,3,2
2022-05-01,RUS,Pulau Pinang,15,10,5
2022-05-01,RUS,Sabah,10,9,1
2022-05-01,RUS,Sarawak,7,2,5
2022-05-01,RUS,Selangor,1084,570,514
2022-05-01,RUS,W.P. Labuan,0,0,0
2022-05-01,RWA,Johor,0,0,0
2022-05-01,RWA,Kedah,0,0,0
2022-05-01,RWA,Pulau Pinang,0,0,0
2022-05-01,RWA,Selangor,7,1,6
2022-05-01,SAU,Johor,66,39,27
2022-05-01,SAU,Kedah,5,2,3
2022-05-01,SAU,Kelantan,0,0,0
2022-05-01,SAU,Melaka,0,0,0
2022-05-01,SAU,Perak,1,0,1
2022-05-01,SAU,Perlis,0,0,0
2022-05-01,SAU,Pulau Pinang,12,7,5
2022-05-01,SAU,Sabah,0,0,0
2022-05-01,SAU,Sarawak,0,0,0
2022-05-01,SAU,Selangor,4039,2282,1757
2022-05-01,SAU,W.P. Labuan,0,0,0
2022-05-01,SDN,Johor,4,4,0
2022-05-01,SDN,Kedah,0,0,0
2022-05-01,SDN,Kelantan,0,0,0
2022-05-01,SDN,Perlis,0,0,0
2022-05-01,SDN,Pulau Pinang,2,2,0
2022-05-01,SDN,Sabah,0,0,0
2022-05-01,SDN,Sarawak,0,0,0
2022-05-01,SDN,Selangor,662,402,260
2022-05-01,SDN,W.P. Labuan,0,0,0
2022-05-01,SEN,Johor,3,3,0
2022-05-01,SEN,Kedah,0,0,0
2022-05-01,SEN,Kelantan,0,0,0
2022-05-01,SEN,Perak,0,0,0
2022-05-01,SEN,Perlis,0,0,0
2022-05-01,SEN,Pulau Pinang,0,0,0
2022-05-01,SEN,Sabah,0,0,0
2022-05-01,SEN,Sarawak,0,0,0
2022-05-01,SEN,Selangor,34,23,11
2022-05-01,SGP,Johor,617144,385634,231510
2022-05-01,SGP,Kedah,921,503,418
2022-05-01,SGP,Kelantan,3,3,0
2022-05-01,SGP,Melaka,1,0,1
2022-05-01,SGP,Negeri Sembilan,1,1,0
2022-05-01,SGP,Pahang,41,33,8
2022-05-01,SGP,Perak,1921,900,1021
2022-05-01,SGP,Perlis,27,17,10
2022-05-01,SGP,Pulau Pinang,7700,4101,3599
2022-05-01,SGP,Sabah,1146,652,494
2022-05-01,SGP,Sarawak,1734,1029,705
2022-05-01,SGP,Selangor,19426,10889,8537
2022-05-01,SGP,Terengganu,0,0,0
2022-05-01,SGP,W.P. Labuan,0,0,0
2022-05-01,SGS,Johor,0,0,0
2022-05-01,SGS,Sabah,0,0,0
2022-05-01,SGS,Selangor,0,0,0
2022-05-01,SHN,Sarawak,0,0,0
2022-05-01,SLB,Johor,0,0,0
2022-05-01,SLB,Perlis,0,0,0
2022-05-01,SLB,Pulau Pinang,0,0,0
2022-05-01,SLB,Sabah,0,0,0
2022-05-01,SLB,Sarawak,0,0,0
2022-05-01,SLB,Selangor,0,0,0
2022-05-01,SLB,W.P. Labuan,0,0,0
2022-05-01,SLE,Johor,0,0,0
2022-05-01,SLE,Kedah,0,0,0
2022-05-01,SLE,Perak,0,0,0
2022-05-01,SLE,Pulau Pinang,0,0,0
2022-05-01,SLE,Sabah,0,0,0
2022-05-01,SLE,Selangor,7,6,1
2022-05-01,SLV,Johor,0,0,0
2022-05-01,SLV,Kedah,2,0,2
2022-05-01,SLV,Perak,0,0,0
2022-05-01,SLV,Perlis,0,0,0
2022-05-01,SLV,Pulau Pinang,0,0,0
2022-05-01,SLV,Sabah,0,0,0
2022-05-01,SLV,Selangor,4,1,3
2022-05-01,SLV,W.P. Labuan,0,0,0
2022-05-01,SMR,Johor,0,0,0
2022-05-01,SMR,Selangor,1,1,0
2022-05-01,SOM,Johor,0,0,0
2022-05-01,SOM,Kedah,0,0,0
2022-05-01,SOM,Kelantan,0,0,0
2022-05-01,SOM,Perlis,0,0,0
2022-05-01,SOM,Sabah,0,0,0
2022-05-01,SOM,Sarawak,0,0,0
2022-05-01,SOM,Selangor,132,80,52
2022-05-01,SRB,Johor,5,4,1
2022-05-01,SRB,Kedah,0,0,0
2022-05-01,SRB,Kelantan,0,0,0
2022-05-01,SRB,Pahang,0,0,0
2022-05-01,SRB,Perak,0,0,0
2022-05-01,SRB,Perlis,1,1,0
2022-05-01,SRB,Pulau Pinang,0,0,0
2022-05-01,SRB,Sabah,0,0,0
2022-05-01,SRB,Sarawak,1,0,1
2022-05-01,SRB,Selangor,21,12,9
2022-05-01,SSD,Johor,0,0,0
2022-05-01,SSD,Kedah,0,0,0
2022-05-01,SSD,Sarawak,0,0,0
2022-05-01,SSD,Selangor,19,16,3
2022-05-01,SSD,W.P. Labuan,0,0,0
2022-05-01,STP,Selangor,0,0,0
2022-05-01,SUR,Johor,0,0,0
2022-05-01,SUR,Kedah,0,0,0
2022-05-01,SUR,Kelantan,0,0,0
2022-05-01,SUR,Perak,0,0,0
2022-05-01,SUR,Perlis,0,0,0
2022-05-01,SUR,Pulau Pinang,0,0,0
2022-05-01,SUR,Sabah,0,0,0
2022-05-01,SUR,Sarawak,0,0,0
2022-05-01,SUR,Selangor,3,0,3
2022-05-01,SVK,Johor,14,8,6
2022-05-01,SVK,Kedah,3,2,1
2022-05-01,SVK,Kelantan,0,0,0
2022-05-01,SVK,Negeri Sembilan,0,0,0
2022-05-01,SVK,Pahang,0,0,0
2022-05-01,SVK,Perak,0,0,0
2022-05-01,SVK,Perlis,0,0,0
2022-05-01,SVK,Pulau Pinang,4,4,0
2022-05-01,SVK,Sabah,1,1,0
2022-05-01,SVK,Sarawak,0,0,0
2022-05-01,SVK,Selangor,111,74,37
2022-05-01,SVK,W.P. Labuan,0,0,0
2022-05-01,SVN,Johor,6,1,5
2022-05-01,SVN,Kedah,0,0,0
2022-05-01,SVN,Kelantan,0,0,0
2022-05-01,SVN,Perak,0,0,0
2022-05-01,SVN,Perlis,0,0,0
2022-05-01,SVN,Pulau Pinang,3,1,2
2022-05-01,SVN,Sabah,1,0,1
2022-05-01,SVN,Sarawak,0,0,0
2022-05-01,SVN,Selangor,25,12,13
2022-05-01,SVN,W.P. Labuan,0,0,0
2022-05-01,SWE,Johor,179,120,59
2022-05-01,SWE,Kedah,17,11,6
2022-05-01,SWE,Kelantan,1,0,1
2022-05-01,SWE,Melaka,0,0,0
2022-05-01,SWE,Negeri Sembilan,0,0,0
2022-05-01,SWE,Pahang,0,0,0
2022-05-01,SWE,Perak,0,0,0
2022-05-01,SWE,Perlis,5,4,1
2022-05-01,SWE,Pulau Pinang,14,12,2
2022-05-01,SWE,Sabah,14,9,5
2022-05-01,SWE,Sarawak,2,0,2
2022-05-01,SWE,Selangor,400,273,127
2022-05-01,SWE,W.P. Labuan,0,0,0
2022-05-01,SWZ,Johor,0,0,0
2022-05-01,SWZ,Kedah,0,0,0
2022-05-01,SWZ,Pulau Pinang,1,1,0
2022-05-01,SWZ,Sabah,0,0,0
2022-05-01,SWZ,Selangor,14,6,8
2022-05-01,SYC,Johor,4,3,1
2022-05-01,SYC,Kedah,0,0,0
2022-05-01,SYC,Pulau Pinang,0,0,0
2022-05-01,SYC,Sabah,0,0,0
2022-05-01,SYC,Sarawak,1,0,1
2022-05-01,SYC,Selangor,35,19,16
2022-05-01,SYR,Johor,5,2,3
2022-05-01,SYR,Kedah,1,1,0
2022-05-01,SYR,Kelantan,0,0,0
2022-05-01,SYR,Pahang,0,0,0
2022-05-01,SYR,Perlis,0,0,0
2022-05-01,SYR,Pulau Pinang,0,0,0
2022-05-01,SYR,Sabah,0,0,0
2022-05-01,SYR,Sarawak,1,0,1
2022-05-01,SYR,Selangor,448,263,185
2022-05-01,SYR,W.P. Labuan,0,0,0
2022-05-01,TCA,Perlis,0,0,0
2022-05-01,TCD,Johor,5,5,0
2022-05-01,TCD,Kedah,0,0,0
2022-05-01,TCD,Perlis,0,0,0
2022-05-01,TCD,Selangor,3,2,1
2022-05-01,TGO,Johor,0,0,0
2022-05-01,TGO,Perak,0,0,0
2022-05-01,TGO,Pulau Pinang,0,0,0
2022-05-01,TGO,Selangor,3,2,1
2022-05-01,THA,Johor,1969,355,1614
2022-05-01,THA,Kedah,27841,20609,7232
2022-05-01,THA,Kelantan,3808,1902,1906
2022-05-01,THA,Melaka,0,0,0
2022-05-01,THA,Negeri Sembilan,0,0,0
2022-05-01,THA,Pahang,21,15,6
2022-05-01,THA,Perak,697,205,492
2022-05-01,THA,Perlis,24792,17411,7381
2022-05-01,THA,Pulau Pinang,637,299,338
2022-05-01,THA,Sabah,13,4,9
2022-05-01,THA,Sarawak,31,15,16
2022-05-01,THA,Selangor,4898,2038,2860
2022-05-01,THA,Terengganu,0,0,0
2022-05-01,THA,W.P. Labuan,0,0,0
2022-05-01,TJK,Johor,0,0,0
2022-05-01,TJK,Kedah,0,0,0
2022-05-01,TJK,Perlis,0,0,0
2022-05-01,TJK,Pulau Pinang,0,0,0
2022-05-01,TJK,Sabah,0,0,0
2022-05-01,TJK,Selangor,29,12,17
2022-05-01,TKL,Selangor,0,0,0
2022-05-01,TKM,Johor,4,0,4
2022-05-01,TKM,Kedah,0,0,0
2022-05-01,TKM,Kelantan,0,0,0
2022-05-01,TKM,Perlis,0,0,0
2022-05-01,TKM,Pulau Pinang,0,0,0
2022-05-01,TKM,Sabah,0,0,0
2022-05-01,TKM,Sarawak,0,0,0
2022-05-01,TKM,Selangor,34,24,10
2022-05-01,TLS,Johor,3,1,2
2022-05-01,TLS,Kedah,0,0,0
2022-05-01,TLS,Perlis,0,0,0
2022-05-01,TLS,Pulau Pinang,2,1,1
2022-05-01,TLS,Sabah,0,0,0
2022-05-01,TLS,Sarawak,0,0,0
2022-05-01,TLS,Selangor,173,122,51
2022-05-01,TON,Johor,0,0,0
2022-05-01,TON,Pulau Pinang,0,0,0
2022-05-01,TON,Sarawak,0,0,0
2022-05-01,TON,Selangor,3,1,2
2022-05-01,TTO,Johor,0,0,0
2022-05-01,TTO,Kedah,2,1,1
2022-05-01,TTO,Pahang,0,0,0
2022-05-01,TTO,Pulau Pinang,0,0,0
2022-05-01,TTO,Sabah,0,0,0
2022-05-01,TTO,Sarawak,0,0,0
2022-05-01,TTO,Selangor,9,5,4
2022-05-01,TUN,Johor,8,6,2
2022-05-01,TUN,Kedah,0,0,0
2022-05-01,TUN,Kelantan,0,0,0
2022-05-01,TUN,Melaka,0,0,0
2022-05-01,TUN,Perak,0,0,0
2022-05-01,TUN,Perlis,0,0,0
2022-05-01,TUN,Pulau Pinang,4,3,1
2022-05-01,TUN,Sabah,1,0,1
2022-05-01,TUN,Sarawak,0,0,0
2022-05-01,TUN,Selangor,138,79,59
2022-05-01,TUN,W.P. Labuan,0,0,0
2022-05-01,TUR,Johor,134,87,47
2022-05-01,TUR,Kedah,9,5,4
2022-05-01,TUR,Kelantan,0,0,0
2022-05-01,TUR,Melaka,0,0,0
2022-05-01,TUR,Negeri Sembilan,0,0,0
2022-05-01,TUR,Pahang,0,0,0
2022-05-01,TUR,Perak,0,0,0
2022-05-01,TUR,Perlis,2,2,0
2022-05-01,TUR,Pulau Pinang,11,6,5
2022-05-01,TUR,Sabah,0,0,0
2022-05-01,TUR,Sarawak,1,1,0
2022-05-01,TUR,Selangor,607,452,155
2022-05-01,TUR,W.P. Labuan,0,0,0
2022-05-01,TUV,Selangor,0,0,0
2022-05-01,TWN,Johor,1863,762,1101
2022-05-01,TWN,Kedah,32,13,19
2022-05-01,TWN,Kelantan,0,0,0
2022-05-01,TWN,Melaka,0,0,0
2022-05-01,TWN,Negeri Sembilan,0,0,0
2022-05-01,TWN,Pahang,0,0,0
2022-05-01,TWN,Perak,5,1,4
2022-05-01,TWN,Perlis,3,3,0
2022-05-01,TWN,Pulau Pinang,233,143,90
2022-05-01,TWN,Sabah,38,16,22
2022-05-01,TWN,Sarawak,25,17,8
2022-05-01,TWN,Selangor,881,537,344
2022-05-01,TWN,W.P. Labuan,0,0,0
2022-05-01,TZA,Johor,2,2,0
2022-05-01,TZA,Kedah,0,0,0
2022-05-01,TZA,Perak,0,0,0
2022-05-01,TZA,Perlis,0,0,0
2022-05-01,TZA,Pulau Pinang,0,0,0
2022-05-01,TZA,Sabah,0,0,0
2022-05-01,TZA,Sarawak,0,0,0
2022-05-01,TZA,Selangor,72,32,40
2022-05-01,UGA,Johor,0,0,0
2022-05-01,UGA,Kedah,0,0,0
2022-05-01,UGA,Perak,0,0,0
2022-05-01,UGA,Perlis,0,0,0
2022-05-01,UGA,Pulau Pinang,1,1,0
2022-05-01,UGA,Sabah,0,0,0
2022-05-01,UGA,Sarawak,0,0,0
2022-05-01,UGA,Selangor,49,22,27
2022-05-01,UKR,Johor,54,24,30
2022-05-01,UKR,Kedah,6,3,3
2022-05-01,UKR,Kelantan,0,0,0
2022-05-01,UKR,Melaka,0,0,0
2022-05-01,UKR,Negeri Sembilan,0,0,0
2022-05-01,UKR,Pahang,0,0,0
2022-05-01,UKR,Perak,0,0,0
2022-05-01,UKR,Perlis,0,0,0
2022-05-01,UKR,Pulau Pinang,7,2,5
2022-05-01,UKR,Sabah,0,0,0
2022-05-01,UKR,Sarawak,1,1,0
2022-05-01,UKR,Selangor,257,131,126
2022-05-01,UKR,W.P. Labuan,0,0,0
2022-05-01,URY,Johor,5,1,4
2022-05-01,URY,Kedah,0,0,0
2022-05-01,URY,Kelantan,0,0,0
2022-05-01,URY,Perak,0,0,0
2022-05-01,URY,Perlis,0,0,0
2022-05-01,URY,Pulau Pinang,0,0,0
2022-05-01,URY,Sabah,0,0,0
2022-05-01,URY,Sarawak,0,0,0
2022-05-01,URY,Selangor,7,5,2
2022-05-01,URY,W.P. Labuan,0,0,0
2022-05-01,USA,Johor,1968,1234,734
2022-05-01,USA,Kedah,108,52,56
2022-05-01,USA,Kelantan,2,2,0
2022-05-01,USA,Melaka,0,0,0
2022-05-01,USA,Negeri Sembilan,0,0,0
2022-05-01,USA,Pahang,0,0,0
2022-05-01,USA,Perak,27,16,11
2022-05-01,USA,Perlis,5,4,1
2022-05-01,USA,Pulau Pinang,683,460,223
2022-05-01,USA,Sabah,83,49,34
2022-05-01,USA,Sarawak,72,41,31
2022-05-01,USA,Selangor,5752,3628,2124
2022-05-01,USA,Terengganu,0,0,0
2022-05-01,USA,W.P. Labuan,0,0,0
2022-05-01,UZB,Johor,20,12,8
2022-05-01,UZB,Kedah,3,2,1
2022-05-01,UZB,Kelantan,0,0,0
2022-05-01,UZB,Perak,0,0,0
2022-05-01,UZB,Perlis,0,0,0
2022-05-01,UZB,Pulau Pinang,0,0,0
2022-05-01,UZB,Sabah,0,0,0
2022-05-01,UZB,Sarawak,0,0,0
2022-05-01,UZB,Selangor,137,81,56
2022-05-01,VAT,Johor,1,0,1
2022-05-01,VAT,Sarawak,0,0,0
2022-05-01,VAT,Selangor,0,0,0
2022-05-01,VCT,Johor,0,0,0
2022-05-01,VCT,Kedah,0,0,0
2022-05-01,VCT,Pulau Pinang,0,0,0
2022-05-01,VCT,Sarawak,0,0,0
2022-05-01,VCT,Selangor,1,1,0
2022-05-01,VEN,Johor,4,3,1
2022-05-01,VEN,Kedah,0,0,0
2022-05-01,VEN,Kelantan,0,0,0
2022-05-01,VEN,Melaka,0,0,0
2022-05-01,VEN,Perak,0,0,0
2022-05-01,VEN,Perlis,0,0,0
2022-05-01,VEN,Pulau Pinang,1,0,1
2022-05-01,VEN,Sabah,0,0,0
2022-05-01,VEN,Sarawak,0,0,0
2022-05-01,VEN,Selangor,42,25,17
2022-05-01,VEN,W.P. Labuan,0,0,0
2022-05-01,VNM,Johor,5759,1587,4172
2022-05-01,VNM,Kedah,108,14,94
2022-05-01,VNM,Kelantan,0,0,0
2022-05-01,VNM,Melaka,0,0,0
2022-05-01,VNM,Negeri Sembilan,0,0,0
2022-05-01,VNM,Pahang,0,0,0
2022-05-01,VNM,Perak,11,0,11
2022-05-01,VNM,Perlis,4,2,2
2022-05-01,VNM,Pulau Pinang,651,160,491
2022-05-01,VNM,Sabah,12,5,7
2022-05-01,VNM,Sarawak,26,3,23
2022-05-01,VNM,Selangor,7088,2200,4888
2022-05-01,VNM,Terengganu,0,0,0
2022-05-01,VNM,W.P. Labuan,0,0,0
2022-05-01,VUT,Johor,30,20,10
2022-05-01,VUT,Kedah,3,3,0
2022-05-01,VUT,Pulau Pinang,1,1,0
2022-05-01,VUT,Sabah,0,0,0
2022-05-01,VUT,Sarawak,0,0,0
2022-05-01,VUT,Selangor,24,19,5
2022-05-01,WSM,Johor,0,0,0
2022-05-01,WSM,Sarawak,0,0,0
2022-05-01,WSM,Selangor,1,0,1
2022-05-01,XXX,Johor,116,78,38
2022-05-01,XXX,Kedah,2,2,0
2022-05-01,XXX,Kelantan,0,0,0
2022-05-01,XXX,Melaka,0,0,0
2022-05-01,XXX,Pahang,0,0,0
2022-05-01,XXX,Perak,0,0,0
2022-05-01,XXX,Perlis,0,0,0
2022-05-01,XXX,Pulau Pinang,15,11,4
2022-05-01,XXX,Sabah,3,2,1
2022-05-01,XXX,Sarawak,2,1,1
2022-05-01,XXX,Selangor,214,139,75
2022-05-01,XXX,W.P. Labuan,0,0,0
2022-05-01,YEM,Johor,19,15,4
2022-05-01,YEM,Kedah,1,1,0
2022-05-01,YEM,Kelantan,0,0,0
2022-05-01,YEM,Melaka,4,2,2
2022-05-01,YEM,Pahang,0,0,0
2022-05-01,YEM,Perak,0,0,0
2022-05-01,YEM,Perlis,1,1,0
2022-05-01,YEM,Pulau Pinang,2,2,0
2022-05-01,YEM,Sabah,0,0,0
2022-05-01,YEM,Sarawak,1,0,1
2022-05-01,YEM,Selangor,1031,690,341
2022-05-01,YEM,W.P. Labuan,0,0,0
2022-05-01,ZAF,Johor,136,85,51
2022-05-01,ZAF,Kedah,7,3,4
2022-05-01,ZAF,Kelantan,0,0,0
2022-05-01,ZAF,Melaka,0,0,0
2022-05-01,ZAF,Pahang,1,1,0
2022-05-01,ZAF,Perak,0,0,0
2022-05-01,ZAF,Perlis,2,1,1
2022-05-01,ZAF,Pulau Pinang,20,11,9
2022-05-01,ZAF,Sabah,4,2,2
2022-05-01,ZAF,Sarawak,6,5,1
2022-05-01,ZAF,Selangor,514,304,210
2022-05-01,ZAF,Terengganu,0,0,0
2022-05-01,ZAF,W.P. Labuan,0,0,0
2022-05-01,ZAR,Selangor,0,0,0
2022-05-01,ZMB,Johor,3,3,0
2022-05-01,ZMB,Kedah,0,0,0
2022-05-01,ZMB,Perak,0,0,0
2022-05-01,ZMB,Perlis,0,0,0
2022-05-01,ZMB,Pulau Pinang,0,0,0
2022-05-01,ZMB,Sabah,0,0,0
2022-05-01,ZMB,Sarawak,0,0,0
2022-05-01,ZMB,Selangor,27,18,9
2022-05-01,ZWE,Johor,4,3,1
2022-05-01,ZWE,Kedah,0,0,0
2022-05-01,ZWE,Kelantan,0,0,0
2022-05-01,ZWE,Perak,0,0,0
2022-05-01,ZWE,Perlis,0,0,0
2022-05-01,ZWE,Pulau Pinang,2,0,2
2022-05-01,ZWE,Sabah,0,0,0
2022-05-01,ZWE,Sarawak,0,0,0
2022-05-01,ZWE,Selangor,63,40,23
2022-06-01,ABW,Kedah,0,0,0
2022-06-01,ABW,Pulau Pinang,1,0,1
2022-06-01,AFG,Johor,1,1,0
2022-06-01,AFG,Kedah,0,0,0
2022-06-01,AFG,Perlis,0,0,0
2022-06-01,AFG,Pulau Pinang,0,0,0
2022-06-01,AFG,Sarawak,0,0,0
2022-06-01,AFG,Selangor,101,72,29
2022-06-01,AGO,Johor,0,0,0
2022-06-01,AGO,Kedah,0,0,0
2022-06-01,AGO,Sabah,0,0,0
2022-06-01,AGO,Selangor,0,0,0
2022-06-01,AIA,Selangor,0,0,0
2022-06-01,ALB,Johor,3,1,2
2022-06-01,ALB,Kedah,1,1,0
2022-06-01,ALB,Perak,0,0,0
2022-06-01,ALB,Perlis,0,0,0
2022-06-01,ALB,Pulau Pinang,1,1,0
2022-06-01,ALB,Sabah,0,0,0
2022-06-01,ALB,Sarawak,0,0,0
2022-06-01,ALB,Selangor,8,5,3
2022-06-01,AND,Johor,0,0,0
2022-06-01,AND,Kedah,1,0,1
2022-06-01,AND,Perlis,0,0,0
2022-06-01,AND,Pulau Pinang,0,0,0
2022-06-01,AND,Selangor,2,1,1
2022-06-01,ANT,Selangor,0,0,0
2022-06-01,ARE,Johor,20,12,8
2022-06-01,ARE,Kedah,2,1,1
2022-06-01,ARE,Kelantan,0,0,0
2022-06-01,ARE,Perak,0,0,0
2022-06-01,ARE,Perlis,0,0,0
2022-06-01,ARE,Pulau Pinang,0,0,0
2022-06-01,ARE,Sabah,0,0,0
2022-06-01,ARE,Sarawak,0,0,0
2022-06-01,ARE,Selangor,173,119,54
2022-06-01,ARG,Johor,33,23,10
2022-06-01,ARG,Kedah,4,2,2
2022-06-01,ARG,Kelantan,5,3,2
2022-06-01,ARG,Melaka,0,0,0
2022-06-01,ARG,Perak,0,0,0
2022-06-01,ARG,Perlis,3,1,2
2022-06-01,ARG,Pulau Pinang,0,0,0
2022-06-01,ARG,Sabah,7,3,4
2022-06-01,ARG,Sarawak,0,0,0
2022-06-01,ARG,Selangor,132,77,55
2022-06-01,ARG,W.P. Labuan,0,0,0
2022-06-01,ARM,Johor,2,0,2
2022-06-01,ARM,Kedah,1,0,1
2022-06-01,ARM,Kelantan,0,0,0
2022-06-01,ARM,Perak,0,0,0
2022-06-01,ARM,Perlis,0,0,0
2022-06-01,ARM,Pulau Pinang,0,0,0
2022-06-01,ARM,Sabah,0,0,0
2022-06-01,ARM,Sarawak,0,0,0
2022-06-01,ARM,Selangor,14,5,9
2022-06-01,ATA,Selangor,0,0,0
2022-06-01,ATG,Johor,7,5,2
2022-06-01,ATG,Kedah,0,0,0
2022-06-01,ATG,Pulau Pinang,0,0,0
2022-06-01,ATG,Sarawak,0,0,0
2022-06-01,ATG,Selangor,8,5,3
2022-06-01,AUS,Johor,2835,1770,1065
2022-06-01,AUS,Kedah,188,101,87
2022-06-01,AUS,Kelantan,5,4,1
2022-06-01,AUS,Melaka,3,2,1
2022-06-01,AUS,Negeri Sembilan,0,0,0
2022-06-01,AUS,Pahang,0,0,0
2022-06-01,AUS,Perak,100,45,55
2022-06-01,AUS,Perlis,6,4,2
2022-06-01,AUS,Pulau Pinang,1042,582,460
2022-06-01,AUS,Sabah,234,129,105
2022-06-01,AUS,Sarawak,227,112,115
2022-06-01,AUS,Selangor,8651,5218,3433
2022-06-01,AUS,Terengganu,0,0,0
2022-06-01,AUS,W.P. Labuan,1,1,0
2022-06-01,AUT,Johor,75,57,18
2022-06-01,AUT,Kedah,7,6,1
2022-06-01,AUT,Kelantan,1,1,0
2022-06-01,AUT,Melaka,0,0,0
2022-06-01,AUT,Negeri Sembilan,0,0,0
2022-06-01,AUT,Pahang,0,0,0
2022-06-01,AUT,Perak,2,1,1
2022-06-01,AUT,Perlis,2,2,0
2022-06-01,AUT,Pulau Pinang,31,27,4
2022-06-01,AUT,Sabah,8,2,6
2022-06-01,AUT,Sarawak,3,2,1
2022-06-01,AUT,Selangor,315,209,106
2022-06-01,AUT,Terengganu,0,0,0
2022-06-01,AUT,W.P. Labuan,0,0,0
2022-06-01,AZE,Johor,8,8,0
2022-06-01,AZE,Kedah,0,0,0
2022-06-01,AZE,Kelantan,0,0,0
2022-06-01,AZE,Melaka,0,0,0
2022-06-01,AZE,Perlis,0,0,0
2022-06-01,AZE,Pulau Pinang,0,0,0
2022-06-01,AZE,Sabah,0,0,0
2022-06-01,AZE,Sarawak,0,0,0
2022-06-01,AZE,Selangor,34,19,15
2022-06-01,AZE,W.P. Labuan,0,0,0
2022-06-01,BDI,Pulau Pinang,0,0,0
2022-06-01,BDI,Sarawak,0,0,0
2022-06-01,BDI,Selangor,0,0,0
2022-06-01,BEL,Johor,123,91,32
2022-06-01,BEL,Kedah,10,4,6
2022-06-01,BEL,Kelantan,0,0,0
2022-06-01,BEL,Melaka,0,0,0
2022-06-01,BEL,Negeri Sembilan,0,0,0
2022-06-01,BEL,Pahang,0,0,0
2022-06-01,BEL,Perak,2,1,1
2022-06-01,BEL,Perlis,3,3,0
2022-06-01,BEL,Pulau Pinang,16,9,7
2022-06-01,BEL,Sabah,12,9,3
2022-06-01,BEL,Sarawak,11,7,4
2022-06-01,BEL,Selangor,496,341,155
2022-06-01,BEL,W.P. Labuan,0,0,0
2022-06-01,BEN,Johor,0,0,0
2022-06-01,BEN,Kedah,0,0,0
2022-06-01,BEN,Perak,0,0,0
2022-06-01,BEN,Pulau Pinang,0,0,0
2022-06-01,BEN,Sabah,0,0,0
2022-06-01,BEN,Sarawak,0,0,0
2022-06-01,BEN,Selangor,1,1,0
2022-06-01,BFA,Perak,0,0,0
2022-06-01,BFA,Pulau Pinang,0,0,0
2022-06-01,BFA,Selangor,2,1,1
2022-06-01,BGD,Johor,1012,823,189
2022-06-01,BGD,Kedah,24,16,8
2022-06-01,BGD,Kelantan,1,1,0
2022-06-01,BGD,Melaka,0,0,0
2022-06-01,BGD,Negeri Sembilan,0,0,0
2022-06-01,BGD,Pahang,0,0,0
2022-06-01,BGD,Perak,0,0,0
2022-06-01,BGD,Perlis,3,3,0
2022-06-01,BGD,Pulau Pinang,36,29,7
2022-06-01,BGD,Sabah,0,0,0
2022-06-01,BGD,Sarawak,22,22,0
2022-06-01,BGD,Selangor,13817,12880,937
2022-06-01,BGD,W.P. Labuan,0,0,0
2022-06-01,BGR,Johor,14,7,7
2022-06-01,BGR,Kedah,2,0,2
2022-06-01,BGR,Kelantan,0,0,0
2022-06-01,BGR,Pahang,0,0,0
2022-06-01,BGR,Perak,0,0,0
2022-06-01,BGR,Perlis,0,0,0
2022-06-01,BGR,Pulau Pinang,3,2,1
2022-06-01,BGR,Sabah,1,0,1
2022-06-01,BGR,Sarawak,1,0,1
2022-06-01,BGR,Selangor,104,58,46
2022-06-01,BGR,W.P. Labuan,0,0,0
2022-06-01,BHR,Johor,6,3,3
2022-06-01,BHR,Kedah,2,1,1
2022-06-01,BHR,Kelantan,0,0,0
2022-06-01,BHR,Perlis,0,0,0
2022-06-01,BHR,Pulau Pinang,2,1,1
2022-06-01,BHR,Sabah,0,0,0
2022-06-01,BHR,Sarawak,0,0,0
2022-06-01,BHR,Selangor,219,139,80
2022-06-01,BHS,Johor,0,0,0
2022-06-01,BHS,Kedah,0,0,0
2022-06-01,BHS,Perak,0,0,0
2022-06-01,BHS,Sabah,0,0,0
2022-06-01,BHS,Sarawak,0,0,0
2022-06-01,BHS,Selangor,4,2,2
2022-06-01,BIH,Johor,6,4,2
2022-06-01,BIH,Kedah,0,0,0
2022-06-01,BIH,Perlis,0,0,0
2022-06-01,BIH,Pulau Pinang,0,0,0
2022-06-01,BIH,Sabah,0,0,0
2022-06-01,BIH,Sarawak,0,0,0
2022-06-01,BIH,Selangor,29,18,11
2022-06-01,BLR,Johor,7,2,5
2022-06-01,BLR,Kedah,5,1,4
2022-06-01,BLR,Kelantan,0,0,0
2022-06-01,BLR,Pahang,0,0,0
2022-06-01,BLR,Perak,0,0,0
2022-06-01,BLR,Perlis,1,1,0
2022-06-01,BLR,Pulau Pinang,1,1,0
2022-06-01,BLR,Sabah,1,1,0
2022-06-01,BLR,Sarawak,0,0,0
2022-06-01,BLR,Selangor,70,32,38
2022-06-01,BLR,W.P. Labuan,0,0,0
2022-06-01,BLZ,Johor,1,0,1
2022-06-01,BLZ,Pulau Pinang,0,0,0
2022-06-01,BLZ,Sarawak,0,0,0
2022-06-01,BLZ,Selangor,0,0,0
2022-06-01,BMU,Selangor,0,0,0
2022-06-01,BOL,Johor,1,0,1
2022-06-01,BOL,Kedah,0,0,0
2022-06-01,BOL,Melaka,0,0,0
2022-06-01,BOL,Perak,0,0,0
2022-06-01,BOL,Perlis,0,0,0
2022-06-01,BOL,Pulau Pinang,0,0,0
2022-06-01,BOL,Sabah,0,0,0
2022-06-01,BOL,Sarawak,0,0,0
2022-06-01,BOL,Selangor,9,6,3
2022-06-01,BRA,Johor,113,80,33
2022-06-01,BRA,Kedah,5,2,3
2022-06-01,BRA,Kelantan,0,0,0
2022-06-01,BRA,Melaka,4,2,2
2022-06-01,BRA,Pahang,0,0,0
2022-06-01,BRA,Perak,0,0,0
2022-06-01,BRA,Perlis,1,1,0
2022-06-01,BRA,Pulau Pinang,4,3,1
2022-06-01,BRA,Sabah,3,0,3
2022-06-01,BRA,Sarawak,1,0,1
2022-06-01,BRA,Selangor,376,236,140
2022-06-01,BRA,W.P. Labuan,0,0,0
2022-06-01,BRB,Johor,0,0,0
2022-06-01,BRB,Kedah,0,0,0
2022-06-01,BRB,Perlis,0,0,0
2022-06-01,BRB,Pulau Pinang,0,0,0
2022-06-01,BRB,Selangor,3,1,2
2022-06-01,BRN,Johor,177,105,72
2022-06-01,BRN,Kedah,1,0,1
2022-06-01,BRN,Kelantan,2,2,0
2022-06-01,BRN,Melaka,0,0,0
2022-06-01,BRN,Pahang,0,0,0
2022-06-01,BRN,Perak,1,0,1
2022-06-01,BRN,Perlis,0,0,0
2022-06-01,BRN,Pulau Pinang,9,2,7
2022-06-01,BRN,Sabah,394,199,195
2022-06-01,BRN,Sarawak,1622,1182,440
2022-06-01,BRN,Selangor,1930,1020,910
2022-06-01,BRN,W.P. Labuan,29,13,16
2022-06-01,BTN,Johor,0,0,0
2022-06-01,BTN,Kedah,0,0,0
2022-06-01,BTN,Perak,0,0,0
2022-06-01,BTN,Perlis,0,0,0
2022-06-01,BTN,Pulau Pinang,1,1,0
2022-06-01,BTN,Sabah,0,0,0
2022-06-01,BTN,Sarawak,0,0,0
2022-06-01,BTN,Selangor,44,25,19
2022-06-01,BWA,Johor,0,0,0
2022-06-01,BWA,Kedah,1,1,0
2022-06-01,BWA,Perlis,0,0,0
2022-06-01,BWA,Pulau Pinang,0,0,0
2022-06-01,BWA,Sabah,0,0,0
2022-06-01,BWA,Sarawak,0,0,0
2022-06-01,BWA,Selangor,10,8,2
2022-06-01,CAF,Kedah,0,0,0
2022-06-01,CAF,Selangor,1,1,0
2022-06-01,CAN,Johor,660,412,248
2022-06-01,CAN,Kedah,39,18,21
2022-06-01,CAN,Kelantan,0,0,0
2022-06-01,CAN,Melaka,0,0,0
2022-06-01,CAN,Negeri Sembilan,0,0,0
2022-06-01,CAN,Pahang,0,0,0
2022-06-01,CAN,Perak,9,7,2
2022-06-01,CAN,Perlis,6,5,1
2022-06-01,CAN,Pulau Pinang,151,92,59
2022-06-01,CAN,Sabah,55,27,28
2022-06-01,CAN,Sarawak,44,22,22
2022-06-01,CAN,Selangor,1675,1013,662
2022-06-01,CAN,Terengganu,0,0,0
2022-06-01,CAN,W.P. Labuan,0,0,0
2022-06-01,CCK,Selangor,0,0,0
2022-06-01,CHE,Johor,208,148,60
2022-06-01,CHE,Kedah,23,10,13
2022-06-01,CHE,Kelantan,0,0,0
2022-06-01,CHE,Melaka,0,0,0
2022-06-01,CHE,Negeri Sembilan,0,0,0
2022-06-01,CHE,Pahang,0,0,0
2022-06-01,CHE,Perak,3,2,1
2022-06-01,CHE,Perlis,7,4,3
2022-06-01,CHE,Pulau Pinang,61,43,18
2022-06-01,CHE,Sabah,19,9,10
2022-06-01,CHE,Sarawak,16,11,5
2022-06-01,CHE,Selangor,528,327,201
2022-06-01,CHE,W.P. Labuan,0,0,0
2022-06-01,CHL,Johor,24,12,12
2022-06-01,CHL,Kedah,2,1,1
2022-06-01,CHL,Kelantan,1,1,0
2022-06-01,CHL,Melaka,0,0,0
2022-06-01,CHL,Pahang,0,0,0
2022-06-01,CHL,Perak,0,0,0
2022-06-01,CHL,Perlis,0,0,0
2022-06-01,CHL,Pulau Pinang,0,0,0
2022-06-01,CHL,Sabah,2,1,1
2022-06-01,CHL,Sarawak,0,0,0
2022-06-01,CHL,Selangor,103,52,51
2022-06-01,CHN,Johor,13803,5571,8232
2022-06-01,CHN,Kedah,227,104,123
2022-06-01,CHN,Kelantan,4,1,3
2022-06-01,CHN,Melaka,0,0,0
2022-06-01,CHN,Pahang,1,1,0
2022-06-01,CHN,Perak,89,35,54
2022-06-01,CHN,Perlis,17,10,7
2022-06-01,CHN,Pulau Pinang,704,333,371
2022-06-01,CHN,Sabah,244,96,148
2022-06-01,CHN,Sarawak,93,40,53
2022-06-01,CHN,Selangor,7602,4605,2997
2022-06-01,CHN,Terengganu,0,0,0
2022-06-01,CHN,W.P. Labuan,0,0,0
2022-06-01,CIV,Johor,0,0,0
2022-06-01,CIV,Kedah,0,0,0
2022-06-01,CIV,Pulau Pinang,0,0,0
2022-06-01,CIV,Sabah,0,0,0
2022-06-01,CIV,Sarawak,0,0,0
2022-06-01,CIV,Selangor,7,2,5
2022-06-01,CMR,Johor,1,1,0
2022-06-01,CMR,Kedah,0,0,0
2022-06-01,CMR,Pulau Pinang,1,1,0
2022-06-01,CMR,Sabah,0,0,0
2022-06-01,CMR,Sarawak,0,0,0
2022-06-01,CMR,Selangor,10,9,1
2022-06-01,COD,Johor,0,0,0
2022-06-01,COD,Pulau Pinang,0,0,0
2022-06-01,COD,Sarawak,0,0,0
2022-06-01,COD,Selangor,9,5,4
2022-06-01,COG,Johor,0,0,0
2022-06-01,COG,Kedah,0,0,0
2022-06-01,COG,Selangor,2,2,0
2022-06-01,COK,Selangor,0,0,0
2022-06-01,COL,Johor,13,5,8
2022-06-01,COL,Kedah,1,0,1
2022-06-01,COL,Perak,0,0,0
2022-06-01,COL,Pulau Pinang,0,0,0
2022-06-01,COL,Sabah,1,1,0
2022-06-01,COL,Sarawak,2,1,1
2022-06-01,COL,Selangor,61,28,33
2022-06-01,COL,W.P. Labuan,0,0,0
2022-06-01,COM,Johor,0,0,0
2022-06-01,COM,Kedah,0,0,0
2022-06-01,COM,Selangor,9,5,4
2022-06-01,CPV,Johor,0,0,0
2022-06-01,CPV,Kedah,0,0,0
2022-06-01,CPV,Pulau Pinang,0,0,0
2022-06-01,CPV,Sabah,0,0,0
2022-06-01,CPV,Selangor,1,1,0
2022-06-01,CRI,Johor,8,7,1
2022-06-01,CRI,Kedah,0,0,0
2022-06-01,CRI,Perak,0,0,0
2022-06-01,CRI,Perlis,0,0,0
2022-06-01,CRI,Pulau Pinang,5,4,1
2022-06-01,CRI,Sabah,0,0,0
2022-06-01,CRI,Sarawak,1,0,1
2022-06-01,CRI,Selangor,17,8,9
2022-06-01,CUB,Johor,2,2,0
2022-06-01,CUB,Kedah,0,0,0
2022-06-01,CUB,Perlis,0,0,0
2022-06-01,CUB,Pulau Pinang,0,0,0
2022-06-01,CUB,Sabah,0,0,0
2022-06-01,CUB,Sarawak,0,0,0
2022-06-01,CUB,Selangor,4,3,1
2022-06-01,CYP,Johor,9,7,2
2022-06-01,CYP,Kedah,0,0,0
2022-06-01,CYP,Perak,0,0,0
2022-06-01,CYP,Perlis,0,0,0
2022-06-01,CYP,Pulau Pinang,1,1,0
2022-06-01,CYP,Sabah,0,0,0
2022-06-01,CYP,Sarawak,0,0,0
2022-06-01,CYP,Selangor,29,22,7
2022-06-01,CZE,Johor,33,21,12
2022-06-01,CZE,Kedah,10,8,2
2022-06-01,CZE,Kelantan,2,2,0
2022-06-01,CZE,Melaka,0,0,0
2022-06-01,CZE,Negeri Sembilan,0,0,0
2022-06-01,CZE,Perak,0,0,0
2022-06-01,CZE,Perlis,2,2,0
2022-06-01,CZE,Pulau Pinang,7,6,1
2022-06-01,CZE,Sabah,3,1,2
2022-06-01,CZE,Sarawak,1,1,0
2022-06-01,CZE,Selangor,233,134,99
2022-06-01,CZE,W.P. Labuan,0,0,0
2022-06-01,DEU,Johor,1010,716,294
2022-06-01,DEU,Kedah,103,61,42
2022-06-01,DEU,Kelantan,3,2,1
2022-06-01,DEU,Melaka,0,0,0
2022-06-01,DEU,Negeri Sembilan,0,0,0
2022-06-01,DEU,Pahang,0,0,0
2022-06-01,DEU,Perak,14,10,4
2022-06-01,DEU,Perlis,29,15,14
2022-06-01,DEU,Pulau Pinang,309,239,70
2022-06-01,DEU,Sabah,48,26,22
2022-06-01,DEU,Sarawak,49,34,15
2022-06-01,DEU,Selangor,3499,2308,1191
2022-06-01,DEU,Terengganu,0,0,0
2022-06-01,DEU,W.P. Labuan,0,0,0
2022-06-01,DJI,Johor,1,1,0
2022-06-01,DJI,Selangor,4,3,1
2022-06-01,DMA,Johor,1,1,0
2022-06-01,DMA,Kedah,0,0,0
2022-06-01,DMA,Pulau Pinang,0,0,0
2022-06-01,DMA,Sabah,0,0,0
2022-06-01,DMA,Sarawak,0,0,0
2022-06-01,DMA,Selangor,15,12,3
2022-06-01,DMA,W.P. Labuan,0,0,0
2022-06-01,DNK,Johor,143,118,25
2022-06-01,DNK,Kedah,10,5,5
2022-06-01,DNK,Kelantan,2,1,1
2022-06-01,DNK,Melaka,0,0,0
2022-06-01,DNK,Negeri Sembilan,0,0,0
2022-06-01,DNK,Pahang,0,0,0
2022-06-01,DNK,Perak,0,0,0
2022-06-01,DNK,Perlis,3,3,0
2022-06-01,DNK,Pulau Pinang,24,17,7
2022-06-01,DNK,Sabah,26,17,9
2022-06-01,DNK,Sarawak,13,9,4
2022-06-01,DNK,Selangor,520,333,187
2022-06-01,DNK,W.P. Labuan,0,0,0
2022-06-01,DOM,Johor,1,1,0
2022-06-01,DOM,Kedah,0,0,0
2022-06-01,DOM,Perak,0,0,0
2022-06-01,DOM,Perlis,0,0,0
2022-06-01,DOM,Pulau Pinang,0,0,0
2022-06-01,DOM,Sabah,0,0,0
2022-06-01,DOM,Sarawak,1,0,1
2022-06-01,DOM,Selangor,7,4,3
2022-06-01,DZA,Johor,23,21,2
2022-06-01,DZA,Kedah,3,3,0
2022-06-01,DZA,Kelantan,0,0,0
2022-06-01,DZA,Melaka,0,0,0
2022-06-01,DZA,Perak,0,0,0
2022-06-01,DZA,Perlis,0,0,0
2022-06-01,DZA,Pulau Pinang,0,0,0
2022-06-01,DZA,Sabah,0,0,0
2022-06-01,DZA,Sarawak,0,0,0
2022-06-01,DZA,Selangor,196,112,84
2022-06-01,DZA,W.P. Labuan,0,0,0
2022-06-01,ECU,Johor,9,4,5
2022-06-01,ECU,Kedah,1,0,1
2022-06-01,ECU,Perak,0,0,0
2022-06-01,ECU,Perlis,0,0,0
2022-06-01,ECU,Pulau Pinang,0,0,0
2022-06-01,ECU,Sabah,0,0,0
2022-06-01,ECU,Sarawak,0,0,0
2022-06-01,ECU,Selangor,19,12,7
2022-06-01,EGY,Johor,117,99,18
2022-06-01,EGY,Kedah,5,3,2
2022-06-01,EGY,Kelantan,2,2,0
2022-06-01,EGY,Melaka,0,0,0
2022-06-01,EGY,Pahang,0,0,0
2022-06-01,EGY,Perak,0,0,0
2022-06-01,EGY,Perlis,0,0,0
2022-06-01,EGY,Pulau Pinang,1,1,0
2022-06-01,EGY,Sabah,3,1,2
2022-06-01,EGY,Sarawak,2,2,0
2022-06-01,EGY,Selangor,1006,667,339
2022-06-01,EGY,Terengganu,0,0,0
2022-06-01,EGY,W.P. Labuan,0,0,0
2022-06-01,ERI,Johor,1,1,0
2022-06-01,ERI,Pulau Pinang,0,0,0
2022-06-01,ERI,Sabah,0,0,0
2022-06-01,ERI,Selangor,5,1,4
2022-06-01,ESP,Johor,279,168,111
2022-06-01,ESP,Kedah,17,8,9
2022-06-01,ESP,Kelantan,1,1,0
2022-06-01,ESP,Melaka,2,1,1
2022-06-01,ESP,Negeri Sembilan,1,1,0
2022-06-01,ESP,Pahang,0,0,0
2022-06-01,ESP,Perak,2,2,0
2022-06-01,ESP,Perlis,5,2,3
2022-06-01,ESP,Pulau Pinang,19,10,9
2022-06-01,ESP,Sabah,25,11,14
2022-06-01,ESP,Sarawak,6,5,1
2022-06-01,ESP,Selangor,1133,734,399
2022-06-01,ESP,W.P. Labuan,0,0,0
2022-06-01,EST,Johor,11,7,4
2022-06-01,EST,Kedah,0,0,0
2022-06-01,EST,Kelantan,0,0,0
2022-06-01,EST,Pahang,0,0,0
2022-06-01,EST,Perak,0,0,0
2022-06-01,EST,Perlis,0,0,0
2022-06-01,EST,Pulau Pinang,3,1,2
2022-06-01,EST,Sabah,0,0,0
2022-06-01,EST,Sarawak,0,0,0
2022-06-01,EST,Selangor,33,14,19
2022-06-01,EST,W.P. Labuan,0,0,0
2022-06-01,ETH,Johor,3,2,1
2022-06-01,ETH,Kedah,0,0,0
2022-06-01,ETH,Pulau Pinang,1,1,0
2022-06-01,ETH,Sarawak,0,0,0
2022-06-01,ETH,Selangor,16,11,5
2022-06-01,FIN,Johor,136,87,49
2022-06-01,FIN,Kedah,1,0,1
2022-06-01,FIN,Kelantan,0,0,0
2022-06-01,FIN,Melaka,0,0,0
2022-06-01,FIN,Negeri Sembilan,0,0,0
2022-06-01,FIN,Pahang,4,2,2
2022-06-01,FIN,Perak,5,4,1
2022-06-01,FIN,Perlis,2,1,1
2022-06-01,FIN,Pulau Pinang,25,20,5
2022-06-01,FIN,Sabah,5,1,4
2022-06-01,FIN,Sarawak,1,1,0
2022-06-01,FIN,Selangor,195,135,60
2022-06-01,FIN,W.P. Labuan,0,0,0
2022-06-01,FJI,Johor,19,13,6
2022-06-01,FJI,Kedah,1,1,0
2022-06-01,FJI,Kelantan,0,0,0
2022-06-01,FJI,Perak,0,0,0
2022-06-01,FJI,Perlis,0,0,0
2022-06-01,FJI,Pulau Pinang,2,2,0
2022-06-01,FJI,Sabah,1,0,1
2022-06-01,FJI,Sarawak,0,0,0
2022-06-01,FJI,Selangor,49,35,14
2022-06-01,FRA,Johor,1095,704,391
2022-06-01,FRA,Kedah,110,64,46
2022-06-01,FRA,Kelantan,2,0,2
2022-06-01,FRA,Melaka,5,3,2
2022-06-01,FRA,Negeri Sembilan,1,0,1
2022-06-01,FRA,Pahang,1,1,0
2022-06-01,FRA,Perak,10,7,3
2022-06-01,FRA,Perlis,29,17,12
2022-06-01,FRA,Pulau Pinang,144,105,39
2022-06-01,FRA,Sabah,74,40,34
2022-06-01,FRA,Sarawak,38,23,15
2022-06-01,FRA,Selangor,3398,2148,1250
2022-06-01,FRA,Terengganu,1,1,0
2022-06-01,FRA,W.P. Labuan,0,0,0
2022-06-01,FSM,Johor,0,0,0
2022-06-01,FSM,Pulau Pinang,0,0,0
2022-06-01,FSM,Selangor,0,0,0
2022-06-01,GAB,Johor,1,1,0
2022-06-01,GAB,Pulau Pinang,0,0,0
2022-06-01,GAB,Sarawak,0,0,0
2022-06-01,GAB,Selangor,1,1,0
2022-06-01,GBR,Johor,2907,2017,890
2022-06-01,GBR,Kedah,328,179,149
2022-06-01,GBR,Kelantan,7,5,2
2022-06-01,GBR,Melaka,0,0,0
2022-06-01,GBR,Negeri Sembilan,0,0,0
2022-06-01,GBR,Pahang,7,7,0
2022-06-01,GBR,Perak,32,16,16
2022-06-01,GBR,Perlis,40,25,15
2022-06-01,GBR,Pulau Pinang,532,348,184
2022-06-01,GBR,Sabah,197,109,88
2022-06-01,GBR,Sarawak,119,73,46
2022-06-01,GBR,Selangor,8474,5417,3057
2022-06-01,GBR,Terengganu,3,3,0
2022-06-01,GBR,W.P. Labuan,0,0,0
2022-06-01,GEO,Johor,9,6,3
2022-06-01,GEO,Kedah,2,1,1
2022-06-01,GEO,Melaka,0,0,0
2022-06-01,GEO,Perak,0,0,0
2022-06-01,GEO,Perlis,0,0,0
2022-06-01,GEO,Pulau Pinang,1,1,0
2022-06-01,GEO,Sabah,0,0,0
2022-06-01,GEO,Sarawak,0,0,0
2022-06-01,GEO,Selangor,18,13,5
2022-06-01,GHA,Johor,3,1,2
2022-06-01,GHA,Kedah,0,0,0
2022-06-01,GHA,Kelantan,0,0,0
2022-06-01,GHA,Pulau Pinang,0,0,0
2022-06-01,GHA,Sabah,0,0,0
2022-06-01,GHA,Sarawak,1,0,1
2022-06-01,GHA,Selangor,22,13,9
2022-06-01,GIB,Johor,0,0,0
2022-06-01,GIB,Sarawak,0,0,0
2022-06-01,GIN,Johor,4,4,0
2022-06-01,GIN,Kedah,0,0,0
2022-06-01,GIN,Kelantan,0,0,0
2022-06-01,GIN,Perlis,0,0,0
2022-06-01,GIN,Pulau Pinang,0,0,0
2022-06-01,GIN,Sabah,0,0,0
2022-06-01,GIN,Sarawak,0,0,0
2022-06-01,GIN,Selangor,19,14,5
2022-06-01,GLP,Selangor,0,0,0
2022-06-01,GMB,Johor,0,0,0
2022-06-01,GMB,Kedah,0,0,0
2022-06-01,GMB,Kelantan,0,0,0
2022-06-01,GMB,Pulau Pinang,0,0,0
2022-06-01,GMB,Sabah,0,0,0
2022-06-01,GMB,Sarawak,0,0,0
2022-06-01,GMB,Selangor,10,6,4
2022-06-01,GNB,Johor,0,0,0
2022-06-01,GNB,Selangor,0,0,0
2022-06-01,GNQ,Johor,0,0,0
2022-06-01,GNQ,Selangor,1,1,0
2022-06-01,GRC,Johor,24,22,2
2022-06-01,GRC,Kedah,2,1,1
2022-06-01,GRC,Kelantan,0,0,0
2022-06-01,GRC,Melaka,0,0,0
2022-06-01,GRC,Negeri Sembilan,1,1,0
2022-06-01,GRC,Pahang,3,3,0
2022-06-01,GRC,Perak,0,0,0
2022-06-01,GRC,Perlis,0,0,0
2022-06-01,GRC,Pulau Pinang,1,0,1
2022-06-01,GRC,Sabah,0,0,0
2022-06-01,GRC,Sarawak,2,1,1
2022-06-01,GRC,Selangor,94,73,21
2022-06-01,GRD,Johor,1,0,1
2022-06-01,GRD,Kedah,0,0,0
2022-06-01,GRD,Pulau Pinang,2,2,0
2022-06-01,GRD,Sabah,0,0,0
2022-06-01,GRD,Sarawak,0,0,0
2022-06-01,GRD,Selangor,6,6,0
2022-06-01,GRL,Johor,0,0,0
2022-06-01,GRL,Selangor,0,0,0
2022-06-01,GTM,Johor,2,0,2
2022-06-01,GTM,Kedah,0,0,0
2022-06-01,GTM,Pahang,0,0,0
2022-06-01,GTM,Perak,0,0,0
2022-06-01,GTM,Pulau Pinang,0,0,0
2022-06-01,GTM,Sabah,0,0,0
2022-06-01,GTM,Sarawak,0,0,0
2022-06-01,GTM,Selangor,13,5,8
2022-06-01,GTM,W.P. Labuan,0,0,0
2022-06-01,GUY,Johor,0,0,0
2022-06-01,GUY,Kedah,0,0,0
2022-06-01,GUY,Pulau Pinang,0,0,0
2022-06-01,GUY,Sarawak,0,0,0
2022-06-01,GUY,Selangor,5,4,1
2022-06-01,HKG,Johor,9,3,6
2022-06-01,HKG,Kedah,1,1,0
2022-06-01,HKG,Kelantan,0,0,0
2022-06-01,HKG,Pahang,0,0,0
2022-06-01,HKG,Perak,8,5,3
2022-06-01,HKG,Perlis,1,1,0
2022-06-01,HKG,Pulau Pinang,137,84,53
2022-06-01,HKG,Sabah,70,23,47
2022-06-01,HKG,Sarawak,53,23,30
2022-06-01,HKG,Selangor,11,4,7
2022-06-01,HKG,Terengganu,0,0,0
2022-06-01,HMD,Johor,0,0,0
2022-06-01,HND,Johor,1,0,1
2022-06-01,HND,Kedah,0,0,0
2022-06-01,HND,Perak,0,0,0
2022-06-01,HND,Pulau Pinang,0,0,0
2022-06-01,HND,Sabah,0,0,0
2022-06-01,HND,Sarawak,0,0,0
2022-06-01,HND,Selangor,7,5,2
2022-06-01,HRV,Johor,11,11,0
2022-06-01,HRV,Kedah,0,0,0
2022-06-01,HRV,Kelantan,0,0,0
2022-06-01,HRV,Melaka,0,0,0
2022-06-01,HRV,Pahang,1,1,0
2022-06-01,HRV,Perak,0,0,0
2022-06-01,HRV,Perlis,0,0,0
2022-06-01,HRV,Pulau Pinang,2,1,1
2022-06-01,HRV,Sabah,1,0,1
2022-06-01,HRV,Sarawak,0,0,0
2022-06-01,HRV,Selangor,62,51,11
2022-06-01,HTI,Johor,0,0,0
2022-06-01,HTI,Kedah,0,0,0
2022-06-01,HTI,Kelantan,0,0,0
2022-06-01,HTI,Perak,0,0,0
2022-06-01,HTI,Pulau Pinang,0,0,0
2022-06-01,HTI,Sabah,0,0,0
2022-06-01,HTI,Selangor,1,1,0
2022-06-01,HUN,Johor,51,40,11
2022-06-01,HUN,Kedah,5,4,1
2022-06-01,HUN,Kelantan,0,0,0
2022-06-01,HUN,Pahang,0,0,0
2022-06-01,HUN,Perak,0,0,0
2022-06-01,HUN,Perlis,0,0,0
2022-06-01,HUN,Pulau Pinang,8,1,7
2022-06-01,HUN,Sabah,6,1,5
2022-06-01,HUN,Sarawak,1,0,1
2022-06-01,HUN,Selangor,134,75,59
2022-06-01,HUN,W.P. Labuan,0,0,0
2022-06-01,IDN,Johor,69380,35949,33431
2022-06-01,IDN,Kedah,577,207,370
2022-06-01,IDN,Kelantan,33,15,18
2022-06-01,IDN,Melaka,5685,2555,3130
2022-06-01,IDN,Negeri Sembilan,5752,4019,1733
2022-06-01,IDN,Pahang,0,0,0
2022-06-01,IDN,Perak,58,14,44
2022-06-01,IDN,Perlis,77,37,40
2022-06-01,IDN,Pulau Pinang,15595,6352,9243
2022-06-01,IDN,Sabah,3148,1492,1656
2022-06-01,IDN,Sarawak,23177,14458,8719
2022-06-01,IDN,Selangor,39776,19320,20456
2022-06-01,IDN,Terengganu,0,0,0
2022-06-01,IDN,W.P. Labuan,7,7,0
2022-06-01,IND,Johor,9893,6559,3334
2022-06-01,IND,Kedah,1420,1095,325
2022-06-01,IND,Kelantan,12,11,1
2022-06-01,IND,Melaka,1,1,0
2022-06-01,IND,Negeri Sembilan,0,0,0
2022-06-01,IND,Pahang,1,1,0
2022-06-01,IND,Perak,209,153,56
2022-06-01,IND,Perlis,40,39,1
2022-06-01,IND,Pulau Pinang,472,327,145
2022-06-01,IND,Sabah,163,99,64
2022-06-01,IND,Sarawak,55,39,16
2022-06-01,IND,Selangor,34418,24965,9453
2022-06-01,IND,Terengganu,0,0,0
2022-06-01,IND,W.P. Labuan,0,0,0
2022-06-01,IOT,Pulau Pinang,0,0,0
2022-06-01,IOT,Selangor,0,0,0
2022-06-01,IRL,Johor,213,155,58
2022-06-01,IRL,Kedah,36,21,15
2022-06-01,IRL,Kelantan,0,0,0
2022-06-01,IRL,Negeri Sembilan,0,0,0
2022-06-01,IRL,Pahang,0,0,0
2022-06-01,IRL,Perak,4,1,3
2022-06-01,IRL,Perlis,8,3,5
2022-06-01,IRL,Pulau Pinang,49,31,18
2022-06-01,IRL,Sabah,9,2,7
2022-06-01,IRL,Sarawak,0,0,0
2022-06-01,IRL,Selangor,643,411,232
2022-06-01,IRL,Terengganu,0,0,0
2022-06-01,IRL,W.P. Labuan,0,0,0
2022-06-01,IRN,Johor,132,74,58
2022-06-01,IRN,Kedah,8,6,2
2022-06-01,IRN,Kelantan,0,0,0
2022-06-01,IRN,Perak,0,0,0
2022-06-01,IRN,Perlis,0,0,0
2022-06-01,IRN,Pulau Pinang,2,1,1
2022-06-01,IRN,Sabah,0,0,0
2022-06-01,IRN,Sarawak,1,1,0
2022-06-01,IRN,Selangor,1132,612,520
2022-06-01,IRN,W.P. Labuan,0,0,0
2022-06-01,IRQ,Johor,15,9,6
2022-06-01,IRQ,Kedah,0,0,0
2022-06-01,IRQ,Kelantan,0,0,0
2022-06-01,IRQ,Melaka,0,0,0
2022-06-01,IRQ,Pahang,0,0,0
2022-06-01,IRQ,Perak,0,0,0
2022-06-01,IRQ,Perlis,0,0,0
2022-06-01,IRQ,Pulau Pinang,0,0,0
2022-06-01,IRQ,Sabah,0,0,0
2022-06-01,IRQ,Sarawak,0,0,0
2022-06-01,IRQ,Selangor,645,445,200
2022-06-01,ISL,Johor,5,2,3
2022-06-01,ISL,Kedah,0,0,0
2022-06-01,ISL,Kelantan,0,0,0
2022-06-01,ISL,Perak,0,0,0
2022-06-01,ISL,Perlis,0,0,0
2022-06-01,ISL,Pulau Pinang,0,0,0
2022-06-01,ISL,Sabah,0,0,0
2022-06-01,ISL,Sarawak,0,0,0
2022-06-01,ISL,Selangor,25,11,14
2022-06-01,ISL,W.P. Labuan,0,0,0
2022-06-01,ISR,Pulau Pinang,0,0,0
2022-06-01,ITA,Johor,333,257,76
2022-06-01,ITA,Kedah,23,10,13
2022-06-01,ITA,Kelantan,1,1,0
2022-06-01,ITA,Melaka,0,0,0
2022-06-01,ITA,Negeri Sembilan,0,0,0
2022-06-01,ITA,Pahang,0,0,0
2022-06-01,ITA,Perak,1,1,0
2022-06-01,ITA,Perlis,0,0,0
2022-06-01,ITA,Pulau Pinang,43,35,8
2022-06-01,ITA,Sabah,15,11,4
2022-06-01,ITA,Sarawak,10,7,3
2022-06-01,ITA,Selangor,1027,740,287
2022-06-01,ITA,W.P. Labuan,0,0,0
2022-06-01,JAM,Johor,1,1,0
2022-06-01,JAM,Kedah,1,0,1
2022-06-01,JAM,Perak,0,0,0
2022-06-01,JAM,Pulau Pinang,0,0,0
2022-06-01,JAM,Sabah,0,0,0
2022-06-01,JAM,Sarawak,0,0,0
2022-06-01,JAM,Selangor,7,4,3
2022-06-01,JAM,W.P. Labuan,0,0,0
2022-06-01,JOR,Johor,3,1,2
2022-06-01,JOR,Kedah,3,2,1
2022-06-01,JOR,Kelantan,0,0,0
2022-06-01,JOR,Melaka,0,0,0
2022-06-01,JOR,Perlis,1,1,0
2022-06-01,JOR,Pulau Pinang,0,0,0
2022-06-01,JOR,Sabah,0,0,0
2022-06-01,JOR,Sarawak,0,0,0
2022-06-01,JOR,Selangor,569,338,231
2022-06-01,JOR,W.P. Labuan,0,0,0
2022-06-01,JPN,Johor,3081,2282,799
2022-06-01,JPN,Kedah,88,44,44
2022-06-01,JPN,Kelantan,1,1,0
2022-06-01,JPN,Melaka,0,0,0
2022-06-01,JPN,Negeri Sembilan,0,0,0
2022-06-01,JPN,Pahang,1,0,1
2022-06-01,JPN,Perak,15,12,3
2022-06-01,JPN,Perlis,6,6,0
2022-06-01,JPN,Pulau Pinang,491,383,108
2022-06-01,JPN,Sabah,60,31,29
2022-06-01,JPN,Sarawak,51,38,13
2022-06-01,JPN,Selangor,5495,4016,1479
2022-06-01,JPN,W.P. Labuan,1,1,0
2022-06-01,KAZ,Johor,14,8,6
2022-06-01,KAZ,Kedah,3,1,2
2022-06-01,KAZ,Kelantan,0,0,0
2022-06-01,KAZ,Melaka,0,0,0
2022-06-01,KAZ,Perak,0,0,0
2022-06-01,KAZ,Perlis,0,0,0
2022-06-01,KAZ,Pulau Pinang,1,0,1
2022-06-01,KAZ,Sabah,0,0,0
2022-06-01,KAZ,Sarawak,0,0,0
2022-06-01,KAZ,Selangor,205,82,123
2022-06-01,KAZ,W.P. Labuan,0,0,0
2022-06-01,KEN,Johor,22,9,13
2022-06-01,KEN,Kedah,0,0,0
2022-06-01,KEN,Kelantan,0,0,0
2022-06-01,KEN,Perak,0,0,0
2022-06-01,KEN,Perlis,1,1,0
2022-06-01,KEN,Pulau Pinang,0,0,0
2022-06-01,KEN,Sabah,0,0,0
2022-06-01,KEN,Sarawak,1,0,1
2022-06-01,KEN,Selangor,163,94,69
2022-06-01,KGZ,Johor,17,11,6
2022-06-01,KGZ,Kedah,0,0,0
2022-06-01,KGZ,Kelantan,0,0,0
2022-06-01,KGZ,Perak,0,0,0
2022-06-01,KGZ,Perlis,0,0,0
2022-06-01,KGZ,Pulau Pinang,1,0,1
2022-06-01,KGZ,Sabah,0,0,0
2022-06-01,KGZ,Sarawak,0,0,0
2022-06-01,KGZ,Selangor,138,86,52
2022-06-01,KHM,Johor,644,274,370
2022-06-01,KHM,Kedah,385,253,132
2022-06-01,KHM,Kelantan,35,21,14
2022-06-01,KHM,Melaka,0,0,0
2022-06-01,KHM,Negeri Sembilan,0,0,0
2022-06-01,KHM,Pahang,0,0,0
2022-06-01,KHM,Perak,4,3,1
2022-06-01,KHM,Perlis,605,431,174
2022-06-01,KHM,Pulau Pinang,18,3,15
2022-06-01,KHM,Sabah,0,0,0
2022-06-01,KHM,Sarawak,3,2,1
2022-06-01,KHM,Selangor,2407,1272,1135
2022-06-01,KHM,W.P. Labuan,0,0,0
2022-06-01,KIR,Johor,0,0,0
2022-06-01,KIR,Sabah,0,0,0
2022-06-01,KIR,Selangor,0,0,0
2022-06-01,KNA,Johor,18,14,4
2022-06-01,KNA,Kedah,0,0,0
2022-06-01,KNA,Perlis,0,0,0
2022-06-01,KNA,Pulau Pinang,1,1,0
2022-06-01,KNA,Sabah,0,0,0
2022-06-01,KNA,Selangor,29,23,6
2022-06-01,KNA,W.P. Labuan,0,0,0
2022-06-01,KOR,Johor,5453,3265,2188
2022-06-01,KOR,Kedah,45,24,21
2022-06-01,KOR,Kelantan,0,0,0
2022-06-01,KOR,Melaka,1,1,0
2022-06-01,KOR,Negeri Sembilan,0,0,0
2022-06-01,KOR,Pahang,0,0,0
2022-06-01,KOR,Perak,13,7,6
2022-06-01,KOR,Perlis,20,17,3
2022-06-01,KOR,Pulau Pinang,189,122,67
2022-06-01,KOR,Sabah,1976,901,1075
2022-06-01,KOR,Sarawak,76,50,26
2022-06-01,KOR,Selangor,5050,3145,1905
2022-06-01,KOR,Terengganu,0,0,0
2022-06-01,KOR,W.P. Labuan,0,0,0
2022-06-01,KWT,Johor,20,10,10
2022-06-01,KWT,Kedah,11,5,6
2022-06-01,KWT,Kelantan,0,0,0
2022-06-01,KWT,Perak,0,0,0
2022-06-01,KWT,Perlis,0,0,0
2022-06-01,KWT,Pulau Pinang,4,3,1
2022-06-01,KWT,Sabah,1,0,1
2022-06-01,KWT,Sarawak,5,3,2
2022-06-01,KWT,Selangor,323,170,153
2022-06-01,KWT,W.P. Labuan,0,0,0
2022-06-01,LAO,Johor,27,7,20
2022-06-01,LAO,Kedah,295,39,256
2022-06-01,LAO,Kelantan,25,1,24
2022-06-01,LAO,Melaka,0,0,0
2022-06-01,LAO,Perak,0,0,0
2022-06-01,LAO,Perlis,36,26,10
2022-06-01,LAO,Pulau Pinang,6,0,6
2022-06-01,LAO,Sabah,0,0,0
2022-06-01,LAO,Sarawak,1,1,0
2022-06-01,LAO,Selangor,100,43,57
2022-06-01,LAO,W.P. Labuan,0,0,0
2022-06-01,LBN,Johor,6,4,2
2022-06-01,LBN,Kedah,0,0,0
2022-06-01,LBN,Kelantan,0,0,0
2022-06-01,LBN,Pahang,0,0,0
2022-06-01,LBN,Perak,0,0,0
2022-06-01,LBN,Perlis,0,0,0
2022-06-01,LBN,Pulau Pinang,3,2,1
2022-06-01,LBN,Sabah,1,0,1
2022-06-01,LBN,Sarawak,0,0,0
2022-06-01,LBN,Selangor,127,81,46
2022-06-01,LBN,W.P. Labuan,0,0,0
2022-06-01,LBR,Johor,1,1,0
2022-06-01,LBR,Kedah,0,0,0
2022-06-01,LBR,Sabah,0,0,0
2022-06-01,LBR,Sarawak,0,0,0
2022-06-01,LBR,Selangor,4,4,0
2022-06-01,LBY,Johor,0,0,0
2022-06-01,LBY,Kedah,0,0,0
2022-06-01,LBY,Perlis,0,0,0
2022-06-01,LBY,Pulau Pinang,0,0,0
2022-06-01,LBY,Sabah,0,0,0
2022-06-01,LBY,Sarawak,0,0,0
2022-06-01,LBY,Selangor,242,172,70
2022-06-01,LCA,Johor,5,5,0
2022-06-01,LCA,Kedah,0,0,0
2022-06-01,LCA,Pulau Pinang,0,0,0
2022-06-01,LCA,Sarawak,0,0,0
2022-06-01,LCA,Selangor,0,0,0
2022-06-01,LIE,Johor,1,0,1
2022-06-01,LIE,Kedah,0,0,0
2022-06-01,LIE,Perlis,0,0,0
2022-06-01,LIE,Pulau Pinang,0,0,0
2022-06-01,LIE,Sabah,2,1,1
2022-06-01,LIE,Sarawak,0,0,0
2022-06-01,LIE,Selangor,1,1,0
2022-06-01,LKA,Johor,535,338,197
2022-06-01,LKA,Kedah,33,18,15
2022-06-01,LKA,Kelantan,0,0,0
2022-06-01,LKA,Melaka,0,0,0
2022-06-01,LKA,Pahang,0,0,0
2022-06-01,LKA,Perak,2,1,1
2022-06-01,LKA,Perlis,0,0,0
2022-06-01,LKA,Pulau Pinang,19,13,6
2022-06-01,LKA,Sabah,8,5,3
2022-06-01,LKA,Sarawak,5,3,2
2022-06-01,LKA,Selangor,1798,1189,609
2022-06-01,LKA,W.P. Labuan,0,0,0
2022-06-01,LSO,Johor,1,0,1
2022-06-01,LSO,Kedah,0,0,0
2022-06-01,LSO,Pulau Pinang,0,0,0
2022-06-01,LSO,Sarawak,0,0,0
2022-06-01,LSO,Selangor,1,1,0
2022-06-01,LTU,Johor,7,4,3
2022-06-01,LTU,Kedah,5,3,2
2022-06-01,LTU,Kelantan,1,0,1
2022-06-01,LTU,Pahang,0,0,0
2022-06-01,LTU,Perak,0,0,0
2022-06-01,LTU,Perlis,0,0,0
2022-06-01,LTU,Pulau Pinang,1,1,0
2022-06-01,LTU,Sabah,2,1,1
2022-06-01,LTU,Sarawak,2,1,1
2022-06-01,LTU,Selangor,59,28,31
2022-06-01,LTU,W.P. Labuan,0,0,0
2022-06-01,LUX,Johor,3,2,1
2022-06-01,LUX,Kedah,0,0,0
2022-06-01,LUX,Kelantan,0,0,0
2022-06-01,LUX,Perak,0,0,0
2022-06-01,LUX,Perlis,0,0,0
2022-06-01,LUX,Pulau Pinang,2,1,1
2022-06-01,LUX,Sabah,0,0,0
2022-06-01,LUX,Sarawak,0,0,0
2022-06-01,LUX,Selangor,14,8,6
2022-06-01,LVA,Johor,6,4,2
2022-06-01,LVA,Kedah,0,0,0
2022-06-01,LVA,Kelantan,0,0,0
2022-06-01,LVA,Pahang,0,0,0
2022-06-01,LVA,Perak,0,0,0
2022-06-01,LVA,Perlis,0,0,0
2022-06-01,LVA,Pulau Pinang,0,0,0
2022-06-01,LVA,Sabah,1,0,1
2022-06-01,LVA,Sarawak,0,0,0
2022-06-01,LVA,Selangor,25,10,15
2022-06-01,LVA,W.P. Labuan,0,0,0
2022-06-01,MAC,Johor,0,0,0
2022-06-01,MAC,Pahang,0,0,0
2022-06-01,MAC,Perak,0,0,0
2022-06-01,MAC,Selangor,0,0,0
2022-06-01,MAC,W.P. Labuan,0,0,0
2022-06-01,MAR,Johor,43,32,11
2022-06-01,MAR,Kedah,1,0,1
2022-06-01,MAR,Kelantan,0,0,0
2022-06-01,MAR,Melaka,0,0,0
2022-06-01,MAR,Pahang,0,0,0
2022-06-01,MAR,Perak,0,0,0
2022-06-01,MAR,Perlis,0,0,0
2022-06-01,MAR,Pulau Pinang,2,0,2
2022-06-01,MAR,Sabah,1,1,0
2022-06-01,MAR,Sarawak,0,0,0
2022-06-01,MAR,Selangor,302,144,158
2022-06-01,MAR,W.P. Labuan,0,0,0
2022-06-01,MCO,Johor,4,3,1
2022-06-01,MCO,Kedah,0,0,0
2022-06-01,MCO,Sabah,0,0,0
2022-06-01,MCO,Selangor,0,0,0
2022-06-01,MDA,Johor,6,3,3
2022-06-01,MDA,Kedah,0,0,0
2022-06-01,MDA,Kelantan,0,0,0
2022-06-01,MDA,Negeri Sembilan,0,0,0
2022-06-01,MDA,Perlis,0,0,0
2022-06-01,MDA,Pulau Pinang,0,0,0
2022-06-01,MDA,Sabah,0,0,0
2022-06-01,MDA,Sarawak,0,0,0
2022-06-01,MDA,Selangor,3,1,2
2022-06-01,MDG,Johor,1,0,1
2022-06-01,MDG,Kedah,0,0,0
2022-06-01,MDG,Perak,0,0,0
2022-06-01,MDG,Perlis,0,0,0
2022-06-01,MDG,Pulau Pinang,0,0,0
2022-06-01,MDG,Sabah,0,0,0
2022-06-01,MDG,Sarawak,0,0,0
2022-06-01,MDG,Selangor,14,7,7
2022-06-01,MDV,Johor,82,49,33
2022-06-01,MDV,Kedah,0,0,0
2022-06-01,MDV,Kelantan,0,0,0
2022-06-01,MDV,Perak,0,0,0
2022-06-01,MDV,Perlis,1,1,0
2022-06-01,MDV,Pulau Pinang,14,9,5
2022-06-01,MDV,Sabah,0,0,0
2022-06-01,MDV,Sarawak,1,1,0
2022-06-01,MDV,Selangor,1376,697,679
2022-06-01,MEX,Johor,45,25,20
2022-06-01,MEX,Kedah,0,0,0
2022-06-01,MEX,Kelantan,0,0,0
2022-06-01,MEX,Pahang,0,0,0
2022-06-01,MEX,Perak,0,0,0
2022-06-01,MEX,Perlis,0,0,0
2022-06-01,MEX,Pulau Pinang,26,21,5
2022-06-01,MEX,Sabah,1,1,0
2022-06-01,MEX,Sarawak,1,1,0
2022-06-01,MEX,Selangor,197,102,95
2022-06-01,MEX,W.P. Labuan,0,0,0
2022-06-01,MHL,Johor,3,0,3
2022-06-01,MHL,Kedah,0,0,0
2022-06-01,MHL,Perak,0,0,0
2022-06-01,MHL,Pulau Pinang,0,0,0
2022-06-01,MHL,Sabah,0,0,0
2022-06-01,MHL,Selangor,0,0,0
2022-06-01,MKD,Johor,2,1,1
2022-06-01,MKD,Kedah,0,0,0
2022-06-01,MKD,Perak,0,0,0
2022-06-01,MKD,Pulau Pinang,0,0,0
2022-06-01,MKD,Sabah,0,0,0
2022-06-01,MKD,Sarawak,0,0,0
2022-06-01,MKD,Selangor,13,10,3
2022-06-01,MLI,Johor,2,2,0
2022-06-01,MLI,Sabah,0,0,0
2022-06-01,MLI,Selangor,3,2,1
2022-06-01,MLT,Johor,6,5,1
2022-06-01,MLT,Kedah,1,0,1
2022-06-01,MLT,Kelantan,0,0,0
2022-06-01,MLT,Perak,0,0,0
2022-06-01,MLT,Perlis,0,0,0
2022-06-01,MLT,Pulau Pinang,1,1,0
2022-06-01,MLT,Sabah,3,2,1
2022-06-01,MLT,Sarawak,0,0,0
2022-06-01,MLT,Selangor,19,12,7
2022-06-01,MLT,W.P. Labuan,0,0,0
2022-06-01,MMR,Johor,2342,713,1629
2022-06-01,MMR,Kedah,13,4,9
2022-06-01,MMR,Kelantan,0,0,0
2022-06-01,MMR,Negeri Sembilan,0,0,0
2022-06-01,MMR,Pahang,0,0,0
2022-06-01,MMR,Perak,11,2,9
2022-06-01,MMR,Perlis,0,0,0
2022-06-01,MMR,Pulau Pinang,64,14,50
2022-06-01,MMR,Sabah,10,4,6
2022-06-01,MMR,Sarawak,15,6,9
2022-06-01,MMR,Selangor,3261,1974,1287
2022-06-01,MMR,Terengganu,0,0,0
2022-06-01,MMR,W.P. Labuan,0,0,0
2022-06-01,MNE,Johor,1,1,0
2022-06-01,MNE,Kedah,0,0,0
2022-06-01,MNE,Pulau Pinang,0,0,0
2022-06-01,MNE,Sabah,0,0,0
2022-06-01,MNE,Sarawak,0,0,0
2022-06-01,MNE,Selangor,4,3,1
2022-06-01,MNG,Johor,61,18,43
2022-06-01,MNG,Kedah,1,0,1
2022-06-01,MNG,Kelantan,0,0,0
2022-06-01,MNG,Perak,0,0,0
2022-06-01,MNG,Perlis,1,0,1
2022-06-01,MNG,Pulau Pinang,7,3,4
2022-06-01,MNG,Sabah,3,1,2
2022-06-01,MNG,Sarawak,0,0,0
2022-06-01,MNG,Selangor,115,47,68
2022-06-01,MNP,Selangor,0,0,0
2022-06-01,MOZ,Johor,1,1,0
2022-06-01,MOZ,Kedah,0,0,0
2022-06-01,MOZ,Perak,0,0,0
2022-06-01,MOZ,Pulau Pinang,0,0,0
2022-06-01,MOZ,Sabah,0,0,0
2022-06-01,MOZ,Sarawak,0,0,0
2022-06-01,MOZ,Selangor,41,22,19
2022-06-01,MRT,Johor,1,1,0
2022-06-01,MRT,Kedah,0,0,0
2022-06-01,MRT,Pulau Pinang,0,0,0
2022-06-01,MRT,Sabah,0,0,0
2022-06-01,MRT,Sarawak,0,0,0
2022-06-01,MRT,Selangor,8,6,2
2022-06-01,MUS,Johor,40,20,20
2022-06-01,MUS,Kedah,4,2,2
2022-06-01,MUS,Kelantan,0,0,0
2022-06-01,MUS,Pahang,0,0,0
2022-06-01,MUS,Perak,0,0,0
2022-06-01,MUS,Perlis,0,0,0
2022-06-01,MUS,Pulau Pinang,0,0,0
2022-06-01,MUS,Sabah,0,0,0
2022-06-01,MUS,Sarawak,0,0,0
2022-06-01,MUS,Selangor,156,80,76
2022-06-01,MWI,Johor,0,0,0
2022-06-01,MWI,Pulau Pinang,0,0,0
2022-06-01,MWI,Sabah,0,0,0
2022-06-01,MWI,Sarawak,0,0,0
2022-06-01,MWI,Selangor,18,8,10
2022-06-01,MYT,Selangor,0,0,0
2022-06-01,NAM,Johor,1,0,1
2022-06-01,NAM,Kedah,0,0,0
2022-06-01,NAM,Perak,0,0,0
2022-06-01,NAM,Perlis,0,0,0
2022-06-01,NAM,Pulau Pinang,0,0,0
2022-06-01,NAM,Sabah,0,0,0
2022-06-01,NAM,Sarawak,0,0,0
2022-06-01,NAM,Selangor,5,2,3
2022-06-01,NCL,Selangor,0,0,0
2022-06-01,NER,Johor,0,0,0
2022-06-01,NER,Sabah,0,0,0
2022-06-01,NER,Selangor,6,2,4
2022-06-01,NGA,Johor,31,25,6
2022-06-01,NGA,Kedah,0,0,0
2022-06-01,NGA,Perlis,0,0,0
2022-06-01,NGA,Pulau Pinang,1,1,0
2022-06-01,NGA,Sabah,1,1,0
2022-06-01,NGA,Sarawak,1,1,0
2022-06-01,NGA,Selangor,303,241,62
2022-06-01,NIC,Johor,0,0,0
2022-06-01,NIC,Kedah,0,0,0
2022-06-01,NIC,Pulau Pinang,0,0,0
2022-06-01,NIC,Sabah,0,0,0
2022-06-01,NIC,Selangor,2,2,0
2022-06-01,NLD,Johor,531,384,147
2022-06-01,NLD,Kedah,40,28,12
2022-06-01,NLD,Kelantan,4,3,1
2022-06-01,NLD,Melaka,0,0,0
2022-06-01,NLD,Negeri Sembilan,3,0,3
2022-06-01,NLD,Pahang,2,1,1
2022-06-01,NLD,Perak,2,1,1
2022-06-01,NLD,Perlis,12,7,5
2022-06-01,NLD,Pulau Pinang,97,71,26
2022-06-01,NLD,Sabah,39,23,16
2022-06-01,NLD,Sarawak,26,15,11
2022-06-01,NLD,Selangor,1856,1228,628
2022-06-01,NLD,Terengganu,0,0,0
2022-06-01,NLD,W.P. Labuan,0,0,0
2022-06-01,NOR,Johor,84,59,25
2022-06-01,NOR,Kedah,3,2,1
2022-06-01,NOR,Kelantan,1,1,0
2022-06-01,NOR,Melaka,0,0,0
2022-06-01,NOR,Pahang,0,0,0
2022-06-01,NOR,Perak,0,0,0
2022-06-01,NOR,Perlis,3,1,2
2022-06-01,NOR,Pulau Pinang,25,12,13
2022-06-01,NOR,Sabah,9,8,1
2022-06-01,NOR,Sarawak,5,2,3
2022-06-01,NOR,Selangor,427,253,174
2022-06-01,NOR,W.P. Labuan,0,0,0
2022-06-01,NPL,Johor,668,572,96
2022-06-01,NPL,Kedah,2,2,0
2022-06-01,NPL,Pahang,0,0,0
2022-06-01,NPL,Perak,0,0,0
2022-06-01,NPL,Perlis,1,1,0
2022-06-01,NPL,Pulau Pinang,4,3,1
2022-06-01,NPL,Sabah,3,3,0
2022-06-01,NPL,Sarawak,3,3,0
2022-06-01,NPL,Selangor,11640,11011,629
2022-06-01,NPL,W.P. Labuan,0,0,0
2022-06-01,NRU,Johor,0,0,0
2022-06-01,NRU,Pulau Pinang,0,0,0
2022-06-01,NRU,Selangor,0,0,0
2022-06-01,NZL,Johor,394,268,126
2022-06-01,NZL,Kedah,26,15,11
2022-06-01,NZL,Kelantan,2,2,0
2022-06-01,NZL,Melaka,0,0,0
2022-06-01,NZL,Negeri Sembilan,0,0,0
2022-06-01,NZL,Pahang,2,1,1
2022-06-01,NZL,Perak,10,6,4
2022-06-01,NZL,Perlis,0,0,0
2022-06-01,NZL,Pulau Pinang,91,58,33
2022-06-01,NZL,Sabah,19,9,10
2022-06-01,NZL,Sarawak,23,15,8
2022-06-01,NZL,Selangor,997,647,350
2022-06-01,NZL,Terengganu,1,1,0
2022-06-01,NZL,W.P. Labuan,0,0,0
2022-06-01,OMN,Johor,52,32,20
2022-06-01,OMN,Kedah,0,0,0
2022-06-01,OMN,Kelantan,0,0,0
2022-06-01,OMN,Melaka,0,0,0
2022-06-01,OMN,Perak,0,0,0
2022-06-01,OMN,Perlis,0,0,0
2022-06-01,OMN,Pulau Pinang,2,1,1
2022-06-01,OMN,Sabah,2,1,1
2022-06-01,OMN,Sarawak,0,0,0
2022-06-01,OMN,Selangor,870,499,371
2022-06-01,PAK,Johor,598,423,175
2022-06-01,PAK,Kedah,57,35,22
2022-06-01,PAK,Kelantan,11,11,0
2022-06-01,PAK,Melaka,0,0,0
2022-06-01,PAK,Negeri Sembilan,0,0,0
2022-06-01,PAK,Pahang,0,0,0
2022-06-01,PAK,Perak,0,0,0
2022-06-01,PAK,Perlis,9,9,0
2022-06-01,PAK,Pulau Pinang,21,19,2
2022-06-01,PAK,Sabah,2,2,0
2022-06-01,PAK,Sarawak,14,7,7
2022-06-01,PAK,Selangor,7132,5840,1292
2022-06-01,PAK,W.P. Labuan,0,0,0
2022-06-01,PAN,Johor,0,0,0
2022-06-01,PAN,Kedah,0,0,0
2022-06-01,PAN,Perak,0,0,0
2022-06-01,PAN,Perlis,0,0,0
2022-06-01,PAN,Pulau Pinang,0,0,0
2022-06-01,PAN,Sabah,0,0,0
2022-06-01,PAN,Sarawak,0,0,0
2022-06-01,PAN,Selangor,6,1,5
2022-06-01,PER,Johor,14,6,8
2022-06-01,PER,Kedah,1,1,0
2022-06-01,PER,Kelantan,0,0,0
2022-06-01,PER,Pahang,0,0,0
2022-06-01,PER,Perak,0,0,0
2022-06-01,PER,Perlis,0,0,0
2022-06-01,PER,Pulau Pinang,6,3,3
2022-06-01,PER,Sabah,0,0,0
2022-06-01,PER,Sarawak,0,0,0
2022-06-01,PER,Selangor,30,19,11
2022-06-01,PER,W.P. Labuan,0,0,0
2022-06-01,PHL,Johor,9956,3030,6926
2022-06-01,PHL,Kedah,193,49,144
2022-06-01,PHL,Kelantan,7,5,2
2022-06-01,PHL,Melaka,0,0,0
2022-06-01,PHL,Negeri Sembilan,0,0,0
2022-06-01,PHL,Pahang,1,1,0
2022-06-01,PHL,Perak,34,8,26
2022-06-01,PHL,Perlis,42,21,21
2022-06-01,PHL,Pulau Pinang,261,113,148
2022-06-01,PHL,Sabah,344,109,235
2022-06-01,PHL,Sarawak,117,57,60
2022-06-01,PHL,Selangor,7501,3134,4367
2022-06-01,PHL,Terengganu,1,1,0
2022-06-01,PHL,W.P. Labuan,4,3,1
2022-06-01,PLW,Johor,0,0,0
2022-06-01,PLW,Pulau Pinang,0,0,0
2022-06-01,PLW,Selangor,0,0,0
2022-06-01,PNG,Johor,11,6,5
2022-06-01,PNG,Kedah,0,0,0
2022-06-01,PNG,Kelantan,0,0,0
2022-06-01,PNG,Perak,0,0,0
2022-06-01,PNG,Pulau Pinang,4,2,2
2022-06-01,PNG,Sabah,0,0,0
2022-06-01,PNG,Sarawak,0,0,0
2022-06-01,PNG,Selangor,45,23,22
2022-06-01,POL,Johor,130,78,52
2022-06-01,POL,Kedah,9,4,5
2022-06-01,POL,Kelantan,1,1,0
2022-06-01,POL,Melaka,0,0,0
2022-06-01,POL,Negeri Sembilan,0,0,0
2022-06-01,POL,Pahang,0,0,0
2022-06-01,POL,Perak,0,0,0
2022-06-01,POL,Perlis,5,2,3
2022-06-01,POL,Pulau Pinang,10,5,5
2022-06-01,POL,Sabah,17,6,11
2022-06-01,POL,Sarawak,1,1,0
2022-06-01,POL,Selangor,457,261,196
2022-06-01,POL,Terengganu,0,0,0
2022-06-01,POL,W.P. Labuan,0,0,0
2022-06-01,PRK,Selangor,0,0,0
2022-06-01,PRT,Johor,77,44,33
2022-06-01,PRT,Kedah,13,8,5
2022-06-01,PRT,Kelantan,0,0,0
2022-06-01,PRT,Melaka,0,0,0
2022-06-01,PRT,Pahang,0,0,0
2022-06-01,PRT,Perak,0,0,0
2022-06-01,PRT,Perlis,3,3,0
2022-06-01,PRT,Pulau Pinang,24,15,9
2022-06-01,PRT,Sabah,2,1,1
2022-06-01,PRT,Sarawak,1,1,0
2022-06-01,PRT,Selangor,440,278,162
2022-06-01,PRT,W.P. Labuan,0,0,0
2022-06-01,PRY,Johor,3,3,0
2022-06-01,PRY,Kedah,0,0,0
2022-06-01,PRY,Perak,0,0,0
2022-06-01,PRY,Perlis,0,0,0
2022-06-01,PRY,Pulau Pinang,0,0,0
2022-06-01,PRY,Sabah,0,0,0
2022-06-01,PRY,Sarawak,0,0,0
2022-06-01,PRY,Selangor,0,0,0
2022-06-01,PSE,Johor,11,6,5
2022-06-01,PSE,Kedah,0,0,0
2022-06-01,PSE,Kelantan,0,0,0
2022-06-01,PSE,Melaka,0,0,0
2022-06-01,PSE,Perak,0,0,0
2022-06-01,PSE,Perlis,0,0,0
2022-06-01,PSE,Pulau Pinang,0,0,0
2022-06-01,PSE,Sabah,0,0,0
2022-06-01,PSE,Sarawak,0,0,0
2022-06-01,PSE,Selangor,219,134,85
2022-06-01,QAT,Johor,18,8,10
2022-06-01,QAT,Kedah,0,0,0
2022-06-01,QAT,Perlis,0,0,0
2022-06-01,QAT,Pulau Pinang,0,0,0
2022-06-01,QAT,Sabah,0,0,0
2022-06-01,QAT,Sarawak,0,0,0
2022-06-01,QAT,Selangor,250,163,87
2022-06-01,REU,Johor,0,0,0
2022-06-01,REU,Sarawak,0,0,0
2022-06-01,ROU,Johor,78,50,28
2022-06-01,ROU,Kedah,2,2,0
2022-06-01,ROU,Kelantan,0,0,0
2022-06-01,ROU,Negeri Sembilan,0,0,0
2022-06-01,ROU,Pahang,0,0,0
2022-06-01,ROU,Perak,0,0,0
2022-06-01,ROU,Perlis,0,0,0
2022-06-01,ROU,Pulau Pinang,8,5,3
2022-06-01,ROU,Sabah,8,5,3
2022-06-01,ROU,Sarawak,4,4,0
2022-06-01,ROU,Selangor,197,112,85
2022-06-01,ROU,W.P. Labuan,0,0,0
2022-06-01,RUS,Johor,178,101,77
2022-06-01,RUS,Kedah,48,22,26
2022-06-01,RUS,Kelantan,3,0,3
2022-06-01,RUS,Melaka,0,0,0
2022-06-01,RUS,Negeri Sembilan,0,0,0
2022-06-01,RUS,Pahang,0,0,0
2022-06-01,RUS,Perak,0,0,0
2022-06-01,RUS,Perlis,14,9,5
2022-06-01,RUS,Pulau Pinang,18,10,8
2022-06-01,RUS,Sabah,6,3,3
2022-06-01,RUS,Sarawak,8,3,5
2022-06-01,RUS,Selangor,1167,641,526
2022-06-01,RUS,W.P. Labuan,0,0,0
2022-06-01,RWA,Johor,1,1,0
2022-06-01,RWA,Kedah,0,0,0
2022-06-01,RWA,Pulau Pinang,0,0,0
2022-06-01,RWA,Selangor,1,1,0
2022-06-01,SAU,Johor,64,44,20
2022-06-01,SAU,Kedah,6,3,3
2022-06-01,SAU,Kelantan,0,0,0
2022-06-01,SAU,Melaka,0,0,0
2022-06-01,SAU,Perak,0,0,0
2022-06-01,SAU,Perlis,0,0,0
2022-06-01,SAU,Pulau Pinang,9,3,6
2022-06-01,SAU,Sabah,0,0,0
2022-06-01,SAU,Sarawak,0,0,0
2022-06-01,SAU,Selangor,4293,2370,1923
2022-06-01,SAU,W.P. Labuan,0,0,0
2022-06-01,SDN,Johor,9,5,4
2022-06-01,SDN,Kedah,0,0,0
2022-06-01,SDN,Kelantan,0,0,0
2022-06-01,SDN,Perlis,0,0,0
2022-06-01,SDN,Pulau Pinang,0,0,0
2022-06-01,SDN,Sabah,0,0,0
2022-06-01,SDN,Sarawak,0,0,0
2022-06-01,SDN,Selangor,625,351,274
2022-06-01,SDN,W.P. Labuan,0,0,0
2022-06-01,SEN,Johor,2,2,0
2022-06-01,SEN,Kedah,2,0,2
2022-06-01,SEN,Kelantan,0,0,0
2022-06-01,SEN,Perak,0,0,0
2022-06-01,SEN,Perlis,0,0,0
2022-06-01,SEN,Pulau Pinang,0,0,0
2022-06-01,SEN,Sabah,0,0,0
2022-06-01,SEN,Sarawak,0,0,0
2022-06-01,SEN,Selangor,14,12,2
2022-06-01,SGP,Johor,795093,471150,323943
2022-06-01,SGP,Kedah,2739,1354,1385
2022-06-01,SGP,Kelantan,16,13,3
2022-06-01,SGP,Melaka,20,15,5
2022-06-01,SGP,Negeri Sembilan,2,0,2
2022-06-01,SGP,Pahang,20,15,5
2022-06-01,SGP,Perak,3887,1893,1994
2022-06-01,SGP,Perlis,44,33,11
2022-06-01,SGP,Pulau Pinang,14417,7398,7019
2022-06-01,SGP,Sabah,2986,1503,1483
2022-06-01,SGP,Sarawak,2856,1515,1341
2022-06-01,SGP,Selangor,29204,15654,13550
2022-06-01,SGP,Terengganu,1,1,0
2022-06-01,SGP,W.P. Labuan,0,0,0
2022-06-01,SGS,Johor,0,0,0
2022-06-01,SGS,Sabah,0,0,0
2022-06-01,SGS,Selangor,2,2,0
2022-06-01,SHN,Sarawak,0,0,0
2022-06-01,SLB,Johor,3,3,0
2022-06-01,SLB,Perlis,0,0,0
2022-06-01,SLB,Pulau Pinang,0,0,0
2022-06-01,SLB,Sabah,0,0,0
2022-06-01,SLB,Sarawak,1,0,1
2022-06-01,SLB,Selangor,2,2,0
2022-06-01,SLB,W.P. Labuan,0,0,0
2022-06-01,SLE,Johor,1,1,0
2022-06-01,SLE,Kedah,0,0,0
2022-06-01,SLE,Perak,0,0,0
2022-06-01,SLE,Pulau Pinang,0,0,0
2022-06-01,SLE,Sabah,0,0,0
2022-06-01,SLE,Selangor,14,9,5
2022-06-01,SLV,Johor,0,0,0
2022-06-01,SLV,Kedah,0,0,0
2022-06-01,SLV,Perak,0,0,0
2022-06-01,SLV,Perlis,0,0,0
2022-06-01,SLV,Pulau Pinang,0,0,0
2022-06-01,SLV,Sabah,0,0,0
2022-06-01,SLV,Selangor,5,3,2
2022-06-01,SLV,W.P. Labuan,0,0,0
2022-06-01,SMR,Johor,0,0,0
2022-06-01,SMR,Selangor,0,0,0
2022-06-01,SOM,Johor,0,0,0
2022-06-01,SOM,Kedah,0,0,0
2022-06-01,SOM,Kelantan,0,0,0
2022-06-01,SOM,Perlis,0,0,0
2022-06-01,SOM,Sabah,0,0,0
2022-06-01,SOM,Sarawak,0,0,0
2022-06-01,SOM,Selangor,138,81,57
2022-06-01,SRB,Johor,5,5,0
2022-06-01,SRB,Kedah,0,0,0
2022-06-01,SRB,Kelantan,0,0,0
2022-06-01,SRB,Pahang,0,0,0
2022-06-01,SRB,Perak,0,0,0
2022-06-01,SRB,Perlis,1,0,1
2022-06-01,SRB,Pulau Pinang,0,0,0
2022-06-01,SRB,Sabah,0,0,0
2022-06-01,SRB,Sarawak,0,0,0
2022-06-01,SRB,Selangor,25,15,10
2022-06-01,SSD,Johor,0,0,0
2022-06-01,SSD,Kedah,0,0,0
2022-06-01,SSD,Sarawak,0,0,0
2022-06-01,SSD,Selangor,10,6,4
2022-06-01,SSD,W.P. Labuan,0,0,0
2022-06-01,STP,Selangor,0,0,0
2022-06-01,SUR,Johor,0,0,0
2022-06-01,SUR,Kedah,0,0,0
2022-06-01,SUR,Kelantan,0,0,0
2022-06-01,SUR,Perak,0,0,0
2022-06-01,SUR,Perlis,0,0,0
2022-06-01,SUR,Pulau Pinang,0,0,0
2022-06-01,SUR,Sabah,0,0,0
2022-06-01,SUR,Sarawak,0,0,0
2022-06-01,SUR,Selangor,5,4,1
2022-06-01,SVK,Johor,16,8,8
2022-06-01,SVK,Kedah,1,1,0
2022-06-01,SVK,Kelantan,0,0,0
2022-06-01,SVK,Negeri Sembilan,0,0,0
2022-06-01,SVK,Pahang,0,0,0
2022-06-01,SVK,Perak,0,0,0
2022-06-01,SVK,Perlis,0,0,0
2022-06-01,SVK,Pulau Pinang,1,1,0
2022-06-01,SVK,Sabah,1,1,0
2022-06-01,SVK,Sarawak,0,0,0
2022-06-01,SVK,Selangor,109,45,64
2022-06-01,SVK,W.P. Labuan,0,0,0
2022-06-01,SVN,Johor,3,0,3
2022-06-01,SVN,Kedah,0,0,0
2022-06-01,SVN,Kelantan,0,0,0
2022-06-01,SVN,Perak,0,0,0
2022-06-01,SVN,Perlis,0,0,0
2022-06-01,SVN,Pulau Pinang,0,0,0
2022-06-01,SVN,Sabah,0,0,0
2022-06-01,SVN,Sarawak,1,1,0
2022-06-01,SVN,Selangor,30,20,10
2022-06-01,SVN,W.P. Labuan,0,0,0
2022-06-01,SWE,Johor,145,107,38
2022-06-01,SWE,Kedah,7,6,1
2022-06-01,SWE,Kelantan,3,2,1
2022-06-01,SWE,Melaka,0,0,0
2022-06-01,SWE,Negeri Sembilan,0,0,0
2022-06-01,SWE,Pahang,0,0,0
2022-06-01,SWE,Perak,4,2,2
2022-06-01,SWE,Perlis,6,5,1
2022-06-01,SWE,Pulau Pinang,37,20,17
2022-06-01,SWE,Sabah,22,11,11
2022-06-01,SWE,Sarawak,8,5,3
2022-06-01,SWE,Selangor,495,324,171
2022-06-01,SWE,W.P. Labuan,0,0,0
2022-06-01,SWZ,Johor,0,0,0
2022-06-01,SWZ,Kedah,0,0,0
2022-06-01,SWZ,Pulau Pinang,0,0,0
2022-06-01,SWZ,Sabah,0,0,0
2022-06-01,SWZ,Selangor,9,6,3
2022-06-01,SYC,Johor,3,3,0
2022-06-01,SYC,Kedah,0,0,0
2022-06-01,SYC,Pulau Pinang,0,0,0
2022-06-01,SYC,Sabah,0,0,0
2022-06-01,SYC,Sarawak,0,0,0
2022-06-01,SYC,Selangor,30,11,19
2022-06-01,SYR,Johor,6,2,4
2022-06-01,SYR,Kedah,1,1,0
2022-06-01,SYR,Kelantan,0,0,0
2022-06-01,SYR,Pahang,0,0,0
2022-06-01,SYR,Perlis,0,0,0
2022-06-01,SYR,Pulau Pinang,0,0,0
2022-06-01,SYR,Sabah,0,0,0
2022-06-01,SYR,Sarawak,0,0,0
2022-06-01,SYR,Selangor,464,278,186
2022-06-01,SYR,W.P. Labuan,0,0,0
2022-06-01,TCA,Perlis,0,0,0
2022-06-01,TCD,Johor,1,1,0
2022-06-01,TCD,Kedah,0,0,0
2022-06-01,TCD,Perlis,0,0,0
2022-06-01,TCD,Selangor,10,7,3
2022-06-01,TGO,Johor,0,0,0
2022-06-01,TGO,Perak,0,0,0
2022-06-01,TGO,Pulau Pinang,0,0,0
2022-06-01,TGO,Selangor,1,0,1
2022-06-01,THA,Johor,2429,510,1919
2022-06-01,THA,Kedah,36092,24203,11889
2022-06-01,THA,Kelantan,8681,3840,4841
2022-06-01,THA,Melaka,3,1,2
2022-06-01,THA,Negeri Sembilan,0,0,0
2022-06-01,THA,Pahang,3,3,0
2022-06-01,THA,Perak,3068,1365,1703
2022-06-01,THA,Perlis,40471,25967,14504
2022-06-01,THA,Pulau Pinang,1079,432,647
2022-06-01,THA,Sabah,17,9,8
2022-06-01,THA,Sarawak,29,20,9
2022-06-01,THA,Selangor,5756,2333,3423
2022-06-01,THA,Terengganu,0,0,0
2022-06-01,THA,W.P. Labuan,0,0,0
2022-06-01,TJK,Johor,2,2,0
2022-06-01,TJK,Kedah,0,0,0
2022-06-01,TJK,Perlis,0,0,0
2022-06-01,TJK,Pulau Pinang,0,0,0
2022-06-01,TJK,Sabah,0,0,0
2022-06-01,TJK,Selangor,38,28,10
2022-06-01,TKL,Selangor,0,0,0
2022-06-01,TKM,Johor,0,0,0
2022-06-01,TKM,Kedah,0,0,0
2022-06-01,TKM,Kelantan,0,0,0
2022-06-01,TKM,Perlis,0,0,0
2022-06-01,TKM,Pulau Pinang,0,0,0
2022-06-01,TKM,Sabah,0,0,0
2022-06-01,TKM,Sarawak,0,0,0
2022-06-01,TKM,Selangor,49,40,9
2022-06-01,TLS,Johor,1,1,0
2022-06-01,TLS,Kedah,0,0,0
2022-06-01,TLS,Perlis,0,0,0
2022-06-01,TLS,Pulau Pinang,3,2,1
2022-06-01,TLS,Sabah,0,0,0
2022-06-01,TLS,Sarawak,3,1,2
2022-06-01,TLS,Selangor,234,152,82
2022-06-01,TON,Johor,0,0,0
2022-06-01,TON,Pulau Pinang,0,0,0
2022-06-01,TON,Sarawak,0,0,0
2022-06-01,TON,Selangor,0,0,0
2022-06-01,TTO,Johor,1,0,1
2022-06-01,TTO,Kedah,0,0,0
2022-06-01,TTO,Pahang,0,0,0
2022-06-01,TTO,Pulau Pinang,0,0,0
2022-06-01,TTO,Sabah,0,0,0
2022-06-01,TTO,Sarawak,1,0,1
2022-06-01,TTO,Selangor,5,5,0
2022-06-01,TUN,Johor,1,1,0
2022-06-01,TUN,Kedah,6,4,2
2022-06-01,TUN,Kelantan,0,0,0
2022-06-01,TUN,Melaka,1,0,1
2022-06-01,TUN,Perak,0,0,0
2022-06-01,TUN,Perlis,0,0,0
2022-06-01,TUN,Pulau Pinang,2,2,0
2022-06-01,TUN,Sabah,0,0,0
2022-06-01,TUN,Sarawak,0,0,0
2022-06-01,TUN,Selangor,199,95,104
2022-06-01,TUN,W.P. Labuan,0,0,0
2022-06-01,TUR,Johor,123,93,30
2022-06-01,TUR,Kedah,20,8,12
2022-06-01,TUR,Kelantan,0,0,0
2022-06-01,TUR,Melaka,0,0,0
2022-06-01,TUR,Negeri Sembilan,0,0,0
2022-06-01,TUR,Pahang,0,0,0
2022-06-01,TUR,Perak,2,2,0
2022-06-01,TUR,Perlis,7,4,3
2022-06-01,TUR,Pulau Pinang,5,3,2
2022-06-01,TUR,Sabah,1,1,0
2022-06-01,TUR,Sarawak,0,0,0
2022-06-01,TUR,Selangor,527,382,145
2022-06-01,TUR,W.P. Labuan,0,0,0
2022-06-01,TUV,Selangor,0,0,0
2022-06-01,TWN,Johor,1973,779,1194
2022-06-01,TWN,Kedah,38,19,19
2022-06-01,TWN,Kelantan,0,0,0
2022-06-01,TWN,Melaka,0,0,0
2022-06-01,TWN,Negeri Sembilan,0,0,0
2022-06-01,TWN,Pahang,3,3,0
2022-06-01,TWN,Perak,7,2,5
2022-06-01,TWN,Perlis,2,2,0
2022-06-01,TWN,Pulau Pinang,368,214,154
2022-06-01,TWN,Sabah,54,18,36
2022-06-01,TWN,Sarawak,48,23,25
2022-06-01,TWN,Selangor,1306,745,561
2022-06-01,TWN,W.P. Labuan,0,0,0
2022-06-01,TZA,Johor,6,1,5
2022-06-01,TZA,Kedah,0,0,0
2022-06-01,TZA,Perak,0,0,0
2022-06-01,TZA,Perlis,0,0,0
2022-06-01,TZA,Pulau Pinang,0,0,0
2022-06-01,TZA,Sabah,0,0,0
2022-06-01,TZA,Sarawak,0,0,0
2022-06-01,TZA,Selangor,69,33,36
2022-06-01,UGA,Johor,1,1,0
2022-06-01,UGA,Kedah,0,0,0
2022-06-01,UGA,Perak,0,0,0
2022-06-01,UGA,Perlis,0,0,0
2022-06-01,UGA,Pulau Pinang,1,0,1
2022-06-01,UGA,Sabah,0,0,0
2022-06-01,UGA,Sarawak,0,0,0
2022-06-01,UGA,Selangor,39,20,19
2022-06-01,UKR,Johor,62,36,26
2022-06-01,UKR,Kedah,8,4,4
2022-06-01,UKR,Kelantan,0,0,0
2022-06-01,UKR,Melaka,0,0,0
2022-06-01,UKR,Negeri Sembilan,0,0,0
2022-06-01,UKR,Pahang,0,0,0
2022-06-01,UKR,Perak,0,0,0
2022-06-01,UKR,Perlis,1,1,0
2022-06-01,UKR,Pulau Pinang,3,1,2
2022-06-01,UKR,Sabah,5,0,5
2022-06-01,UKR,Sarawak,0,0,0
2022-06-01,UKR,Selangor,295,162,133
2022-06-01,UKR,W.P. Labuan,0,0,0
2022-06-01,URY,Johor,8,3,5
2022-06-01,URY,Kedah,0,0,0
2022-06-01,URY,Kelantan,0,0,0
2022-06-01,URY,Perak,0,0,0
2022-06-01,URY,Perlis,0,0,0
2022-06-01,URY,Pulau Pinang,0,0,0
2022-06-01,URY,Sabah,0,0,0
2022-06-01,URY,Sarawak,0,0,0
2022-06-01,URY,Selangor,13,8,5
2022-06-01,URY,W.P. Labuan,0,0,0
2022-06-01,USA,Johor,2673,1645,1028
2022-06-01,USA,Kedah,175,86,89
2022-06-01,USA,Kelantan,4,2,2
2022-06-01,USA,Melaka,3,3,0
2022-06-01,USA,Negeri Sembilan,0,0,0
2022-06-01,USA,Pahang,3,3,0
2022-06-01,USA,Perak,42,24,18
2022-06-01,USA,Perlis,25,16,9
2022-06-01,USA,Pulau Pinang,1072,686,386
2022-06-01,USA,Sabah,179,95,84
2022-06-01,USA,Sarawak,87,52,35
2022-06-01,USA,Selangor,8380,4950,3430
2022-06-01,USA,Terengganu,0,0,0
2022-06-01,USA,W.P. Labuan,0,0,0
2022-06-01,UZB,Johor,25,13,12
2022-06-01,UZB,Kedah,0,0,0
2022-06-01,UZB,Kelantan,0,0,0
2022-06-01,UZB,Perak,0,0,0
2022-06-01,UZB,Perlis,3,0,3
2022-06-01,UZB,Pulau Pinang,0,0,0
2022-06-01,UZB,Sabah,0,0,0
2022-06-01,UZB,Sarawak,0,0,0
2022-06-01,UZB,Selangor,214,93,121
2022-06-01,VAT,Johor,1,1,0
2022-06-01,VAT,Sarawak,0,0,0
2022-06-01,VAT,Selangor,0,0,0
2022-06-01,VCT,Johor,0,0,0
2022-06-01,VCT,Kedah,0,0,0
2022-06-01,VCT,Pulau Pinang,0,0,0
2022-06-01,VCT,Sarawak,0,0,0
2022-06-01,VCT,Selangor,0,0,0
2022-06-01,VEN,Johor,7,5,2
2022-06-01,VEN,Kedah,1,1,0
2022-06-01,VEN,Kelantan,0,0,0
2022-06-01,VEN,Melaka,0,0,0
2022-06-01,VEN,Perak,0,0,0
2022-06-01,VEN,Perlis,0,0,0
2022-06-01,VEN,Pulau Pinang,0,0,0
2022-06-01,VEN,Sabah,0,0,0
2022-06-01,VEN,Sarawak,0,0,0
2022-06-01,VEN,Selangor,36,25,11
2022-06-01,VEN,W.P. Labuan,0,0,0
2022-06-01,VNM,Johor,9803,3265,6538
2022-06-01,VNM,Kedah,198,30,168
2022-06-01,VNM,Kelantan,6,6,0
2022-06-01,VNM,Melaka,0,0,0
2022-06-01,VNM,Negeri Sembilan,0,0,0
2022-06-01,VNM,Pahang,0,0,0
2022-06-01,VNM,Perak,44,9,35
2022-06-01,VNM,Perlis,6,4,2
2022-06-01,VNM,Pulau Pinang,685,150,535
2022-06-01,VNM,Sabah,18,7,11
2022-06-01,VNM,Sarawak,27,4,23
2022-06-01,VNM,Selangor,10157,3087,7070
2022-06-01,VNM,Terengganu,0,0,0
2022-06-01,VNM,W.P. Labuan,0,0,0
2022-06-01,VUT,Johor,13,10,3
2022-06-01,VUT,Kedah,1,1,0
2022-06-01,VUT,Pulau Pinang,0,0,0
2022-06-01,VUT,Sabah,0,0,0
2022-06-01,VUT,Sarawak,0,0,0
2022-06-01,VUT,Selangor,25,22,3
2022-06-01,WSM,Johor,0,0,0
2022-06-01,WSM,Sarawak,0,0,0
2022-06-01,WSM,Selangor,1,0,1
2022-06-01,XXX,Johor,103,60,43
2022-06-01,XXX,Kedah,5,1,4
2022-06-01,XXX,Kelantan,0,0,0
2022-06-01,XXX,Melaka,0,0,0
2022-06-01,XXX,Pahang,0,0,0
2022-06-01,XXX,Perak,1,0,1
2022-06-01,XXX,Perlis,2,1,1
2022-06-01,XXX,Pulau Pinang,15,10,5
2022-06-01,XXX,Sabah,5,3,2
2022-06-01,XXX,Sarawak,5,3,2
2022-06-01,XXX,Selangor,205,117,88
2022-06-01,XXX,W.P. Labuan,0,0,0
2022-06-01,YEM,Johor,29,22,7
2022-06-01,YEM,Kedah,2,2,0
2022-06-01,YEM,Kelantan,0,0,0
2022-06-01,YEM,Melaka,0,0,0
2022-06-01,YEM,Pahang,0,0,0
2022-06-01,YEM,Perak,0,0,0
2022-06-01,YEM,Perlis,0,0,0
2022-06-01,YEM,Pulau Pinang,0,0,0
2022-06-01,YEM,Sabah,0,0,0
2022-06-01,YEM,Sarawak,0,0,0
2022-06-01,YEM,Selangor,1150,743,407
2022-06-01,YEM,W.P. Labuan,0,0,0
2022-06-01,ZAF,Johor,168,104,64
2022-06-01,ZAF,Kedah,17,8,9
2022-06-01,ZAF,Kelantan,2,1,1
2022-06-01,ZAF,Melaka,2,1,1
2022-06-01,ZAF,Pahang,0,0,0
2022-06-01,ZAF,Perak,1,1,0
2022-06-01,ZAF,Perlis,7,5,2
2022-06-01,ZAF,Pulau Pinang,19,13,6
2022-06-01,ZAF,Sabah,6,4,2
2022-06-01,ZAF,Sarawak,11,8,3
2022-06-01,ZAF,Selangor,514,295,219
2022-06-01,ZAF,Terengganu,0,0,0
2022-06-01,ZAF,W.P. Labuan,0,0,0
2022-06-01,ZAR,Selangor,0,0,0
2022-06-01,ZMB,Johor,1,1,0
2022-06-01,ZMB,Kedah,0,0,0
2022-06-01,ZMB,Perak,0,0,0
2022-06-01,ZMB,Perlis,0,0,0
2022-06-01,ZMB,Pulau Pinang,0,0,0
2022-06-01,ZMB,Sabah,0,0,0
2022-06-01,ZMB,Sarawak,0,0,0
2022-06-01,ZMB,Selangor,37,20,17
2022-06-01,ZWE,Johor,3,2,1
2022-06-01,ZWE,Kedah,0,0,0
2022-06-01,ZWE,Kelantan,0,0,0
2022-06-01,ZWE,Perak,0,0,0
2022-06-01,ZWE,Perlis,0,0,0
2022-06-01,ZWE,Pulau Pinang,2,0,2
2022-06-01,ZWE,Sabah,0,0,0
2022-06-01,ZWE,Sarawak,0,0,0
2022-06-01,ZWE,Selangor,66,33,33
2022-07-01,ABW,Kedah,0,0,0
2022-07-01,ABW,Pulau Pinang,0,0,0
2022-07-01,AFG,Johor,1,1,0
2022-07-01,AFG,Kedah,0,0,0
2022-07-01,AFG,Perlis,0,0,0
2022-07-01,AFG,Pulau Pinang,0,0,0
2022-07-01,AFG,Sarawak,1,1,0
2022-07-01,AFG,Selangor,61,42,19
2022-07-01,AGO,Johor,0,0,0
2022-07-01,AGO,Kedah,0,0,0
2022-07-01,AGO,Sabah,0,0,0
2022-07-01,AGO,Selangor,1,0,1
2022-07-01,AIA,Selangor,0,0,0
2022-07-01,ALB,Johor,11,5,6
2022-07-01,ALB,Kedah,0,0,0
2022-07-01,ALB,Perak,0,0,0
2022-07-01,ALB,Perlis,0,0,0
2022-07-01,ALB,Pulau Pinang,2,2,0
2022-07-01,ALB,Sabah,0,0,0
2022-07-01,ALB,Sarawak,0,0,0
2022-07-01,ALB,Selangor,20,13,7
2022-07-01,AND,Johor,1,0,1
2022-07-01,AND,Kedah,1,1,0
2022-07-01,AND,Perlis,0,0,0
2022-07-01,AND,Pulau Pinang,0,0,0
2022-07-01,AND,Selangor,3,1,2
2022-07-01,ANT,Selangor,0,0,0
2022-07-01,ARE,Johor,37,18,19
2022-07-01,ARE,Kedah,15,6,9
2022-07-01,ARE,Kelantan,0,0,0
2022-07-01,ARE,Perak,0,0,0
2022-07-01,ARE,Perlis,1,1,0
2022-07-01,ARE,Pulau Pinang,5,3,2
2022-07-01,ARE,Sabah,1,1,0
2022-07-01,ARE,Sarawak,2,2,0
2022-07-01,ARE,Selangor,650,340,310
2022-07-01,ARG,Johor,59,31,28
2022-07-01,ARG,Kedah,8,5,3
2022-07-01,ARG,Kelantan,0,0,0
2022-07-01,ARG,Melaka,0,0,0
2022-07-01,ARG,Perak,0,0,0
2022-07-01,ARG,Perlis,1,1,0
2022-07-01,ARG,Pulau Pinang,5,3,2
2022-07-01,ARG,Sabah,5,1,4
2022-07-01,ARG,Sarawak,3,0,3
2022-07-01,ARG,Selangor,201,123,78
2022-07-01,ARG,W.P. Labuan,0,0,0
2022-07-01,ARM,Johor,7,1,6
2022-07-01,ARM,Kedah,0,0,0
2022-07-01,ARM,Kelantan,0,0,0
2022-07-01,ARM,Perak,0,0,0
2022-07-01,ARM,Perlis,0,0,0
2022-07-01,ARM,Pulau Pinang,0,0,0
2022-07-01,ARM,Sabah,0,0,0
2022-07-01,ARM,Sarawak,0,0,0
2022-07-01,ARM,Selangor,25,16,9
2022-07-01,ATA,Selangor,0,0,0
2022-07-01,ATG,Johor,0,0,0
2022-07-01,ATG,Kedah,0,0,0
2022-07-01,ATG,Pulau Pinang,0,0,0
2022-07-01,ATG,Sarawak,0,0,0
2022-07-01,ATG,Selangor,9,6,3
2022-07-01,AUS,Johor,3909,2355,1554
2022-07-01,AUS,Kedah,386,212,174
2022-07-01,AUS,Kelantan,3,2,1
2022-07-01,AUS,Melaka,0,0,0
2022-07-01,AUS,Negeri Sembilan,0,0,0
2022-07-01,AUS,Pahang,3,3,0
2022-07-01,AUS,Perak,203,114,89
2022-07-01,AUS,Perlis,44,24,20
2022-07-01,AUS,Pulau Pinang,1348,715,633
2022-07-01,AUS,Sabah,387,220,167
2022-07-01,AUS,Sarawak,384,214,170
2022-07-01,AUS,Selangor,12143,7141,5002
2022-07-01,AUS,Terengganu,0,0,0
2022-07-01,AUS,W.P. Labuan,0,0,0
2022-07-01,AUT,Johor,146,97,49
2022-07-01,AUT,Kedah,17,12,5
2022-07-01,AUT,Kelantan,1,1,0
2022-07-01,AUT,Melaka,0,0,0
2022-07-01,AUT,Negeri Sembilan,0,0,0
2022-07-01,AUT,Pahang,0,0,0
2022-07-01,AUT,Perak,4,4,0
2022-07-01,AUT,Perlis,11,6,5
2022-07-01,AUT,Pulau Pinang,48,36,12
2022-07-01,AUT,Sabah,18,12,6
2022-07-01,AUT,Sarawak,17,9,8
2022-07-01,AUT,Selangor,677,413,264
2022-07-01,AUT,Terengganu,0,0,0
2022-07-01,AUT,W.P. Labuan,0,0,0
2022-07-01,AZE,Johor,2,1,1
2022-07-01,AZE,Kedah,1,1,0
2022-07-01,AZE,Kelantan,0,0,0
2022-07-01,AZE,Melaka,0,0,0
2022-07-01,AZE,Perlis,0,0,0
2022-07-01,AZE,Pulau Pinang,0,0,0
2022-07-01,AZE,Sabah,0,0,0
2022-07-01,AZE,Sarawak,0,0,0
2022-07-01,AZE,Selangor,57,34,23
2022-07-01,AZE,W.P. Labuan,0,0,0
2022-07-01,BDI,Pulau Pinang,0,0,0
2022-07-01,BDI,Sarawak,0,0,0
2022-07-01,BDI,Selangor,2,1,1
2022-07-01,BEL,Johor,223,133,90
2022-07-01,BEL,Kedah,25,14,11
2022-07-01,BEL,Kelantan,2,0,2
2022-07-01,BEL,Melaka,0,0,0
2022-07-01,BEL,Negeri Sembilan,0,0,0
2022-07-01,BEL,Pahang,0,0,0
2022-07-01,BEL,Perak,8,5,3
2022-07-01,BEL,Perlis,2,2,0
2022-07-01,BEL,Pulau Pinang,59,36,23
2022-07-01,BEL,Sabah,42,23,19
2022-07-01,BEL,Sarawak,17,8,9
2022-07-01,BEL,Selangor,1169,658,511
2022-07-01,BEL,W.P. Labuan,0,0,0
2022-07-01,BEN,Johor,1,1,0
2022-07-01,BEN,Kedah,0,0,0
2022-07-01,BEN,Perak,0,0,0
2022-07-01,BEN,Pulau Pinang,0,0,0
2022-07-01,BEN,Sabah,0,0,0
2022-07-01,BEN,Sarawak,0,0,0
2022-07-01,BEN,Selangor,5,4,1
2022-07-01,BFA,Perak,0,0,0
2022-07-01,BFA,Pulau Pinang,0,0,0
2022-07-01,BFA,Selangor,4,4,0
2022-07-01,BGD,Johor,1656,1366,290
2022-07-01,BGD,Kedah,40,23,17
2022-07-01,BGD,Kelantan,0,0,0
2022-07-01,BGD,Melaka,0,0,0
2022-07-01,BGD,Negeri Sembilan,0,0,0
2022-07-01,BGD,Pahang,0,0,0
2022-07-01,BGD,Perak,0,0,0
2022-07-01,BGD,Perlis,1,1,0
2022-07-01,BGD,Pulau Pinang,82,77,5
2022-07-01,BGD,Sabah,3,2,1
2022-07-01,BGD,Sarawak,2,1,1
2022-07-01,BGD,Selangor,16380,14386,1994
2022-07-01,BGD,W.P. Labuan,0,0,0
2022-07-01,BGR,Johor,31,16,15
2022-07-01,BGR,Kedah,1,0,1
2022-07-01,BGR,Kelantan,0,0,0
2022-07-01,BGR,Pahang,0,0,0
2022-07-01,BGR,Perak,1,1,0
2022-07-01,BGR,Perlis,0,0,0
2022-07-01,BGR,Pulau Pinang,0,0,0
2022-07-01,BGR,Sabah,1,0,1
2022-07-01,BGR,Sarawak,1,1,0
2022-07-01,BGR,Selangor,84,50,34
2022-07-01,BGR,W.P. Labuan,0,0,0
2022-07-01,BHR,Johor,38,20,18
2022-07-01,BHR,Kedah,0,0,0
2022-07-01,BHR,Kelantan,0,0,0
2022-07-01,BHR,Perlis,1,1,0
2022-07-01,BHR,Pulau Pinang,0,0,0
2022-07-01,BHR,Sabah,0,0,0
2022-07-01,BHR,Sarawak,0,0,0
2022-07-01,BHR,Selangor,192,88,104
2022-07-01,BHS,Johor,0,0,0
2022-07-01,BHS,Kedah,2,1,1
2022-07-01,BHS,Perak,1,0,1
2022-07-01,BHS,Sabah,0,0,0
2022-07-01,BHS,Sarawak,0,0,0
2022-07-01,BHS,Selangor,3,1,2
2022-07-01,BIH,Johor,5,3,2
2022-07-01,BIH,Kedah,1,1,0
2022-07-01,BIH,Perlis,0,0,0
2022-07-01,BIH,Pulau Pinang,0,0,0
2022-07-01,BIH,Sabah,0,0,0
2022-07-01,BIH,Sarawak,0,0,0
2022-07-01,BIH,Selangor,36,22,14
2022-07-01,BLR,Johor,6,5,1
2022-07-01,BLR,Kedah,0,0,0
2022-07-01,BLR,Kelantan,0,0,0
2022-07-01,BLR,Pahang,0,0,0
2022-07-01,BLR,Perak,2,1,1
2022-07-01,BLR,Perlis,0,0,0
2022-07-01,BLR,Pulau Pinang,2,1,1
2022-07-01,BLR,Sabah,3,1,2
2022-07-01,BLR,Sarawak,0,0,0
2022-07-01,BLR,Selangor,76,36,40
2022-07-01,BLR,W.P. Labuan,0,0,0
2022-07-01,BLZ,Johor,0,0,0
2022-07-01,BLZ,Pulau Pinang,0,0,0
2022-07-01,BLZ,Sarawak,0,0,0
2022-07-01,BLZ,Selangor,7,2,5
2022-07-01,BMU,Selangor,0,0,0
2022-07-01,BOL,Johor,0,0,0
2022-07-01,BOL,Kedah,0,0,0
2022-07-01,BOL,Melaka,0,0,0
2022-07-01,BOL,Perak,0,0,0
2022-07-01,BOL,Perlis,0,0,0
2022-07-01,BOL,Pulau Pinang,0,0,0
2022-07-01,BOL,Sabah,0,0,0
2022-07-01,BOL,Sarawak,5,3,2
2022-07-01,BOL,Selangor,7,5,2
2022-07-01,BRA,Johor,201,113,88
2022-07-01,BRA,Kedah,30,14,16
2022-07-01,BRA,Kelantan,1,0,1
2022-07-01,BRA,Melaka,2,2,0
2022-07-01,BRA,Pahang,0,0,0
2022-07-01,BRA,Perak,5,2,3
2022-07-01,BRA,Perlis,3,3,0
2022-07-01,BRA,Pulau Pinang,23,18,5
2022-07-01,BRA,Sabah,5,4,1
2022-07-01,BRA,Sarawak,1,1,0
2022-07-01,BRA,Selangor,498,272,226
2022-07-01,BRA,W.P. Labuan,0,0,0
2022-07-01,BRB,Johor,1,0,1
2022-07-01,BRB,Kedah,0,0,0
2022-07-01,BRB,Perlis,0,0,0
2022-07-01,BRB,Pulau Pinang,0,0,0
2022-07-01,BRB,Selangor,2,0,2
2022-07-01,BRN,Johor,198,112,86
2022-07-01,BRN,Kedah,1,1,0
2022-07-01,BRN,Kelantan,0,0,0
2022-07-01,BRN,Melaka,0,0,0
2022-07-01,BRN,Pahang,0,0,0
2022-07-01,BRN,Perak,1,1,0
2022-07-01,BRN,Perlis,9,3,6
2022-07-01,BRN,Pulau Pinang,3,2,1
2022-07-01,BRN,Sabah,889,443,446
2022-07-01,BRN,Sarawak,6462,3682,2780
2022-07-01,BRN,Selangor,2978,1542,1436
2022-07-01,BRN,W.P. Labuan,53,26,27
2022-07-01,BTN,Johor,0,0,0
2022-07-01,BTN,Kedah,1,1,0
2022-07-01,BTN,Perak,0,0,0
2022-07-01,BTN,Perlis,0,0,0
2022-07-01,BTN,Pulau Pinang,0,0,0
2022-07-01,BTN,Sabah,0,0,0
2022-07-01,BTN,Sarawak,0,0,0
2022-07-01,BTN,Selangor,42,25,17
2022-07-01,BWA,Johor,1,1,0
2022-07-01,BWA,Kedah,0,0,0
2022-07-01,BWA,Perlis,0,0,0
2022-07-01,BWA,Pulau Pinang,0,0,0
2022-07-01,BWA,Sabah,0,0,0
2022-07-01,BWA,Sarawak,0,0,0
2022-07-01,BWA,Selangor,12,4,8
2022-07-01,CAF,Kedah,0,0,0
2022-07-01,CAF,Selangor,0,0,0
2022-07-01,CAN,Johor,788,482,306
2022-07-01,CAN,Kedah,57,30,27
2022-07-01,CAN,Kelantan,0,0,0
2022-07-01,CAN,Melaka,0,0,0
2022-07-01,CAN,Negeri Sembilan,0,0,0
2022-07-01,CAN,Pahang,5,1,4
2022-07-01,CAN,Perak,23,13,10
2022-07-01,CAN,Perlis,16,12,4
2022-07-01,CAN,Pulau Pinang,168,94,74
2022-07-01,CAN,Sabah,62,28,34
2022-07-01,CAN,Sarawak,51,33,18
2022-07-01,CAN,Selangor,2517,1461,1056
2022-07-01,CAN,Terengganu,0,0,0
2022-07-01,CAN,W.P. Labuan,1,1,0
2022-07-01,CCK,Selangor,0,0,0
2022-07-01,CHE,Johor,385,224,161
2022-07-01,CHE,Kedah,56,30,26
2022-07-01,CHE,Kelantan,5,4,1
2022-07-01,CHE,Melaka,0,0,0
2022-07-01,CHE,Negeri Sembilan,0,0,0
2022-07-01,CHE,Pahang,2,2,0
2022-07-01,CHE,Perak,5,3,2
2022-07-01,CHE,Perlis,11,6,5
2022-07-01,CHE,Pulau Pinang,94,58,36
2022-07-01,CHE,Sabah,49,22,27
2022-07-01,CHE,Sarawak,42,25,17
2022-07-01,CHE,Selangor,1235,705,530
2022-07-01,CHE,W.P. Labuan,1,1,0
2022-07-01,CHL,Johor,20,13,7
2022-07-01,CHL,Kedah,5,2,3
2022-07-01,CHL,Kelantan,0,0,0
2022-07-01,CHL,Melaka,0,0,0
2022-07-01,CHL,Pahang,0,0,0
2022-07-01,CHL,Perak,0,0,0
2022-07-01,CHL,Perlis,1,1,0
2022-07-01,CHL,Pulau Pinang,4,3,1
2022-07-01,CHL,Sabah,0,0,0
2022-07-01,CHL,Sarawak,0,0,0
2022-07-01,CHL,Selangor,114,62,52
2022-07-01,CHN,Johor,18366,7545,10821
2022-07-01,CHN,Kedah,341,143,198
2022-07-01,CHN,Kelantan,5,0,5
2022-07-01,CHN,Melaka,1,1,0
2022-07-01,CHN,Pahang,3,3,0
2022-07-01,CHN,Perak,144,73,71
2022-07-01,CHN,Perlis,44,27,17
2022-07-01,CHN,Pulau Pinang,1048,524,524
2022-07-01,CHN,Sabah,308,122,186
2022-07-01,CHN,Sarawak,141,62,79
2022-07-01,CHN,Selangor,9849,5931,3918
2022-07-01,CHN,Terengganu,0,0,0
2022-07-01,CHN,W.P. Labuan,0,0,0
2022-07-01,CIV,Johor,0,0,0
2022-07-01,CIV,Kedah,0,0,0
2022-07-01,CIV,Pulau Pinang,0,0,0
2022-07-01,CIV,Sabah,0,0,0
2022-07-01,CIV,Sarawak,1,0,1
2022-07-01,CIV,Selangor,16,11,5
2022-07-01,CMR,Johor,2,2,0
2022-07-01,CMR,Kedah,0,0,0
2022-07-01,CMR,Pulau Pinang,1,1,0
2022-07-01,CMR,Sabah,0,0,0
2022-07-01,CMR,Sarawak,1,1,0
2022-07-01,CMR,Selangor,16,13,3
2022-07-01,COD,Johor,0,0,0
2022-07-01,COD,Pulau Pinang,0,0,0
2022-07-01,COD,Sarawak,0,0,0
2022-07-01,COD,Selangor,6,1,5
2022-07-01,COG,Johor,0,0,0
2022-07-01,COG,Kedah,0,0,0
2022-07-01,COG,Selangor,0,0,0
2022-07-01,COK,Selangor,0,0,0
2022-07-01,COL,Johor,27,11,16
2022-07-01,COL,Kedah,2,0,2
2022-07-01,COL,Perak,0,0,0
2022-07-01,COL,Pulau Pinang,5,2,3
2022-07-01,COL,Sabah,2,2,0
2022-07-01,COL,Sarawak,2,2,0
2022-07-01,COL,Selangor,88,41,47
2022-07-01,COL,W.P. Labuan,0,0,0
2022-07-01,COM,Johor,0,0,0
2022-07-01,COM,Kedah,0,0,0
2022-07-01,COM,Selangor,2,1,1
2022-07-01,CPV,Johor,0,0,0
2022-07-01,CPV,Kedah,0,0,0
2022-07-01,CPV,Pulau Pinang,0,0,0
2022-07-01,CPV,Sabah,0,0,0
2022-07-01,CPV,Selangor,1,1,0
2022-07-01,CRI,Johor,11,6,5
2022-07-01,CRI,Kedah,0,0,0
2022-07-01,CRI,Perak,0,0,0
2022-07-01,CRI,Perlis,0,0,0
2022-07-01,CRI,Pulau Pinang,6,1,5
2022-07-01,CRI,Sabah,0,0,0
2022-07-01,CRI,Sarawak,0,0,0
2022-07-01,CRI,Selangor,27,12,15
2022-07-01,CUB,Johor,10,7,3
2022-07-01,CUB,Kedah,0,0,0
2022-07-01,CUB,Perlis,0,0,0
2022-07-01,CUB,Pulau Pinang,0,0,0
2022-07-01,CUB,Sabah,0,0,0
2022-07-01,CUB,Sarawak,2,1,1
2022-07-01,CUB,Selangor,11,5,6
2022-07-01,CYP,Johor,11,9,2
2022-07-01,CYP,Kedah,4,2,2
2022-07-01,CYP,Perak,2,2,0
2022-07-01,CYP,Perlis,0,0,0
2022-07-01,CYP,Pulau Pinang,1,0,1
2022-07-01,CYP,Sabah,3,2,1
2022-07-01,CYP,Sarawak,0,0,0
2022-07-01,CYP,Selangor,43,27,16
2022-07-01,CZE,Johor,85,56,29
2022-07-01,CZE,Kedah,20,9,11
2022-07-01,CZE,Kelantan,5,3,2
2022-07-01,CZE,Melaka,0,0,0
2022-07-01,CZE,Negeri Sembilan,0,0,0
2022-07-01,CZE,Perak,2,1,1
2022-07-01,CZE,Perlis,4,3,1
2022-07-01,CZE,Pulau Pinang,19,12,7
2022-07-01,CZE,Sabah,8,4,4
2022-07-01,CZE,Sarawak,16,8,8
2022-07-01,CZE,Selangor,375,201,174
2022-07-01,CZE,W.P. Labuan,0,0,0
2022-07-01,DEU,Johor,1486,981,505
2022-07-01,DEU,Kedah,245,130,115
2022-07-01,DEU,Kelantan,16,10,6
2022-07-01,DEU,Melaka,0,0,0
2022-07-01,DEU,Negeri Sembilan,0,0,0
2022-07-01,DEU,Pahang,1,1,0
2022-07-01,DEU,Perak,24,18,6
2022-07-01,DEU,Perlis,58,38,20
2022-07-01,DEU,Pulau Pinang,412,307,105
2022-07-01,DEU,Sabah,124,72,52
2022-07-01,DEU,Sarawak,125,74,51
2022-07-01,DEU,Selangor,5314,3167,2147
2022-07-01,DEU,Terengganu,0,0,0
2022-07-01,DEU,W.P. Labuan,1,1,0
2022-07-01,DJI,Johor,0,0,0
2022-07-01,DJI,Selangor,1,0,1
2022-07-01,DMA,Johor,3,3,0
2022-07-01,DMA,Kedah,0,0,0
2022-07-01,DMA,Pulau Pinang,1,1,0
2022-07-01,DMA,Sabah,0,0,0
2022-07-01,DMA,Sarawak,0,0,0
2022-07-01,DMA,Selangor,22,13,9
2022-07-01,DMA,W.P. Labuan,0,0,0
2022-07-01,DNK,Johor,235,130,105
2022-07-01,DNK,Kedah,32,16,16
2022-07-01,DNK,Kelantan,0,0,0
2022-07-01,DNK,Melaka,0,0,0
2022-07-01,DNK,Negeri Sembilan,0,0,0
2022-07-01,DNK,Pahang,0,0,0
2022-07-01,DNK,Perak,2,2,0
2022-07-01,DNK,Perlis,7,6,1
2022-07-01,DNK,Pulau Pinang,38,25,13
2022-07-01,DNK,Sabah,24,16,8
2022-07-01,DNK,Sarawak,27,17,10
2022-07-01,DNK,Selangor,1136,637,499
2022-07-01,DNK,W.P. Labuan,0,0,0
2022-07-01,DOM,Johor,2,0,2
2022-07-01,DOM,Kedah,0,0,0
2022-07-01,DOM,Perak,0,0,0
2022-07-01,DOM,Perlis,0,0,0
2022-07-01,DOM,Pulau Pinang,0,0,0
2022-07-01,DOM,Sabah,0,0,0
2022-07-01,DOM,Sarawak,0,0,0
2022-07-01,DOM,Selangor,15,10,5
2022-07-01,DZA,Johor,14,13,1
2022-07-01,DZA,Kedah,4,3,1
2022-07-01,DZA,Kelantan,0,0,0
2022-07-01,DZA,Melaka,0,0,0
2022-07-01,DZA,Perak,0,0,0
2022-07-01,DZA,Perlis,0,0,0
2022-07-01,DZA,Pulau Pinang,1,1,0
2022-07-01,DZA,Sabah,5,4,1
2022-07-01,DZA,Sarawak,1,1,0
2022-07-01,DZA,Selangor,264,144,120
2022-07-01,DZA,W.P. Labuan,0,0,0
2022-07-01,ECU,Johor,4,2,2
2022-07-01,ECU,Kedah,3,1,2
2022-07-01,ECU,Perak,0,0,0
2022-07-01,ECU,Perlis,0,0,0
2022-07-01,ECU,Pulau Pinang,0,0,0
2022-07-01,ECU,Sabah,0,0,0
2022-07-01,ECU,Sarawak,1,0,1
2022-07-01,ECU,Selangor,34,14,20
2022-07-01,EGY,Johor,140,112,28
2022-07-01,EGY,Kedah,7,4,3
2022-07-01,EGY,Kelantan,0,0,0
2022-07-01,EGY,Melaka,0,0,0
2022-07-01,EGY,Pahang,0,0,0
2022-07-01,EGY,Perak,0,0,0
2022-07-01,EGY,Perlis,0,0,0
2022-07-01,EGY,Pulau Pinang,12,6,6
2022-07-01,EGY,Sabah,12,8,4
2022-07-01,EGY,Sarawak,6,2,4
2022-07-01,EGY,Selangor,1113,666,447
2022-07-01,EGY,Terengganu,0,0,0
2022-07-01,EGY,W.P. Labuan,0,0,0
2022-07-01,ERI,Johor,1,0,1
2022-07-01,ERI,Pulau Pinang,0,0,0
2022-07-01,ERI,Sabah,0,0,0
2022-07-01,ERI,Selangor,7,5,2
2022-07-01,ESP,Johor,498,273,225
2022-07-01,ESP,Kedah,54,28,26
2022-07-01,ESP,Kelantan,10,4,6
2022-07-01,ESP,Melaka,0,0,0
2022-07-01,ESP,Negeri Sembilan,0,0,0
2022-07-01,ESP,Pahang,0,0,0
2022-07-01,ESP,Perak,12,8,4
2022-07-01,ESP,Perlis,10,5,5
2022-07-01,ESP,Pulau Pinang,141,69,72
2022-07-01,ESP,Sabah,41,23,18
2022-07-01,ESP,Sarawak,63,26,37
2022-07-01,ESP,Selangor,2916,1523,1393
2022-07-01,ESP,W.P. Labuan,0,0,0
2022-07-01,EST,Johor,5,3,2
2022-07-01,EST,Kedah,0,0,0
2022-07-01,EST,Kelantan,0,0,0
2022-07-01,EST,Pahang,0,0,0
2022-07-01,EST,Perak,1,1,0
2022-07-01,EST,Perlis,0,0,0
2022-07-01,EST,Pulau Pinang,2,0,2
2022-07-01,EST,Sabah,0,0,0
2022-07-01,EST,Sarawak,0,0,0
2022-07-01,EST,Selangor,31,16,15
2022-07-01,EST,W.P. Labuan,0,0,0
2022-07-01,ETH,Johor,3,1,2
2022-07-01,ETH,Kedah,0,0,0
2022-07-01,ETH,Pulau Pinang,0,0,0
2022-07-01,ETH,Sarawak,0,0,0
2022-07-01,ETH,Selangor,34,16,18
2022-07-01,FIN,Johor,125,64,61
2022-07-01,FIN,Kedah,13,7,6
2022-07-01,FIN,Kelantan,0,0,0
2022-07-01,FIN,Melaka,0,0,0
2022-07-01,FIN,Negeri Sembilan,0,0,0
2022-07-01,FIN,Pahang,0,0,0
2022-07-01,FIN,Perak,0,0,0
2022-07-01,FIN,Perlis,0,0,0
2022-07-01,FIN,Pulau Pinang,16,9,7
2022-07-01,FIN,Sabah,0,0,0
2022-07-01,FIN,Sarawak,3,2,1
2022-07-01,FIN,Selangor,227,138,89
2022-07-01,FIN,W.P. Labuan,0,0,0
2022-07-01,FJI,Johor,54,24,30
2022-07-01,FJI,Kedah,1,1,0
2022-07-01,FJI,Kelantan,0,0,0
2022-07-01,FJI,Perak,0,0,0
2022-07-01,FJI,Perlis,0,0,0
2022-07-01,FJI,Pulau Pinang,0,0,0
2022-07-01,FJI,Sabah,0,0,0
2022-07-01,FJI,Sarawak,2,0,2
2022-07-01,FJI,Selangor,48,24,24
2022-07-01,FRA,Johor,2080,1212,868
2022-07-01,FRA,Kedah,159,92,67
2022-07-01,FRA,Kelantan,8,6,2
2022-07-01,FRA,Melaka,1,1,0
2022-07-01,FRA,Negeri Sembilan,0,0,0
2022-07-01,FRA,Pahang,4,3,1
2022-07-01,FRA,Perak,22,17,5
2022-07-01,FRA,Perlis,27,17,10
2022-07-01,FRA,Pulau Pinang,275,169,106
2022-07-01,FRA,Sabah,131,78,53
2022-07-01,FRA,Sarawak,136,73,63
2022-07-01,FRA,Selangor,6709,3780,2929
2022-07-01,FRA,Terengganu,0,0,0
2022-07-01,FRA,W.P. Labuan,0,0,0
2022-07-01,FSM,Johor,0,0,0
2022-07-01,FSM,Pulau Pinang,0,0,0
2022-07-01,FSM,Selangor,0,0,0
2022-07-01,GAB,Johor,0,0,0
2022-07-01,GAB,Pulau Pinang,0,0,0
2022-07-01,GAB,Sarawak,0,0,0
2022-07-01,GAB,Selangor,7,5,2
2022-07-01,GBR,Johor,3444,2214,1230
2022-07-01,GBR,Kedah,451,262,189
2022-07-01,GBR,Kelantan,7,4,3
2022-07-01,GBR,Melaka,1,1,0
2022-07-01,GBR,Negeri Sembilan,1,1,0
2022-07-01,GBR,Pahang,2,2,0
2022-07-01,GBR,Perak,97,56,41
2022-07-01,GBR,Perlis,120,68,52
2022-07-01,GBR,Pulau Pinang,898,538,360
2022-07-01,GBR,Sabah,601,328,273
2022-07-01,GBR,Sarawak,296,179,117
2022-07-01,GBR,Selangor,14178,8171,6007
2022-07-01,GBR,Terengganu,0,0,0
2022-07-01,GBR,W.P. Labuan,3,2,1
2022-07-01,GEO,Johor,2,2,0
2022-07-01,GEO,Kedah,0,0,0
2022-07-01,GEO,Melaka,0,0,0
2022-07-01,GEO,Perak,0,0,0
2022-07-01,GEO,Perlis,0,0,0
2022-07-01,GEO,Pulau Pinang,0,0,0
2022-07-01,GEO,Sabah,0,0,0
2022-07-01,GEO,Sarawak,0,0,0
2022-07-01,GEO,Selangor,17,10,7
2022-07-01,GHA,Johor,3,3,0
2022-07-01,GHA,Kedah,0,0,0
2022-07-01,GHA,Kelantan,0,0,0
2022-07-01,GHA,Pulau Pinang,0,0,0
2022-07-01,GHA,Sabah,0,0,0
2022-07-01,GHA,Sarawak,0,0,0
2022-07-01,GHA,Selangor,34,26,8
2022-07-01,GIB,Johor,0,0,0
2022-07-01,GIB,Sarawak,1,0,1
2022-07-01,GIN,Johor,0,0,0
2022-07-01,GIN,Kedah,0,0,0
2022-07-01,GIN,Kelantan,0,0,0
2022-07-01,GIN,Perlis,0,0,0
2022-07-01,GIN,Pulau Pinang,0,0,0
2022-07-01,GIN,Sabah,0,0,0
2022-07-01,GIN,Sarawak,0,0,0
2022-07-01,GIN,Selangor,23,19,4
2022-07-01,GLP,Selangor,0,0,0
2022-07-01,GMB,Johor,0,0,0
2022-07-01,GMB,Kedah,0,0,0
2022-07-01,GMB,Kelantan,0,0,0
2022-07-01,GMB,Pulau Pinang,0,0,0
2022-07-01,GMB,Sabah,0,0,0
2022-07-01,GMB,Sarawak,0,0,0
2022-07-01,GMB,Selangor,6,3,3
2022-07-01,GNB,Johor,0,0,0
2022-07-01,GNB,Selangor,0,0,0
2022-07-01,GNQ,Johor,0,0,0
2022-07-01,GNQ,Selangor,1,1,0
2022-07-01,GRC,Johor,22,16,6
2022-07-01,GRC,Kedah,10,8,2
2022-07-01,GRC,Kelantan,1,0,1
2022-07-01,GRC,Melaka,0,0,0
2022-07-01,GRC,Negeri Sembilan,0,0,0
2022-07-01,GRC,Pahang,0,0,0
2022-07-01,GRC,Perak,0,0,0
2022-07-01,GRC,Perlis,1,0,1
2022-07-01,GRC,Pulau Pinang,2,2,0
2022-07-01,GRC,Sabah,2,1,1
2022-07-01,GRC,Sarawak,3,3,0
2022-07-01,GRC,Selangor,105,71,34
2022-07-01,GRD,Johor,5,2,3
2022-07-01,GRD,Kedah,0,0,0
2022-07-01,GRD,Pulau Pinang,0,0,0
2022-07-01,GRD,Sabah,0,0,0
2022-07-01,GRD,Sarawak,0,0,0
2022-07-01,GRD,Selangor,10,5,5
2022-07-01,GRL,Johor,0,0,0
2022-07-01,GRL,Selangor,0,0,0
2022-07-01,GTM,Johor,1,0,1
2022-07-01,GTM,Kedah,0,0,0
2022-07-01,GTM,Pahang,0,0,0
2022-07-01,GTM,Perak,0,0,0
2022-07-01,GTM,Pulau Pinang,0,0,0
2022-07-01,GTM,Sabah,0,0,0
2022-07-01,GTM,Sarawak,0,0,0
2022-07-01,GTM,Selangor,9,7,2
2022-07-01,GTM,W.P. Labuan,0,0,0
2022-07-01,GUY,Johor,0,0,0
2022-07-01,GUY,Kedah,0,0,0
2022-07-01,GUY,Pulau Pinang,0,0,0
2022-07-01,GUY,Sarawak,0,0,0
2022-07-01,GUY,Selangor,1,0,1
2022-07-01,HKG,Johor,0,0,0
2022-07-01,HKG,Kedah,0,0,0
2022-07-01,HKG,Kelantan,0,0,0
2022-07-01,HKG,Pahang,0,0,0
2022-07-01,HKG,Perak,33,10,23
2022-07-01,HKG,Perlis,1,1,0
2022-07-01,HKG,Pulau Pinang,12,8,4
2022-07-01,HKG,Sabah,53,27,26
2022-07-01,HKG,Sarawak,42,23,19
2022-07-01,HKG,Selangor,12,7,5
2022-07-01,HKG,Terengganu,0,0,0
2022-07-01,HMD,Johor,0,0,0
2022-07-01,HND,Johor,4,0,4
2022-07-01,HND,Kedah,0,0,0
2022-07-01,HND,Perak,0,0,0
2022-07-01,HND,Pulau Pinang,0,0,0
2022-07-01,HND,Sabah,0,0,0
2022-07-01,HND,Sarawak,0,0,0
2022-07-01,HND,Selangor,10,7,3
2022-07-01,HRV,Johor,25,16,9
2022-07-01,HRV,Kedah,1,0,1
2022-07-01,HRV,Kelantan,0,0,0
2022-07-01,HRV,Melaka,0,0,0
2022-07-01,HRV,Pahang,0,0,0
2022-07-01,HRV,Perak,0,0,0
2022-07-01,HRV,Perlis,0,0,0
2022-07-01,HRV,Pulau Pinang,2,1,1
2022-07-01,HRV,Sabah,3,3,0
2022-07-01,HRV,Sarawak,0,0,0
2022-07-01,HRV,Selangor,96,66,30
2022-07-01,HTI,Johor,5,4,1
2022-07-01,HTI,Kedah,0,0,0
2022-07-01,HTI,Kelantan,0,0,0
2022-07-01,HTI,Perak,0,0,0
2022-07-01,HTI,Pulau Pinang,0,0,0
2022-07-01,HTI,Sabah,0,0,0
2022-07-01,HTI,Selangor,7,4,3
2022-07-01,HUN,Johor,64,50,14
2022-07-01,HUN,Kedah,13,4,9
2022-07-01,HUN,Kelantan,0,0,0
2022-07-01,HUN,Pahang,0,0,0
2022-07-01,HUN,Perak,2,2,0
2022-07-01,HUN,Perlis,3,3,0
2022-07-01,HUN,Pulau Pinang,19,11,8
2022-07-01,HUN,Sabah,9,5,4
2022-07-01,HUN,Sarawak,8,3,5
2022-07-01,HUN,Selangor,234,126,108
2022-07-01,HUN,W.P. Labuan,0,0,0
2022-07-01,IDN,Johor,84876,45924,38952
2022-07-01,IDN,Kedah,1658,661,997
2022-07-01,IDN,Kelantan,89,53,36
2022-07-01,IDN,Melaka,6231,2663,3568
2022-07-01,IDN,Negeri Sembilan,6081,4051,2030
2022-07-01,IDN,Pahang,7,6,1
2022-07-01,IDN,Perak,127,46,81
2022-07-01,IDN,Perlis,140,62,78
2022-07-01,IDN,Pulau Pinang,18153,7138,11015
2022-07-01,IDN,Sabah,3963,1890,2073
2022-07-01,IDN,Sarawak,23710,13814,9896
2022-07-01,IDN,Selangor,45541,21372,24169
2022-07-01,IDN,Terengganu,0,0,0
2022-07-01,IDN,W.P. Labuan,2,2,0
2022-07-01,IND,Johor,12385,8784,3601
2022-07-01,IND,Kedah,477,271,206
2022-07-01,IND,Kelantan,8,6,2
2022-07-01,IND,Melaka,0,0,0
2022-07-01,IND,Negeri Sembilan,0,0,0
2022-07-01,IND,Pahang,0,0,0
2022-07-01,IND,Perak,643,542,101
2022-07-01,IND,Perlis,117,101,16
2022-07-01,IND,Pulau Pinang,659,464,195
2022-07-01,IND,Sabah,180,119,61
2022-07-01,IND,Sarawak,93,70,23
2022-07-01,IND,Selangor,38269,28244,10025
2022-07-01,IND,Terengganu,0,0,0
2022-07-01,IND,W.P. Labuan,0,0,0
2022-07-01,IOT,Pulau Pinang,0,0,0
2022-07-01,IOT,Selangor,0,0,0
2022-07-01,IRL,Johor,253,160,93
2022-07-01,IRL,Kedah,21,11,10
2022-07-01,IRL,Kelantan,0,0,0
2022-07-01,IRL,Negeri Sembilan,0,0,0
2022-07-01,IRL,Pahang,0,0,0
2022-07-01,IRL,Perak,7,4,3
2022-07-01,IRL,Perlis,8,1,7
2022-07-01,IRL,Pulau Pinang,68,42,26
2022-07-01,IRL,Sabah,18,8,10
2022-07-01,IRL,Sarawak,14,8,6
2022-07-01,IRL,Selangor,973,547,426
2022-07-01,IRL,Terengganu,0,0,0
2022-07-01,IRL,W.P. Labuan,0,0,0
2022-07-01,IRN,Johor,152,88,64
2022-07-01,IRN,Kedah,3,1,2
2022-07-01,IRN,Kelantan,0,0,0
2022-07-01,IRN,Perak,0,0,0
2022-07-01,IRN,Perlis,1,1,0
2022-07-01,IRN,Pulau Pinang,3,1,2
2022-07-01,IRN,Sabah,4,3,1
2022-07-01,IRN,Sarawak,1,1,0
2022-07-01,IRN,Selangor,1417,737,680
2022-07-01,IRN,W.P. Labuan,0,0,0
2022-07-01,IRQ,Johor,17,16,1
2022-07-01,IRQ,Kedah,0,0,0
2022-07-01,IRQ,Kelantan,0,0,0
2022-07-01,IRQ,Melaka,0,0,0
2022-07-01,IRQ,Pahang,0,0,0
2022-07-01,IRQ,Perak,0,0,0
2022-07-01,IRQ,Perlis,0,0,0
2022-07-01,IRQ,Pulau Pinang,0,0,0
2022-07-01,IRQ,Sabah,0,0,0
2022-07-01,IRQ,Sarawak,0,0,0
2022-07-01,IRQ,Selangor,672,393,279
2022-07-01,ISL,Johor,0,0,0
2022-07-01,ISL,Kedah,0,0,0
2022-07-01,ISL,Kelantan,1,0,1
2022-07-01,ISL,Perak,2,1,1
2022-07-01,ISL,Perlis,0,0,0
2022-07-01,ISL,Pulau Pinang,3,1,2
2022-07-01,ISL,Sabah,0,0,0
2022-07-01,ISL,Sarawak,4,2,2
2022-07-01,ISL,Selangor,22,7,15
2022-07-01,ISL,W.P. Labuan,0,0,0
2022-07-01,ISR,Pulau Pinang,0,0,0
2022-07-01,ITA,Johor,468,305,163
2022-07-01,ITA,Kedah,34,23,11
2022-07-01,ITA,Kelantan,0,0,0
2022-07-01,ITA,Melaka,0,0,0
2022-07-01,ITA,Negeri Sembilan,0,0,0
2022-07-01,ITA,Pahang,0,0,0
2022-07-01,ITA,Perak,2,2,0
2022-07-01,ITA,Perlis,9,4,5
2022-07-01,ITA,Pulau Pinang,81,54,27
2022-07-01,ITA,Sabah,29,15,14
2022-07-01,ITA,Sarawak,27,16,11
2022-07-01,ITA,Selangor,1936,1219,717
2022-07-01,ITA,W.P. Labuan,0,0,0
2022-07-01,JAM,Johor,0,0,0
2022-07-01,JAM,Kedah,0,0,0
2022-07-01,JAM,Perak,0,0,0
2022-07-01,JAM,Pulau Pinang,0,0,0
2022-07-01,JAM,Sabah,0,0,0
2022-07-01,JAM,Sarawak,0,0,0
2022-07-01,JAM,Selangor,5,4,1
2022-07-01,JAM,W.P. Labuan,0,0,0
2022-07-01,JOR,Johor,15,10,5
2022-07-01,JOR,Kedah,1,1,0
2022-07-01,JOR,Kelantan,0,0,0
2022-07-01,JOR,Melaka,0,0,0
2022-07-01,JOR,Perlis,0,0,0
2022-07-01,JOR,Pulau Pinang,9,5,4
2022-07-01,JOR,Sabah,1,1,0
2022-07-01,JOR,Sarawak,1,1,0
2022-07-01,JOR,Selangor,602,378,224
2022-07-01,JOR,W.P. Labuan,0,0,0
2022-07-01,JPN,Johor,4233,3059,1174
2022-07-01,JPN,Kedah,99,56,43
2022-07-01,JPN,Kelantan,3,1,2
2022-07-01,JPN,Melaka,1,1,0
2022-07-01,JPN,Negeri Sembilan,2,0,2
2022-07-01,JPN,Pahang,0,0,0
2022-07-01,JPN,Perak,10,6,4
2022-07-01,JPN,Perlis,10,9,1
2022-07-01,JPN,Pulau Pinang,666,457,209
2022-07-01,JPN,Sabah,182,104,78
2022-07-01,JPN,Sarawak,59,34,25
2022-07-01,JPN,Selangor,8192,5378,2814
2022-07-01,JPN,W.P. Labuan,0,0,0
2022-07-01,KAZ,Johor,36,23,13
2022-07-01,KAZ,Kedah,2,0,2
2022-07-01,KAZ,Kelantan,1,1,0
2022-07-01,KAZ,Melaka,0,0,0
2022-07-01,KAZ,Perak,0,0,0
2022-07-01,KAZ,Perlis,0,0,0
2022-07-01,KAZ,Pulau Pinang,0,0,0
2022-07-01,KAZ,Sabah,1,1,0
2022-07-01,KAZ,Sarawak,0,0,0
2022-07-01,KAZ,Selangor,290,129,161
2022-07-01,KAZ,W.P. Labuan,0,0,0
2022-07-01,KEN,Johor,15,6,9
2022-07-01,KEN,Kedah,2,1,1
2022-07-01,KEN,Kelantan,0,0,0
2022-07-01,KEN,Perak,0,0,0
2022-07-01,KEN,Perlis,1,1,0
2022-07-01,KEN,Pulau Pinang,1,1,0
2022-07-01,KEN,Sabah,0,0,0
2022-07-01,KEN,Sarawak,0,0,0
2022-07-01,KEN,Selangor,170,90,80
2022-07-01,KGZ,Johor,7,3,4
2022-07-01,KGZ,Kedah,0,0,0
2022-07-01,KGZ,Kelantan,0,0,0
2022-07-01,KGZ,Perak,0,0,0
2022-07-01,KGZ,Perlis,0,0,0
2022-07-01,KGZ,Pulau Pinang,0,0,0
2022-07-01,KGZ,Sabah,0,0,0
2022-07-01,KGZ,Sarawak,0,0,0
2022-07-01,KGZ,Selangor,136,79,57
2022-07-01,KHM,Johor,1025,424,601
2022-07-01,KHM,Kedah,997,635,362
2022-07-01,KHM,Kelantan,216,124,92
2022-07-01,KHM,Melaka,1,0,1
2022-07-01,KHM,Negeri Sembilan,0,0,0
2022-07-01,KHM,Pahang,0,0,0
2022-07-01,KHM,Perak,17,16,1
2022-07-01,KHM,Perlis,312,223,89
2022-07-01,KHM,Pulau Pinang,39,16,23
2022-07-01,KHM,Sabah,2,0,2
2022-07-01,KHM,Sarawak,6,5,1
2022-07-01,KHM,Selangor,3060,1468,1592
2022-07-01,KHM,W.P. Labuan,0,0,0
2022-07-01,KIR,Johor,0,0,0
2022-07-01,KIR,Sabah,0,0,0
2022-07-01,KIR,Selangor,1,1,0
2022-07-01,KNA,Johor,26,20,6
2022-07-01,KNA,Kedah,0,0,0
2022-07-01,KNA,Perlis,0,0,0
2022-07-01,KNA,Pulau Pinang,0,0,0
2022-07-01,KNA,Sabah,0,0,0
2022-07-01,KNA,Selangor,60,38,22
2022-07-01,KNA,W.P. Labuan,0,0,0
2022-07-01,KOR,Johor,8437,4798,3639
2022-07-01,KOR,Kedah,84,45,39
2022-07-01,KOR,Kelantan,0,0,0
2022-07-01,KOR,Melaka,0,0,0
2022-07-01,KOR,Negeri Sembilan,1,1,0
2022-07-01,KOR,Pahang,0,0,0
2022-07-01,KOR,Perak,15,9,6
2022-07-01,KOR,Perlis,29,23,6
2022-07-01,KOR,Pulau Pinang,416,218,198
2022-07-01,KOR,Sabah,8963,3888,5075
2022-07-01,KOR,Sarawak,103,60,43
2022-07-01,KOR,Selangor,8451,4763,3688
2022-07-01,KOR,Terengganu,0,0,0
2022-07-01,KOR,W.P. Labuan,0,0,0
2022-07-01,KWT,Johor,72,39,33
2022-07-01,KWT,Kedah,46,22,24
2022-07-01,KWT,Kelantan,0,0,0
2022-07-01,KWT,Perak,0,0,0
2022-07-01,KWT,Perlis,3,1,2
2022-07-01,KWT,Pulau Pinang,29,13,16
2022-07-01,KWT,Sabah,0,0,0
2022-07-01,KWT,Sarawak,0,0,0
2022-07-01,KWT,Selangor,782,410,372
2022-07-01,KWT,W.P. Labuan,0,0,0
2022-07-01,LAO,Johor,55,17,38
2022-07-01,LAO,Kedah,568,83,485
2022-07-01,LAO,Kelantan,42,2,40
2022-07-01,LAO,Melaka,0,0,0
2022-07-01,LAO,Perak,1,1,0
2022-07-01,LAO,Perlis,51,13,38
2022-07-01,LAO,Pulau Pinang,53,32,21
2022-07-01,LAO,Sabah,7,4,3
2022-07-01,LAO,Sarawak,0,0,0
2022-07-01,LAO,Selangor,305,93,212
2022-07-01,LAO,W.P. Labuan,0,0,0
2022-07-01,LBN,Johor,8,5,3
2022-07-01,LBN,Kedah,0,0,0
2022-07-01,LBN,Kelantan,0,0,0
2022-07-01,LBN,Pahang,0,0,0
2022-07-01,LBN,Perak,0,0,0
2022-07-01,LBN,Perlis,0,0,0
2022-07-01,LBN,Pulau Pinang,1,1,0
2022-07-01,LBN,Sabah,0,0,0
2022-07-01,LBN,Sarawak,1,1,0
2022-07-01,LBN,Selangor,180,116,64
2022-07-01,LBN,W.P. Labuan,0,0,0
2022-07-01,LBR,Johor,3,3,0
2022-07-01,LBR,Kedah,0,0,0
2022-07-01,LBR,Sabah,0,0,0
2022-07-01,LBR,Sarawak,0,0,0
2022-07-01,LBR,Selangor,3,3,0
2022-07-01,LBY,Johor,2,2,0
2022-07-01,LBY,Kedah,0,0,0
2022-07-01,LBY,Perlis,0,0,0
2022-07-01,LBY,Pulau Pinang,0,0,0
2022-07-01,LBY,Sabah,0,0,0
2022-07-01,LBY,Sarawak,0,0,0
2022-07-01,LBY,Selangor,138,91,47
2022-07-01,LCA,Johor,6,5,1
2022-07-01,LCA,Kedah,0,0,0
2022-07-01,LCA,Pulau Pinang,0,0,0
2022-07-01,LCA,Sarawak,0,0,0
2022-07-01,LCA,Selangor,2,2,0
2022-07-01,LIE,Johor,2,2,0
2022-07-01,LIE,Kedah,0,0,0
2022-07-01,LIE,Perlis,0,0,0
2022-07-01,LIE,Pulau Pinang,0,0,0
2022-07-01,LIE,Sabah,0,0,0
2022-07-01,LIE,Sarawak,0,0,0
2022-07-01,LIE,Selangor,2,2,0
2022-07-01,LKA,Johor,812,569,243
2022-07-01,LKA,Kedah,10,7,3
2022-07-01,LKA,Kelantan,0,0,0
2022-07-01,LKA,Melaka,0,0,0
2022-07-01,LKA,Pahang,0,0,0
2022-07-01,LKA,Perak,7,5,2
2022-07-01,LKA,Perlis,0,0,0
2022-07-01,LKA,Pulau Pinang,31,17,14
2022-07-01,LKA,Sabah,10,8,2
2022-07-01,LKA,Sarawak,9,6,3
2022-07-01,LKA,Selangor,2154,1314,840
2022-07-01,LKA,W.P. Labuan,0,0,0
2022-07-01,LSO,Johor,0,0,0
2022-07-01,LSO,Kedah,0,0,0
2022-07-01,LSO,Pulau Pinang,0,0,0
2022-07-01,LSO,Sarawak,0,0,0
2022-07-01,LSO,Selangor,8,4,4
2022-07-01,LTU,Johor,20,9,11
2022-07-01,LTU,Kedah,1,1,0
2022-07-01,LTU,Kelantan,0,0,0
2022-07-01,LTU,Pahang,0,0,0
2022-07-01,LTU,Perak,0,0,0
2022-07-01,LTU,Perlis,1,0,1
2022-07-01,LTU,Pulau Pinang,0,0,0
2022-07-01,LTU,Sabah,3,2,1
2022-07-01,LTU,Sarawak,1,1,0
2022-07-01,LTU,Selangor,102,53,49
2022-07-01,LTU,W.P. Labuan,0,0,0
2022-07-01,LUX,Johor,13,7,6
2022-07-01,LUX,Kedah,2,2,0
2022-07-01,LUX,Kelantan,0,0,0
2022-07-01,LUX,Perak,0,0,0
2022-07-01,LUX,Perlis,0,0,0
2022-07-01,LUX,Pulau Pinang,1,0,1
2022-07-01,LUX,Sabah,0,0,0
2022-07-01,LUX,Sarawak,1,1,0
2022-07-01,LUX,Selangor,29,17,12
2022-07-01,LVA,Johor,5,1,4
2022-07-01,LVA,Kedah,0,0,0
2022-07-01,LVA,Kelantan,0,0,0
2022-07-01,LVA,Pahang,0,0,0
2022-07-01,LVA,Perak,0,0,0
2022-07-01,LVA,Perlis,0,0,0
2022-07-01,LVA,Pulau Pinang,0,0,0
2022-07-01,LVA,Sabah,4,0,4
2022-07-01,LVA,Sarawak,1,1,0
2022-07-01,LVA,Selangor,36,15,21
2022-07-01,LVA,W.P. Labuan,0,0,0
2022-07-01,MAC,Johor,0,0,0
2022-07-01,MAC,Pahang,0,0,0
2022-07-01,MAC,Perak,0,0,0
2022-07-01,MAC,Selangor,0,0,0
2022-07-01,MAC,W.P. Labuan,0,0,0
2022-07-01,MAR,Johor,58,38,20
2022-07-01,MAR,Kedah,2,2,0
2022-07-01,MAR,Kelantan,1,1,0
2022-07-01,MAR,Melaka,0,0,0
2022-07-01,MAR,Pahang,0,0,0
2022-07-01,MAR,Perak,0,0,0
2022-07-01,MAR,Perlis,2,2,0
2022-07-01,MAR,Pulau Pinang,2,2,0
2022-07-01,MAR,Sabah,3,1,2
2022-07-01,MAR,Sarawak,4,3,1
2022-07-01,MAR,Selangor,388,204,184
2022-07-01,MAR,W.P. Labuan,0,0,0
2022-07-01,MCO,Johor,0,0,0
2022-07-01,MCO,Kedah,0,0,0
2022-07-01,MCO,Sabah,0,0,0
2022-07-01,MCO,Selangor,3,0,3
2022-07-01,MDA,Johor,0,0,0
2022-07-01,MDA,Kedah,0,0,0
2022-07-01,MDA,Kelantan,0,0,0
2022-07-01,MDA,Negeri Sembilan,0,0,0
2022-07-01,MDA,Perlis,0,0,0
2022-07-01,MDA,Pulau Pinang,1,0,1
2022-07-01,MDA,Sabah,0,0,0
2022-07-01,MDA,Sarawak,1,0,1
2022-07-01,MDA,Selangor,6,4,2
2022-07-01,MDG,Johor,6,3,3
2022-07-01,MDG,Kedah,0,0,0
2022-07-01,MDG,Perak,0,0,0
2022-07-01,MDG,Perlis,0,0,0
2022-07-01,MDG,Pulau Pinang,0,0,0
2022-07-01,MDG,Sabah,0,0,0
2022-07-01,MDG,Sarawak,0,0,0
2022-07-01,MDG,Selangor,7,4,3
2022-07-01,MDV,Johor,288,143,145
2022-07-01,MDV,Kedah,1,1,0
2022-07-01,MDV,Kelantan,1,1,0
2022-07-01,MDV,Perak,0,0,0
2022-07-01,MDV,Perlis,2,2,0
2022-07-01,MDV,Pulau Pinang,11,6,5
2022-07-01,MDV,Sabah,1,1,0
2022-07-01,MDV,Sarawak,1,0,1
2022-07-01,MDV,Selangor,4409,2055,2354
2022-07-01,MEX,Johor,58,37,21
2022-07-01,MEX,Kedah,10,6,4
2022-07-01,MEX,Kelantan,0,0,0
2022-07-01,MEX,Pahang,0,0,0
2022-07-01,MEX,Perak,0,0,0
2022-07-01,MEX,Perlis,0,0,0
2022-07-01,MEX,Pulau Pinang,33,25,8
2022-07-01,MEX,Sabah,3,1,2
2022-07-01,MEX,Sarawak,0,0,0
2022-07-01,MEX,Selangor,308,170,138
2022-07-01,MEX,W.P. Labuan,0,0,0
2022-07-01,MHL,Johor,0,0,0
2022-07-01,MHL,Kedah,0,0,0
2022-07-01,MHL,Perak,0,0,0
2022-07-01,MHL,Pulau Pinang,1,1,0
2022-07-01,MHL,Sabah,0,0,0
2022-07-01,MHL,Selangor,1,1,0
2022-07-01,MKD,Johor,4,3,1
2022-07-01,MKD,Kedah,0,0,0
2022-07-01,MKD,Perak,0,0,0
2022-07-01,MKD,Pulau Pinang,0,0,0
2022-07-01,MKD,Sabah,0,0,0
2022-07-01,MKD,Sarawak,0,0,0
2022-07-01,MKD,Selangor,5,2,3
2022-07-01,MLI,Johor,3,3,0
2022-07-01,MLI,Sabah,0,0,0
2022-07-01,MLI,Selangor,1,1,0
2022-07-01,MLT,Johor,5,3,2
2022-07-01,MLT,Kedah,8,4,4
2022-07-01,MLT,Kelantan,0,0,0
2022-07-01,MLT,Perak,0,0,0
2022-07-01,MLT,Perlis,0,0,0
2022-07-01,MLT,Pulau Pinang,3,3,0
2022-07-01,MLT,Sabah,1,1,0
2022-07-01,MLT,Sarawak,0,0,0
2022-07-01,MLT,Selangor,51,25,26
2022-07-01,MLT,W.P. Labuan,0,0,0
2022-07-01,MMR,Johor,2999,1040,1959
2022-07-01,MMR,Kedah,30,9,21
2022-07-01,MMR,Kelantan,1,1,0
2022-07-01,MMR,Negeri Sembilan,0,0,0
2022-07-01,MMR,Pahang,0,0,0
2022-07-01,MMR,Perak,16,6,10
2022-07-01,MMR,Perlis,5,2,3
2022-07-01,MMR,Pulau Pinang,89,35,54
2022-07-01,MMR,Sabah,12,7,5
2022-07-01,MMR,Sarawak,10,5,5
2022-07-01,MMR,Selangor,4649,2929,1720
2022-07-01,MMR,Terengganu,0,0,0
2022-07-01,MMR,W.P. Labuan,0,0,0
2022-07-01,MNE,Johor,0,0,0
2022-07-01,MNE,Kedah,0,0,0
2022-07-01,MNE,Pulau Pinang,0,0,0
2022-07-01,MNE,Sabah,0,0,0
2022-07-01,MNE,Sarawak,0,0,0
2022-07-01,MNE,Selangor,5,4,1
2022-07-01,MNG,Johor,128,51,77
2022-07-01,MNG,Kedah,0,0,0
2022-07-01,MNG,Kelantan,0,0,0
2022-07-01,MNG,Perak,0,0,0
2022-07-01,MNG,Perlis,0,0,0
2022-07-01,MNG,Pulau Pinang,11,4,7
2022-07-01,MNG,Sabah,6,3,3
2022-07-01,MNG,Sarawak,0,0,0
2022-07-01,MNG,Selangor,209,93,116
2022-07-01,MNP,Selangor,0,0,0
2022-07-01,MOZ,Johor,1,1,0
2022-07-01,MOZ,Kedah,0,0,0
2022-07-01,MOZ,Perak,0,0,0
2022-07-01,MOZ,Pulau Pinang,0,0,0
2022-07-01,MOZ,Sabah,0,0,0
2022-07-01,MOZ,Sarawak,0,0,0
2022-07-01,MOZ,Selangor,6,2,4
2022-07-01,MRT,Johor,9,9,0
2022-07-01,MRT,Kedah,0,0,0
2022-07-01,MRT,Pulau Pinang,0,0,0
2022-07-01,MRT,Sabah,0,0,0
2022-07-01,MRT,Sarawak,0,0,0
2022-07-01,MRT,Selangor,9,7,2
2022-07-01,MUS,Johor,69,37,32
2022-07-01,MUS,Kedah,0,0,0
2022-07-01,MUS,Kelantan,2,1,1
2022-07-01,MUS,Pahang,0,0,0
2022-07-01,MUS,Perak,0,0,0
2022-07-01,MUS,Perlis,1,1,0
2022-07-01,MUS,Pulau Pinang,6,4,2
2022-07-01,MUS,Sabah,0,0,0
2022-07-01,MUS,Sarawak,3,1,2
2022-07-01,MUS,Selangor,233,115,118
2022-07-01,MWI,Johor,1,0,1
2022-07-01,MWI,Pulau Pinang,0,0,0
2022-07-01,MWI,Sabah,0,0,0
2022-07-01,MWI,Sarawak,0,0,0
2022-07-01,MWI,Selangor,11,9,2
2022-07-01,MYT,Selangor,0,0,0
2022-07-01,NAM,Johor,1,0,1
2022-07-01,NAM,Kedah,0,0,0
2022-07-01,NAM,Perak,0,0,0
2022-07-01,NAM,Perlis,0,0,0
2022-07-01,NAM,Pulau Pinang,1,0,1
2022-07-01,NAM,Sabah,0,0,0
2022-07-01,NAM,Sarawak,0,0,0
2022-07-01,NAM,Selangor,4,1,3
2022-07-01,NCL,Selangor,0,0,0
2022-07-01,NER,Johor,0,0,0
2022-07-01,NER,Sabah,0,0,0
2022-07-01,NER,Selangor,2,0,2
2022-07-01,NGA,Johor,13,11,2
2022-07-01,NGA,Kedah,1,1,0
2022-07-01,NGA,Perlis,0,0,0
2022-07-01,NGA,Pulau Pinang,4,3,1
2022-07-01,NGA,Sabah,0,0,0
2022-07-01,NGA,Sarawak,5,3,2
2022-07-01,NGA,Selangor,265,191,74
2022-07-01,NIC,Johor,1,1,0
2022-07-01,NIC,Kedah,0,0,0
2022-07-01,NIC,Pulau Pinang,0,0,0
2022-07-01,NIC,Sabah,0,0,0
2022-07-01,NIC,Selangor,5,2,3
2022-07-01,NLD,Johor,1048,617,431
2022-07-01,NLD,Kedah,113,65,48
2022-07-01,NLD,Kelantan,5,2,3
2022-07-01,NLD,Melaka,0,0,0
2022-07-01,NLD,Negeri Sembilan,0,0,0
2022-07-01,NLD,Pahang,0,0,0
2022-07-01,NLD,Perak,18,8,10
2022-07-01,NLD,Perlis,27,16,11
2022-07-01,NLD,Pulau Pinang,207,122,85
2022-07-01,NLD,Sabah,107,52,55
2022-07-01,NLD,Sarawak,121,62,59
2022-07-01,NLD,Selangor,4552,2519,2033
2022-07-01,NLD,Terengganu,0,0,0
2022-07-01,NLD,W.P. Labuan,0,0,0
2022-07-01,NOR,Johor,186,125,61
2022-07-01,NOR,Kedah,28,15,13
2022-07-01,NOR,Kelantan,0,0,0
2022-07-01,NOR,Melaka,0,0,0
2022-07-01,NOR,Pahang,0,0,0
2022-07-01,NOR,Perak,0,0,0
2022-07-01,NOR,Perlis,1,0,1
2022-07-01,NOR,Pulau Pinang,31,17,14
2022-07-01,NOR,Sabah,27,17,10
2022-07-01,NOR,Sarawak,7,3,4
2022-07-01,NOR,Selangor,684,389,295
2022-07-01,NOR,W.P. Labuan,0,0,0
2022-07-01,NPL,Johor,477,431,46
2022-07-01,NPL,Kedah,2,1,1
2022-07-01,NPL,Pahang,0,0,0
2022-07-01,NPL,Perak,1,1,0
2022-07-01,NPL,Perlis,1,1,0
2022-07-01,NPL,Pulau Pinang,10,7,3
2022-07-01,NPL,Sabah,17,12,5
2022-07-01,NPL,Sarawak,1,1,0
2022-07-01,NPL,Selangor,18711,17944,767
2022-07-01,NPL,W.P. Labuan,0,0,0
2022-07-01,NRU,Johor,0,0,0
2022-07-01,NRU,Pulau Pinang,0,0,0
2022-07-01,NRU,Selangor,1,0,1
2022-07-01,NZL,Johor,499,340,159
2022-07-01,NZL,Kedah,41,25,16
2022-07-01,NZL,Kelantan,1,1,0
2022-07-01,NZL,Melaka,0,0,0
2022-07-01,NZL,Negeri Sembilan,0,0,0
2022-07-01,NZL,Pahang,1,0,1
2022-07-01,NZL,Perak,15,13,2
2022-07-01,NZL,Perlis,3,2,1
2022-07-01,NZL,Pulau Pinang,115,62,53
2022-07-01,NZL,Sabah,60,35,25
2022-07-01,NZL,Sarawak,48,28,20
2022-07-01,NZL,Selangor,1564,905,659
2022-07-01,NZL,Terengganu,0,0,0
2022-07-01,NZL,W.P. Labuan,0,0,0
2022-07-01,OMN,Johor,204,91,113
2022-07-01,OMN,Kedah,4,1,3
2022-07-01,OMN,Kelantan,0,0,0
2022-07-01,OMN,Melaka,0,0,0
2022-07-01,OMN,Perak,0,0,0
2022-07-01,OMN,Perlis,1,1,0
2022-07-01,OMN,Pulau Pinang,8,5,3
2022-07-01,OMN,Sabah,0,0,0
2022-07-01,OMN,Sarawak,0,0,0
2022-07-01,OMN,Selangor,1212,638,574
2022-07-01,PAK,Johor,813,551,262
2022-07-01,PAK,Kedah,103,66,37
2022-07-01,PAK,Kelantan,12,12,0
2022-07-01,PAK,Melaka,1,1,0
2022-07-01,PAK,Negeri Sembilan,0,0,0
2022-07-01,PAK,Pahang,0,0,0
2022-07-01,PAK,Perak,1,1,0
2022-07-01,PAK,Perlis,5,5,0
2022-07-01,PAK,Pulau Pinang,24,18,6
2022-07-01,PAK,Sabah,17,11,6
2022-07-01,PAK,Sarawak,5,5,0
2022-07-01,PAK,Selangor,8292,6636,1656
2022-07-01,PAK,W.P. Labuan,0,0,0
2022-07-01,PAN,Johor,0,0,0
2022-07-01,PAN,Kedah,0,0,0
2022-07-01,PAN,Perak,0,0,0
2022-07-01,PAN,Perlis,0,0,0
2022-07-01,PAN,Pulau Pinang,2,1,1
2022-07-01,PAN,Sabah,0,0,0
2022-07-01,PAN,Sarawak,0,0,0
2022-07-01,PAN,Selangor,6,2,4
2022-07-01,PER,Johor,27,14,13
2022-07-01,PER,Kedah,2,2,0
2022-07-01,PER,Kelantan,0,0,0
2022-07-01,PER,Pahang,0,0,0
2022-07-01,PER,Perak,0,0,0
2022-07-01,PER,Perlis,0,0,0
2022-07-01,PER,Pulau Pinang,0,0,0
2022-07-01,PER,Sabah,0,0,0
2022-07-01,PER,Sarawak,0,0,0
2022-07-01,PER,Selangor,58,29,29
2022-07-01,PER,W.P. Labuan,0,0,0
2022-07-01,PHL,Johor,13058,4163,8895
2022-07-01,PHL,Kedah,231,92,139
2022-07-01,PHL,Kelantan,15,5,10
2022-07-01,PHL,Melaka,2,1,1
2022-07-01,PHL,Negeri Sembilan,0,0,0
2022-07-01,PHL,Pahang,7,4,3
2022-07-01,PHL,Perak,39,13,26
2022-07-01,PHL,Perlis,122,35,87
2022-07-01,PHL,Pulau Pinang,652,266,386
2022-07-01,PHL,Sabah,597,222,375
2022-07-01,PHL,Sarawak,178,96,82
2022-07-01,PHL,Selangor,11204,4467,6737
2022-07-01,PHL,Terengganu,0,0,0
2022-07-01,PHL,W.P. Labuan,3,3,0
2022-07-01,PLW,Johor,0,0,0
2022-07-01,PLW,Pulau Pinang,0,0,0
2022-07-01,PLW,Selangor,1,1,0
2022-07-01,PNG,Johor,10,7,3
2022-07-01,PNG,Kedah,1,1,0
2022-07-01,PNG,Kelantan,0,0,0
2022-07-01,PNG,Perak,0,0,0
2022-07-01,PNG,Pulau Pinang,0,0,0
2022-07-01,PNG,Sabah,0,0,0
2022-07-01,PNG,Sarawak,1,0,1
2022-07-01,PNG,Selangor,46,31,15
2022-07-01,POL,Johor,256,149,107
2022-07-01,POL,Kedah,13,6,7
2022-07-01,POL,Kelantan,0,0,0
2022-07-01,POL,Melaka,0,0,0
2022-07-01,POL,Negeri Sembilan,0,0,0
2022-07-01,POL,Pahang,0,0,0
2022-07-01,POL,Perak,1,0,1
2022-07-01,POL,Perlis,8,6,2
2022-07-01,POL,Pulau Pinang,24,11,13
2022-07-01,POL,Sabah,37,19,18
2022-07-01,POL,Sarawak,23,11,12
2022-07-01,POL,Selangor,582,277,305
2022-07-01,POL,Terengganu,0,0,0
2022-07-01,POL,W.P. Labuan,0,0,0
2022-07-01,PRK,Selangor,0,0,0
2022-07-01,PRT,Johor,92,51,41
2022-07-01,PRT,Kedah,9,5,4
2022-07-01,PRT,Kelantan,0,0,0
2022-07-01,PRT,Melaka,0,0,0
2022-07-01,PRT,Pahang,0,0,0
2022-07-01,PRT,Perak,4,3,1
2022-07-01,PRT,Perlis,4,0,4
2022-07-01,PRT,Pulau Pinang,22,17,5
2022-07-01,PRT,Sabah,7,2,5
2022-07-01,PRT,Sarawak,1,0,1
2022-07-01,PRT,Selangor,575,305,270
2022-07-01,PRT,W.P. Labuan,0,0,0
2022-07-01,PRY,Johor,4,3,1
2022-07-01,PRY,Kedah,0,0,0
2022-07-01,PRY,Perak,0,0,0
2022-07-01,PRY,Perlis,0,0,0
2022-07-01,PRY,Pulau Pinang,0,0,0
2022-07-01,PRY,Sabah,0,0,0
2022-07-01,PRY,Sarawak,0,0,0
2022-07-01,PRY,Selangor,5,3,2
2022-07-01,PSE,Johor,3,2,1
2022-07-01,PSE,Kedah,5,2,3
2022-07-01,PSE,Kelantan,0,0,0
2022-07-01,PSE,Melaka,0,0,0
2022-07-01,PSE,Perak,0,0,0
2022-07-01,PSE,Perlis,0,0,0
2022-07-01,PSE,Pulau Pinang,0,0,0
2022-07-01,PSE,Sabah,1,1,0
2022-07-01,PSE,Sarawak,0,0,0
2022-07-01,PSE,Selangor,224,143,81
2022-07-01,QAT,Johor,75,33,42
2022-07-01,QAT,Kedah,1,0,1
2022-07-01,QAT,Perlis,0,0,0
2022-07-01,QAT,Pulau Pinang,1,1,0
2022-07-01,QAT,Sabah,0,0,0
2022-07-01,QAT,Sarawak,0,0,0
2022-07-01,QAT,Selangor,439,211,228
2022-07-01,REU,Johor,0,0,0
2022-07-01,REU,Sarawak,0,0,0
2022-07-01,ROU,Johor,107,55,52
2022-07-01,ROU,Kedah,2,1,1
2022-07-01,ROU,Kelantan,1,0,1
2022-07-01,ROU,Negeri Sembilan,0,0,0
2022-07-01,ROU,Pahang,0,0,0
2022-07-01,ROU,Perak,0,0,0
2022-07-01,ROU,Perlis,1,1,0
2022-07-01,ROU,Pulau Pinang,14,9,5
2022-07-01,ROU,Sabah,4,2,2
2022-07-01,ROU,Sarawak,1,0,1
2022-07-01,ROU,Selangor,297,177,120
2022-07-01,ROU,W.P. Labuan,0,0,0
2022-07-01,RUS,Johor,271,139,132
2022-07-01,RUS,Kedah,56,27,29
2022-07-01,RUS,Kelantan,4,2,2
2022-07-01,RUS,Melaka,1,1,0
2022-07-01,RUS,Negeri Sembilan,0,0,0
2022-07-01,RUS,Pahang,0,0,0
2022-07-01,RUS,Perak,1,1,0
2022-07-01,RUS,Perlis,6,2,4
2022-07-01,RUS,Pulau Pinang,37,17,20
2022-07-01,RUS,Sabah,22,8,14
2022-07-01,RUS,Sarawak,8,3,5
2022-07-01,RUS,Selangor,1664,861,803
2022-07-01,RUS,W.P. Labuan,0,0,0
2022-07-01,RWA,Johor,1,1,0
2022-07-01,RWA,Kedah,0,0,0
2022-07-01,RWA,Pulau Pinang,0,0,0
2022-07-01,RWA,Selangor,1,1,0
2022-07-01,SAU,Johor,255,145,110
2022-07-01,SAU,Kedah,66,35,31
2022-07-01,SAU,Kelantan,4,3,1
2022-07-01,SAU,Melaka,0,0,0
2022-07-01,SAU,Perak,3,2,1
2022-07-01,SAU,Perlis,4,3,1
2022-07-01,SAU,Pulau Pinang,67,28,39
2022-07-01,SAU,Sabah,11,10,1
2022-07-01,SAU,Sarawak,5,4,1
2022-07-01,SAU,Selangor,9163,4578,4585
2022-07-01,SAU,W.P. Labuan,0,0,0
2022-07-01,SDN,Johor,8,5,3
2022-07-01,SDN,Kedah,1,1,0
2022-07-01,SDN,Kelantan,0,0,0
2022-07-01,SDN,Perlis,0,0,0
2022-07-01,SDN,Pulau Pinang,0,0,0
2022-07-01,SDN,Sabah,0,0,0
2022-07-01,SDN,Sarawak,0,0,0
2022-07-01,SDN,Selangor,905,458,447
2022-07-01,SDN,W.P. Labuan,0,0,0
2022-07-01,SEN,Johor,0,0,0
2022-07-01,SEN,Kedah,0,0,0
2022-07-01,SEN,Kelantan,1,1,0
2022-07-01,SEN,Perak,0,0,0
2022-07-01,SEN,Perlis,0,0,0
2022-07-01,SEN,Pulau Pinang,0,0,0
2022-07-01,SEN,Sabah,0,0,0
2022-07-01,SEN,Sarawak,1,1,0
2022-07-01,SEN,Selangor,15,13,2
2022-07-01,SGP,Johor,931641,555703,375938
2022-07-01,SGP,Kedah,2168,1165,1003
2022-07-01,SGP,Kelantan,25,13,12
2022-07-01,SGP,Melaka,11,4,7
2022-07-01,SGP,Negeri Sembilan,3,3,0
2022-07-01,SGP,Pahang,39,31,8
2022-07-01,SGP,Perak,3645,1723,1922
2022-07-01,SGP,Perlis,55,36,19
2022-07-01,SGP,Pulau Pinang,12524,6227,6297
2022-07-01,SGP,Sabah,1941,1063,878
2022-07-01,SGP,Sarawak,2439,1466,973
2022-07-01,SGP,Selangor,25819,13936,11883
2022-07-01,SGP,Terengganu,0,0,0
2022-07-01,SGP,W.P. Labuan,0,0,0
2022-07-01,SGS,Johor,0,0,0
2022-07-01,SGS,Sabah,0,0,0
2022-07-01,SGS,Selangor,1,1,0
2022-07-01,SHN,Sarawak,0,0,0
2022-07-01,SLB,Johor,1,1,0
2022-07-01,SLB,Perlis,0,0,0
2022-07-01,SLB,Pulau Pinang,0,0,0
2022-07-01,SLB,Sabah,0,0,0
2022-07-01,SLB,Sarawak,0,0,0
2022-07-01,SLB,Selangor,6,3,3
2022-07-01,SLB,W.P. Labuan,0,0,0
2022-07-01,SLE,Johor,1,1,0
2022-07-01,SLE,Kedah,0,0,0
2022-07-01,SLE,Perak,0,0,0
2022-07-01,SLE,Pulau Pinang,1,1,0
2022-07-01,SLE,Sabah,0,0,0
2022-07-01,SLE,Selangor,13,11,2
2022-07-01,SLV,Johor,0,0,0
2022-07-01,SLV,Kedah,0,0,0
2022-07-01,SLV,Perak,0,0,0
2022-07-01,SLV,Perlis,0,0,0
2022-07-01,SLV,Pulau Pinang,1,1,0
2022-07-01,SLV,Sabah,0,0,0
2022-07-01,SLV,Selangor,0,0,0
2022-07-01,SLV,W.P. Labuan,0,0,0
2022-07-01,SMR,Johor,0,0,0
2022-07-01,SMR,Selangor,0,0,0
2022-07-01,SOM,Johor,0,0,0
2022-07-01,SOM,Kedah,0,0,0
2022-07-01,SOM,Kelantan,0,0,0
2022-07-01,SOM,Perlis,0,0,0
2022-07-01,SOM,Sabah,0,0,0
2022-07-01,SOM,Sarawak,0,0,0
2022-07-01,SOM,Selangor,123,60,63
2022-07-01,SRB,Johor,6,2,4
2022-07-01,SRB,Kedah,0,0,0
2022-07-01,SRB,Kelantan,1,1,0
2022-07-01,SRB,Pahang,0,0,0
2022-07-01,SRB,Perak,0,0,0
2022-07-01,SRB,Perlis,0,0,0
2022-07-01,SRB,Pulau Pinang,0,0,0
2022-07-01,SRB,Sabah,0,0,0
2022-07-01,SRB,Sarawak,0,0,0
2022-07-01,SRB,Selangor,33,23,10
2022-07-01,SSD,Johor,0,0,0
2022-07-01,SSD,Kedah,0,0,0
2022-07-01,SSD,Sarawak,0,0,0
2022-07-01,SSD,Selangor,16,13,3
2022-07-01,SSD,W.P. Labuan,0,0,0
2022-07-01,STP,Selangor,1,0,1
2022-07-01,SUR,Johor,1,1,0
2022-07-01,SUR,Kedah,0,0,0
2022-07-01,SUR,Kelantan,0,0,0
2022-07-01,SUR,Perak,0,0,0
2022-07-01,SUR,Perlis,0,0,0
2022-07-01,SUR,Pulau Pinang,0,0,0
2022-07-01,SUR,Sabah,0,0,0
2022-07-01,SUR,Sarawak,0,0,0
2022-07-01,SUR,Selangor,4,2,2
2022-07-01,SVK,Johor,21,11,10
2022-07-01,SVK,Kedah,39,20,19
2022-07-01,SVK,Kelantan,0,0,0
2022-07-01,SVK,Negeri Sembilan,0,0,0
2022-07-01,SVK,Pahang,0,0,0
2022-07-01,SVK,Perak,0,0,0
2022-07-01,SVK,Perlis,0,0,0
2022-07-01,SVK,Pulau Pinang,5,4,1
2022-07-01,SVK,Sabah,1,0,1
2022-07-01,SVK,Sarawak,2,0,2
2022-07-01,SVK,Selangor,216,117,99
2022-07-01,SVK,W.P. Labuan,0,0,0
2022-07-01,SVN,Johor,10,9,1
2022-07-01,SVN,Kedah,0,0,0
2022-07-01,SVN,Kelantan,1,1,0
2022-07-01,SVN,Perak,0,0,0
2022-07-01,SVN,Perlis,0,0,0
2022-07-01,SVN,Pulau Pinang,1,1,0
2022-07-01,SVN,Sabah,6,3,3
2022-07-01,SVN,Sarawak,9,6,3
2022-07-01,SVN,Selangor,80,50,30
2022-07-01,SVN,W.P. Labuan,0,0,0
2022-07-01,SWE,Johor,166,107,59
2022-07-01,SWE,Kedah,30,23,7
2022-07-01,SWE,Kelantan,24,11,13
2022-07-01,SWE,Melaka,0,0,0
2022-07-01,SWE,Negeri Sembilan,0,0,0
2022-07-01,SWE,Pahang,0,0,0
2022-07-01,SWE,Perak,7,3,4
2022-07-01,SWE,Perlis,11,8,3
2022-07-01,SWE,Pulau Pinang,38,23,15
2022-07-01,SWE,Sabah,33,21,12
2022-07-01,SWE,Sarawak,8,5,3
2022-07-01,SWE,Selangor,683,416,267
2022-07-01,SWE,W.P. Labuan,0,0,0
2022-07-01,SWZ,Johor,0,0,0
2022-07-01,SWZ,Kedah,0,0,0
2022-07-01,SWZ,Pulau Pinang,0,0,0
2022-07-01,SWZ,Sabah,0,0,0
2022-07-01,SWZ,Selangor,11,5,6
2022-07-01,SYC,Johor,1,0,1
2022-07-01,SYC,Kedah,0,0,0
2022-07-01,SYC,Pulau Pinang,0,0,0
2022-07-01,SYC,Sabah,0,0,0
2022-07-01,SYC,Sarawak,2,1,1
2022-07-01,SYC,Selangor,41,19,22
2022-07-01,SYR,Johor,11,5,6
2022-07-01,SYR,Kedah,0,0,0
2022-07-01,SYR,Kelantan,0,0,0
2022-07-01,SYR,Pahang,0,0,0
2022-07-01,SYR,Perlis,0,0,0
2022-07-01,SYR,Pulau Pinang,2,2,0
2022-07-01,SYR,Sabah,0,0,0
2022-07-01,SYR,Sarawak,4,2,2
2022-07-01,SYR,Selangor,541,305,236
2022-07-01,SYR,W.P. Labuan,0,0,0
2022-07-01,TCA,Perlis,0,0,0
2022-07-01,TCD,Johor,0,0,0
2022-07-01,TCD,Kedah,0,0,0
2022-07-01,TCD,Perlis,0,0,0
2022-07-01,TCD,Selangor,11,8,3
2022-07-01,TGO,Johor,0,0,0
2022-07-01,TGO,Perak,0,0,0
2022-07-01,TGO,Pulau Pinang,0,0,0
2022-07-01,TGO,Selangor,1,1,0
2022-07-01,THA,Johor,3762,904,2858
2022-07-01,THA,Kedah,44100,26582,17518
2022-07-01,THA,Kelantan,15453,7350,8103
2022-07-01,THA,Melaka,1,0,1
2022-07-01,THA,Negeri Sembilan,0,0,0
2022-07-01,THA,Pahang,9,9,0
2022-07-01,THA,Perak,5468,2425,3043
2022-07-01,THA,Perlis,49284,30984,18300
2022-07-01,THA,Pulau Pinang,1827,815,1012
2022-07-01,THA,Sabah,172,67,105
2022-07-01,THA,Sarawak,47,25,22
2022-07-01,THA,Selangor,8969,3690,5279
2022-07-01,THA,Terengganu,0,0,0
2022-07-01,THA,W.P. Labuan,0,0,0
2022-07-01,TJK,Johor,0,0,0
2022-07-01,TJK,Kedah,1,1,0
2022-07-01,TJK,Perlis,0,0,0
2022-07-01,TJK,Pulau Pinang,0,0,0
2022-07-01,TJK,Sabah,1,1,0
2022-07-01,TJK,Selangor,77,46,31
2022-07-01,TKL,Selangor,0,0,0
2022-07-01,TKM,Johor,1,1,0
2022-07-01,TKM,Kedah,0,0,0
2022-07-01,TKM,Kelantan,0,0,0
2022-07-01,TKM,Perlis,0,0,0
2022-07-01,TKM,Pulau Pinang,0,0,0
2022-07-01,TKM,Sabah,0,0,0
2022-07-01,TKM,Sarawak,0,0,0
2022-07-01,TKM,Selangor,71,37,34
2022-07-01,TLS,Johor,21,20,1
2022-07-01,TLS,Kedah,0,0,0
2022-07-01,TLS,Perlis,0,0,0
2022-07-01,TLS,Pulau Pinang,0,0,0
2022-07-01,TLS,Sabah,0,0,0
2022-07-01,TLS,Sarawak,0,0,0
2022-07-01,TLS,Selangor,457,311,146
2022-07-01,TON,Johor,1,0,1
2022-07-01,TON,Pulau Pinang,2,0,2
2022-07-01,TON,Sarawak,0,0,0
2022-07-01,TON,Selangor,6,2,4
2022-07-01,TTO,Johor,2,0,2
2022-07-01,TTO,Kedah,0,0,0
2022-07-01,TTO,Pahang,0,0,0
2022-07-01,TTO,Pulau Pinang,2,0,2
2022-07-01,TTO,Sabah,0,0,0
2022-07-01,TTO,Sarawak,0,0,0
2022-07-01,TTO,Selangor,17,9,8
2022-07-01,TUN,Johor,2,1,1
2022-07-01,TUN,Kedah,0,0,0
2022-07-01,TUN,Kelantan,5,3,2
2022-07-01,TUN,Melaka,0,0,0
2022-07-01,TUN,Perak,0,0,0
2022-07-01,TUN,Perlis,0,0,0
2022-07-01,TUN,Pulau Pinang,0,0,0
2022-07-01,TUN,Sabah,2,2,0
2022-07-01,TUN,Sarawak,0,0,0
2022-07-01,TUN,Selangor,307,148,159
2022-07-01,TUN,W.P. Labuan,0,0,0
2022-07-01,TUR,Johor,200,130,70
2022-07-01,TUR,Kedah,10,6,4
2022-07-01,TUR,Kelantan,4,4,0
2022-07-01,TUR,Melaka,0,0,0
2022-07-01,TUR,Negeri Sembilan,0,0,0
2022-07-01,TUR,Pahang,0,0,0
2022-07-01,TUR,Perak,1,1,0
2022-07-01,TUR,Perlis,1,0,1
2022-07-01,TUR,Pulau Pinang,19,13,6
2022-07-01,TUR,Sabah,2,1,1
2022-07-01,TUR,Sarawak,3,2,1
2022-07-01,TUR,Selangor,748,463,285
2022-07-01,TUR,W.P. Labuan,0,0,0
2022-07-01,TUV,Selangor,0,0,0
2022-07-01,TWN,Johor,2579,1126,1453
2022-07-01,TWN,Kedah,54,24,30
2022-07-01,TWN,Kelantan,0,0,0
2022-07-01,TWN,Melaka,0,0,0
2022-07-01,TWN,Negeri Sembilan,2,1,1
2022-07-01,TWN,Pahang,1,1,0
2022-07-01,TWN,Perak,29,16,13
2022-07-01,TWN,Perlis,0,0,0
2022-07-01,TWN,Pulau Pinang,493,277,216
2022-07-01,TWN,Sabah,39,18,21
2022-07-01,TWN,Sarawak,92,39,53
2022-07-01,TWN,Selangor,2075,1147,928
2022-07-01,TWN,W.P. Labuan,0,0,0
2022-07-01,TZA,Johor,3,1,2
2022-07-01,TZA,Kedah,0,0,0
2022-07-01,TZA,Perak,0,0,0
2022-07-01,TZA,Perlis,0,0,0
2022-07-01,TZA,Pulau Pinang,0,0,0
2022-07-01,TZA,Sabah,0,0,0
2022-07-01,TZA,Sarawak,0,0,0
2022-07-01,TZA,Selangor,75,31,44
2022-07-01,UGA,Johor,10,6,4
2022-07-01,UGA,Kedah,0,0,0
2022-07-01,UGA,Perak,0,0,0
2022-07-01,UGA,Perlis,0,0,0
2022-07-01,UGA,Pulau Pinang,0,0,0
2022-07-01,UGA,Sabah,0,0,0
2022-07-01,UGA,Sarawak,0,0,0
2022-07-01,UGA,Selangor,42,15,27
2022-07-01,UKR,Johor,89,51,38
2022-07-01,UKR,Kedah,7,1,6
2022-07-01,UKR,Kelantan,2,1,1
2022-07-01,UKR,Melaka,0,0,0
2022-07-01,UKR,Negeri Sembilan,0,0,0
2022-07-01,UKR,Pahang,0,0,0
2022-07-01,UKR,Perak,1,1,0
2022-07-01,UKR,Perlis,2,2,0
2022-07-01,UKR,Pulau Pinang,8,4,4
2022-07-01,UKR,Sabah,10,6,4
2022-07-01,UKR,Sarawak,2,0,2
2022-07-01,UKR,Selangor,359,182,177
2022-07-01,UKR,W.P. Labuan,0,0,0
2022-07-01,URY,Johor,8,2,6
2022-07-01,URY,Kedah,1,1,0
2022-07-01,URY,Kelantan,0,0,0
2022-07-01,URY,Perak,0,0,0
2022-07-01,URY,Perlis,0,0,0
2022-07-01,URY,Pulau Pinang,0,0,0
2022-07-01,URY,Sabah,1,1,0
2022-07-01,URY,Sarawak,0,0,0
2022-07-01,URY,Selangor,23,16,7
2022-07-01,URY,W.P. Labuan,0,0,0
2022-07-01,USA,Johor,3361,2020,1341
2022-07-01,USA,Kedah,237,138,99
2022-07-01,USA,Kelantan,16,12,4
2022-07-01,USA,Melaka,7,5,2
2022-07-01,USA,Negeri Sembilan,0,0,0
2022-07-01,USA,Pahang,0,0,0
2022-07-01,USA,Perak,122,65,57
2022-07-01,USA,Perlis,34,25,9
2022-07-01,USA,Pulau Pinang,1364,833,531
2022-07-01,USA,Sabah,308,171,137
2022-07-01,USA,Sarawak,173,94,79
2022-07-01,USA,Selangor,10431,5972,4459
2022-07-01,USA,Terengganu,0,0,0
2022-07-01,USA,W.P. Labuan,0,0,0
2022-07-01,UZB,Johor,25,17,8
2022-07-01,UZB,Kedah,18,10,8
2022-07-01,UZB,Kelantan,0,0,0
2022-07-01,UZB,Perak,0,0,0
2022-07-01,UZB,Perlis,0,0,0
2022-07-01,UZB,Pulau Pinang,6,1,5
2022-07-01,UZB,Sabah,46,45,1
2022-07-01,UZB,Sarawak,0,0,0
2022-07-01,UZB,Selangor,514,251,263
2022-07-01,VAT,Johor,1,1,0
2022-07-01,VAT,Sarawak,0,0,0
2022-07-01,VAT,Selangor,0,0,0
2022-07-01,VCT,Johor,0,0,0
2022-07-01,VCT,Kedah,0,0,0
2022-07-01,VCT,Pulau Pinang,0,0,0
2022-07-01,VCT,Sarawak,0,0,0
2022-07-01,VCT,Selangor,0,0,0
2022-07-01,VEN,Johor,4,2,2
2022-07-01,VEN,Kedah,0,0,0
2022-07-01,VEN,Kelantan,0,0,0
2022-07-01,VEN,Melaka,0,0,0
2022-07-01,VEN,Perak,0,0,0
2022-07-01,VEN,Perlis,0,0,0
2022-07-01,VEN,Pulau Pinang,0,0,0
2022-07-01,VEN,Sabah,1,1,0
2022-07-01,VEN,Sarawak,0,0,0
2022-07-01,VEN,Selangor,33,18,15
2022-07-01,VEN,W.P. Labuan,0,0,0
2022-07-01,VNM,Johor,15197,5214,9983
2022-07-01,VNM,Kedah,328,43,285
2022-07-01,VNM,Kelantan,3,2,1
2022-07-01,VNM,Melaka,0,0,0
2022-07-01,VNM,Negeri Sembilan,0,0,0
2022-07-01,VNM,Pahang,1,1,0
2022-07-01,VNM,Perak,86,7,79
2022-07-01,VNM,Perlis,19,6,13
2022-07-01,VNM,Pulau Pinang,1102,306,796
2022-07-01,VNM,Sabah,17,3,14
2022-07-01,VNM,Sarawak,35,7,28
2022-07-01,VNM,Selangor,10851,3555,7296
2022-07-01,VNM,Terengganu,0,0,0
2022-07-01,VNM,W.P. Labuan,0,0,0
2022-07-01,VUT,Johor,14,11,3
2022-07-01,VUT,Kedah,0,0,0
2022-07-01,VUT,Pulau Pinang,2,2,0
2022-07-01,VUT,Sabah,0,0,0
2022-07-01,VUT,Sarawak,0,0,0
2022-07-01,VUT,Selangor,19,16,3
2022-07-01,WSM,Johor,0,0,0
2022-07-01,WSM,Sarawak,0,0,0
2022-07-01,WSM,Selangor,1,1,0
2022-07-01,XXX,Johor,171,100,71
2022-07-01,XXX,Kedah,2,0,2
2022-07-01,XXX,Kelantan,1,0,1
2022-07-01,XXX,Melaka,0,0,0
2022-07-01,XXX,Pahang,0,0,0
2022-07-01,XXX,Perak,0,0,0
2022-07-01,XXX,Perlis,2,1,1
2022-07-01,XXX,Pulau Pinang,23,14,9
2022-07-01,XXX,Sabah,4,1,3
2022-07-01,XXX,Sarawak,5,5,0
2022-07-01,XXX,Selangor,219,118,101
2022-07-01,XXX,W.P. Labuan,0,0,0
2022-07-01,YEM,Johor,34,22,12
2022-07-01,YEM,Kedah,7,3,4
2022-07-01,YEM,Kelantan,1,1,0
2022-07-01,YEM,Melaka,4,2,2
2022-07-01,YEM,Pahang,0,0,0
2022-07-01,YEM,Perak,0,0,0
2022-07-01,YEM,Perlis,3,3,0
2022-07-01,YEM,Pulau Pinang,3,2,1
2022-07-01,YEM,Sabah,1,1,0
2022-07-01,YEM,Sarawak,0,0,0
2022-07-01,YEM,Selangor,1148,724,424
2022-07-01,YEM,W.P. Labuan,0,0,0
2022-07-01,ZAF,Johor,194,100,94
2022-07-01,ZAF,Kedah,20,8,12
2022-07-01,ZAF,Kelantan,1,1,0
2022-07-01,ZAF,Melaka,0,0,0
2022-07-01,ZAF,Pahang,0,0,0
2022-07-01,ZAF,Perak,2,2,0
2022-07-01,ZAF,Perlis,12,10,2
2022-07-01,ZAF,Pulau Pinang,32,16,16
2022-07-01,ZAF,Sabah,18,10,8
2022-07-01,ZAF,Sarawak,38,20,18
2022-07-01,ZAF,Selangor,643,384,259
2022-07-01,ZAF,Terengganu,0,0,0
2022-07-01,ZAF,W.P. Labuan,0,0,0
2022-07-01,ZAR,Selangor,0,0,0
2022-07-01,ZMB,Johor,2,2,0
2022-07-01,ZMB,Kedah,0,0,0
2022-07-01,ZMB,Perak,0,0,0
2022-07-01,ZMB,Perlis,0,0,0
2022-07-01,ZMB,Pulau Pinang,1,0,1
2022-07-01,ZMB,Sabah,0,0,0
2022-07-01,ZMB,Sarawak,0,0,0
2022-07-01,ZMB,Selangor,19,13,6
2022-07-01,ZWE,Johor,10,5,5
2022-07-01,ZWE,Kedah,5,3,2
2022-07-01,ZWE,Kelantan,0,0,0
2022-07-01,ZWE,Perak,0,0,0
2022-07-01,ZWE,Perlis,1,0,1
2022-07-01,ZWE,Pulau Pinang,2,0,2
2022-07-01,ZWE,Sabah,0,0,0
2022-07-01,ZWE,Sarawak,0,0,0
2022-07-01,ZWE,Selangor,94,49,45
2022-08-01,ABW,Kedah,0,0,0
2022-08-01,ABW,Pulau Pinang,0,0,0
2022-08-01,AFG,Johor,0,0,0
2022-08-01,AFG,Kedah,0,0,0
2022-08-01,AFG,Perlis,0,0,0
2022-08-01,AFG,Pulau Pinang,0,0,0
2022-08-01,AFG,Sarawak,0,0,0
2022-08-01,AFG,Selangor,74,50,24
2022-08-01,AGO,Johor,0,0,0
2022-08-01,AGO,Kedah,0,0,0
2022-08-01,AGO,Sabah,0,0,0
2022-08-01,AGO,Selangor,0,0,0
2022-08-01,AIA,Selangor,0,0,0
2022-08-01,ALB,Johor,17,12,5
2022-08-01,ALB,Kedah,1,1,0
2022-08-01,ALB,Perak,0,0,0
2022-08-01,ALB,Perlis,0,0,0
2022-08-01,ALB,Pulau Pinang,1,0,1
2022-08-01,ALB,Sabah,0,0,0
2022-08-01,ALB,Sarawak,0,0,0
2022-08-01,ALB,Selangor,35,22,13
2022-08-01,AND,Johor,1,0,1
2022-08-01,AND,Kedah,0,0,0
2022-08-01,AND,Perlis,2,0,2
2022-08-01,AND,Pulau Pinang,0,0,0
2022-08-01,AND,Selangor,2,2,0
2022-08-01,ANT,Selangor,0,0,0
2022-08-01,ARE,Johor,37,23,14
2022-08-01,ARE,Kedah,3,3,0
2022-08-01,ARE,Kelantan,0,0,0
2022-08-01,ARE,Perak,0,0,0
2022-08-01,ARE,Perlis,0,0,0
2022-08-01,ARE,Pulau Pinang,0,0,0
2022-08-01,ARE,Sabah,0,0,0
2022-08-01,ARE,Sarawak,0,0,0
2022-08-01,ARE,Selangor,605,313,292
2022-08-01,ARG,Johor,44,23,21
2022-08-01,ARG,Kedah,13,9,4
2022-08-01,ARG,Kelantan,2,1,1
2022-08-01,ARG,Melaka,0,0,0
2022-08-01,ARG,Perak,0,0,0
2022-08-01,ARG,Perlis,1,0,1
2022-08-01,ARG,Pulau Pinang,2,2,0
2022-08-01,ARG,Sabah,2,2,0
2022-08-01,ARG,Sarawak,2,1,1
2022-08-01,ARG,Selangor,193,106,87
2022-08-01,ARG,W.P. Labuan,0,0,0
2022-08-01,ARM,Johor,6,3,3
2022-08-01,ARM,Kedah,1,1,0
2022-08-01,ARM,Kelantan,0,0,0
2022-08-01,ARM,Perak,0,0,0
2022-08-01,ARM,Perlis,0,0,0
2022-08-01,ARM,Pulau Pinang,0,0,0
2022-08-01,ARM,Sabah,0,0,0
2022-08-01,ARM,Sarawak,0,0,0
2022-08-01,ARM,Selangor,15,8,7
2022-08-01,ATA,Selangor,0,0,0
2022-08-01,ATG,Johor,4,3,1
2022-08-01,ATG,Kedah,3,0,3
2022-08-01,ATG,Pulau Pinang,0,0,0
2022-08-01,ATG,Sarawak,0,0,0
2022-08-01,ATG,Selangor,13,10,3
2022-08-01,AUS,Johor,3198,1924,1274
2022-08-01,AUS,Kedah,333,194,139
2022-08-01,AUS,Kelantan,7,5,2
2022-08-01,AUS,Melaka,9,6,3
2022-08-01,AUS,Negeri Sembilan,0,0,0
2022-08-01,AUS,Pahang,1,1,0
2022-08-01,AUS,Perak,144,78,66
2022-08-01,AUS,Perlis,30,23,7
2022-08-01,AUS,Pulau Pinang,1286,716,570
2022-08-01,AUS,Sabah,312,164,148
2022-08-01,AUS,Sarawak,450,244,206
2022-08-01,AUS,Selangor,11071,6783,4288
2022-08-01,AUS,Terengganu,0,0,0
2022-08-01,AUS,W.P. Labuan,2,2,0
2022-08-01,AUT,Johor,154,96,58
2022-08-01,AUT,Kedah,37,18,19
2022-08-01,AUT,Kelantan,0,0,0
2022-08-01,AUT,Melaka,3,2,1
2022-08-01,AUT,Negeri Sembilan,0,0,0
2022-08-01,AUT,Pahang,0,0,0
2022-08-01,AUT,Perak,1,0,1
2022-08-01,AUT,Perlis,15,9,6
2022-08-01,AUT,Pulau Pinang,62,45,17
2022-08-01,AUT,Sabah,22,15,7
2022-08-01,AUT,Sarawak,19,13,6
2022-08-01,AUT,Selangor,673,413,260
2022-08-01,AUT,Terengganu,0,0,0
2022-08-01,AUT,W.P. Labuan,0,0,0
2022-08-01,AZE,Johor,4,3,1
2022-08-01,AZE,Kedah,5,3,2
2022-08-01,AZE,Kelantan,0,0,0
2022-08-01,AZE,Melaka,0,0,0
2022-08-01,AZE,Perlis,0,0,0
2022-08-01,AZE,Pulau Pinang,0,0,0
2022-08-01,AZE,Sabah,1,1,0
2022-08-01,AZE,Sarawak,0,0,0
2022-08-01,AZE,Selangor,104,47,57
2022-08-01,AZE,W.P. Labuan,0,0,0
2022-08-01,BDI,Pulau Pinang,0,0,0
2022-08-01,BDI,Sarawak,0,0,0
2022-08-01,BDI,Selangor,4,2,2
2022-08-01,BEL,Johor,226,147,79
2022-08-01,BEL,Kedah,12,7,5
2022-08-01,BEL,Kelantan,0,0,0
2022-08-01,BEL,Melaka,0,0,0
2022-08-01,BEL,Negeri Sembilan,1,1,0
2022-08-01,BEL,Pahang,6,4,2
2022-08-01,BEL,Perak,7,2,5
2022-08-01,BEL,Perlis,9,6,3
2022-08-01,BEL,Pulau Pinang,68,46,22
2022-08-01,BEL,Sabah,16,10,6
2022-08-01,BEL,Sarawak,29,16,13
2022-08-01,BEL,Selangor,1002,563,439
2022-08-01,BEL,W.P. Labuan,0,0,0
2022-08-01,BEN,Johor,1,1,0
2022-08-01,BEN,Kedah,0,0,0
2022-08-01,BEN,Perak,0,0,0
2022-08-01,BEN,Pulau Pinang,0,0,0
2022-08-01,BEN,Sabah,0,0,0
2022-08-01,BEN,Sarawak,0,0,0
2022-08-01,BEN,Selangor,5,4,1
2022-08-01,BFA,Perak,0,0,0
2022-08-01,BFA,Pulau Pinang,0,0,0
2022-08-01,BFA,Selangor,1,1,0
2022-08-01,BGD,Johor,1521,1228,293
2022-08-01,BGD,Kedah,33,25,8
2022-08-01,BGD,Kelantan,0,0,0
2022-08-01,BGD,Melaka,0,0,0
2022-08-01,BGD,Negeri Sembilan,0,0,0
2022-08-01,BGD,Pahang,0,0,0
2022-08-01,BGD,Perak,0,0,0
2022-08-01,BGD,Perlis,2,2,0
2022-08-01,BGD,Pulau Pinang,160,150,10
2022-08-01,BGD,Sabah,1,1,0
2022-08-01,BGD,Sarawak,19,12,7
2022-08-01,BGD,Selangor,24441,22429,2012
2022-08-01,BGD,W.P. Labuan,2,2,0
2022-08-01,BGR,Johor,39,20,19
2022-08-01,BGR,Kedah,4,1,3
2022-08-01,BGR,Kelantan,0,0,0
2022-08-01,BGR,Pahang,0,0,0
2022-08-01,BGR,Perak,0,0,0
2022-08-01,BGR,Perlis,0,0,0
2022-08-01,BGR,Pulau Pinang,1,1,0
2022-08-01,BGR,Sabah,0,0,0
2022-08-01,BGR,Sarawak,9,2,7
2022-08-01,BGR,Selangor,146,88,58
2022-08-01,BGR,W.P. Labuan,0,0,0
2022-08-01,BHR,Johor,42,23,19
2022-08-01,BHR,Kedah,3,1,2
2022-08-01,BHR,Kelantan,0,0,0
2022-08-01,BHR,Perlis,0,0,0
2022-08-01,BHR,Pulau Pinang,0,0,0
2022-08-01,BHR,Sabah,1,1,0
2022-08-01,BHR,Sarawak,4,4,0
2022-08-01,BHR,Selangor,233,101,132
2022-08-01,BHS,Johor,8,4,4
2022-08-01,BHS,Kedah,0,0,0
2022-08-01,BHS,Perak,0,0,0
2022-08-01,BHS,Sabah,0,0,0
2022-08-01,BHS,Sarawak,1,0,1
2022-08-01,BHS,Selangor,4,1,3
2022-08-01,BIH,Johor,21,11,10
2022-08-01,BIH,Kedah,1,1,0
2022-08-01,BIH,Perlis,0,0,0
2022-08-01,BIH,Pulau Pinang,0,0,0
2022-08-01,BIH,Sabah,0,0,0
2022-08-01,BIH,Sarawak,2,2,0
2022-08-01,BIH,Selangor,45,27,18
2022-08-01,BLR,Johor,5,3,2
2022-08-01,BLR,Kedah,3,2,1
2022-08-01,BLR,Kelantan,0,0,0
2022-08-01,BLR,Pahang,0,0,0
2022-08-01,BLR,Perak,0,0,0
2022-08-01,BLR,Perlis,0,0,0
2022-08-01,BLR,Pulau Pinang,2,0,2
2022-08-01,BLR,Sabah,1,1,0
2022-08-01,BLR,Sarawak,0,0,0
2022-08-01,BLR,Selangor,105,50,55
2022-08-01,BLR,W.P. Labuan,0,0,0
2022-08-01,BLZ,Johor,0,0,0
2022-08-01,BLZ,Pulau Pinang,0,0,0
2022-08-01,BLZ,Sarawak,3,2,1
2022-08-01,BLZ,Selangor,4,3,1
2022-08-01,BMU,Selangor,0,0,0
2022-08-01,BOL,Johor,2,1,1
2022-08-01,BOL,Kedah,0,0,0
2022-08-01,BOL,Melaka,0,0,0
2022-08-01,BOL,Perak,0,0,0
2022-08-01,BOL,Perlis,0,0,0
2022-08-01,BOL,Pulau Pinang,0,0,0
2022-08-01,BOL,Sabah,0,0,0
2022-08-01,BOL,Sarawak,2,0,2
2022-08-01,BOL,Selangor,15,9,6
2022-08-01,BRA,Johor,170,102,68
2022-08-01,BRA,Kedah,23,11,12
2022-08-01,BRA,Kelantan,0,0,0
2022-08-01,BRA,Melaka,0,0,0
2022-08-01,BRA,Pahang,0,0,0
2022-08-01,BRA,Perak,2,1,1
2022-08-01,BRA,Perlis,8,3,5
2022-08-01,BRA,Pulau Pinang,12,4,8
2022-08-01,BRA,Sabah,10,4,6
2022-08-01,BRA,Sarawak,3,2,1
2022-08-01,BRA,Selangor,662,360,302
2022-08-01,BRA,W.P. Labuan,0,0,0
2022-08-01,BRB,Johor,1,0,1
2022-08-01,BRB,Kedah,0,0,0
2022-08-01,BRB,Perlis,1,0,1
2022-08-01,BRB,Pulau Pinang,1,1,0
2022-08-01,BRB,Selangor,5,4,1
2022-08-01,BRN,Johor,184,100,84
2022-08-01,BRN,Kedah,2,1,1
2022-08-01,BRN,Kelantan,0,0,0
2022-08-01,BRN,Melaka,0,0,0
2022-08-01,BRN,Pahang,0,0,0
2022-08-01,BRN,Perak,1,0,1
2022-08-01,BRN,Perlis,9,6,3
2022-08-01,BRN,Pulau Pinang,20,9,11
2022-08-01,BRN,Sabah,655,307,348
2022-08-01,BRN,Sarawak,32245,17935,14310
2022-08-01,BRN,Selangor,3362,1746,1616
2022-08-01,BRN,W.P. Labuan,475,278,197
2022-08-01,BTN,Johor,2,2,0
2022-08-01,BTN,Kedah,0,0,0
2022-08-01,BTN,Perak,0,0,0
2022-08-01,BTN,Perlis,0,0,0
2022-08-01,BTN,Pulau Pinang,3,1,2
2022-08-01,BTN,Sabah,0,0,0
2022-08-01,BTN,Sarawak,0,0,0
2022-08-01,BTN,Selangor,38,29,9
2022-08-01,BWA,Johor,0,0,0
2022-08-01,BWA,Kedah,1,0,1
2022-08-01,BWA,Perlis,0,0,0
2022-08-01,BWA,Pulau Pinang,0,0,0
2022-08-01,BWA,Sabah,0,0,0
2022-08-01,BWA,Sarawak,0,0,0
2022-08-01,BWA,Selangor,10,4,6
2022-08-01,CAF,Kedah,0,0,0
2022-08-01,CAF,Selangor,0,0,0
2022-08-01,CAN,Johor,902,521,381
2022-08-01,CAN,Kedah,84,51,33
2022-08-01,CAN,Kelantan,11,5,6
2022-08-01,CAN,Melaka,0,0,0
2022-08-01,CAN,Negeri Sembilan,0,0,0
2022-08-01,CAN,Pahang,0,0,0
2022-08-01,CAN,Perak,21,14,7
2022-08-01,CAN,Perlis,31,19,12
2022-08-01,CAN,Pulau Pinang,219,123,96
2022-08-01,CAN,Sabah,74,34,40
2022-08-01,CAN,Sarawak,164,100,64
2022-08-01,CAN,Selangor,2708,1575,1133
2022-08-01,CAN,Terengganu,0,0,0
2022-08-01,CAN,W.P. Labuan,0,0,0
2022-08-01,CCK,Selangor,0,0,0
2022-08-01,CHE,Johor,347,221,126
2022-08-01,CHE,Kedah,45,24,21
2022-08-01,CHE,Kelantan,4,2,2
2022-08-01,CHE,Melaka,4,2,2
2022-08-01,CHE,Negeri Sembilan,2,1,1
2022-08-01,CHE,Pahang,0,0,0
2022-08-01,CHE,Perak,5,4,1
2022-08-01,CHE,Perlis,28,14,14
2022-08-01,CHE,Pulau Pinang,81,55,26
2022-08-01,CHE,Sabah,30,16,14
2022-08-01,CHE,Sarawak,21,10,11
2022-08-01,CHE,Selangor,993,602,391
2022-08-01,CHE,W.P. Labuan,0,0,0
2022-08-01,CHL,Johor,26,14,12
2022-08-01,CHL,Kedah,5,1,4
2022-08-01,CHL,Kelantan,0,0,0
2022-08-01,CHL,Melaka,0,0,0
2022-08-01,CHL,Pahang,0,0,0
2022-08-01,CHL,Perak,0,0,0
2022-08-01,CHL,Perlis,14,8,6
2022-08-01,CHL,Pulau Pinang,4,3,1
2022-08-01,CHL,Sabah,2,1,1
2022-08-01,CHL,Sarawak,0,0,0
2022-08-01,CHL,Selangor,101,58,43
2022-08-01,CHN,Johor,18386,7559,10827
2022-08-01,CHN,Kedah,290,132,158
2022-08-01,CHN,Kelantan,6,3,3
2022-08-01,CHN,Melaka,0,0,0
2022-08-01,CHN,Pahang,1,1,0
2022-08-01,CHN,Perak,139,64,75
2022-08-01,CHN,Perlis,26,13,13
2022-08-01,CHN,Pulau Pinang,1086,501,585
2022-08-01,CHN,Sabah,272,104,168
2022-08-01,CHN,Sarawak,246,113,133
2022-08-01,CHN,Selangor,11847,7049,4798
2022-08-01,CHN,Terengganu,0,0,0
2022-08-01,CHN,W.P. Labuan,2,0,2
2022-08-01,CIV,Johor,1,0,1
2022-08-01,CIV,Kedah,2,0,2
2022-08-01,CIV,Pulau Pinang,0,0,0
2022-08-01,CIV,Sabah,0,0,0
2022-08-01,CIV,Sarawak,0,0,0
2022-08-01,CIV,Selangor,16,10,6
2022-08-01,CMR,Johor,1,1,0
2022-08-01,CMR,Kedah,0,0,0
2022-08-01,CMR,Pulau Pinang,0,0,0
2022-08-01,CMR,Sabah,1,1,0
2022-08-01,CMR,Sarawak,0,0,0
2022-08-01,CMR,Selangor,20,10,10
2022-08-01,COD,Johor,0,0,0
2022-08-01,COD,Pulau Pinang,0,0,0
2022-08-01,COD,Sarawak,0,0,0
2022-08-01,COD,Selangor,14,10,4
2022-08-01,COG,Johor,0,0,0
2022-08-01,COG,Kedah,0,0,0
2022-08-01,COG,Selangor,0,0,0
2022-08-01,COK,Selangor,0,0,0
2022-08-01,COL,Johor,16,6,10
2022-08-01,COL,Kedah,0,0,0
2022-08-01,COL,Perak,3,1,2
2022-08-01,COL,Pulau Pinang,2,1,1
2022-08-01,COL,Sabah,2,1,1
2022-08-01,COL,Sarawak,0,0,0
2022-08-01,COL,Selangor,92,51,41
2022-08-01,COL,W.P. Labuan,0,0,0
2022-08-01,COM,Johor,0,0,0
2022-08-01,COM,Kedah,1,0,1
2022-08-01,COM,Selangor,9,3,6
2022-08-01,CPV,Johor,0,0,0
2022-08-01,CPV,Kedah,0,0,0
2022-08-01,CPV,Pulau Pinang,0,0,0
2022-08-01,CPV,Sabah,0,0,0
2022-08-01,CPV,Selangor,5,3,2
2022-08-01,CRI,Johor,0,0,0
2022-08-01,CRI,Kedah,0,0,0
2022-08-01,CRI,Perak,0,0,0
2022-08-01,CRI,Perlis,1,1,0
2022-08-01,CRI,Pulau Pinang,4,2,2
2022-08-01,CRI,Sabah,1,0,1
2022-08-01,CRI,Sarawak,2,1,1
2022-08-01,CRI,Selangor,35,17,18
2022-08-01,CUB,Johor,0,0,0
2022-08-01,CUB,Kedah,0,0,0
2022-08-01,CUB,Perlis,1,1,0
2022-08-01,CUB,Pulau Pinang,0,0,0
2022-08-01,CUB,Sabah,0,0,0
2022-08-01,CUB,Sarawak,0,0,0
2022-08-01,CUB,Selangor,19,12,7
2022-08-01,CYP,Johor,7,6,1
2022-08-01,CYP,Kedah,0,0,0
2022-08-01,CYP,Perak,0,0,0
2022-08-01,CYP,Perlis,0,0,0
2022-08-01,CYP,Pulau Pinang,2,2,0
2022-08-01,CYP,Sabah,2,1,1
2022-08-01,CYP,Sarawak,3,2,1
2022-08-01,CYP,Selangor,60,32,28
2022-08-01,CZE,Johor,109,59,50
2022-08-01,CZE,Kedah,21,9,12
2022-08-01,CZE,Kelantan,0,0,0
2022-08-01,CZE,Melaka,0,0,0
2022-08-01,CZE,Negeri Sembilan,0,0,0
2022-08-01,CZE,Perak,0,0,0
2022-08-01,CZE,Perlis,6,4,2
2022-08-01,CZE,Pulau Pinang,19,9,10
2022-08-01,CZE,Sabah,12,7,5
2022-08-01,CZE,Sarawak,17,7,10
2022-08-01,CZE,Selangor,312,175,137
2022-08-01,CZE,W.P. Labuan,0,0,0
2022-08-01,DEU,Johor,1900,1196,704
2022-08-01,DEU,Kedah,244,126,118
2022-08-01,DEU,Kelantan,12,8,4
2022-08-01,DEU,Melaka,1,1,0
2022-08-01,DEU,Negeri Sembilan,0,0,0
2022-08-01,DEU,Pahang,0,0,0
2022-08-01,DEU,Perak,21,13,8
2022-08-01,DEU,Perlis,76,35,41
2022-08-01,DEU,Pulau Pinang,493,340,153
2022-08-01,DEU,Sabah,151,77,74
2022-08-01,DEU,Sarawak,174,102,72
2022-08-01,DEU,Selangor,6483,3742,2741
2022-08-01,DEU,Terengganu,0,0,0
2022-08-01,DEU,W.P. Labuan,0,0,0
2022-08-01,DJI,Johor,0,0,0
2022-08-01,DJI,Selangor,18,13,5
2022-08-01,DMA,Johor,1,1,0
2022-08-01,DMA,Kedah,1,1,0
2022-08-01,DMA,Pulau Pinang,5,5,0
2022-08-01,DMA,Sabah,0,0,0
2022-08-01,DMA,Sarawak,0,0,0
2022-08-01,DMA,Selangor,31,21,10
2022-08-01,DMA,W.P. Labuan,0,0,0
2022-08-01,DNK,Johor,199,132,67
2022-08-01,DNK,Kedah,44,19,25
2022-08-01,DNK,Kelantan,1,0,1
2022-08-01,DNK,Melaka,0,0,0
2022-08-01,DNK,Negeri Sembilan,0,0,0
2022-08-01,DNK,Pahang,1,1,0
2022-08-01,DNK,Perak,2,2,0
2022-08-01,DNK,Perlis,2,1,1
2022-08-01,DNK,Pulau Pinang,41,36,5
2022-08-01,DNK,Sabah,27,14,13
2022-08-01,DNK,Sarawak,25,11,14
2022-08-01,DNK,Selangor,670,408,262
2022-08-01,DNK,W.P. Labuan,0,0,0
2022-08-01,DOM,Johor,2,0,2
2022-08-01,DOM,Kedah,0,0,0
2022-08-01,DOM,Perak,0,0,0
2022-08-01,DOM,Perlis,0,0,0
2022-08-01,DOM,Pulau Pinang,0,0,0
2022-08-01,DOM,Sabah,0,0,0
2022-08-01,DOM,Sarawak,0,0,0
2022-08-01,DOM,Selangor,11,7,4
2022-08-01,DZA,Johor,20,16,4
2022-08-01,DZA,Kedah,2,2,0
2022-08-01,DZA,Kelantan,0,0,0
2022-08-01,DZA,Melaka,0,0,0
2022-08-01,DZA,Perak,0,0,0
2022-08-01,DZA,Perlis,0,0,0
2022-08-01,DZA,Pulau Pinang,1,1,0
2022-08-01,DZA,Sabah,1,1,0
2022-08-01,DZA,Sarawak,4,3,1
2022-08-01,DZA,Selangor,901,467,434
2022-08-01,DZA,W.P. Labuan,0,0,0
2022-08-01,ECU,Johor,6,4,2
2022-08-01,ECU,Kedah,1,0,1
2022-08-01,ECU,Perak,0,0,0
2022-08-01,ECU,Perlis,0,0,0
2022-08-01,ECU,Pulau Pinang,3,1,2
2022-08-01,ECU,Sabah,1,0,1
2022-08-01,ECU,Sarawak,3,1,2
2022-08-01,ECU,Selangor,52,22,30
2022-08-01,EGY,Johor,183,136,47
2022-08-01,EGY,Kedah,1,1,0
2022-08-01,EGY,Kelantan,1,1,0
2022-08-01,EGY,Melaka,0,0,0
2022-08-01,EGY,Pahang,0,0,0
2022-08-01,EGY,Perak,0,0,0
2022-08-01,EGY,Perlis,0,0,0
2022-08-01,EGY,Pulau Pinang,4,4,0
2022-08-01,EGY,Sabah,5,4,1
2022-08-01,EGY,Sarawak,72,44,28
2022-08-01,EGY,Selangor,1648,1044,604
2022-08-01,EGY,Terengganu,0,0,0
2022-08-01,EGY,W.P. Labuan,1,1,0
2022-08-01,ERI,Johor,0,0,0
2022-08-01,ERI,Pulau Pinang,0,0,0
2022-08-01,ERI,Sabah,0,0,0
2022-08-01,ERI,Selangor,7,4,3
2022-08-01,ESP,Johor,790,396,394
2022-08-01,ESP,Kedah,83,47,36
2022-08-01,ESP,Kelantan,10,7,3
2022-08-01,ESP,Melaka,0,0,0
2022-08-01,ESP,Negeri Sembilan,0,0,0
2022-08-01,ESP,Pahang,0,0,0
2022-08-01,ESP,Perak,15,8,7
2022-08-01,ESP,Perlis,17,11,6
2022-08-01,ESP,Pulau Pinang,233,112,121
2022-08-01,ESP,Sabah,77,42,35
2022-08-01,ESP,Sarawak,87,49,38
2022-08-01,ESP,Selangor,4946,2559,2387
2022-08-01,ESP,W.P. Labuan,1,1,0
2022-08-01,EST,Johor,17,8,9
2022-08-01,EST,Kedah,2,1,1
2022-08-01,EST,Kelantan,0,0,0
2022-08-01,EST,Pahang,0,0,0
2022-08-01,EST,Perak,0,0,0
2022-08-01,EST,Perlis,1,0,1
2022-08-01,EST,Pulau Pinang,2,1,1
2022-08-01,EST,Sabah,0,0,0
2022-08-01,EST,Sarawak,2,1,1
2022-08-01,EST,Selangor,63,26,37
2022-08-01,EST,W.P. Labuan,0,0,0
2022-08-01,ETH,Johor,1,1,0
2022-08-01,ETH,Kedah,0,0,0
2022-08-01,ETH,Pulau Pinang,0,0,0
2022-08-01,ETH,Sarawak,0,0,0
2022-08-01,ETH,Selangor,34,19,15
2022-08-01,FIN,Johor,95,59,36
2022-08-01,FIN,Kedah,7,4,3
2022-08-01,FIN,Kelantan,0,0,0
2022-08-01,FIN,Melaka,0,0,0
2022-08-01,FIN,Negeri Sembilan,0,0,0
2022-08-01,FIN,Pahang,0,0,0
2022-08-01,FIN,Perak,1,1,0
2022-08-01,FIN,Perlis,2,1,1
2022-08-01,FIN,Pulau Pinang,11,7,4
2022-08-01,FIN,Sabah,6,1,5
2022-08-01,FIN,Sarawak,3,1,2
2022-08-01,FIN,Selangor,193,121,72
2022-08-01,FIN,W.P. Labuan,0,0,0
2022-08-01,FJI,Johor,26,14,12
2022-08-01,FJI,Kedah,0,0,0
2022-08-01,FJI,Kelantan,0,0,0
2022-08-01,FJI,Perak,0,0,0
2022-08-01,FJI,Perlis,1,1,0
2022-08-01,FJI,Pulau Pinang,0,0,0
2022-08-01,FJI,Sabah,1,1,0
2022-08-01,FJI,Sarawak,0,0,0
2022-08-01,FJI,Selangor,59,30,29
2022-08-01,FRA,Johor,2203,1303,900
2022-08-01,FRA,Kedah,194,111,83
2022-08-01,FRA,Kelantan,4,2,2
2022-08-01,FRA,Melaka,1,0,1
2022-08-01,FRA,Negeri Sembilan,1,1,0
2022-08-01,FRA,Pahang,5,5,0
2022-08-01,FRA,Perak,23,13,10
2022-08-01,FRA,Perlis,82,44,38
2022-08-01,FRA,Pulau Pinang,314,199,115
2022-08-01,FRA,Sabah,167,94,73
2022-08-01,FRA,Sarawak,161,88,73
2022-08-01,FRA,Selangor,10785,5892,4893
2022-08-01,FRA,Terengganu,0,0,0
2022-08-01,FRA,W.P. Labuan,9,7,2
2022-08-01,FSM,Johor,0,0,0
2022-08-01,FSM,Pulau Pinang,0,0,0
2022-08-01,FSM,Selangor,1,0,1
2022-08-01,GAB,Johor,11,6,5
2022-08-01,GAB,Pulau Pinang,0,0,0
2022-08-01,GAB,Sarawak,0,0,0
2022-08-01,GAB,Selangor,6,2,4
2022-08-01,GBR,Johor,4151,2630,1521
2022-08-01,GBR,Kedah,598,331,267
2022-08-01,GBR,Kelantan,9,8,1
2022-08-01,GBR,Melaka,2,1,1
2022-08-01,GBR,Negeri Sembilan,0,0,0
2022-08-01,GBR,Pahang,10,8,2
2022-08-01,GBR,Perak,93,51,42
2022-08-01,GBR,Perlis,140,93,47
2022-08-01,GBR,Pulau Pinang,1067,644,423
2022-08-01,GBR,Sabah,552,307,245
2022-08-01,GBR,Sarawak,985,609,376
2022-08-01,GBR,Selangor,16004,9302,6702
2022-08-01,GBR,Terengganu,0,0,0
2022-08-01,GBR,W.P. Labuan,16,10,6
2022-08-01,GEO,Johor,9,8,1
2022-08-01,GEO,Kedah,0,0,0
2022-08-01,GEO,Melaka,0,0,0
2022-08-01,GEO,Perak,0,0,0
2022-08-01,GEO,Perlis,0,0,0
2022-08-01,GEO,Pulau Pinang,0,0,0
2022-08-01,GEO,Sabah,0,0,0
2022-08-01,GEO,Sarawak,0,0,0
2022-08-01,GEO,Selangor,41,32,9
2022-08-01,GHA,Johor,3,3,0
2022-08-01,GHA,Kedah,0,0,0
2022-08-01,GHA,Kelantan,0,0,0
2022-08-01,GHA,Pulau Pinang,0,0,0
2022-08-01,GHA,Sabah,0,0,0
2022-08-01,GHA,Sarawak,0,0,0
2022-08-01,GHA,Selangor,45,30,15
2022-08-01,GIB,Johor,0,0,0
2022-08-01,GIB,Sarawak,0,0,0
2022-08-01,GIN,Johor,3,1,2
2022-08-01,GIN,Kedah,0,0,0
2022-08-01,GIN,Kelantan,0,0,0
2022-08-01,GIN,Perlis,0,0,0
2022-08-01,GIN,Pulau Pinang,0,0,0
2022-08-01,GIN,Sabah,0,0,0
2022-08-01,GIN,Sarawak,0,0,0
2022-08-01,GIN,Selangor,38,26,12
2022-08-01,GLP,Selangor,0,0,0
2022-08-01,GMB,Johor,4,4,0
2022-08-01,GMB,Kedah,0,0,0
2022-08-01,GMB,Kelantan,0,0,0
2022-08-01,GMB,Pulau Pinang,0,0,0
2022-08-01,GMB,Sabah,0,0,0
2022-08-01,GMB,Sarawak,0,0,0
2022-08-01,GMB,Selangor,21,12,9
2022-08-01,GNB,Johor,0,0,0
2022-08-01,GNB,Selangor,0,0,0
2022-08-01,GNQ,Johor,0,0,0
2022-08-01,GNQ,Selangor,1,0,1
2022-08-01,GRC,Johor,34,31,3
2022-08-01,GRC,Kedah,6,2,4
2022-08-01,GRC,Kelantan,0,0,0
2022-08-01,GRC,Melaka,0,0,0
2022-08-01,GRC,Negeri Sembilan,0,0,0
2022-08-01,GRC,Pahang,0,0,0
2022-08-01,GRC,Perak,0,0,0
2022-08-01,GRC,Perlis,0,0,0
2022-08-01,GRC,Pulau Pinang,15,10,5
2022-08-01,GRC,Sabah,1,1,0
2022-08-01,GRC,Sarawak,3,1,2
2022-08-01,GRC,Selangor,197,116,81
2022-08-01,GRD,Johor,9,6,3
2022-08-01,GRD,Kedah,4,3,1
2022-08-01,GRD,Pulau Pinang,2,1,1
2022-08-01,GRD,Sabah,0,0,0
2022-08-01,GRD,Sarawak,1,1,0
2022-08-01,GRD,Selangor,9,6,3
2022-08-01,GRL,Johor,0,0,0
2022-08-01,GRL,Selangor,0,0,0
2022-08-01,GTM,Johor,1,1,0
2022-08-01,GTM,Kedah,0,0,0
2022-08-01,GTM,Pahang,0,0,0
2022-08-01,GTM,Perak,0,0,0
2022-08-01,GTM,Pulau Pinang,0,0,0
2022-08-01,GTM,Sabah,0,0,0
2022-08-01,GTM,Sarawak,0,0,0
2022-08-01,GTM,Selangor,11,9,2
2022-08-01,GTM,W.P. Labuan,0,0,0
2022-08-01,GUY,Johor,3,3,0
2022-08-01,GUY,Kedah,0,0,0
2022-08-01,GUY,Pulau Pinang,0,0,0
2022-08-01,GUY,Sarawak,0,0,0
2022-08-01,GUY,Selangor,3,2,1
2022-08-01,HKG,Johor,3,3,0
2022-08-01,HKG,Kedah,0,0,0
2022-08-01,HKG,Kelantan,0,0,0
2022-08-01,HKG,Pahang,0,0,0
2022-08-01,HKG,Perak,21,9,12
2022-08-01,HKG,Perlis,9,5,4
2022-08-01,HKG,Pulau Pinang,0,0,0
2022-08-01,HKG,Sabah,47,26,21
2022-08-01,HKG,Sarawak,31,20,11
2022-08-01,HKG,Selangor,4,3,1
2022-08-01,HKG,Terengganu,0,0,0
2022-08-01,HMD,Johor,0,0,0
2022-08-01,HND,Johor,1,0,1
2022-08-01,HND,Kedah,0,0,0
2022-08-01,HND,Perak,0,0,0
2022-08-01,HND,Pulau Pinang,1,0,1
2022-08-01,HND,Sabah,0,0,0
2022-08-01,HND,Sarawak,0,0,0
2022-08-01,HND,Selangor,9,5,4
2022-08-01,HRV,Johor,13,9,4
2022-08-01,HRV,Kedah,2,0,2
2022-08-01,HRV,Kelantan,0,0,0
2022-08-01,HRV,Melaka,0,0,0
2022-08-01,HRV,Pahang,0,0,0
2022-08-01,HRV,Perak,0,0,0
2022-08-01,HRV,Perlis,0,0,0
2022-08-01,HRV,Pulau Pinang,3,1,2
2022-08-01,HRV,Sabah,5,5,0
2022-08-01,HRV,Sarawak,0,0,0
2022-08-01,HRV,Selangor,127,90,37
2022-08-01,HTI,Johor,0,0,0
2022-08-01,HTI,Kedah,0,0,0
2022-08-01,HTI,Kelantan,0,0,0
2022-08-01,HTI,Perak,0,0,0
2022-08-01,HTI,Pulau Pinang,0,0,0
2022-08-01,HTI,Sabah,0,0,0
2022-08-01,HTI,Selangor,1,1,0
2022-08-01,HUN,Johor,81,56,25
2022-08-01,HUN,Kedah,4,1,3
2022-08-01,HUN,Kelantan,0,0,0
2022-08-01,HUN,Pahang,0,0,0
2022-08-01,HUN,Perak,1,0,1
2022-08-01,HUN,Perlis,0,0,0
2022-08-01,HUN,Pulau Pinang,9,7,2
2022-08-01,HUN,Sabah,5,4,1
2022-08-01,HUN,Sarawak,2,2,0
2022-08-01,HUN,Selangor,245,137,108
2022-08-01,HUN,W.P. Labuan,0,0,0
2022-08-01,IDN,Johor,85856,48437,37419
2022-08-01,IDN,Kedah,2239,857,1382
2022-08-01,IDN,Kelantan,126,63,63
2022-08-01,IDN,Melaka,6462,2744,3718
2022-08-01,IDN,Negeri Sembilan,7501,5238,2263
2022-08-01,IDN,Pahang,28,24,4
2022-08-01,IDN,Perak,105,36,69
2022-08-01,IDN,Perlis,291,128,163
2022-08-01,IDN,Pulau Pinang,20947,7971,12976
2022-08-01,IDN,Sabah,3757,1882,1875
2022-08-01,IDN,Sarawak,24047,13692,10355
2022-08-01,IDN,Selangor,60380,29211,31169
2022-08-01,IDN,Terengganu,0,0,0
2022-08-01,IDN,W.P. Labuan,11,4,7
2022-08-01,IND,Johor,13312,9303,4009
2022-08-01,IND,Kedah,514,286,228
2022-08-01,IND,Kelantan,5,4,1
2022-08-01,IND,Melaka,1,1,0
2022-08-01,IND,Negeri Sembilan,0,0,0
2022-08-01,IND,Pahang,0,0,0
2022-08-01,IND,Perak,865,740,125
2022-08-01,IND,Perlis,68,55,13
2022-08-01,IND,Pulau Pinang,628,452,176
2022-08-01,IND,Sabah,174,116,58
2022-08-01,IND,Sarawak,199,160,39
2022-08-01,IND,Selangor,40291,29328,10963
2022-08-01,IND,Terengganu,0,0,0
2022-08-01,IND,W.P. Labuan,4,3,1
2022-08-01,IOT,Pulau Pinang,0,0,0
2022-08-01,IOT,Selangor,0,0,0
2022-08-01,IRL,Johor,199,130,69
2022-08-01,IRL,Kedah,27,14,13
2022-08-01,IRL,Kelantan,0,0,0
2022-08-01,IRL,Negeri Sembilan,0,0,0
2022-08-01,IRL,Pahang,0,0,0
2022-08-01,IRL,Perak,8,4,4
2022-08-01,IRL,Perlis,8,5,3
2022-08-01,IRL,Pulau Pinang,49,32,17
2022-08-01,IRL,Sabah,28,13,15
2022-08-01,IRL,Sarawak,28,13,15
2022-08-01,IRL,Selangor,973,567,406
2022-08-01,IRL,Terengganu,0,0,0
2022-08-01,IRL,W.P. Labuan,0,0,0
2022-08-01,IRN,Johor,62,41,21
2022-08-01,IRN,Kedah,2,2,0
2022-08-01,IRN,Kelantan,0,0,0
2022-08-01,IRN,Perak,0,0,0
2022-08-01,IRN,Perlis,0,0,0
2022-08-01,IRN,Pulau Pinang,2,1,1
2022-08-01,IRN,Sabah,3,2,1
2022-08-01,IRN,Sarawak,1,0,1
2022-08-01,IRN,Selangor,1129,600,529
2022-08-01,IRN,W.P. Labuan,0,0,0
2022-08-01,IRQ,Johor,14,10,4
2022-08-01,IRQ,Kedah,5,2,3
2022-08-01,IRQ,Kelantan,0,0,0
2022-08-01,IRQ,Melaka,4,3,1
2022-08-01,IRQ,Pahang,0,0,0
2022-08-01,IRQ,Perak,0,0,0
2022-08-01,IRQ,Perlis,0,0,0
2022-08-01,IRQ,Pulau Pinang,2,2,0
2022-08-01,IRQ,Sabah,1,1,0
2022-08-01,IRQ,Sarawak,0,0,0
2022-08-01,IRQ,Selangor,872,523,349
2022-08-01,ISL,Johor,2,2,0
2022-08-01,ISL,Kedah,2,2,0
2022-08-01,ISL,Kelantan,0,0,0
2022-08-01,ISL,Perak,0,0,0
2022-08-01,ISL,Perlis,0,0,0
2022-08-01,ISL,Pulau Pinang,1,1,0
2022-08-01,ISL,Sabah,0,0,0
2022-08-01,ISL,Sarawak,5,3,2
2022-08-01,ISL,Selangor,17,12,5
2022-08-01,ISL,W.P. Labuan,0,0,0
2022-08-01,ISR,Pulau Pinang,0,0,0
2022-08-01,ITA,Johor,923,555,368
2022-08-01,ITA,Kedah,65,38,27
2022-08-01,ITA,Kelantan,7,2,5
2022-08-01,ITA,Melaka,0,0,0
2022-08-01,ITA,Negeri Sembilan,0,0,0
2022-08-01,ITA,Pahang,1,1,0
2022-08-01,ITA,Perak,12,5,7
2022-08-01,ITA,Perlis,21,12,9
2022-08-01,ITA,Pulau Pinang,145,88,57
2022-08-01,ITA,Sabah,90,41,49
2022-08-01,ITA,Sarawak,106,49,57
2022-08-01,ITA,Selangor,4930,2751,2179
2022-08-01,ITA,W.P. Labuan,0,0,0
2022-08-01,JAM,Johor,0,0,0
2022-08-01,JAM,Kedah,0,0,0
2022-08-01,JAM,Perak,0,0,0
2022-08-01,JAM,Pulau Pinang,2,1,1
2022-08-01,JAM,Sabah,0,0,0
2022-08-01,JAM,Sarawak,0,0,0
2022-08-01,JAM,Selangor,21,12,9
2022-08-01,JAM,W.P. Labuan,0,0,0
2022-08-01,JOR,Johor,5,4,1
2022-08-01,JOR,Kedah,1,1,0
2022-08-01,JOR,Kelantan,0,0,0
2022-08-01,JOR,Melaka,0,0,0
2022-08-01,JOR,Perlis,0,0,0
2022-08-01,JOR,Pulau Pinang,2,1,1
2022-08-01,JOR,Sabah,0,0,0
2022-08-01,JOR,Sarawak,0,0,0
2022-08-01,JOR,Selangor,648,382,266
2022-08-01,JOR,W.P. Labuan,0,0,0
2022-08-01,JPN,Johor,4695,3275,1420
2022-08-01,JPN,Kedah,142,71,71
2022-08-01,JPN,Kelantan,6,4,2
2022-08-01,JPN,Melaka,0,0,0
2022-08-01,JPN,Negeri Sembilan,0,0,0
2022-08-01,JPN,Pahang,6,4,2
2022-08-01,JPN,Perak,34,20,14
2022-08-01,JPN,Perlis,26,18,8
2022-08-01,JPN,Pulau Pinang,1091,710,381
2022-08-01,JPN,Sabah,240,104,136
2022-08-01,JPN,Sarawak,113,60,53
2022-08-01,JPN,Selangor,11022,6681,4341
2022-08-01,JPN,W.P. Labuan,6,4,2
2022-08-01,KAZ,Johor,31,17,14
2022-08-01,KAZ,Kedah,8,2,6
2022-08-01,KAZ,Kelantan,0,0,0
2022-08-01,KAZ,Melaka,0,0,0
2022-08-01,KAZ,Perak,0,0,0
2022-08-01,KAZ,Perlis,0,0,0
2022-08-01,KAZ,Pulau Pinang,1,1,0
2022-08-01,KAZ,Sabah,5,1,4
2022-08-01,KAZ,Sarawak,2,0,2
2022-08-01,KAZ,Selangor,378,184,194
2022-08-01,KAZ,W.P. Labuan,0,0,0
2022-08-01,KEN,Johor,35,13,22
2022-08-01,KEN,Kedah,6,5,1
2022-08-01,KEN,Kelantan,0,0,0
2022-08-01,KEN,Perak,0,0,0
2022-08-01,KEN,Perlis,0,0,0
2022-08-01,KEN,Pulau Pinang,2,1,1
2022-08-01,KEN,Sabah,1,1,0
2022-08-01,KEN,Sarawak,1,0,1
2022-08-01,KEN,Selangor,219,116,103
2022-08-01,KGZ,Johor,20,6,14
2022-08-01,KGZ,Kedah,0,0,0
2022-08-01,KGZ,Kelantan,1,0,1
2022-08-01,KGZ,Perak,0,0,0
2022-08-01,KGZ,Perlis,0,0,0
2022-08-01,KGZ,Pulau Pinang,0,0,0
2022-08-01,KGZ,Sabah,0,0,0
2022-08-01,KGZ,Sarawak,0,0,0
2022-08-01,KGZ,Selangor,172,90,82
2022-08-01,KHM,Johor,1325,588,737
2022-08-01,KHM,Kedah,57,44,13
2022-08-01,KHM,Kelantan,514,316,198
2022-08-01,KHM,Melaka,0,0,0
2022-08-01,KHM,Negeri Sembilan,0,0,0
2022-08-01,KHM,Pahang,0,0,0
2022-08-01,KHM,Perak,20,16,4
2022-08-01,KHM,Perlis,1020,647,373
2022-08-01,KHM,Pulau Pinang,18,8,10
2022-08-01,KHM,Sabah,0,0,0
2022-08-01,KHM,Sarawak,2,1,1
2022-08-01,KHM,Selangor,3146,1562,1584
2022-08-01,KHM,W.P. Labuan,0,0,0
2022-08-01,KIR,Johor,0,0,0
2022-08-01,KIR,Sabah,0,0,0
2022-08-01,KIR,Selangor,0,0,0
2022-08-01,KNA,Johor,19,10,9
2022-08-01,KNA,Kedah,0,0,0
2022-08-01,KNA,Perlis,1,1,0
2022-08-01,KNA,Pulau Pinang,0,0,0
2022-08-01,KNA,Sabah,0,0,0
2022-08-01,KNA,Selangor,33,29,4
2022-08-01,KNA,W.P. Labuan,0,0,0
2022-08-01,KOR,Johor,8356,4576,3780
2022-08-01,KOR,Kedah,125,60,65
2022-08-01,KOR,Kelantan,1,1,0
2022-08-01,KOR,Melaka,4,4,0
2022-08-01,KOR,Negeri Sembilan,0,0,0
2022-08-01,KOR,Pahang,0,0,0
2022-08-01,KOR,Perak,15,10,5
2022-08-01,KOR,Perlis,47,33,14
2022-08-01,KOR,Pulau Pinang,480,270,210
2022-08-01,KOR,Sabah,8892,3946,4946
2022-08-01,KOR,Sarawak,110,69,41
2022-08-01,KOR,Selangor,8249,4679,3570
2022-08-01,KOR,Terengganu,0,0,0
2022-08-01,KOR,W.P. Labuan,1,0,1
2022-08-01,KWT,Johor,100,58,42
2022-08-01,KWT,Kedah,23,13,10
2022-08-01,KWT,Kelantan,0,0,0
2022-08-01,KWT,Perak,1,1,0
2022-08-01,KWT,Perlis,0,0,0
2022-08-01,KWT,Pulau Pinang,13,6,7
2022-08-01,KWT,Sabah,0,0,0
2022-08-01,KWT,Sarawak,0,0,0
2022-08-01,KWT,Selangor,1308,641,667
2022-08-01,KWT,W.P. Labuan,0,0,0
2022-08-01,LAO,Johor,48,12,36
2022-08-01,LAO,Kedah,212,32,180
2022-08-01,LAO,Kelantan,82,5,77
2022-08-01,LAO,Melaka,0,0,0
2022-08-01,LAO,Perak,27,3,24
2022-08-01,LAO,Perlis,475,79,396
2022-08-01,LAO,Pulau Pinang,10,1,9
2022-08-01,LAO,Sabah,1,0,1
2022-08-01,LAO,Sarawak,6,4,2
2022-08-01,LAO,Selangor,309,105,204
2022-08-01,LAO,W.P. Labuan,0,0,0
2022-08-01,LBN,Johor,13,11,2
2022-08-01,LBN,Kedah,1,1,0
2022-08-01,LBN,Kelantan,0,0,0
2022-08-01,LBN,Pahang,0,0,0
2022-08-01,LBN,Perak,0,0,0
2022-08-01,LBN,Perlis,0,0,0
2022-08-01,LBN,Pulau Pinang,2,1,1
2022-08-01,LBN,Sabah,1,0,1
2022-08-01,LBN,Sarawak,0,0,0
2022-08-01,LBN,Selangor,177,115,62
2022-08-01,LBN,W.P. Labuan,1,1,0
2022-08-01,LBR,Johor,3,3,0
2022-08-01,LBR,Kedah,0,0,0
2022-08-01,LBR,Sabah,0,0,0
2022-08-01,LBR,Sarawak,0,0,0
2022-08-01,LBR,Selangor,5,2,3
2022-08-01,LBY,Johor,3,3,0
2022-08-01,LBY,Kedah,0,0,0
2022-08-01,LBY,Perlis,0,0,0
2022-08-01,LBY,Pulau Pinang,0,0,0
2022-08-01,LBY,Sabah,0,0,0
2022-08-01,LBY,Sarawak,7,3,4
2022-08-01,LBY,Selangor,258,180,78
2022-08-01,LCA,Johor,3,3,0
2022-08-01,LCA,Kedah,0,0,0
2022-08-01,LCA,Pulau Pinang,0,0,0
2022-08-01,LCA,Sarawak,0,0,0
2022-08-01,LCA,Selangor,13,5,8
2022-08-01,LIE,Johor,1,1,0
2022-08-01,LIE,Kedah,0,0,0
2022-08-01,LIE,Perlis,0,0,0
2022-08-01,LIE,Pulau Pinang,0,0,0
2022-08-01,LIE,Sabah,0,0,0
2022-08-01,LIE,Sarawak,0,0,0
2022-08-01,LIE,Selangor,2,1,1
2022-08-01,LKA,Johor,1010,659,351
2022-08-01,LKA,Kedah,53,30,23
2022-08-01,LKA,Kelantan,0,0,0
2022-08-01,LKA,Melaka,0,0,0
2022-08-01,LKA,Pahang,0,0,0
2022-08-01,LKA,Perak,6,3,3
2022-08-01,LKA,Perlis,2,1,1
2022-08-01,LKA,Pulau Pinang,27,16,11
2022-08-01,LKA,Sabah,2,1,1
2022-08-01,LKA,Sarawak,12,11,1
2022-08-01,LKA,Selangor,2490,1615,875
2022-08-01,LKA,W.P. Labuan,0,0,0
2022-08-01,LSO,Johor,0,0,0
2022-08-01,LSO,Kedah,0,0,0
2022-08-01,LSO,Pulau Pinang,0,0,0
2022-08-01,LSO,Sarawak,0,0,0
2022-08-01,LSO,Selangor,1,1,0
2022-08-01,LTU,Johor,21,6,15
2022-08-01,LTU,Kedah,5,1,4
2022-08-01,LTU,Kelantan,0,0,0
2022-08-01,LTU,Pahang,0,0,0
2022-08-01,LTU,Perak,0,0,0
2022-08-01,LTU,Perlis,2,2,0
2022-08-01,LTU,Pulau Pinang,12,5,7
2022-08-01,LTU,Sabah,1,1,0
2022-08-01,LTU,Sarawak,2,0,2
2022-08-01,LTU,Selangor,128,78,50
2022-08-01,LTU,W.P. Labuan,0,0,0
2022-08-01,LUX,Johor,5,0,5
2022-08-01,LUX,Kedah,4,2,2
2022-08-01,LUX,Kelantan,0,0,0
2022-08-01,LUX,Perak,0,0,0
2022-08-01,LUX,Perlis,2,1,1
2022-08-01,LUX,Pulau Pinang,4,3,1
2022-08-01,LUX,Sabah,0,0,0
2022-08-01,LUX,Sarawak,0,0,0
2022-08-01,LUX,Selangor,55,31,24
2022-08-01,LVA,Johor,6,5,1
2022-08-01,LVA,Kedah,3,1,2
2022-08-01,LVA,Kelantan,0,0,0
2022-08-01,LVA,Pahang,0,0,0
2022-08-01,LVA,Perak,0,0,0
2022-08-01,LVA,Perlis,0,0,0
2022-08-01,LVA,Pulau Pinang,1,0,1
2022-08-01,LVA,Sabah,0,0,0
2022-08-01,LVA,Sarawak,4,3,1
2022-08-01,LVA,Selangor,98,58,40
2022-08-01,LVA,W.P. Labuan,0,0,0
2022-08-01,MAC,Johor,0,0,0
2022-08-01,MAC,Pahang,0,0,0
2022-08-01,MAC,Perak,0,0,0
2022-08-01,MAC,Selangor,0,0,0
2022-08-01,MAC,W.P. Labuan,0,0,0
2022-08-01,MAR,Johor,69,49,20
2022-08-01,MAR,Kedah,9,4,5
2022-08-01,MAR,Kelantan,1,1,0
2022-08-01,MAR,Melaka,1,0,1
2022-08-01,MAR,Pahang,0,0,0
2022-08-01,MAR,Perak,0,0,0
2022-08-01,MAR,Perlis,4,2,2
2022-08-01,MAR,Pulau Pinang,6,3,3
2022-08-01,MAR,Sabah,1,1,0
2022-08-01,MAR,Sarawak,2,2,0
2022-08-01,MAR,Selangor,851,389,462
2022-08-01,MAR,W.P. Labuan,0,0,0
2022-08-01,MCO,Johor,0,0,0
2022-08-01,MCO,Kedah,0,0,0
2022-08-01,MCO,Sabah,0,0,0
2022-08-01,MCO,Selangor,0,0,0
2022-08-01,MDA,Johor,2,1,1
2022-08-01,MDA,Kedah,0,0,0
2022-08-01,MDA,Kelantan,0,0,0
2022-08-01,MDA,Negeri Sembilan,0,0,0
2022-08-01,MDA,Perlis,0,0,0
2022-08-01,MDA,Pulau Pinang,0,0,0
2022-08-01,MDA,Sabah,0,0,0
2022-08-01,MDA,Sarawak,0,0,0
2022-08-01,MDA,Selangor,22,11,11
2022-08-01,MDG,Johor,5,3,2
2022-08-01,MDG,Kedah,0,0,0
2022-08-01,MDG,Perak,0,0,0
2022-08-01,MDG,Perlis,0,0,0
2022-08-01,MDG,Pulau Pinang,0,0,0
2022-08-01,MDG,Sabah,0,0,0
2022-08-01,MDG,Sarawak,0,0,0
2022-08-01,MDG,Selangor,12,4,8
2022-08-01,MDV,Johor,71,46,25
2022-08-01,MDV,Kedah,6,3,3
2022-08-01,MDV,Kelantan,0,0,0
2022-08-01,MDV,Perak,4,2,2
2022-08-01,MDV,Perlis,0,0,0
2022-08-01,MDV,Pulau Pinang,2,1,1
2022-08-01,MDV,Sabah,0,0,0
2022-08-01,MDV,Sarawak,3,1,2
2022-08-01,MDV,Selangor,1763,897,866
2022-08-01,MEX,Johor,73,41,32
2022-08-01,MEX,Kedah,2,0,2
2022-08-01,MEX,Kelantan,0,0,0
2022-08-01,MEX,Pahang,0,0,0
2022-08-01,MEX,Perak,0,0,0
2022-08-01,MEX,Perlis,2,2,0
2022-08-01,MEX,Pulau Pinang,31,23,8
2022-08-01,MEX,Sabah,5,2,3
2022-08-01,MEX,Sarawak,2,1,1
2022-08-01,MEX,Selangor,306,167,139
2022-08-01,MEX,W.P. Labuan,0,0,0
2022-08-01,MHL,Johor,0,0,0
2022-08-01,MHL,Kedah,0,0,0
2022-08-01,MHL,Perak,0,0,0
2022-08-01,MHL,Pulau Pinang,0,0,0
2022-08-01,MHL,Sabah,0,0,0
2022-08-01,MHL,Selangor,2,2,0
2022-08-01,MKD,Johor,2,1,1
2022-08-01,MKD,Kedah,0,0,0
2022-08-01,MKD,Perak,0,0,0
2022-08-01,MKD,Pulau Pinang,0,0,0
2022-08-01,MKD,Sabah,0,0,0
2022-08-01,MKD,Sarawak,0,0,0
2022-08-01,MKD,Selangor,20,15,5
2022-08-01,MLI,Johor,5,5,0
2022-08-01,MLI,Sabah,0,0,0
2022-08-01,MLI,Selangor,3,3,0
2022-08-01,MLT,Johor,4,2,2
2022-08-01,MLT,Kedah,0,0,0
2022-08-01,MLT,Kelantan,0,0,0
2022-08-01,MLT,Perak,0,0,0
2022-08-01,MLT,Perlis,0,0,0
2022-08-01,MLT,Pulau Pinang,0,0,0
2022-08-01,MLT,Sabah,0,0,0
2022-08-01,MLT,Sarawak,4,2,2
2022-08-01,MLT,Selangor,55,29,26
2022-08-01,MLT,W.P. Labuan,0,0,0
2022-08-01,MMR,Johor,2736,921,1815
2022-08-01,MMR,Kedah,21,5,16
2022-08-01,MMR,Kelantan,1,0,1
2022-08-01,MMR,Negeri Sembilan,0,0,0
2022-08-01,MMR,Pahang,0,0,0
2022-08-01,MMR,Perak,6,3,3
2022-08-01,MMR,Perlis,2,0,2
2022-08-01,MMR,Pulau Pinang,104,44,60
2022-08-01,MMR,Sabah,15,7,8
2022-08-01,MMR,Sarawak,49,25,24
2022-08-01,MMR,Selangor,6512,4147,2365
2022-08-01,MMR,Terengganu,0,0,0
2022-08-01,MMR,W.P. Labuan,0,0,0
2022-08-01,MNE,Johor,3,3,0
2022-08-01,MNE,Kedah,0,0,0
2022-08-01,MNE,Pulau Pinang,0,0,0
2022-08-01,MNE,Sabah,0,0,0
2022-08-01,MNE,Sarawak,0,0,0
2022-08-01,MNE,Selangor,4,4,0
2022-08-01,MNG,Johor,114,45,69
2022-08-01,MNG,Kedah,0,0,0
2022-08-01,MNG,Kelantan,0,0,0
2022-08-01,MNG,Perak,0,0,0
2022-08-01,MNG,Perlis,0,0,0
2022-08-01,MNG,Pulau Pinang,6,3,3
2022-08-01,MNG,Sabah,0,0,0
2022-08-01,MNG,Sarawak,0,0,0
2022-08-01,MNG,Selangor,169,65,104
2022-08-01,MNP,Selangor,0,0,0
2022-08-01,MOZ,Johor,0,0,0
2022-08-01,MOZ,Kedah,0,0,0
2022-08-01,MOZ,Perak,0,0,0
2022-08-01,MOZ,Pulau Pinang,0,0,0
2022-08-01,MOZ,Sabah,0,0,0
2022-08-01,MOZ,Sarawak,1,1,0
2022-08-01,MOZ,Selangor,16,10,6
2022-08-01,MRT,Johor,4,1,3
2022-08-01,MRT,Kedah,1,1,0
2022-08-01,MRT,Pulau Pinang,0,0,0
2022-08-01,MRT,Sabah,0,0,0
2022-08-01,MRT,Sarawak,0,0,0
2022-08-01,MRT,Selangor,21,16,5
2022-08-01,MUS,Johor,59,32,27
2022-08-01,MUS,Kedah,2,0,2
2022-08-01,MUS,Kelantan,0,0,0
2022-08-01,MUS,Pahang,0,0,0
2022-08-01,MUS,Perak,1,0,1
2022-08-01,MUS,Perlis,0,0,0
2022-08-01,MUS,Pulau Pinang,7,2,5
2022-08-01,MUS,Sabah,0,0,0
2022-08-01,MUS,Sarawak,0,0,0
2022-08-01,MUS,Selangor,266,137,129
2022-08-01,MWI,Johor,0,0,0
2022-08-01,MWI,Pulau Pinang,1,0,1
2022-08-01,MWI,Sabah,0,0,0
2022-08-01,MWI,Sarawak,0,0,0
2022-08-01,MWI,Selangor,28,16,12
2022-08-01,MYT,Selangor,0,0,0
2022-08-01,NAM,Johor,1,0,1
2022-08-01,NAM,Kedah,0,0,0
2022-08-01,NAM,Perak,0,0,0
2022-08-01,NAM,Perlis,0,0,0
2022-08-01,NAM,Pulau Pinang,0,0,0
2022-08-01,NAM,Sabah,0,0,0
2022-08-01,NAM,Sarawak,0,0,0
2022-08-01,NAM,Selangor,19,11,8
2022-08-01,NCL,Selangor,1,1,0
2022-08-01,NER,Johor,0,0,0
2022-08-01,NER,Sabah,0,0,0
2022-08-01,NER,Selangor,1,1,0
2022-08-01,NGA,Johor,21,17,4
2022-08-01,NGA,Kedah,1,1,0
2022-08-01,NGA,Perlis,0,0,0
2022-08-01,NGA,Pulau Pinang,3,3,0
2022-08-01,NGA,Sabah,1,1,0
2022-08-01,NGA,Sarawak,3,3,0
2022-08-01,NGA,Selangor,319,252,67
2022-08-01,NIC,Johor,4,2,2
2022-08-01,NIC,Kedah,0,0,0
2022-08-01,NIC,Pulau Pinang,0,0,0
2022-08-01,NIC,Sabah,0,0,0
2022-08-01,NIC,Selangor,3,2,1
2022-08-01,NLD,Johor,1040,645,395
2022-08-01,NLD,Kedah,142,79,63
2022-08-01,NLD,Kelantan,1,1,0
2022-08-01,NLD,Melaka,0,0,0
2022-08-01,NLD,Negeri Sembilan,1,1,0
2022-08-01,NLD,Pahang,0,0,0
2022-08-01,NLD,Perak,11,8,3
2022-08-01,NLD,Perlis,24,15,9
2022-08-01,NLD,Pulau Pinang,207,128,79
2022-08-01,NLD,Sabah,93,48,45
2022-08-01,NLD,Sarawak,146,87,59
2022-08-01,NLD,Selangor,4282,2479,1803
2022-08-01,NLD,Terengganu,0,0,0
2022-08-01,NLD,W.P. Labuan,3,1,2
2022-08-01,NOR,Johor,101,70,31
2022-08-01,NOR,Kedah,3,3,0
2022-08-01,NOR,Kelantan,3,3,0
2022-08-01,NOR,Melaka,0,0,0
2022-08-01,NOR,Pahang,0,0,0
2022-08-01,NOR,Perak,0,0,0
2022-08-01,NOR,Perlis,3,0,3
2022-08-01,NOR,Pulau Pinang,33,21,12
2022-08-01,NOR,Sabah,16,15,1
2022-08-01,NOR,Sarawak,14,11,3
2022-08-01,NOR,Selangor,422,281,141
2022-08-01,NOR,W.P. Labuan,0,0,0
2022-08-01,NPL,Johor,432,338,94
2022-08-01,NPL,Kedah,4,3,1
2022-08-01,NPL,Pahang,0,0,0
2022-08-01,NPL,Perak,0,0,0
2022-08-01,NPL,Perlis,0,0,0
2022-08-01,NPL,Pulau Pinang,19,16,3
2022-08-01,NPL,Sabah,9,8,1
2022-08-01,NPL,Sarawak,73,48,25
2022-08-01,NPL,Selangor,27956,27201,755
2022-08-01,NPL,W.P. Labuan,79,72,7
2022-08-01,NRU,Johor,0,0,0
2022-08-01,NRU,Pulau Pinang,0,0,0
2022-08-01,NRU,Selangor,0,0,0
2022-08-01,NZL,Johor,473,304,169
2022-08-01,NZL,Kedah,46,24,22
2022-08-01,NZL,Kelantan,0,0,0
2022-08-01,NZL,Melaka,0,0,0
2022-08-01,NZL,Negeri Sembilan,0,0,0
2022-08-01,NZL,Pahang,1,1,0
2022-08-01,NZL,Perak,11,5,6
2022-08-01,NZL,Perlis,12,9,3
2022-08-01,NZL,Pulau Pinang,136,83,53
2022-08-01,NZL,Sabah,32,20,12
2022-08-01,NZL,Sarawak,73,42,31
2022-08-01,NZL,Selangor,1445,925,520
2022-08-01,NZL,Terengganu,0,0,0
2022-08-01,NZL,W.P. Labuan,0,0,0
2022-08-01,OMN,Johor,125,75,50
2022-08-01,OMN,Kedah,5,4,1
2022-08-01,OMN,Kelantan,0,0,0
2022-08-01,OMN,Melaka,0,0,0
2022-08-01,OMN,Perak,0,0,0
2022-08-01,OMN,Perlis,0,0,0
2022-08-01,OMN,Pulau Pinang,10,7,3
2022-08-01,OMN,Sabah,0,0,0
2022-08-01,OMN,Sarawak,7,6,1
2022-08-01,OMN,Selangor,1118,603,515
2022-08-01,PAK,Johor,664,477,187
2022-08-01,PAK,Kedah,93,69,24
2022-08-01,PAK,Kelantan,20,20,0
2022-08-01,PAK,Melaka,0,0,0
2022-08-01,PAK,Negeri Sembilan,1,1,0
2022-08-01,PAK,Pahang,0,0,0
2022-08-01,PAK,Perak,32,27,5
2022-08-01,PAK,Perlis,25,23,2
2022-08-01,PAK,Pulau Pinang,50,34,16
2022-08-01,PAK,Sabah,6,6,0
2022-08-01,PAK,Sarawak,27,26,1
2022-08-01,PAK,Selangor,8805,7367,1438
2022-08-01,PAK,W.P. Labuan,0,0,0
2022-08-01,PAN,Johor,1,1,0
2022-08-01,PAN,Kedah,0,0,0
2022-08-01,PAN,Perak,0,0,0
2022-08-01,PAN,Perlis,0,0,0
2022-08-01,PAN,Pulau Pinang,2,2,0
2022-08-01,PAN,Sabah,0,0,0
2022-08-01,PAN,Sarawak,0,0,0
2022-08-01,PAN,Selangor,9,3,6
2022-08-01,PER,Johor,26,19,7
2022-08-01,PER,Kedah,2,0,2
2022-08-01,PER,Kelantan,0,0,0
2022-08-01,PER,Pahang,0,0,0
2022-08-01,PER,Perak,0,0,0
2022-08-01,PER,Perlis,0,0,0
2022-08-01,PER,Pulau Pinang,11,4,7
2022-08-01,PER,Sabah,1,1,0
2022-08-01,PER,Sarawak,0,0,0
2022-08-01,PER,Selangor,105,58,47
2022-08-01,PER,W.P. Labuan,0,0,0
2022-08-01,PHL,Johor,12757,4045,8712
2022-08-01,PHL,Kedah,189,67,122
2022-08-01,PHL,Kelantan,7,3,4
2022-08-01,PHL,Melaka,1,0,1
2022-08-01,PHL,Negeri Sembilan,0,0,0
2022-08-01,PHL,Pahang,32,27,5
2022-08-01,PHL,Perak,51,22,29
2022-08-01,PHL,Perlis,230,77,153
2022-08-01,PHL,Pulau Pinang,348,144,204
2022-08-01,PHL,Sabah,634,244,390
2022-08-01,PHL,Sarawak,543,223,320
2022-08-01,PHL,Selangor,11100,4475,6625
2022-08-01,PHL,Terengganu,0,0,0
2022-08-01,PHL,W.P. Labuan,25,4,21
2022-08-01,PLW,Johor,0,0,0
2022-08-01,PLW,Pulau Pinang,0,0,0
2022-08-01,PLW,Selangor,1,1,0
2022-08-01,PNG,Johor,8,7,1
2022-08-01,PNG,Kedah,0,0,0
2022-08-01,PNG,Kelantan,0,0,0
2022-08-01,PNG,Perak,1,1,0
2022-08-01,PNG,Pulau Pinang,1,1,0
2022-08-01,PNG,Sabah,0,0,0
2022-08-01,PNG,Sarawak,4,1,3
2022-08-01,PNG,Selangor,38,18,20
2022-08-01,POL,Johor,320,174,146
2022-08-01,POL,Kedah,14,6,8
2022-08-01,POL,Kelantan,3,1,2
2022-08-01,POL,Melaka,1,1,0
2022-08-01,POL,Negeri Sembilan,0,0,0
2022-08-01,POL,Pahang,0,0,0
2022-08-01,POL,Perak,5,2,3
2022-08-01,POL,Perlis,5,3,2
2022-08-01,POL,Pulau Pinang,35,20,15
2022-08-01,POL,Sabah,19,7,12
2022-08-01,POL,Sarawak,46,21,25
2022-08-01,POL,Selangor,863,433,430
2022-08-01,POL,Terengganu,0,0,0
2022-08-01,POL,W.P. Labuan,0,0,0
2022-08-01,PRK,Selangor,0,0,0
2022-08-01,PRT,Johor,164,89,75
2022-08-01,PRT,Kedah,17,11,6
2022-08-01,PRT,Kelantan,0,0,0
2022-08-01,PRT,Melaka,0,0,0
2022-08-01,PRT,Pahang,0,0,0
2022-08-01,PRT,Perak,2,0,2
2022-08-01,PRT,Perlis,4,2,2
2022-08-01,PRT,Pulau Pinang,32,15,17
2022-08-01,PRT,Sabah,9,6,3
2022-08-01,PRT,Sarawak,7,3,4
2022-08-01,PRT,Selangor,739,422,317
2022-08-01,PRT,W.P. Labuan,0,0,0
2022-08-01,PRY,Johor,0,0,0
2022-08-01,PRY,Kedah,0,0,0
2022-08-01,PRY,Perak,0,0,0
2022-08-01,PRY,Perlis,0,0,0
2022-08-01,PRY,Pulau Pinang,1,0,1
2022-08-01,PRY,Sabah,1,0,1
2022-08-01,PRY,Sarawak,0,0,0
2022-08-01,PRY,Selangor,8,2,6
2022-08-01,PSE,Johor,6,4,2
2022-08-01,PSE,Kedah,0,0,0
2022-08-01,PSE,Kelantan,0,0,0
2022-08-01,PSE,Melaka,0,0,0
2022-08-01,PSE,Perak,0,0,0
2022-08-01,PSE,Perlis,0,0,0
2022-08-01,PSE,Pulau Pinang,0,0,0
2022-08-01,PSE,Sabah,0,0,0
2022-08-01,PSE,Sarawak,2,1,1
2022-08-01,PSE,Selangor,283,182,101
2022-08-01,QAT,Johor,9,5,4
2022-08-01,QAT,Kedah,0,0,0
2022-08-01,QAT,Perlis,0,0,0
2022-08-01,QAT,Pulau Pinang,0,0,0
2022-08-01,QAT,Sabah,0,0,0
2022-08-01,QAT,Sarawak,0,0,0
2022-08-01,QAT,Selangor,155,101,54
2022-08-01,REU,Johor,0,0,0
2022-08-01,REU,Sarawak,0,0,0
2022-08-01,ROU,Johor,98,46,52
2022-08-01,ROU,Kedah,1,0,1
2022-08-01,ROU,Kelantan,0,0,0
2022-08-01,ROU,Negeri Sembilan,0,0,0
2022-08-01,ROU,Pahang,0,0,0
2022-08-01,ROU,Perak,0,0,0
2022-08-01,ROU,Perlis,0,0,0
2022-08-01,ROU,Pulau Pinang,9,5,4
2022-08-01,ROU,Sabah,9,3,6
2022-08-01,ROU,Sarawak,4,2,2
2022-08-01,ROU,Selangor,374,195,179
2022-08-01,ROU,W.P. Labuan,0,0,0
2022-08-01,RUS,Johor,236,121,115
2022-08-01,RUS,Kedah,48,21,27
2022-08-01,RUS,Kelantan,2,1,1
2022-08-01,RUS,Melaka,0,0,0
2022-08-01,RUS,Negeri Sembilan,0,0,0
2022-08-01,RUS,Pahang,0,0,0
2022-08-01,RUS,Perak,1,1,0
2022-08-01,RUS,Perlis,29,10,19
2022-08-01,RUS,Pulau Pinang,36,21,15
2022-08-01,RUS,Sabah,12,6,6
2022-08-01,RUS,Sarawak,30,17,13
2022-08-01,RUS,Selangor,2323,1164,1159
2022-08-01,RUS,W.P. Labuan,0,0,0
2022-08-01,RWA,Johor,0,0,0
2022-08-01,RWA,Kedah,0,0,0
2022-08-01,RWA,Pulau Pinang,0,0,0
2022-08-01,RWA,Selangor,2,2,0
2022-08-01,SAU,Johor,167,80,87
2022-08-01,SAU,Kedah,45,34,11
2022-08-01,SAU,Kelantan,9,2,7
2022-08-01,SAU,Melaka,0,0,0
2022-08-01,SAU,Perak,7,1,6
2022-08-01,SAU,Perlis,12,6,6
2022-08-01,SAU,Pulau Pinang,56,32,24
2022-08-01,SAU,Sabah,13,10,3
2022-08-01,SAU,Sarawak,14,11,3
2022-08-01,SAU,Selangor,6898,3563,3335
2022-08-01,SAU,W.P. Labuan,0,0,0
2022-08-01,SDN,Johor,9,3,6
2022-08-01,SDN,Kedah,1,1,0
2022-08-01,SDN,Kelantan,0,0,0
2022-08-01,SDN,Perlis,0,0,0
2022-08-01,SDN,Pulau Pinang,0,0,0
2022-08-01,SDN,Sabah,0,0,0
2022-08-01,SDN,Sarawak,2,2,0
2022-08-01,SDN,Selangor,1001,549,452
2022-08-01,SDN,W.P. Labuan,1,1,0
2022-08-01,SEN,Johor,1,0,1
2022-08-01,SEN,Kedah,2,1,1
2022-08-01,SEN,Kelantan,0,0,0
2022-08-01,SEN,Perak,0,0,0
2022-08-01,SEN,Perlis,0,0,0
2022-08-01,SEN,Pulau Pinang,0,0,0
2022-08-01,SEN,Sabah,0,0,0
2022-08-01,SEN,Sarawak,0,0,0
2022-08-01,SEN,Selangor,25,17,8
2022-08-01,SGP,Johor,925212,550835,374377
2022-08-01,SGP,Kedah,2394,1324,1070
2022-08-01,SGP,Kelantan,61,44,17
2022-08-01,SGP,Melaka,13,11,2
2022-08-01,SGP,Negeri Sembilan,0,0,0
2022-08-01,SGP,Pahang,75,47,28
2022-08-01,SGP,Perak,3457,1629,1828
2022-08-01,SGP,Perlis,147,98,49
2022-08-01,SGP,Pulau Pinang,11206,5832,5374
2022-08-01,SGP,Sabah,2101,1106,995
2022-08-01,SGP,Sarawak,2490,1521,969
2022-08-01,SGP,Selangor,27171,15045,12126
2022-08-01,SGP,Terengganu,0,0,0
2022-08-01,SGP,W.P. Labuan,4,4,0
2022-08-01,SGS,Johor,0,0,0
2022-08-01,SGS,Sabah,0,0,0
2022-08-01,SGS,Selangor,1,1,0
2022-08-01,SHN,Sarawak,0,0,0
2022-08-01,SLB,Johor,0,0,0
2022-08-01,SLB,Perlis,1,1,0
2022-08-01,SLB,Pulau Pinang,0,0,0
2022-08-01,SLB,Sabah,0,0,0
2022-08-01,SLB,Sarawak,4,2,2
2022-08-01,SLB,Selangor,9,4,5
2022-08-01,SLB,W.P. Labuan,0,0,0
2022-08-01,SLE,Johor,0,0,0
2022-08-01,SLE,Kedah,0,0,0
2022-08-01,SLE,Perak,0,0,0
2022-08-01,SLE,Pulau Pinang,1,1,0
2022-08-01,SLE,Sabah,0,0,0
2022-08-01,SLE,Selangor,15,7,8
2022-08-01,SLV,Johor,2,1,1
2022-08-01,SLV,Kedah,0,0,0
2022-08-01,SLV,Perak,0,0,0
2022-08-01,SLV,Perlis,0,0,0
2022-08-01,SLV,Pulau Pinang,1,0,1
2022-08-01,SLV,Sabah,0,0,0
2022-08-01,SLV,Selangor,11,7,4
2022-08-01,SLV,W.P. Labuan,0,0,0
2022-08-01,SMR,Johor,0,0,0
2022-08-01,SMR,Selangor,2,1,1
2022-08-01,SOM,Johor,0,0,0
2022-08-01,SOM,Kedah,0,0,0
2022-08-01,SOM,Kelantan,0,0,0
2022-08-01,SOM,Perlis,0,0,0
2022-08-01,SOM,Sabah,0,0,0
2022-08-01,SOM,Sarawak,0,0,0
2022-08-01,SOM,Selangor,200,120,80
2022-08-01,SRB,Johor,9,4,5
2022-08-01,SRB,Kedah,0,0,0
2022-08-01,SRB,Kelantan,0,0,0
2022-08-01,SRB,Pahang,0,0,0
2022-08-01,SRB,Perak,0,0,0
2022-08-01,SRB,Perlis,0,0,0
2022-08-01,SRB,Pulau Pinang,0,0,0
2022-08-01,SRB,Sabah,1,0,1
2022-08-01,SRB,Sarawak,0,0,0
2022-08-01,SRB,Selangor,28,17,11
2022-08-01,SSD,Johor,0,0,0
2022-08-01,SSD,Kedah,0,0,0
2022-08-01,SSD,Sarawak,0,0,0
2022-08-01,SSD,Selangor,17,17,0
2022-08-01,SSD,W.P. Labuan,0,0,0
2022-08-01,STP,Selangor,2,1,1
2022-08-01,SUR,Johor,2,2,0
2022-08-01,SUR,Kedah,0,0,0
2022-08-01,SUR,Kelantan,0,0,0
2022-08-01,SUR,Perak,0,0,0
2022-08-01,SUR,Perlis,0,0,0
2022-08-01,SUR,Pulau Pinang,0,0,0
2022-08-01,SUR,Sabah,0,0,0
2022-08-01,SUR,Sarawak,0,0,0
2022-08-01,SUR,Selangor,6,4,2
2022-08-01,SVK,Johor,19,10,9
2022-08-01,SVK,Kedah,35,21,14
2022-08-01,SVK,Kelantan,1,0,1
2022-08-01,SVK,Negeri Sembilan,0,0,0
2022-08-01,SVK,Pahang,0,0,0
2022-08-01,SVK,Perak,0,0,0
2022-08-01,SVK,Perlis,1,0,1
2022-08-01,SVK,Pulau Pinang,6,2,4
2022-08-01,SVK,Sabah,12,6,6
2022-08-01,SVK,Sarawak,2,1,1
2022-08-01,SVK,Selangor,214,113,101
2022-08-01,SVK,W.P. Labuan,0,0,0
2022-08-01,SVN,Johor,8,5,3
2022-08-01,SVN,Kedah,1,0,1
2022-08-01,SVN,Kelantan,0,0,0
2022-08-01,SVN,Perak,0,0,0
2022-08-01,SVN,Perlis,0,0,0
2022-08-01,SVN,Pulau Pinang,0,0,0
2022-08-01,SVN,Sabah,0,0,0
2022-08-01,SVN,Sarawak,4,2,2
2022-08-01,SVN,Selangor,72,42,30
2022-08-01,SVN,W.P. Labuan,0,0,0
2022-08-01,SWE,Johor,145,98,47
2022-08-01,SWE,Kedah,6,4,2
2022-08-01,SWE,Kelantan,10,5,5
2022-08-01,SWE,Melaka,0,0,0
2022-08-01,SWE,Negeri Sembilan,0,0,0
2022-08-01,SWE,Pahang,0,0,0
2022-08-01,SWE,Perak,1,1,0
2022-08-01,SWE,Perlis,0,0,0
2022-08-01,SWE,Pulau Pinang,32,20,12
2022-08-01,SWE,Sabah,7,4,3
2022-08-01,SWE,Sarawak,11,7,4
2022-08-01,SWE,Selangor,569,386,183
2022-08-01,SWE,W.P. Labuan,1,1,0
2022-08-01,SWZ,Johor,0,0,0
2022-08-01,SWZ,Kedah,0,0,0
2022-08-01,SWZ,Pulau Pinang,0,0,0
2022-08-01,SWZ,Sabah,0,0,0
2022-08-01,SWZ,Selangor,12,3,9
2022-08-01,SYC,Johor,6,4,2
2022-08-01,SYC,Kedah,0,0,0
2022-08-01,SYC,Pulau Pinang,0,0,0
2022-08-01,SYC,Sabah,0,0,0
2022-08-01,SYC,Sarawak,0,0,0
2022-08-01,SYC,Selangor,75,30,45
2022-08-01,SYR,Johor,10,5,5
2022-08-01,SYR,Kedah,1,1,0
2022-08-01,SYR,Kelantan,0,0,0
2022-08-01,SYR,Pahang,0,0,0
2022-08-01,SYR,Perlis,0,0,0
2022-08-01,SYR,Pulau Pinang,1,1,0
2022-08-01,SYR,Sabah,0,0,0
2022-08-01,SYR,Sarawak,9,6,3
2022-08-01,SYR,Selangor,681,393,288
2022-08-01,SYR,W.P. Labuan,0,0,0
2022-08-01,TCA,Perlis,0,0,0
2022-08-01,TCD,Johor,2,2,0
2022-08-01,TCD,Kedah,0,0,0
2022-08-01,TCD,Perlis,0,0,0
2022-08-01,TCD,Selangor,13,7,6
2022-08-01,TGO,Johor,2,1,1
2022-08-01,TGO,Perak,0,0,0
2022-08-01,TGO,Pulau Pinang,0,0,0
2022-08-01,TGO,Selangor,0,0,0
2022-08-01,THA,Johor,3938,944,2994
2022-08-01,THA,Kedah,39784,27359,12425
2022-08-01,THA,Kelantan,28591,14183,14408
2022-08-01,THA,Melaka,1,0,1
2022-08-01,THA,Negeri Sembilan,0,0,0
2022-08-01,THA,Pahang,21,17,4
2022-08-01,THA,Perak,6861,3018,3843
2022-08-01,THA,Perlis,62471,38204,24267
2022-08-01,THA,Pulau Pinang,1549,641,908
2022-08-01,THA,Sabah,161,48,113
2022-08-01,THA,Sarawak,125,44,81
2022-08-01,THA,Selangor,8545,3620,4925
2022-08-01,THA,Terengganu,0,0,0
2022-08-01,THA,W.P. Labuan,3,1,2
2022-08-01,TJK,Johor,0,0,0
2022-08-01,TJK,Kedah,0,0,0
2022-08-01,TJK,Perlis,0,0,0
2022-08-01,TJK,Pulau Pinang,1,0,1
2022-08-01,TJK,Sabah,0,0,0
2022-08-01,TJK,Selangor,79,52,27
2022-08-01,TKL,Selangor,0,0,0
2022-08-01,TKM,Johor,3,1,2
2022-08-01,TKM,Kedah,1,0,1
2022-08-01,TKM,Kelantan,0,0,0
2022-08-01,TKM,Perlis,0,0,0
2022-08-01,TKM,Pulau Pinang,0,0,0
2022-08-01,TKM,Sabah,0,0,0
2022-08-01,TKM,Sarawak,0,0,0
2022-08-01,TKM,Selangor,74,41,33
2022-08-01,TLS,Johor,22,20,2
2022-08-01,TLS,Kedah,3,2,1
2022-08-01,TLS,Perlis,0,0,0
2022-08-01,TLS,Pulau Pinang,5,3,2
2022-08-01,TLS,Sabah,1,1,0
2022-08-01,TLS,Sarawak,1,0,1
2022-08-01,TLS,Selangor,362,244,118
2022-08-01,TON,Johor,1,0,1
2022-08-01,TON,Pulau Pinang,0,0,0
2022-08-01,TON,Sarawak,0,0,0
2022-08-01,TON,Selangor,5,1,4
2022-08-01,TTO,Johor,4,1,3
2022-08-01,TTO,Kedah,0,0,0
2022-08-01,TTO,Pahang,0,0,0
2022-08-01,TTO,Pulau Pinang,0,0,0
2022-08-01,TTO,Sabah,1,0,1
2022-08-01,TTO,Sarawak,0,0,0
2022-08-01,TTO,Selangor,40,28,12
2022-08-01,TUN,Johor,5,3,2
2022-08-01,TUN,Kedah,2,0,2
2022-08-01,TUN,Kelantan,0,0,0
2022-08-01,TUN,Melaka,0,0,0
2022-08-01,TUN,Perak,0,0,0
2022-08-01,TUN,Perlis,0,0,0
2022-08-01,TUN,Pulau Pinang,4,1,3
2022-08-01,TUN,Sabah,1,0,1
2022-08-01,TUN,Sarawak,1,0,1
2022-08-01,TUN,Selangor,688,308,380
2022-08-01,TUN,W.P. Labuan,0,0,0
2022-08-01,TUR,Johor,224,165,59
2022-08-01,TUR,Kedah,13,9,4
2022-08-01,TUR,Kelantan,2,2,0
2022-08-01,TUR,Melaka,0,0,0
2022-08-01,TUR,Negeri Sembilan,0,0,0
2022-08-01,TUR,Pahang,0,0,0
2022-08-01,TUR,Perak,1,1,0
2022-08-01,TUR,Perlis,9,8,1
2022-08-01,TUR,Pulau Pinang,20,15,5
2022-08-01,TUR,Sabah,4,3,1
2022-08-01,TUR,Sarawak,15,14,1
2022-08-01,TUR,Selangor,797,563,234
2022-08-01,TUR,W.P. Labuan,0,0,0
2022-08-01,TUV,Selangor,1,0,1
2022-08-01,TWN,Johor,2691,1177,1514
2022-08-01,TWN,Kedah,64,31,33
2022-08-01,TWN,Kelantan,1,1,0
2022-08-01,TWN,Melaka,0,0,0
2022-08-01,TWN,Negeri Sembilan,0,0,0
2022-08-01,TWN,Pahang,0,0,0
2022-08-01,TWN,Perak,38,24,14
2022-08-01,TWN,Perlis,5,4,1
2022-08-01,TWN,Pulau Pinang,515,294,221
2022-08-01,TWN,Sabah,70,32,38
2022-08-01,TWN,Sarawak,130,55,75
2022-08-01,TWN,Selangor,3107,1768,1339
2022-08-01,TWN,W.P. Labuan,1,1,0
2022-08-01,TZA,Johor,4,4,0
2022-08-01,TZA,Kedah,0,0,0
2022-08-01,TZA,Perak,0,0,0
2022-08-01,TZA,Perlis,0,0,0
2022-08-01,TZA,Pulau Pinang,0,0,0
2022-08-01,TZA,Sabah,0,0,0
2022-08-01,TZA,Sarawak,0,0,0
2022-08-01,TZA,Selangor,82,41,41
2022-08-01,UGA,Johor,7,3,4
2022-08-01,UGA,Kedah,0,0,0
2022-08-01,UGA,Perak,0,0,0
2022-08-01,UGA,Perlis,1,0,1
2022-08-01,UGA,Pulau Pinang,1,0,1
2022-08-01,UGA,Sabah,4,2,2
2022-08-01,UGA,Sarawak,0,0,0
2022-08-01,UGA,Selangor,49,26,23
2022-08-01,UKR,Johor,83,59,24
2022-08-01,UKR,Kedah,21,10,11
2022-08-01,UKR,Kelantan,0,0,0
2022-08-01,UKR,Melaka,0,0,0
2022-08-01,UKR,Negeri Sembilan,0,0,0
2022-08-01,UKR,Pahang,0,0,0
2022-08-01,UKR,Perak,0,0,0
2022-08-01,UKR,Perlis,7,1,6
2022-08-01,UKR,Pulau Pinang,14,6,8
2022-08-01,UKR,Sabah,6,2,4
2022-08-01,UKR,Sarawak,0,0,0
2022-08-01,UKR,Selangor,442,230,212
2022-08-01,UKR,W.P. Labuan,0,0,0
2022-08-01,URY,Johor,4,1,3
2022-08-01,URY,Kedah,2,1,1
2022-08-01,URY,Kelantan,0,0,0
2022-08-01,URY,Perak,0,0,0
2022-08-01,URY,Perlis,0,0,0
2022-08-01,URY,Pulau Pinang,0,0,0
2022-08-01,URY,Sabah,0,0,0
2022-08-01,URY,Sarawak,0,0,0
2022-08-01,URY,Selangor,11,6,5
2022-08-01,URY,W.P. Labuan,0,0,0
2022-08-01,USA,Johor,2820,1812,1008
2022-08-01,USA,Kedah,235,126,109
2022-08-01,USA,Kelantan,7,6,1
2022-08-01,USA,Melaka,2,2,0
2022-08-01,USA,Negeri Sembilan,1,1,0
2022-08-01,USA,Pahang,2,0,2
2022-08-01,USA,Perak,108,53,55
2022-08-01,USA,Perlis,47,32,15
2022-08-01,USA,Pulau Pinang,1260,805,455
2022-08-01,USA,Sabah,207,116,91
2022-08-01,USA,Sarawak,197,108,89
2022-08-01,USA,Selangor,9455,5746,3709
2022-08-01,USA,Terengganu,0,0,0
2022-08-01,USA,W.P. Labuan,0,0,0
2022-08-01,UZB,Johor,27,18,9
2022-08-01,UZB,Kedah,6,4,2
2022-08-01,UZB,Kelantan,0,0,0
2022-08-01,UZB,Perak,0,0,0
2022-08-01,UZB,Perlis,1,0,1
2022-08-01,UZB,Pulau Pinang,8,2,6
2022-08-01,UZB,Sabah,43,43,0
2022-08-01,UZB,Sarawak,1,1,0
2022-08-01,UZB,Selangor,767,433,334
2022-08-01,VAT,Johor,0,0,0
2022-08-01,VAT,Sarawak,0,0,0
2022-08-01,VAT,Selangor,0,0,0
2022-08-01,VCT,Johor,0,0,0
2022-08-01,VCT,Kedah,0,0,0
2022-08-01,VCT,Pulau Pinang,0,0,0
2022-08-01,VCT,Sarawak,0,0,0
2022-08-01,VCT,Selangor,5,3,2
2022-08-01,VEN,Johor,4,3,1
2022-08-01,VEN,Kedah,1,0,1
2022-08-01,VEN,Kelantan,0,0,0
2022-08-01,VEN,Melaka,0,0,0
2022-08-01,VEN,Perak,0,0,0
2022-08-01,VEN,Perlis,0,0,0
2022-08-01,VEN,Pulau Pinang,0,0,0
2022-08-01,VEN,Sabah,0,0,0
2022-08-01,VEN,Sarawak,4,2,2
2022-08-01,VEN,Selangor,54,25,29
2022-08-01,VEN,W.P. Labuan,0,0,0
2022-08-01,VNM,Johor,15557,5597,9960
2022-08-01,VNM,Kedah,163,26,137
2022-08-01,VNM,Kelantan,8,8,0
2022-08-01,VNM,Melaka,2,0,2
2022-08-01,VNM,Negeri Sembilan,0,0,0
2022-08-01,VNM,Pahang,0,0,0
2022-08-01,VNM,Perak,105,8,97
2022-08-01,VNM,Perlis,174,23,151
2022-08-01,VNM,Pulau Pinang,1269,398,871
2022-08-01,VNM,Sabah,30,10,20
2022-08-01,VNM,Sarawak,50,7,43
2022-08-01,VNM,Selangor,12326,4480,7846
2022-08-01,VNM,Terengganu,0,0,0
2022-08-01,VNM,W.P. Labuan,4,2,2
2022-08-01,VUT,Johor,23,15,8
2022-08-01,VUT,Kedah,0,0,0
2022-08-01,VUT,Pulau Pinang,2,2,0
2022-08-01,VUT,Sabah,0,0,0
2022-08-01,VUT,Sarawak,0,0,0
2022-08-01,VUT,Selangor,37,27,10
2022-08-01,WSM,Johor,2,2,0
2022-08-01,WSM,Sarawak,0,0,0
2022-08-01,WSM,Selangor,0,0,0
2022-08-01,XXX,Johor,149,96,53
2022-08-01,XXX,Kedah,5,2,3
2022-08-01,XXX,Kelantan,0,0,0
2022-08-01,XXX,Melaka,0,0,0
2022-08-01,XXX,Pahang,0,0,0
2022-08-01,XXX,Perak,1,1,0
2022-08-01,XXX,Perlis,0,0,0
2022-08-01,XXX,Pulau Pinang,21,11,10
2022-08-01,XXX,Sabah,7,3,4
2022-08-01,XXX,Sarawak,20,19,1
2022-08-01,XXX,Selangor,226,135,91
2022-08-01,XXX,W.P. Labuan,1,1,0
2022-08-01,YEM,Johor,29,23,6
2022-08-01,YEM,Kedah,2,2,0
2022-08-01,YEM,Kelantan,1,1,0
2022-08-01,YEM,Melaka,0,0,0
2022-08-01,YEM,Pahang,0,0,0
2022-08-01,YEM,Perak,0,0,0
2022-08-01,YEM,Perlis,1,1,0
2022-08-01,YEM,Pulau Pinang,6,4,2
2022-08-01,YEM,Sabah,1,1,0
2022-08-01,YEM,Sarawak,1,1,0
2022-08-01,YEM,Selangor,1486,941,545
2022-08-01,YEM,W.P. Labuan,0,0,0
2022-08-01,ZAF,Johor,199,124,75
2022-08-01,ZAF,Kedah,18,12,6
2022-08-01,ZAF,Kelantan,0,0,0
2022-08-01,ZAF,Melaka,0,0,0
2022-08-01,ZAF,Pahang,0,0,0
2022-08-01,ZAF,Perak,6,2,4
2022-08-01,ZAF,Perlis,8,4,4
2022-08-01,ZAF,Pulau Pinang,35,20,15
2022-08-01,ZAF,Sabah,33,18,15
2022-08-01,ZAF,Sarawak,92,39,53
2022-08-01,ZAF,Selangor,610,351,259
2022-08-01,ZAF,Terengganu,0,0,0
2022-08-01,ZAF,W.P. Labuan,0,0,0
2022-08-01,ZAR,Selangor,0,0,0
2022-08-01,ZMB,Johor,5,3,2
2022-08-01,ZMB,Kedah,0,0,0
2022-08-01,ZMB,Perak,0,0,0
2022-08-01,ZMB,Perlis,0,0,0
2022-08-01,ZMB,Pulau Pinang,0,0,0
2022-08-01,ZMB,Sabah,0,0,0
2022-08-01,ZMB,Sarawak,1,0,1
2022-08-01,ZMB,Selangor,37,20,17
2022-08-01,ZWE,Johor,7,3,4
2022-08-01,ZWE,Kedah,1,0,1
2022-08-01,ZWE,Kelantan,1,0,1
2022-08-01,ZWE,Perak,0,0,0
2022-08-01,ZWE,Perlis,0,0,0
2022-08-01,ZWE,Pulau Pinang,0,0,0
2022-08-01,ZWE,Sabah,0,0,0
2022-08-01,ZWE,Sarawak,2,1,1
2022-08-01,ZWE,Selangor,113,43,70
2022-09-01,ABW,Kedah,0,0,0
2022-09-01,ABW,Pulau Pinang,0,0,0
2022-09-01,AFG,Johor,0,0,0
2022-09-01,AFG,Kedah,0,0,0
2022-09-01,AFG,Perlis,0,0,0
2022-09-01,AFG,Pulau Pinang,0,0,0
2022-09-01,AFG,Sarawak,0,0,0
2022-09-01,AFG,Selangor,51,45,6
2022-09-01,AGO,Johor,0,0,0
2022-09-01,AGO,Kedah,0,0,0
2022-09-01,AGO,Sabah,0,0,0
2022-09-01,AGO,Selangor,12,5,7
2022-09-01,AIA,Selangor,0,0,0
2022-09-01,ALB,Johor,17,10,7
2022-09-01,ALB,Kedah,0,0,0
2022-09-01,ALB,Perak,0,0,0
2022-09-01,ALB,Perlis,0,0,0
2022-09-01,ALB,Pulau Pinang,1,1,0
2022-09-01,ALB,Sabah,1,0,1
2022-09-01,ALB,Sarawak,0,0,0
2022-09-01,ALB,Selangor,23,10,13
2022-09-01,AND,Johor,1,1,0
2022-09-01,AND,Kedah,0,0,0
2022-09-01,AND,Perlis,0,0,0
2022-09-01,AND,Pulau Pinang,1,0,1
2022-09-01,AND,Selangor,7,4,3
2022-09-01,ANT,Selangor,0,0,0
2022-09-01,ARE,Johor,13,5,8
2022-09-01,ARE,Kedah,0,0,0
2022-09-01,ARE,Kelantan,0,0,0
2022-09-01,ARE,Perak,0,0,0
2022-09-01,ARE,Perlis,0,0,0
2022-09-01,ARE,Pulau Pinang,0,0,0
2022-09-01,ARE,Sabah,0,0,0
2022-09-01,ARE,Sarawak,0,0,0
2022-09-01,ARE,Selangor,221,170,51
2022-09-01,ARG,Johor,44,28,16
2022-09-01,ARG,Kedah,10,6,4
2022-09-01,ARG,Kelantan,2,1,1
2022-09-01,ARG,Melaka,0,0,0
2022-09-01,ARG,Perak,2,1,1
2022-09-01,ARG,Perlis,7,5,2
2022-09-01,ARG,Pulau Pinang,6,2,4
2022-09-01,ARG,Sabah,1,0,1
2022-09-01,ARG,Sarawak,3,1,2
2022-09-01,ARG,Selangor,221,127,94
2022-09-01,ARG,W.P. Labuan,0,0,0
2022-09-01,ARM,Johor,4,2,2
2022-09-01,ARM,Kedah,0,0,0
2022-09-01,ARM,Kelantan,0,0,0
2022-09-01,ARM,Perak,0,0,0
2022-09-01,ARM,Perlis,0,0,0
2022-09-01,ARM,Pulau Pinang,0,0,0
2022-09-01,ARM,Sabah,0,0,0
2022-09-01,ARM,Sarawak,0,0,0
2022-09-01,ARM,Selangor,32,18,14
2022-09-01,ATA,Selangor,0,0,0
2022-09-01,ATG,Johor,9,4,5
2022-09-01,ATG,Kedah,0,0,0
2022-09-01,ATG,Pulau Pinang,0,0,0
2022-09-01,ATG,Sarawak,1,1,0
2022-09-01,ATG,Selangor,7,5,2
2022-09-01,AUS,Johor,4241,2505,1736
2022-09-01,AUS,Kedah,326,170,156
2022-09-01,AUS,Kelantan,3,3,0
2022-09-01,AUS,Melaka,6,5,1
2022-09-01,AUS,Negeri Sembilan,2,2,0
2022-09-01,AUS,Pahang,8,4,4
2022-09-01,AUS,Perak,187,89,98
2022-09-01,AUS,Perlis,62,43,19
2022-09-01,AUS,Pulau Pinang,1276,698,578
2022-09-01,AUS,Sabah,355,181,174
2022-09-01,AUS,Sarawak,434,235,199
2022-09-01,AUS,Selangor,14837,8813,6024
2022-09-01,AUS,Terengganu,0,0,0
2022-09-01,AUS,W.P. Labuan,7,5,2
2022-09-01,AUT,Johor,133,84,49
2022-09-01,AUT,Kedah,19,8,11
2022-09-01,AUT,Kelantan,0,0,0
2022-09-01,AUT,Melaka,0,0,0
2022-09-01,AUT,Negeri Sembilan,0,0,0
2022-09-01,AUT,Pahang,1,1,0
2022-09-01,AUT,Perak,6,3,3
2022-09-01,AUT,Perlis,7,2,5
2022-09-01,AUT,Pulau Pinang,77,60,17
2022-09-01,AUT,Sabah,10,6,4
2022-09-01,AUT,Sarawak,9,6,3
2022-09-01,AUT,Selangor,569,369,200
2022-09-01,AUT,Terengganu,2,1,1
2022-09-01,AUT,W.P. Labuan,0,0,0
2022-09-01,AZE,Johor,1,0,1
2022-09-01,AZE,Kedah,1,1,0
2022-09-01,AZE,Kelantan,0,0,0
2022-09-01,AZE,Melaka,0,0,0
2022-09-01,AZE,Perlis,0,0,0
2022-09-01,AZE,Pulau Pinang,0,0,0
2022-09-01,AZE,Sabah,0,0,0
2022-09-01,AZE,Sarawak,1,0,1
2022-09-01,AZE,Selangor,65,30,35
2022-09-01,AZE,W.P. Labuan,0,0,0
2022-09-01,BDI,Pulau Pinang,0,0,0
2022-09-01,BDI,Sarawak,0,0,0
2022-09-01,BDI,Selangor,2,1,1
2022-09-01,BEL,Johor,228,145,83
2022-09-01,BEL,Kedah,26,17,9
2022-09-01,BEL,Kelantan,1,1,0
2022-09-01,BEL,Melaka,0,0,0
2022-09-01,BEL,Negeri Sembilan,0,0,0
2022-09-01,BEL,Pahang,0,0,0
2022-09-01,BEL,Perak,3,3,0
2022-09-01,BEL,Perlis,12,8,4
2022-09-01,BEL,Pulau Pinang,34,22,12
2022-09-01,BEL,Sabah,30,15,15
2022-09-01,BEL,Sarawak,8,5,3
2022-09-01,BEL,Selangor,953,582,371
2022-09-01,BEL,W.P. Labuan,0,0,0
2022-09-01,BEN,Johor,0,0,0
2022-09-01,BEN,Kedah,0,0,0
2022-09-01,BEN,Perak,0,0,0
2022-09-01,BEN,Pulau Pinang,0,0,0
2022-09-01,BEN,Sabah,0,0,0
2022-09-01,BEN,Sarawak,0,0,0
2022-09-01,BEN,Selangor,9,6,3
2022-09-01,BFA,Perak,0,0,0
2022-09-01,BFA,Pulau Pinang,1,1,0
2022-09-01,BFA,Selangor,10,9,1
2022-09-01,BGD,Johor,1702,1368,334
2022-09-01,BGD,Kedah,35,24,11
2022-09-01,BGD,Kelantan,1,1,0
2022-09-01,BGD,Melaka,0,0,0
2022-09-01,BGD,Negeri Sembilan,1,1,0
2022-09-01,BGD,Pahang,0,0,0
2022-09-01,BGD,Perak,0,0,0
2022-09-01,BGD,Perlis,5,5,0
2022-09-01,BGD,Pulau Pinang,172,164,8
2022-09-01,BGD,Sabah,1,1,0
2022-09-01,BGD,Sarawak,17,16,1
2022-09-01,BGD,Selangor,25148,23571,1577
2022-09-01,BGD,W.P. Labuan,3,3,0
2022-09-01,BGR,Johor,42,21,21
2022-09-01,BGR,Kedah,1,0,1
2022-09-01,BGR,Kelantan,0,0,0
2022-09-01,BGR,Pahang,0,0,0
2022-09-01,BGR,Perak,0,0,0
2022-09-01,BGR,Perlis,0,0,0
2022-09-01,BGR,Pulau Pinang,4,1,3
2022-09-01,BGR,Sabah,1,0,1
2022-09-01,BGR,Sarawak,2,2,0
2022-09-01,BGR,Selangor,107,67,40
2022-09-01,BGR,W.P. Labuan,0,0,0
2022-09-01,BHR,Johor,1,1,0
2022-09-01,BHR,Kedah,0,0,0
2022-09-01,BHR,Kelantan,0,0,0
2022-09-01,BHR,Perlis,1,1,0
2022-09-01,BHR,Pulau Pinang,3,3,0
2022-09-01,BHR,Sabah,0,0,0
2022-09-01,BHR,Sarawak,0,0,0
2022-09-01,BHR,Selangor,121,78,43
2022-09-01,BHS,Johor,0,0,0
2022-09-01,BHS,Kedah,0,0,0
2022-09-01,BHS,Perak,0,0,0
2022-09-01,BHS,Sabah,0,0,0
2022-09-01,BHS,Sarawak,0,0,0
2022-09-01,BHS,Selangor,3,3,0
2022-09-01,BIH,Johor,1,0,1
2022-09-01,BIH,Kedah,0,0,0
2022-09-01,BIH,Perlis,0,0,0
2022-09-01,BIH,Pulau Pinang,1,1,0
2022-09-01,BIH,Sabah,2,1,1
2022-09-01,BIH,Sarawak,1,1,0
2022-09-01,BIH,Selangor,35,20,15
2022-09-01,BLR,Johor,12,7,5
2022-09-01,BLR,Kedah,2,1,1
2022-09-01,BLR,Kelantan,0,0,0
2022-09-01,BLR,Pahang,1,0,1
2022-09-01,BLR,Perak,0,0,0
2022-09-01,BLR,Perlis,0,0,0
2022-09-01,BLR,Pulau Pinang,1,1,0
2022-09-01,BLR,Sabah,0,0,0
2022-09-01,BLR,Sarawak,3,2,1
2022-09-01,BLR,Selangor,114,44,70
2022-09-01,BLR,W.P. Labuan,0,0,0
2022-09-01,BLZ,Johor,1,1,0
2022-09-01,BLZ,Pulau Pinang,0,0,0
2022-09-01,BLZ,Sarawak,0,0,0
2022-09-01,BLZ,Selangor,7,4,3
2022-09-01,BMU,Selangor,0,0,0
2022-09-01,BOL,Johor,2,2,0
2022-09-01,BOL,Kedah,0,0,0
2022-09-01,BOL,Melaka,0,0,0
2022-09-01,BOL,Perak,0,0,0
2022-09-01,BOL,Perlis,0,0,0
2022-09-01,BOL,Pulau Pinang,4,1,3
2022-09-01,BOL,Sabah,0,0,0
2022-09-01,BOL,Sarawak,3,2,1
2022-09-01,BOL,Selangor,20,7,13
2022-09-01,BRA,Johor,173,94,79
2022-09-01,BRA,Kedah,9,2,7
2022-09-01,BRA,Kelantan,0,0,0
2022-09-01,BRA,Melaka,0,0,0
2022-09-01,BRA,Pahang,0,0,0
2022-09-01,BRA,Perak,5,5,0
2022-09-01,BRA,Perlis,6,3,3
2022-09-01,BRA,Pulau Pinang,11,7,4
2022-09-01,BRA,Sabah,6,5,1
2022-09-01,BRA,Sarawak,7,3,4
2022-09-01,BRA,Selangor,656,414,242
2022-09-01,BRA,W.P. Labuan,0,0,0
2022-09-01,BRB,Johor,0,0,0
2022-09-01,BRB,Kedah,0,0,0
2022-09-01,BRB,Perlis,0,0,0
2022-09-01,BRB,Pulau Pinang,0,0,0
2022-09-01,BRB,Selangor,7,3,4
2022-09-01,BRN,Johor,365,207,158
2022-09-01,BRN,Kedah,8,7,1
2022-09-01,BRN,Kelantan,3,2,1
2022-09-01,BRN,Melaka,0,0,0
2022-09-01,BRN,Pahang,0,0,0
2022-09-01,BRN,Perak,3,2,1
2022-09-01,BRN,Perlis,26,14,12
2022-09-01,BRN,Pulau Pinang,12,5,7
2022-09-01,BRN,Sabah,739,349,390
2022-09-01,BRN,Sarawak,56010,30172,25838
2022-09-01,BRN,Selangor,3519,1780,1739
2022-09-01,BRN,W.P. Labuan,647,430,217
2022-09-01,BTN,Johor,2,2,0
2022-09-01,BTN,Kedah,0,0,0
2022-09-01,BTN,Perak,0,0,0
2022-09-01,BTN,Perlis,0,0,0
2022-09-01,BTN,Pulau Pinang,2,0,2
2022-09-01,BTN,Sabah,0,0,0
2022-09-01,BTN,Sarawak,0,0,0
2022-09-01,BTN,Selangor,63,37,26
2022-09-01,BWA,Johor,2,0,2
2022-09-01,BWA,Kedah,0,0,0
2022-09-01,BWA,Perlis,0,0,0
2022-09-01,BWA,Pulau Pinang,1,0,1
2022-09-01,BWA,Sabah,0,0,0
2022-09-01,BWA,Sarawak,0,0,0
2022-09-01,BWA,Selangor,3,1,2
2022-09-01,CAF,Kedah,0,0,0
2022-09-01,CAF,Selangor,0,0,0
2022-09-01,CAN,Johor,961,577,384
2022-09-01,CAN,Kedah,53,33,20
2022-09-01,CAN,Kelantan,5,1,4
2022-09-01,CAN,Melaka,0,0,0
2022-09-01,CAN,Negeri Sembilan,0,0,0
2022-09-01,CAN,Pahang,0,0,0
2022-09-01,CAN,Perak,19,10,9
2022-09-01,CAN,Perlis,19,14,5
2022-09-01,CAN,Pulau Pinang,216,132,84
2022-09-01,CAN,Sabah,90,41,49
2022-09-01,CAN,Sarawak,201,114,87
2022-09-01,CAN,Selangor,2608,1656,952
2022-09-01,CAN,Terengganu,0,0,0
2022-09-01,CAN,W.P. Labuan,0,0,0
2022-09-01,CCK,Selangor,0,0,0
2022-09-01,CHE,Johor,255,156,99
2022-09-01,CHE,Kedah,28,21,7
2022-09-01,CHE,Kelantan,1,1,0
2022-09-01,CHE,Melaka,0,0,0
2022-09-01,CHE,Negeri Sembilan,0,0,0
2022-09-01,CHE,Pahang,0,0,0
2022-09-01,CHE,Perak,6,5,1
2022-09-01,CHE,Perlis,6,4,2
2022-09-01,CHE,Pulau Pinang,92,62,30
2022-09-01,CHE,Sabah,29,14,15
2022-09-01,CHE,Sarawak,33,13,20
2022-09-01,CHE,Selangor,835,528,307
2022-09-01,CHE,W.P. Labuan,0,0,0
2022-09-01,CHL,Johor,41,20,21
2022-09-01,CHL,Kedah,3,0,3
2022-09-01,CHL,Kelantan,0,0,0
2022-09-01,CHL,Melaka,0,0,0
2022-09-01,CHL,Pahang,0,0,0
2022-09-01,CHL,Perak,0,0,0
2022-09-01,CHL,Perlis,4,3,1
2022-09-01,CHL,Pulau Pinang,1,1,0
2022-09-01,CHL,Sabah,5,2,3
2022-09-01,CHL,Sarawak,1,0,1
2022-09-01,CHL,Selangor,91,51,40
2022-09-01,CHN,Johor,20790,8385,12405
2022-09-01,CHN,Kedah,300,120,180
2022-09-01,CHN,Kelantan,3,1,2
2022-09-01,CHN,Melaka,0,0,0
2022-09-01,CHN,Pahang,3,2,1
2022-09-01,CHN,Perak,115,43,72
2022-09-01,CHN,Perlis,45,27,18
2022-09-01,CHN,Pulau Pinang,1050,528,522
2022-09-01,CHN,Sabah,347,171,176
2022-09-01,CHN,Sarawak,288,124,164
2022-09-01,CHN,Selangor,14957,8875,6082
2022-09-01,CHN,Terengganu,0,0,0
2022-09-01,CHN,W.P. Labuan,4,2,2
2022-09-01,CIV,Johor,0,0,0
2022-09-01,CIV,Kedah,0,0,0
2022-09-01,CIV,Pulau Pinang,0,0,0
2022-09-01,CIV,Sabah,0,0,0
2022-09-01,CIV,Sarawak,0,0,0
2022-09-01,CIV,Selangor,32,27,5
2022-09-01,CMR,Johor,2,2,0
2022-09-01,CMR,Kedah,0,0,0
2022-09-01,CMR,Pulau Pinang,0,0,0
2022-09-01,CMR,Sabah,0,0,0
2022-09-01,CMR,Sarawak,0,0,0
2022-09-01,CMR,Selangor,16,13,3
2022-09-01,COD,Johor,0,0,0
2022-09-01,COD,Pulau Pinang,0,0,0
2022-09-01,COD,Sarawak,0,0,0
2022-09-01,COD,Selangor,15,13,2
2022-09-01,COG,Johor,0,0,0
2022-09-01,COG,Kedah,0,0,0
2022-09-01,COG,Selangor,1,1,0
2022-09-01,COK,Selangor,0,0,0
2022-09-01,COL,Johor,26,14,12
2022-09-01,COL,Kedah,5,3,2
2022-09-01,COL,Perak,0,0,0
2022-09-01,COL,Pulau Pinang,1,1,0
2022-09-01,COL,Sabah,0,0,0
2022-09-01,COL,Sarawak,0,0,0
2022-09-01,COL,Selangor,107,63,44
2022-09-01,COL,W.P. Labuan,0,0,0
2022-09-01,COM,Johor,0,0,0
2022-09-01,COM,Kedah,0,0,0
2022-09-01,COM,Selangor,4,4,0
2022-09-01,CPV,Johor,0,0,0
2022-09-01,CPV,Kedah,0,0,0
2022-09-01,CPV,Pulau Pinang,0,0,0
2022-09-01,CPV,Sabah,0,0,0
2022-09-01,CPV,Selangor,1,1,0
2022-09-01,CRI,Johor,12,8,4
2022-09-01,CRI,Kedah,0,0,0
2022-09-01,CRI,Perak,0,0,0
2022-09-01,CRI,Perlis,2,2,0
2022-09-01,CRI,Pulau Pinang,3,2,1
2022-09-01,CRI,Sabah,0,0,0
2022-09-01,CRI,Sarawak,0,0,0
2022-09-01,CRI,Selangor,44,23,21
2022-09-01,CUB,Johor,1,1,0
2022-09-01,CUB,Kedah,0,0,0
2022-09-01,CUB,Perlis,0,0,0
2022-09-01,CUB,Pulau Pinang,0,0,0
2022-09-01,CUB,Sabah,0,0,0
2022-09-01,CUB,Sarawak,0,0,0
2022-09-01,CUB,Selangor,15,3,12
2022-09-01,CYP,Johor,12,8,4
2022-09-01,CYP,Kedah,1,0,1
2022-09-01,CYP,Perak,0,0,0
2022-09-01,CYP,Perlis,0,0,0
2022-09-01,CYP,Pulau Pinang,3,3,0
2022-09-01,CYP,Sabah,0,0,0
2022-09-01,CYP,Sarawak,0,0,0
2022-09-01,CYP,Selangor,32,25,7
2022-09-01,CZE,Johor,84,52,32
2022-09-01,CZE,Kedah,3,1,2
2022-09-01,CZE,Kelantan,0,0,0
2022-09-01,CZE,Melaka,0,0,0
2022-09-01,CZE,Negeri Sembilan,1,1,0
2022-09-01,CZE,Perak,0,0,0
2022-09-01,CZE,Perlis,10,7,3
2022-09-01,CZE,Pulau Pinang,12,9,3
2022-09-01,CZE,Sabah,6,3,3
2022-09-01,CZE,Sarawak,1,1,0
2022-09-01,CZE,Selangor,319,193,126
2022-09-01,CZE,W.P. Labuan,0,0,0
2022-09-01,DEU,Johor,1858,1162,696
2022-09-01,DEU,Kedah,144,71,73
2022-09-01,DEU,Kelantan,6,4,2
2022-09-01,DEU,Melaka,8,4,4
2022-09-01,DEU,Negeri Sembilan,0,0,0
2022-09-01,DEU,Pahang,3,2,1
2022-09-01,DEU,Perak,11,9,2
2022-09-01,DEU,Perlis,78,46,32
2022-09-01,DEU,Pulau Pinang,470,346,124
2022-09-01,DEU,Sabah,118,76,42
2022-09-01,DEU,Sarawak,152,80,72
2022-09-01,DEU,Selangor,5457,3392,2065
2022-09-01,DEU,Terengganu,1,1,0
2022-09-01,DEU,W.P. Labuan,3,2,1
2022-09-01,DJI,Johor,0,0,0
2022-09-01,DJI,Selangor,11,7,4
2022-09-01,DMA,Johor,8,8,0
2022-09-01,DMA,Kedah,0,0,0
2022-09-01,DMA,Pulau Pinang,0,0,0
2022-09-01,DMA,Sabah,0,0,0
2022-09-01,DMA,Sarawak,4,2,2
2022-09-01,DMA,Selangor,21,20,1
2022-09-01,DMA,W.P. Labuan,0,0,0
2022-09-01,DNK,Johor,217,146,71
2022-09-01,DNK,Kedah,36,14,22
2022-09-01,DNK,Kelantan,0,0,0
2022-09-01,DNK,Melaka,0,0,0
2022-09-01,DNK,Negeri Sembilan,0,0,0
2022-09-01,DNK,Pahang,29,12,17
2022-09-01,DNK,Perak,0,0,0
2022-09-01,DNK,Perlis,18,10,8
2022-09-01,DNK,Pulau Pinang,55,40,15
2022-09-01,DNK,Sabah,25,16,9
2022-09-01,DNK,Sarawak,17,10,7
2022-09-01,DNK,Selangor,684,427,257
2022-09-01,DNK,W.P. Labuan,1,0,1
2022-09-01,DOM,Johor,0,0,0
2022-09-01,DOM,Kedah,0,0,0
2022-09-01,DOM,Perak,0,0,0
2022-09-01,DOM,Perlis,0,0,0
2022-09-01,DOM,Pulau Pinang,1,1,0
2022-09-01,DOM,Sabah,0,0,0
2022-09-01,DOM,Sarawak,0,0,0
2022-09-01,DOM,Selangor,8,3,5
2022-09-01,DZA,Johor,21,16,5
2022-09-01,DZA,Kedah,0,0,0
2022-09-01,DZA,Kelantan,0,0,0
2022-09-01,DZA,Melaka,0,0,0
2022-09-01,DZA,Perak,0,0,0
2022-09-01,DZA,Perlis,0,0,0
2022-09-01,DZA,Pulau Pinang,0,0,0
2022-09-01,DZA,Sabah,1,1,0
2022-09-01,DZA,Sarawak,1,1,0
2022-09-01,DZA,Selangor,478,285,193
2022-09-01,DZA,W.P. Labuan,0,0,0
2022-09-01,ECU,Johor,7,4,3
2022-09-01,ECU,Kedah,3,2,1
2022-09-01,ECU,Perak,0,0,0
2022-09-01,ECU,Perlis,0,0,0
2022-09-01,ECU,Pulau Pinang,1,0,1
2022-09-01,ECU,Sabah,1,1,0
2022-09-01,ECU,Sarawak,2,1,1
2022-09-01,ECU,Selangor,43,21,22
2022-09-01,EGY,Johor,164,137,27
2022-09-01,EGY,Kedah,2,2,0
2022-09-01,EGY,Kelantan,2,2,0
2022-09-01,EGY,Melaka,0,0,0
2022-09-01,EGY,Pahang,0,0,0
2022-09-01,EGY,Perak,0,0,0
2022-09-01,EGY,Perlis,0,0,0
2022-09-01,EGY,Pulau Pinang,4,4,0
2022-09-01,EGY,Sabah,0,0,0
2022-09-01,EGY,Sarawak,119,74,45
2022-09-01,EGY,Selangor,1708,1135,573
2022-09-01,EGY,Terengganu,0,0,0
2022-09-01,EGY,W.P. Labuan,0,0,0
2022-09-01,ERI,Johor,0,0,0
2022-09-01,ERI,Pulau Pinang,0,0,0
2022-09-01,ERI,Sabah,0,0,0
2022-09-01,ERI,Selangor,17,9,8
2022-09-01,ESP,Johor,473,264,209
2022-09-01,ESP,Kedah,49,28,21
2022-09-01,ESP,Kelantan,3,1,2
2022-09-01,ESP,Melaka,1,0,1
2022-09-01,ESP,Negeri Sembilan,0,0,0
2022-09-01,ESP,Pahang,0,0,0
2022-09-01,ESP,Perak,1,1,0
2022-09-01,ESP,Perlis,7,6,1
2022-09-01,ESP,Pulau Pinang,79,45,34
2022-09-01,ESP,Sabah,38,18,20
2022-09-01,ESP,Sarawak,64,30,34
2022-09-01,ESP,Selangor,2375,1321,1054
2022-09-01,ESP,W.P. Labuan,0,0,0
2022-09-01,EST,Johor,11,8,3
2022-09-01,EST,Kedah,1,1,0
2022-09-01,EST,Kelantan,0,0,0
2022-09-01,EST,Pahang,0,0,0
2022-09-01,EST,Perak,0,0,0
2022-09-01,EST,Perlis,1,1,0
2022-09-01,EST,Pulau Pinang,2,0,2
2022-09-01,EST,Sabah,3,1,2
2022-09-01,EST,Sarawak,8,6,2
2022-09-01,EST,Selangor,73,47,26
2022-09-01,EST,W.P. Labuan,0,0,0
2022-09-01,ETH,Johor,2,2,0
2022-09-01,ETH,Kedah,0,0,0
2022-09-01,ETH,Pulau Pinang,1,1,0
2022-09-01,ETH,Sarawak,0,0,0
2022-09-01,ETH,Selangor,23,11,12
2022-09-01,FIN,Johor,113,77,36
2022-09-01,FIN,Kedah,12,8,4
2022-09-01,FIN,Kelantan,0,0,0
2022-09-01,FIN,Melaka,0,0,0
2022-09-01,FIN,Negeri Sembilan,0,0,0
2022-09-01,FIN,Pahang,0,0,0
2022-09-01,FIN,Perak,0,0,0
2022-09-01,FIN,Perlis,0,0,0
2022-09-01,FIN,Pulau Pinang,19,13,6
2022-09-01,FIN,Sabah,7,5,2
2022-09-01,FIN,Sarawak,7,4,3
2022-09-01,FIN,Selangor,269,181,88
2022-09-01,FIN,W.P. Labuan,0,0,0
2022-09-01,FJI,Johor,56,31,25
2022-09-01,FJI,Kedah,0,0,0
2022-09-01,FJI,Kelantan,0,0,0
2022-09-01,FJI,Perak,0,0,0
2022-09-01,FJI,Perlis,0,0,0
2022-09-01,FJI,Pulau Pinang,3,2,1
2022-09-01,FJI,Sabah,2,1,1
2022-09-01,FJI,Sarawak,1,0,1
2022-09-01,FJI,Selangor,72,36,36
2022-09-01,FRA,Johor,1357,870,487
2022-09-01,FRA,Kedah,150,100,50
2022-09-01,FRA,Kelantan,3,3,0
2022-09-01,FRA,Melaka,2,1,1
2022-09-01,FRA,Negeri Sembilan,6,3,3
2022-09-01,FRA,Pahang,4,3,1
2022-09-01,FRA,Perak,21,12,9
2022-09-01,FRA,Perlis,49,32,17
2022-09-01,FRA,Pulau Pinang,246,163,83
2022-09-01,FRA,Sabah,68,48,20
2022-09-01,FRA,Sarawak,54,34,20
2022-09-01,FRA,Selangor,6180,3628,2552
2022-09-01,FRA,Terengganu,2,1,1
2022-09-01,FRA,W.P. Labuan,3,3,0
2022-09-01,FSM,Johor,0,0,0
2022-09-01,FSM,Pulau Pinang,0,0,0
2022-09-01,FSM,Selangor,0,0,0
2022-09-01,GAB,Johor,4,3,1
2022-09-01,GAB,Pulau Pinang,0,0,0
2022-09-01,GAB,Sarawak,0,0,0
2022-09-01,GAB,Selangor,4,3,1
2022-09-01,GBR,Johor,3265,2234,1031
2022-09-01,GBR,Kedah,331,198,133
2022-09-01,GBR,Kelantan,3,3,0
2022-09-01,GBR,Melaka,3,1,2
2022-09-01,GBR,Negeri Sembilan,2,2,0
2022-09-01,GBR,Pahang,8,6,2
2022-09-01,GBR,Perak,53,34,19
2022-09-01,GBR,Perlis,113,74,39
2022-09-01,GBR,Pulau Pinang,879,532,347
2022-09-01,GBR,Sabah,318,180,138
2022-09-01,GBR,Sarawak,968,632,336
2022-09-01,GBR,Selangor,11781,7331,4450
2022-09-01,GBR,Terengganu,3,3,0
2022-09-01,GBR,W.P. Labuan,44,39,5
2022-09-01,GEO,Johor,18,12,6
2022-09-01,GEO,Kedah,1,1,0
2022-09-01,GEO,Melaka,0,0,0
2022-09-01,GEO,Perak,0,0,0
2022-09-01,GEO,Perlis,0,0,0
2022-09-01,GEO,Pulau Pinang,0,0,0
2022-09-01,GEO,Sabah,0,0,0
2022-09-01,GEO,Sarawak,0,0,0
2022-09-01,GEO,Selangor,47,41,6
2022-09-01,GHA,Johor,6,6,0
2022-09-01,GHA,Kedah,0,0,0
2022-09-01,GHA,Kelantan,0,0,0
2022-09-01,GHA,Pulau Pinang,0,0,0
2022-09-01,GHA,Sabah,0,0,0
2022-09-01,GHA,Sarawak,0,0,0
2022-09-01,GHA,Selangor,56,43,13
2022-09-01,GIB,Johor,0,0,0
2022-09-01,GIB,Sarawak,0,0,0
2022-09-01,GIN,Johor,2,2,0
2022-09-01,GIN,Kedah,0,0,0
2022-09-01,GIN,Kelantan,1,1,0
2022-09-01,GIN,Perlis,0,0,0
2022-09-01,GIN,Pulau Pinang,1,1,0
2022-09-01,GIN,Sabah,0,0,0
2022-09-01,GIN,Sarawak,0,0,0
2022-09-01,GIN,Selangor,25,22,3
2022-09-01,GLP,Selangor,0,0,0
2022-09-01,GMB,Johor,0,0,0
2022-09-01,GMB,Kedah,0,0,0
2022-09-01,GMB,Kelantan,0,0,0
2022-09-01,GMB,Pulau Pinang,0,0,0
2022-09-01,GMB,Sabah,0,0,0
2022-09-01,GMB,Sarawak,0,0,0
2022-09-01,GMB,Selangor,13,10,3
2022-09-01,GNB,Johor,0,0,0
2022-09-01,GNB,Selangor,0,0,0
2022-09-01,GNQ,Johor,0,0,0
2022-09-01,GNQ,Selangor,0,0,0
2022-09-01,GRC,Johor,41,30,11
2022-09-01,GRC,Kedah,0,0,0
2022-09-01,GRC,Kelantan,0,0,0
2022-09-01,GRC,Melaka,0,0,0
2022-09-01,GRC,Negeri Sembilan,0,0,0
2022-09-01,GRC,Pahang,0,0,0
2022-09-01,GRC,Perak,0,0,0
2022-09-01,GRC,Perlis,1,0,1
2022-09-01,GRC,Pulau Pinang,2,2,0
2022-09-01,GRC,Sabah,5,3,2
2022-09-01,GRC,Sarawak,3,2,1
2022-09-01,GRC,Selangor,134,101,33
2022-09-01,GRD,Johor,6,4,2
2022-09-01,GRD,Kedah,0,0,0
2022-09-01,GRD,Pulau Pinang,1,1,0
2022-09-01,GRD,Sabah,0,0,0
2022-09-01,GRD,Sarawak,0,0,0
2022-09-01,GRD,Selangor,11,9,2
2022-09-01,GRL,Johor,0,0,0
2022-09-01,GRL,Selangor,0,0,0
2022-09-01,GTM,Johor,0,0,0
2022-09-01,GTM,Kedah,0,0,0
2022-09-01,GTM,Pahang,0,0,0
2022-09-01,GTM,Perak,0,0,0
2022-09-01,GTM,Pulau Pinang,1,0,1
2022-09-01,GTM,Sabah,0,0,0
2022-09-01,GTM,Sarawak,0,0,0
2022-09-01,GTM,Selangor,10,5,5
2022-09-01,GTM,W.P. Labuan,0,0,0
2022-09-01,GUY,Johor,0,0,0
2022-09-01,GUY,Kedah,0,0,0
2022-09-01,GUY,Pulau Pinang,0,0,0
2022-09-01,GUY,Sarawak,0,0,0
2022-09-01,GUY,Selangor,2,1,1
2022-09-01,HKG,Johor,1,1,0
2022-09-01,HKG,Kedah,2,1,1
2022-09-01,HKG,Kelantan,0,0,0
2022-09-01,HKG,Pahang,0,0,0
2022-09-01,HKG,Perak,19,11,8
2022-09-01,HKG,Perlis,4,2,2
2022-09-01,HKG,Pulau Pinang,0,0,0
2022-09-01,HKG,Sabah,13,7,6
2022-09-01,HKG,Sarawak,0,0,0
2022-09-01,HKG,Selangor,1,1,0
2022-09-01,HKG,Terengganu,0,0,0
2022-09-01,HMD,Johor,0,0,0
2022-09-01,HND,Johor,2,1,1
2022-09-01,HND,Kedah,0,0,0
2022-09-01,HND,Perak,0,0,0
2022-09-01,HND,Pulau Pinang,0,0,0
2022-09-01,HND,Sabah,0,0,0
2022-09-01,HND,Sarawak,0,0,0
2022-09-01,HND,Selangor,13,4,9
2022-09-01,HRV,Johor,32,20,12
2022-09-01,HRV,Kedah,3,1,2
2022-09-01,HRV,Kelantan,0,0,0
2022-09-01,HRV,Melaka,0,0,0
2022-09-01,HRV,Pahang,0,0,0
2022-09-01,HRV,Perak,3,2,1
2022-09-01,HRV,Perlis,0,0,0
2022-09-01,HRV,Pulau Pinang,4,3,1
2022-09-01,HRV,Sabah,0,0,0
2022-09-01,HRV,Sarawak,2,2,0
2022-09-01,HRV,Selangor,116,86,30
2022-09-01,HTI,Johor,4,3,1
2022-09-01,HTI,Kedah,0,0,0
2022-09-01,HTI,Kelantan,0,0,0
2022-09-01,HTI,Perak,0,0,0
2022-09-01,HTI,Pulau Pinang,1,0,1
2022-09-01,HTI,Sabah,0,0,0
2022-09-01,HTI,Selangor,3,2,1
2022-09-01,HUN,Johor,66,42,24
2022-09-01,HUN,Kedah,7,2,5
2022-09-01,HUN,Kelantan,2,2,0
2022-09-01,HUN,Pahang,1,1,0
2022-09-01,HUN,Perak,0,0,0
2022-09-01,HUN,Perlis,2,1,1
2022-09-01,HUN,Pulau Pinang,9,5,4
2022-09-01,HUN,Sabah,3,1,2
2022-09-01,HUN,Sarawak,2,1,1
2022-09-01,HUN,Selangor,300,160,140
2022-09-01,HUN,W.P. Labuan,0,0,0
2022-09-01,IDN,Johor,85343,46090,39253
2022-09-01,IDN,Kedah,2035,783,1252
2022-09-01,IDN,Kelantan,93,59,34
2022-09-01,IDN,Melaka,7816,3486,4330
2022-09-01,IDN,Negeri Sembilan,6826,4691,2135
2022-09-01,IDN,Pahang,8,7,1
2022-09-01,IDN,Perak,133,27,106
2022-09-01,IDN,Perlis,275,109,166
2022-09-01,IDN,Pulau Pinang,23721,8843,14878
2022-09-01,IDN,Sabah,3700,1799,1901
2022-09-01,IDN,Sarawak,25941,14755,11186
2022-09-01,IDN,Selangor,63148,31678,31470
2022-09-01,IDN,Terengganu,2,1,1
2022-09-01,IDN,W.P. Labuan,28,20,8
2022-09-01,IND,Johor,14758,10199,4559
2022-09-01,IND,Kedah,591,326,265
2022-09-01,IND,Kelantan,5,3,2
2022-09-01,IND,Melaka,12,7,5
2022-09-01,IND,Negeri Sembilan,0,0,0
2022-09-01,IND,Pahang,2,1,1
2022-09-01,IND,Perak,1029,912,117
2022-09-01,IND,Perlis,61,48,13
2022-09-01,IND,Pulau Pinang,506,366,140
2022-09-01,IND,Sabah,193,130,63
2022-09-01,IND,Sarawak,406,288,118
2022-09-01,IND,Selangor,39817,30128,9689
2022-09-01,IND,Terengganu,0,0,0
2022-09-01,IND,W.P. Labuan,20,13,7
2022-09-01,IOT,Pulau Pinang,0,0,0
2022-09-01,IOT,Selangor,0,0,0
2022-09-01,IRL,Johor,224,157,67
2022-09-01,IRL,Kedah,36,26,10
2022-09-01,IRL,Kelantan,0,0,0
2022-09-01,IRL,Negeri Sembilan,0,0,0
2022-09-01,IRL,Pahang,0,0,0
2022-09-01,IRL,Perak,14,6,8
2022-09-01,IRL,Perlis,27,15,12
2022-09-01,IRL,Pulau Pinang,61,36,25
2022-09-01,IRL,Sabah,14,9,5
2022-09-01,IRL,Sarawak,28,14,14
2022-09-01,IRL,Selangor,949,561,388
2022-09-01,IRL,Terengganu,0,0,0
2022-09-01,IRL,W.P. Labuan,0,0,0
2022-09-01,IRN,Johor,60,45,15
2022-09-01,IRN,Kedah,4,3,1
2022-09-01,IRN,Kelantan,0,0,0
2022-09-01,IRN,Perak,0,0,0
2022-09-01,IRN,Perlis,3,3,0
2022-09-01,IRN,Pulau Pinang,4,2,2
2022-09-01,IRN,Sabah,1,1,0
2022-09-01,IRN,Sarawak,12,4,8
2022-09-01,IRN,Selangor,843,451,392
2022-09-01,IRN,W.P. Labuan,0,0,0
2022-09-01,IRQ,Johor,19,13,6
2022-09-01,IRQ,Kedah,0,0,0
2022-09-01,IRQ,Kelantan,0,0,0
2022-09-01,IRQ,Melaka,0,0,0
2022-09-01,IRQ,Pahang,0,0,0
2022-09-01,IRQ,Perak,0,0,0
2022-09-01,IRQ,Perlis,1,1,0
2022-09-01,IRQ,Pulau Pinang,0,0,0
2022-09-01,IRQ,Sabah,0,0,0
2022-09-01,IRQ,Sarawak,0,0,0
2022-09-01,IRQ,Selangor,770,504,266
2022-09-01,ISL,Johor,9,8,1
2022-09-01,ISL,Kedah,0,0,0
2022-09-01,ISL,Kelantan,0,0,0
2022-09-01,ISL,Perak,0,0,0
2022-09-01,ISL,Perlis,1,1,0
2022-09-01,ISL,Pulau Pinang,1,1,0
2022-09-01,ISL,Sabah,0,0,0
2022-09-01,ISL,Sarawak,0,0,0
2022-09-01,ISL,Selangor,16,12,4
2022-09-01,ISL,W.P. Labuan,0,0,0
2022-09-01,ISR,Pulau Pinang,2,2,0
2022-09-01,ITA,Johor,473,339,134
2022-09-01,ITA,Kedah,29,18,11
2022-09-01,ITA,Kelantan,2,2,0
2022-09-01,ITA,Melaka,1,0,1
2022-09-01,ITA,Negeri Sembilan,2,1,1
2022-09-01,ITA,Pahang,0,0,0
2022-09-01,ITA,Perak,0,0,0
2022-09-01,ITA,Perlis,15,10,5
2022-09-01,ITA,Pulau Pinang,80,61,19
2022-09-01,ITA,Sabah,34,21,13
2022-09-01,ITA,Sarawak,25,15,10
2022-09-01,ITA,Selangor,1839,1248,591
2022-09-01,ITA,W.P. Labuan,0,0,0
2022-09-01,JAM,Johor,0,0,0
2022-09-01,JAM,Kedah,0,0,0
2022-09-01,JAM,Perak,0,0,0
2022-09-01,JAM,Pulau Pinang,1,1,0
2022-09-01,JAM,Sabah,1,0,1
2022-09-01,JAM,Sarawak,0,0,0
2022-09-01,JAM,Selangor,5,1,4
2022-09-01,JAM,W.P. Labuan,0,0,0
2022-09-01,JOR,Johor,17,11,6
2022-09-01,JOR,Kedah,3,3,0
2022-09-01,JOR,Kelantan,0,0,0
2022-09-01,JOR,Melaka,0,0,0
2022-09-01,JOR,Perlis,1,1,0
2022-09-01,JOR,Pulau Pinang,8,8,0
2022-09-01,JOR,Sabah,2,2,0
2022-09-01,JOR,Sarawak,0,0,0
2022-09-01,JOR,Selangor,658,400,258
2022-09-01,JOR,W.P. Labuan,1,1,0
2022-09-01,JPN,Johor,4608,3386,1222
2022-09-01,JPN,Kedah,76,49,27
2022-09-01,JPN,Kelantan,7,7,0
2022-09-01,JPN,Melaka,1,1,0
2022-09-01,JPN,Negeri Sembilan,0,0,0
2022-09-01,JPN,Pahang,0,0,0
2022-09-01,JPN,Perak,36,24,12
2022-09-01,JPN,Perlis,51,42,9
2022-09-01,JPN,Pulau Pinang,817,620,197
2022-09-01,JPN,Sabah,166,91,75
2022-09-01,JPN,Sarawak,97,67,30
2022-09-01,JPN,Selangor,9946,6616,3330
2022-09-01,JPN,W.P. Labuan,4,4,0
2022-09-01,KAZ,Johor,20,5,15
2022-09-01,KAZ,Kedah,8,4,4
2022-09-01,KAZ,Kelantan,0,0,0
2022-09-01,KAZ,Melaka,0,0,0
2022-09-01,KAZ,Perak,0,0,0
2022-09-01,KAZ,Perlis,2,1,1
2022-09-01,KAZ,Pulau Pinang,8,3,5
2022-09-01,KAZ,Sabah,0,0,0
2022-09-01,KAZ,Sarawak,1,1,0
2022-09-01,KAZ,Selangor,382,160,222
2022-09-01,KAZ,W.P. Labuan,0,0,0
2022-09-01,KEN,Johor,26,12,14
2022-09-01,KEN,Kedah,4,2,2
2022-09-01,KEN,Kelantan,0,0,0
2022-09-01,KEN,Perak,0,0,0
2022-09-01,KEN,Perlis,0,0,0
2022-09-01,KEN,Pulau Pinang,1,0,1
2022-09-01,KEN,Sabah,2,2,0
2022-09-01,KEN,Sarawak,3,2,1
2022-09-01,KEN,Selangor,305,162,143
2022-09-01,KGZ,Johor,6,2,4
2022-09-01,KGZ,Kedah,1,1,0
2022-09-01,KGZ,Kelantan,0,0,0
2022-09-01,KGZ,Perak,0,0,0
2022-09-01,KGZ,Perlis,0,0,0
2022-09-01,KGZ,Pulau Pinang,0,0,0
2022-09-01,KGZ,Sabah,0,0,0
2022-09-01,KGZ,Sarawak,0,0,0
2022-09-01,KGZ,Selangor,124,65,59
2022-09-01,KHM,Johor,1325,575,750
2022-09-01,KHM,Kedah,143,83,60
2022-09-01,KHM,Kelantan,601,379,222
2022-09-01,KHM,Melaka,0,0,0
2022-09-01,KHM,Negeri Sembilan,0,0,0
2022-09-01,KHM,Pahang,0,0,0
2022-09-01,KHM,Perak,4,1,3
2022-09-01,KHM,Perlis,901,626,275
2022-09-01,KHM,Pulau Pinang,33,13,20
2022-09-01,KHM,Sabah,1,0,1
2022-09-01,KHM,Sarawak,0,0,0
2022-09-01,KHM,Selangor,3468,1615,1853
2022-09-01,KHM,W.P. Labuan,0,0,0
2022-09-01,KIR,Johor,0,0,0
2022-09-01,KIR,Sabah,0,0,0
2022-09-01,KIR,Selangor,0,0,0
2022-09-01,KNA,Johor,24,18,6
2022-09-01,KNA,Kedah,1,1,0
2022-09-01,KNA,Perlis,0,0,0
2022-09-01,KNA,Pulau Pinang,2,2,0
2022-09-01,KNA,Sabah,0,0,0
2022-09-01,KNA,Selangor,37,26,11
2022-09-01,KNA,W.P. Labuan,0,0,0
2022-09-01,KOR,Johor,6829,3972,2857
2022-09-01,KOR,Kedah,72,27,45
2022-09-01,KOR,Kelantan,0,0,0
2022-09-01,KOR,Melaka,3,3,0
2022-09-01,KOR,Negeri Sembilan,0,0,0
2022-09-01,KOR,Pahang,0,0,0
2022-09-01,KOR,Perak,19,11,8
2022-09-01,KOR,Perlis,26,22,4
2022-09-01,KOR,Pulau Pinang,317,191,126
2022-09-01,KOR,Sabah,5550,2474,3076
2022-09-01,KOR,Sarawak,148,78,70
2022-09-01,KOR,Selangor,7541,4517,3024
2022-09-01,KOR,Terengganu,0,0,0
2022-09-01,KOR,W.P. Labuan,3,0,3
2022-09-01,KWT,Johor,57,30,27
2022-09-01,KWT,Kedah,0,0,0
2022-09-01,KWT,Kelantan,0,0,0
2022-09-01,KWT,Perak,0,0,0
2022-09-01,KWT,Perlis,0,0,0
2022-09-01,KWT,Pulau Pinang,8,7,1
2022-09-01,KWT,Sabah,0,0,0
2022-09-01,KWT,Sarawak,0,0,0
2022-09-01,KWT,Selangor,406,220,186
2022-09-01,KWT,W.P. Labuan,0,0,0
2022-09-01,LAO,Johor,116,40,76
2022-09-01,LAO,Kedah,657,68,589
2022-09-01,LAO,Kelantan,65,8,57
2022-09-01,LAO,Melaka,1,0,1
2022-09-01,LAO,Perak,16,4,12
2022-09-01,LAO,Perlis,303,97,206
2022-09-01,LAO,Pulau Pinang,17,7,10
2022-09-01,LAO,Sabah,2,0,2
2022-09-01,LAO,Sarawak,4,4,0
2022-09-01,LAO,Selangor,206,67,139
2022-09-01,LAO,W.P. Labuan,0,0,0
2022-09-01,LBN,Johor,8,6,2
2022-09-01,LBN,Kedah,0,0,0
2022-09-01,LBN,Kelantan,0,0,0
2022-09-01,LBN,Pahang,0,0,0
2022-09-01,LBN,Perak,0,0,0
2022-09-01,LBN,Perlis,0,0,0
2022-09-01,LBN,Pulau Pinang,2,0,2
2022-09-01,LBN,Sabah,2,2,0
2022-09-01,LBN,Sarawak,2,0,2
2022-09-01,LBN,Selangor,201,130,71
2022-09-01,LBN,W.P. Labuan,0,0,0
2022-09-01,LBR,Johor,1,1,0
2022-09-01,LBR,Kedah,0,0,0
2022-09-01,LBR,Sabah,0,0,0
2022-09-01,LBR,Sarawak,0,0,0
2022-09-01,LBR,Selangor,5,4,1
2022-09-01,LBY,Johor,8,6,2
2022-09-01,LBY,Kedah,0,0,0
2022-09-01,LBY,Perlis,0,0,0
2022-09-01,LBY,Pulau Pinang,1,1,0
2022-09-01,LBY,Sabah,1,1,0
2022-09-01,LBY,Sarawak,1,1,0
2022-09-01,LBY,Selangor,361,245,116
2022-09-01,LCA,Johor,6,5,1
2022-09-01,LCA,Kedah,0,0,0
2022-09-01,LCA,Pulau Pinang,0,0,0
2022-09-01,LCA,Sarawak,0,0,0
2022-09-01,LCA,Selangor,7,7,0
2022-09-01,LIE,Johor,1,1,0
2022-09-01,LIE,Kedah,0,0,0
2022-09-01,LIE,Perlis,0,0,0
2022-09-01,LIE,Pulau Pinang,2,2,0
2022-09-01,LIE,Sabah,0,0,0
2022-09-01,LIE,Sarawak,0,0,0
2022-09-01,LIE,Selangor,3,3,0
2022-09-01,LKA,Johor,914,581,333
2022-09-01,LKA,Kedah,20,11,9
2022-09-01,LKA,Kelantan,0,0,0
2022-09-01,LKA,Melaka,0,0,0
2022-09-01,LKA,Pahang,0,0,0
2022-09-01,LKA,Perak,1,0,1
2022-09-01,LKA,Perlis,3,1,2
2022-09-01,LKA,Pulau Pinang,26,16,10
2022-09-01,LKA,Sabah,16,10,6
2022-09-01,LKA,Sarawak,10,6,4
2022-09-01,LKA,Selangor,2482,1657,825
2022-09-01,LKA,W.P. Labuan,0,0,0
2022-09-01,LSO,Johor,0,0,0
2022-09-01,LSO,Kedah,0,0,0
2022-09-01,LSO,Pulau Pinang,0,0,0
2022-09-01,LSO,Sarawak,0,0,0
2022-09-01,LSO,Selangor,6,3,3
2022-09-01,LTU,Johor,28,10,18
2022-09-01,LTU,Kedah,8,5,3
2022-09-01,LTU,Kelantan,0,0,0
2022-09-01,LTU,Pahang,0,0,0
2022-09-01,LTU,Perak,2,0,2
2022-09-01,LTU,Perlis,3,1,2
2022-09-01,LTU,Pulau Pinang,3,1,2
2022-09-01,LTU,Sabah,5,3,2
2022-09-01,LTU,Sarawak,3,1,2
2022-09-01,LTU,Selangor,158,90,68
2022-09-01,LTU,W.P. Labuan,0,0,0
2022-09-01,LUX,Johor,10,5,5
2022-09-01,LUX,Kedah,0,0,0
2022-09-01,LUX,Kelantan,0,0,0
2022-09-01,LUX,Perak,0,0,0
2022-09-01,LUX,Perlis,0,0,0
2022-09-01,LUX,Pulau Pinang,0,0,0
2022-09-01,LUX,Sabah,0,0,0
2022-09-01,LUX,Sarawak,0,0,0
2022-09-01,LUX,Selangor,34,19,15
2022-09-01,LVA,Johor,13,5,8
2022-09-01,LVA,Kedah,0,0,0
2022-09-01,LVA,Kelantan,0,0,0
2022-09-01,LVA,Pahang,0,0,0
2022-09-01,LVA,Perak,0,0,0
2022-09-01,LVA,Perlis,0,0,0
2022-09-01,LVA,Pulau Pinang,2,1,1
2022-09-01,LVA,Sabah,0,0,0
2022-09-01,LVA,Sarawak,4,2,2
2022-09-01,LVA,Selangor,53,32,21
2022-09-01,LVA,W.P. Labuan,0,0,0
2022-09-01,MAC,Johor,0,0,0
2022-09-01,MAC,Pahang,0,0,0
2022-09-01,MAC,Perak,0,0,0
2022-09-01,MAC,Selangor,0,0,0
2022-09-01,MAC,W.P. Labuan,0,0,0
2022-09-01,MAR,Johor,56,41,15
2022-09-01,MAR,Kedah,4,3,1
2022-09-01,MAR,Kelantan,0,0,0
2022-09-01,MAR,Melaka,0,0,0
2022-09-01,MAR,Pahang,0,0,0
2022-09-01,MAR,Perak,0,0,0
2022-09-01,MAR,Perlis,0,0,0
2022-09-01,MAR,Pulau Pinang,7,6,1
2022-09-01,MAR,Sabah,1,0,1
2022-09-01,MAR,Sarawak,3,3,0
2022-09-01,MAR,Selangor,643,318,325
2022-09-01,MAR,W.P. Labuan,0,0,0
2022-09-01,MCO,Johor,0,0,0
2022-09-01,MCO,Kedah,0,0,0
2022-09-01,MCO,Sabah,0,0,0
2022-09-01,MCO,Selangor,0,0,0
2022-09-01,MDA,Johor,8,5,3
2022-09-01,MDA,Kedah,0,0,0
2022-09-01,MDA,Kelantan,0,0,0
2022-09-01,MDA,Negeri Sembilan,0,0,0
2022-09-01,MDA,Perlis,0,0,0
2022-09-01,MDA,Pulau Pinang,0,0,0
2022-09-01,MDA,Sabah,1,0,1
2022-09-01,MDA,Sarawak,3,0,3
2022-09-01,MDA,Selangor,27,13,14
2022-09-01,MDG,Johor,0,0,0
2022-09-01,MDG,Kedah,1,1,0
2022-09-01,MDG,Perak,0,0,0
2022-09-01,MDG,Perlis,0,0,0
2022-09-01,MDG,Pulau Pinang,0,0,0
2022-09-01,MDG,Sabah,0,0,0
2022-09-01,MDG,Sarawak,0,0,0
2022-09-01,MDG,Selangor,15,4,11
2022-09-01,MDV,Johor,90,61,29
2022-09-01,MDV,Kedah,3,1,2
2022-09-01,MDV,Kelantan,0,0,0
2022-09-01,MDV,Perak,0,0,0
2022-09-01,MDV,Perlis,0,0,0
2022-09-01,MDV,Pulau Pinang,4,3,1
2022-09-01,MDV,Sabah,0,0,0
2022-09-01,MDV,Sarawak,7,5,2
2022-09-01,MDV,Selangor,1741,997,744
2022-09-01,MEX,Johor,120,61,59
2022-09-01,MEX,Kedah,8,4,4
2022-09-01,MEX,Kelantan,0,0,0
2022-09-01,MEX,Pahang,0,0,0
2022-09-01,MEX,Perak,0,0,0
2022-09-01,MEX,Perlis,1,1,0
2022-09-01,MEX,Pulau Pinang,15,14,1
2022-09-01,MEX,Sabah,6,3,3
2022-09-01,MEX,Sarawak,2,1,1
2022-09-01,MEX,Selangor,401,218,183
2022-09-01,MEX,W.P. Labuan,0,0,0
2022-09-01,MHL,Johor,0,0,0
2022-09-01,MHL,Kedah,0,0,0
2022-09-01,MHL,Perak,0,0,0
2022-09-01,MHL,Pulau Pinang,0,0,0
2022-09-01,MHL,Sabah,0,0,0
2022-09-01,MHL,Selangor,1,1,0
2022-09-01,MKD,Johor,5,2,3
2022-09-01,MKD,Kedah,0,0,0
2022-09-01,MKD,Perak,0,0,0
2022-09-01,MKD,Pulau Pinang,5,5,0
2022-09-01,MKD,Sabah,0,0,0
2022-09-01,MKD,Sarawak,4,2,2
2022-09-01,MKD,Selangor,26,15,11
2022-09-01,MLI,Johor,2,2,0
2022-09-01,MLI,Sabah,0,0,0
2022-09-01,MLI,Selangor,5,3,2
2022-09-01,MLT,Johor,3,2,1
2022-09-01,MLT,Kedah,0,0,0
2022-09-01,MLT,Kelantan,0,0,0
2022-09-01,MLT,Perak,2,1,1
2022-09-01,MLT,Perlis,0,0,0
2022-09-01,MLT,Pulau Pinang,1,1,0
2022-09-01,MLT,Sabah,4,2,2
2022-09-01,MLT,Sarawak,0,0,0
2022-09-01,MLT,Selangor,31,21,10
2022-09-01,MLT,W.P. Labuan,0,0,0
2022-09-01,MMR,Johor,3275,1037,2238
2022-09-01,MMR,Kedah,37,12,25
2022-09-01,MMR,Kelantan,3,1,2
2022-09-01,MMR,Negeri Sembilan,0,0,0
2022-09-01,MMR,Pahang,0,0,0
2022-09-01,MMR,Perak,12,5,7
2022-09-01,MMR,Perlis,8,0,8
2022-09-01,MMR,Pulau Pinang,118,50,68
2022-09-01,MMR,Sabah,10,3,7
2022-09-01,MMR,Sarawak,33,11,22
2022-09-01,MMR,Selangor,6809,4840,1969
2022-09-01,MMR,Terengganu,0,0,0
2022-09-01,MMR,W.P. Labuan,0,0,0
2022-09-01,MNE,Johor,0,0,0
2022-09-01,MNE,Kedah,0,0,0
2022-09-01,MNE,Pulau Pinang,0,0,0
2022-09-01,MNE,Sabah,0,0,0
2022-09-01,MNE,Sarawak,2,2,0
2022-09-01,MNE,Selangor,6,5,1
2022-09-01,MNG,Johor,91,42,49
2022-09-01,MNG,Kedah,9,3,6
2022-09-01,MNG,Kelantan,0,0,0
2022-09-01,MNG,Perak,0,0,0
2022-09-01,MNG,Perlis,1,0,1
2022-09-01,MNG,Pulau Pinang,11,6,5
2022-09-01,MNG,Sabah,1,0,1
2022-09-01,MNG,Sarawak,0,0,0
2022-09-01,MNG,Selangor,245,111,134
2022-09-01,MNP,Selangor,0,0,0
2022-09-01,MOZ,Johor,2,0,2
2022-09-01,MOZ,Kedah,0,0,0
2022-09-01,MOZ,Perak,0,0,0
2022-09-01,MOZ,Pulau Pinang,0,0,0
2022-09-01,MOZ,Sabah,0,0,0
2022-09-01,MOZ,Sarawak,0,0,0
2022-09-01,MOZ,Selangor,23,16,7
2022-09-01,MRT,Johor,3,1,2
2022-09-01,MRT,Kedah,0,0,0
2022-09-01,MRT,Pulau Pinang,0,0,0
2022-09-01,MRT,Sabah,0,0,0
2022-09-01,MRT,Sarawak,0,0,0
2022-09-01,MRT,Selangor,14,10,4
2022-09-01,MUS,Johor,73,37,36
2022-09-01,MUS,Kedah,4,3,1
2022-09-01,MUS,Kelantan,0,0,0
2022-09-01,MUS,Pahang,0,0,0
2022-09-01,MUS,Perak,0,0,0
2022-09-01,MUS,Perlis,1,0,1
2022-09-01,MUS,Pulau Pinang,8,3,5
2022-09-01,MUS,Sabah,2,1,1
2022-09-01,MUS,Sarawak,0,0,0
2022-09-01,MUS,Selangor,278,135,143
2022-09-01,MWI,Johor,0,0,0
2022-09-01,MWI,Pulau Pinang,0,0,0
2022-09-01,MWI,Sabah,0,0,0
2022-09-01,MWI,Sarawak,0,0,0
2022-09-01,MWI,Selangor,17,10,7
2022-09-01,MYT,Selangor,0,0,0
2022-09-01,NAM,Johor,7,5,2
2022-09-01,NAM,Kedah,0,0,0
2022-09-01,NAM,Perak,0,0,0
2022-09-01,NAM,Perlis,0,0,0
2022-09-01,NAM,Pulau Pinang,1,0,1
2022-09-01,NAM,Sabah,0,0,0
2022-09-01,NAM,Sarawak,0,0,0
2022-09-01,NAM,Selangor,5,0,5
2022-09-01,NCL,Selangor,0,0,0
2022-09-01,NER,Johor,0,0,0
2022-09-01,NER,Sabah,0,0,0
2022-09-01,NER,Selangor,4,3,1
2022-09-01,NGA,Johor,20,18,2
2022-09-01,NGA,Kedah,0,0,0
2022-09-01,NGA,Perlis,0,0,0
2022-09-01,NGA,Pulau Pinang,2,2,0
2022-09-01,NGA,Sabah,0,0,0
2022-09-01,NGA,Sarawak,1,1,0
2022-09-01,NGA,Selangor,329,261,68
2022-09-01,NIC,Johor,2,0,2
2022-09-01,NIC,Kedah,0,0,0
2022-09-01,NIC,Pulau Pinang,0,0,0
2022-09-01,NIC,Sabah,0,0,0
2022-09-01,NIC,Selangor,6,2,4
2022-09-01,NLD,Johor,859,543,316
2022-09-01,NLD,Kedah,74,45,29
2022-09-01,NLD,Kelantan,4,4,0
2022-09-01,NLD,Melaka,2,1,1
2022-09-01,NLD,Negeri Sembilan,0,0,0
2022-09-01,NLD,Pahang,1,1,0
2022-09-01,NLD,Perak,3,1,2
2022-09-01,NLD,Perlis,24,15,9
2022-09-01,NLD,Pulau Pinang,149,93,56
2022-09-01,NLD,Sabah,94,51,43
2022-09-01,NLD,Sarawak,116,66,50
2022-09-01,NLD,Selangor,3121,1894,1227
2022-09-01,NLD,Terengganu,0,0,0
2022-09-01,NLD,W.P. Labuan,0,0,0
2022-09-01,NOR,Johor,122,82,40
2022-09-01,NOR,Kedah,13,9,4
2022-09-01,NOR,Kelantan,0,0,0
2022-09-01,NOR,Melaka,0,0,0
2022-09-01,NOR,Pahang,0,0,0
2022-09-01,NOR,Perak,2,1,1
2022-09-01,NOR,Perlis,1,1,0
2022-09-01,NOR,Pulau Pinang,11,8,3
2022-09-01,NOR,Sabah,3,3,0
2022-09-01,NOR,Sarawak,16,14,2
2022-09-01,NOR,Selangor,372,240,132
2022-09-01,NOR,W.P. Labuan,1,0,1
2022-09-01,NPL,Johor,392,327,65
2022-09-01,NPL,Kedah,1,0,1
2022-09-01,NPL,Pahang,0,0,0
2022-09-01,NPL,Perak,0,0,0
2022-09-01,NPL,Perlis,0,0,0
2022-09-01,NPL,Pulau Pinang,19,13,6
2022-09-01,NPL,Sabah,7,4,3
2022-09-01,NPL,Sarawak,117,73,44
2022-09-01,NPL,Selangor,33400,32030,1370
2022-09-01,NPL,W.P. Labuan,91,87,4
2022-09-01,NRU,Johor,0,0,0
2022-09-01,NRU,Pulau Pinang,0,0,0
2022-09-01,NRU,Selangor,0,0,0
2022-09-01,NZL,Johor,507,329,178
2022-09-01,NZL,Kedah,56,32,24
2022-09-01,NZL,Kelantan,1,1,0
2022-09-01,NZL,Melaka,0,0,0
2022-09-01,NZL,Negeri Sembilan,1,1,0
2022-09-01,NZL,Pahang,3,3,0
2022-09-01,NZL,Perak,8,6,2
2022-09-01,NZL,Perlis,15,10,5
2022-09-01,NZL,Pulau Pinang,124,72,52
2022-09-01,NZL,Sabah,61,39,22
2022-09-01,NZL,Sarawak,97,47,50
2022-09-01,NZL,Selangor,1737,1110,627
2022-09-01,NZL,Terengganu,0,0,0
2022-09-01,NZL,W.P. Labuan,0,0,0
2022-09-01,OMN,Johor,39,24,15
2022-09-01,OMN,Kedah,2,2,0
2022-09-01,OMN,Kelantan,1,1,0
2022-09-01,OMN,Melaka,0,0,0
2022-09-01,OMN,Perak,0,0,0
2022-09-01,OMN,Perlis,0,0,0
2022-09-01,OMN,Pulau Pinang,5,5,0
2022-09-01,OMN,Sabah,0,0,0
2022-09-01,OMN,Sarawak,19,7,12
2022-09-01,OMN,Selangor,567,356,211
2022-09-01,PAK,Johor,707,555,152
2022-09-01,PAK,Kedah,79,61,18
2022-09-01,PAK,Kelantan,20,20,0
2022-09-01,PAK,Melaka,0,0,0
2022-09-01,PAK,Negeri Sembilan,1,1,0
2022-09-01,PAK,Pahang,0,0,0
2022-09-01,PAK,Perak,103,103,0
2022-09-01,PAK,Perlis,24,24,0
2022-09-01,PAK,Pulau Pinang,26,23,3
2022-09-01,PAK,Sabah,6,5,1
2022-09-01,PAK,Sarawak,63,52,11
2022-09-01,PAK,Selangor,9103,7961,1142
2022-09-01,PAK,W.P. Labuan,2,2,0
2022-09-01,PAN,Johor,6,3,3
2022-09-01,PAN,Kedah,0,0,0
2022-09-01,PAN,Perak,0,0,0
2022-09-01,PAN,Perlis,1,0,1
2022-09-01,PAN,Pulau Pinang,0,0,0
2022-09-01,PAN,Sabah,0,0,0
2022-09-01,PAN,Sarawak,0,0,0
2022-09-01,PAN,Selangor,15,6,9
2022-09-01,PER,Johor,36,25,11
2022-09-01,PER,Kedah,1,0,1
2022-09-01,PER,Kelantan,0,0,0
2022-09-01,PER,Pahang,0,0,0
2022-09-01,PER,Perak,0,0,0
2022-09-01,PER,Perlis,3,1,2
2022-09-01,PER,Pulau Pinang,2,1,1
2022-09-01,PER,Sabah,2,1,1
2022-09-01,PER,Sarawak,3,2,1
2022-09-01,PER,Selangor,69,36,33
2022-09-01,PER,W.P. Labuan,0,0,0
2022-09-01,PHL,Johor,14117,4207,9910
2022-09-01,PHL,Kedah,275,105,170
2022-09-01,PHL,Kelantan,8,6,2
2022-09-01,PHL,Melaka,0,0,0
2022-09-01,PHL,Negeri Sembilan,0,0,0
2022-09-01,PHL,Pahang,9,9,0
2022-09-01,PHL,Perak,43,15,28
2022-09-01,PHL,Perlis,133,62,71
2022-09-01,PHL,Pulau Pinang,320,103,217
2022-09-01,PHL,Sabah,1072,534,538
2022-09-01,PHL,Sarawak,758,299,459
2022-09-01,PHL,Selangor,10486,4141,6345
2022-09-01,PHL,Terengganu,0,0,0
2022-09-01,PHL,W.P. Labuan,42,11,31
2022-09-01,PLW,Johor,4,4,0
2022-09-01,PLW,Pulau Pinang,0,0,0
2022-09-01,PLW,Selangor,0,0,0
2022-09-01,PNG,Johor,8,3,5
2022-09-01,PNG,Kedah,0,0,0
2022-09-01,PNG,Kelantan,0,0,0
2022-09-01,PNG,Perak,0,0,0
2022-09-01,PNG,Pulau Pinang,2,1,1
2022-09-01,PNG,Sabah,1,0,1
2022-09-01,PNG,Sarawak,3,1,2
2022-09-01,PNG,Selangor,36,16,20
2022-09-01,POL,Johor,189,103,86
2022-09-01,POL,Kedah,19,10,9
2022-09-01,POL,Kelantan,2,1,1
2022-09-01,POL,Melaka,0,0,0
2022-09-01,POL,Negeri Sembilan,0,0,0
2022-09-01,POL,Pahang,0,0,0
2022-09-01,POL,Perak,5,4,1
2022-09-01,POL,Perlis,13,8,5
2022-09-01,POL,Pulau Pinang,33,22,11
2022-09-01,POL,Sabah,48,28,20
2022-09-01,POL,Sarawak,17,9,8
2022-09-01,POL,Selangor,896,493,403
2022-09-01,POL,Terengganu,0,0,0
2022-09-01,POL,W.P. Labuan,0,0,0
2022-09-01,PRK,Selangor,0,0,0
2022-09-01,PRT,Johor,80,47,33
2022-09-01,PRT,Kedah,12,5,7
2022-09-01,PRT,Kelantan,0,0,0
2022-09-01,PRT,Melaka,1,1,0
2022-09-01,PRT,Pahang,0,0,0
2022-09-01,PRT,Perak,0,0,0
2022-09-01,PRT,Perlis,1,1,0
2022-09-01,PRT,Pulau Pinang,36,19,17
2022-09-01,PRT,Sabah,9,7,2
2022-09-01,PRT,Sarawak,4,2,2
2022-09-01,PRT,Selangor,445,271,174
2022-09-01,PRT,W.P. Labuan,0,0,0
2022-09-01,PRY,Johor,0,0,0
2022-09-01,PRY,Kedah,0,0,0
2022-09-01,PRY,Perak,0,0,0
2022-09-01,PRY,Perlis,0,0,0
2022-09-01,PRY,Pulau Pinang,0,0,0
2022-09-01,PRY,Sabah,0,0,0
2022-09-01,PRY,Sarawak,0,0,0
2022-09-01,PRY,Selangor,11,7,4
2022-09-01,PSE,Johor,5,3,2
2022-09-01,PSE,Kedah,0,0,0
2022-09-01,PSE,Kelantan,0,0,0
2022-09-01,PSE,Melaka,0,0,0
2022-09-01,PSE,Perak,0,0,0
2022-09-01,PSE,Perlis,0,0,0
2022-09-01,PSE,Pulau Pinang,1,0,1
2022-09-01,PSE,Sabah,0,0,0
2022-09-01,PSE,Sarawak,1,1,0
2022-09-01,PSE,Selangor,302,212,90
2022-09-01,QAT,Johor,0,0,0
2022-09-01,QAT,Kedah,0,0,0
2022-09-01,QAT,Perlis,0,0,0
2022-09-01,QAT,Pulau Pinang,0,0,0
2022-09-01,QAT,Sabah,0,0,0
2022-09-01,QAT,Sarawak,1,1,0
2022-09-01,QAT,Selangor,40,28,12
2022-09-01,REU,Johor,0,0,0
2022-09-01,REU,Sarawak,0,0,0
2022-09-01,ROU,Johor,78,48,30
2022-09-01,ROU,Kedah,6,3,3
2022-09-01,ROU,Kelantan,0,0,0
2022-09-01,ROU,Negeri Sembilan,0,0,0
2022-09-01,ROU,Pahang,0,0,0
2022-09-01,ROU,Perak,0,0,0
2022-09-01,ROU,Perlis,0,0,0
2022-09-01,ROU,Pulau Pinang,13,4,9
2022-09-01,ROU,Sabah,3,1,2
2022-09-01,ROU,Sarawak,4,3,1
2022-09-01,ROU,Selangor,386,226,160
2022-09-01,ROU,W.P. Labuan,1,1,0
2022-09-01,RUS,Johor,265,143,122
2022-09-01,RUS,Kedah,243,122,121
2022-09-01,RUS,Kelantan,9,6,3
2022-09-01,RUS,Melaka,0,0,0
2022-09-01,RUS,Negeri Sembilan,0,0,0
2022-09-01,RUS,Pahang,1,0,1
2022-09-01,RUS,Perak,0,0,0
2022-09-01,RUS,Perlis,94,53,41
2022-09-01,RUS,Pulau Pinang,95,59,36
2022-09-01,RUS,Sabah,10,7,3
2022-09-01,RUS,Sarawak,35,17,18
2022-09-01,RUS,Selangor,2592,1315,1277
2022-09-01,RUS,W.P. Labuan,3,2,1
2022-09-01,RWA,Johor,0,0,0
2022-09-01,RWA,Kedah,0,0,0
2022-09-01,RWA,Pulau Pinang,0,0,0
2022-09-01,RWA,Selangor,3,1,2
2022-09-01,SAU,Johor,99,73,26
2022-09-01,SAU,Kedah,8,5,3
2022-09-01,SAU,Kelantan,9,5,4
2022-09-01,SAU,Melaka,0,0,0
2022-09-01,SAU,Perak,3,1,2
2022-09-01,SAU,Perlis,11,9,2
2022-09-01,SAU,Pulau Pinang,8,6,2
2022-09-01,SAU,Sabah,5,5,0
2022-09-01,SAU,Sarawak,19,17,2
2022-09-01,SAU,Selangor,2463,1446,1017
2022-09-01,SAU,W.P. Labuan,0,0,0
2022-09-01,SDN,Johor,4,2,2
2022-09-01,SDN,Kedah,0,0,0
2022-09-01,SDN,Kelantan,0,0,0
2022-09-01,SDN,Perlis,0,0,0
2022-09-01,SDN,Pulau Pinang,0,0,0
2022-09-01,SDN,Sabah,0,0,0
2022-09-01,SDN,Sarawak,10,5,5
2022-09-01,SDN,Selangor,860,522,338
2022-09-01,SDN,W.P. Labuan,0,0,0
2022-09-01,SEN,Johor,0,0,0
2022-09-01,SEN,Kedah,0,0,0
2022-09-01,SEN,Kelantan,0,0,0
2022-09-01,SEN,Perak,0,0,0
2022-09-01,SEN,Perlis,0,0,0
2022-09-01,SEN,Pulau Pinang,3,0,3
2022-09-01,SEN,Sabah,0,0,0
2022-09-01,SEN,Sarawak,0,0,0
2022-09-01,SEN,Selangor,25,18,7
2022-09-01,SGP,Johor,1006646,580516,426130
2022-09-01,SGP,Kedah,3140,1642,1498
2022-09-01,SGP,Kelantan,90,55,35
2022-09-01,SGP,Melaka,19,11,8
2022-09-01,SGP,Negeri Sembilan,1,1,0
2022-09-01,SGP,Pahang,100,70,30
2022-09-01,SGP,Perak,4322,1981,2341
2022-09-01,SGP,Perlis,249,173,76
2022-09-01,SGP,Pulau Pinang,13498,6674,6824
2022-09-01,SGP,Sabah,3429,1767,1662
2022-09-01,SGP,Sarawak,3149,1807,1342
2022-09-01,SGP,Selangor,32490,17331,15159
2022-09-01,SGP,Terengganu,2,2,0
2022-09-01,SGP,W.P. Labuan,2,2,0
2022-09-01,SGS,Johor,0,0,0
2022-09-01,SGS,Sabah,0,0,0
2022-09-01,SGS,Selangor,0,0,0
2022-09-01,SHN,Sarawak,0,0,0
2022-09-01,SLB,Johor,0,0,0
2022-09-01,SLB,Perlis,0,0,0
2022-09-01,SLB,Pulau Pinang,0,0,0
2022-09-01,SLB,Sabah,0,0,0
2022-09-01,SLB,Sarawak,0,0,0
2022-09-01,SLB,Selangor,4,4,0
2022-09-01,SLB,W.P. Labuan,0,0,0
2022-09-01,SLE,Johor,0,0,0
2022-09-01,SLE,Kedah,0,0,0
2022-09-01,SLE,Perak,0,0,0
2022-09-01,SLE,Pulau Pinang,0,0,0
2022-09-01,SLE,Sabah,0,0,0
2022-09-01,SLE,Selangor,7,5,2
2022-09-01,SLV,Johor,1,1,0
2022-09-01,SLV,Kedah,0,0,0
2022-09-01,SLV,Perak,0,0,0
2022-09-01,SLV,Perlis,0,0,0
2022-09-01,SLV,Pulau Pinang,0,0,0
2022-09-01,SLV,Sabah,0,0,0
2022-09-01,SLV,Selangor,6,4,2
2022-09-01,SLV,W.P. Labuan,0,0,0
2022-09-01,SMR,Johor,0,0,0
2022-09-01,SMR,Selangor,0,0,0
2022-09-01,SOM,Johor,0,0,0
2022-09-01,SOM,Kedah,0,0,0
2022-09-01,SOM,Kelantan,0,0,0
2022-09-01,SOM,Perlis,0,0,0
2022-09-01,SOM,Sabah,0,0,0
2022-09-01,SOM,Sarawak,0,0,0
2022-09-01,SOM,Selangor,235,148,87
2022-09-01,SRB,Johor,5,3,2
2022-09-01,SRB,Kedah,1,1,0
2022-09-01,SRB,Kelantan,0,0,0
2022-09-01,SRB,Pahang,0,0,0
2022-09-01,SRB,Perak,0,0,0
2022-09-01,SRB,Perlis,0,0,0
2022-09-01,SRB,Pulau Pinang,13,13,0
2022-09-01,SRB,Sabah,1,1,0
2022-09-01,SRB,Sarawak,0,0,0
2022-09-01,SRB,Selangor,42,25,17
2022-09-01,SSD,Johor,0,0,0
2022-09-01,SSD,Kedah,0,0,0
2022-09-01,SSD,Sarawak,0,0,0
2022-09-01,SSD,Selangor,48,35,13
2022-09-01,SSD,W.P. Labuan,0,0,0
2022-09-01,STP,Selangor,1,1,0
2022-09-01,SUR,Johor,4,3,1
2022-09-01,SUR,Kedah,0,0,0
2022-09-01,SUR,Kelantan,0,0,0
2022-09-01,SUR,Perak,0,0,0
2022-09-01,SUR,Perlis,0,0,0
2022-09-01,SUR,Pulau Pinang,0,0,0
2022-09-01,SUR,Sabah,0,0,0
2022-09-01,SUR,Sarawak,0,0,0
2022-09-01,SUR,Selangor,4,3,1
2022-09-01,SVK,Johor,37,21,16
2022-09-01,SVK,Kedah,2,1,1
2022-09-01,SVK,Kelantan,1,0,1
2022-09-01,SVK,Negeri Sembilan,0,0,0
2022-09-01,SVK,Pahang,0,0,0
2022-09-01,SVK,Perak,0,0,0
2022-09-01,SVK,Perlis,0,0,0
2022-09-01,SVK,Pulau Pinang,12,7,5
2022-09-01,SVK,Sabah,7,5,2
2022-09-01,SVK,Sarawak,0,0,0
2022-09-01,SVK,Selangor,149,85,64
2022-09-01,SVK,W.P. Labuan,0,0,0
2022-09-01,SVN,Johor,12,8,4
2022-09-01,SVN,Kedah,1,0,1
2022-09-01,SVN,Kelantan,0,0,0
2022-09-01,SVN,Perak,0,0,0
2022-09-01,SVN,Perlis,0,0,0
2022-09-01,SVN,Pulau Pinang,2,2,0
2022-09-01,SVN,Sabah,0,0,0
2022-09-01,SVN,Sarawak,1,0,1
2022-09-01,SVN,Selangor,54,31,23
2022-09-01,SVN,W.P. Labuan,0,0,0
2022-09-01,SWE,Johor,249,168,81
2022-09-01,SWE,Kedah,19,12,7
2022-09-01,SWE,Kelantan,0,0,0
2022-09-01,SWE,Melaka,1,1,0
2022-09-01,SWE,Negeri Sembilan,0,0,0
2022-09-01,SWE,Pahang,0,0,0
2022-09-01,SWE,Perak,4,4,0
2022-09-01,SWE,Perlis,2,1,1
2022-09-01,SWE,Pulau Pinang,50,43,7
2022-09-01,SWE,Sabah,17,11,6
2022-09-01,SWE,Sarawak,7,6,1
2022-09-01,SWE,Selangor,669,429,240
2022-09-01,SWE,W.P. Labuan,0,0,0
2022-09-01,SWZ,Johor,0,0,0
2022-09-01,SWZ,Kedah,0,0,0
2022-09-01,SWZ,Pulau Pinang,0,0,0
2022-09-01,SWZ,Sabah,0,0,0
2022-09-01,SWZ,Selangor,10,5,5
2022-09-01,SYC,Johor,3,1,2
2022-09-01,SYC,Kedah,0,0,0
2022-09-01,SYC,Pulau Pinang,0,0,0
2022-09-01,SYC,Sabah,0,0,0
2022-09-01,SYC,Sarawak,1,1,0
2022-09-01,SYC,Selangor,62,29,33
2022-09-01,SYR,Johor,7,1,6
2022-09-01,SYR,Kedah,0,0,0
2022-09-01,SYR,Kelantan,0,0,0
2022-09-01,SYR,Pahang,0,0,0
2022-09-01,SYR,Perlis,0,0,0
2022-09-01,SYR,Pulau Pinang,1,1,0
2022-09-01,SYR,Sabah,0,0,0
2022-09-01,SYR,Sarawak,2,1,1
2022-09-01,SYR,Selangor,713,438,275
2022-09-01,SYR,W.P. Labuan,0,0,0
2022-09-01,TCA,Perlis,0,0,0
2022-09-01,TCD,Johor,0,0,0
2022-09-01,TCD,Kedah,0,0,0
2022-09-01,TCD,Perlis,0,0,0
2022-09-01,TCD,Selangor,13,10,3
2022-09-01,TGO,Johor,1,0,1
2022-09-01,TGO,Perak,0,0,0
2022-09-01,TGO,Pulau Pinang,0,0,0
2022-09-01,TGO,Selangor,8,7,1
2022-09-01,THA,Johor,4153,947,3206
2022-09-01,THA,Kedah,43887,26352,17535
2022-09-01,THA,Kelantan,29055,14833,14222
2022-09-01,THA,Melaka,2,2,0
2022-09-01,THA,Negeri Sembilan,2,1,1
2022-09-01,THA,Pahang,38,34,4
2022-09-01,THA,Perak,3393,1609,1784
2022-09-01,THA,Perlis,45337,27498,17839
2022-09-01,THA,Pulau Pinang,1580,675,905
2022-09-01,THA,Sabah,135,45,90
2022-09-01,THA,Sarawak,161,58,103
2022-09-01,THA,Selangor,8635,3579,5056
2022-09-01,THA,Terengganu,3,3,0
2022-09-01,THA,W.P. Labuan,1,0,1
2022-09-01,TJK,Johor,1,0,1
2022-09-01,TJK,Kedah,1,1,0
2022-09-01,TJK,Perlis,1,1,0
2022-09-01,TJK,Pulau Pinang,0,0,0
2022-09-01,TJK,Sabah,0,0,0
2022-09-01,TJK,Selangor,153,118,35
2022-09-01,TKL,Selangor,0,0,0
2022-09-01,TKM,Johor,3,1,2
2022-09-01,TKM,Kedah,0,0,0
2022-09-01,TKM,Kelantan,0,0,0
2022-09-01,TKM,Perlis,0,0,0
2022-09-01,TKM,Pulau Pinang,0,0,0
2022-09-01,TKM,Sabah,0,0,0
2022-09-01,TKM,Sarawak,0,0,0
2022-09-01,TKM,Selangor,60,34,26
2022-09-01,TLS,Johor,26,23,3
2022-09-01,TLS,Kedah,0,0,0
2022-09-01,TLS,Perlis,0,0,0
2022-09-01,TLS,Pulau Pinang,8,6,2
2022-09-01,TLS,Sabah,0,0,0
2022-09-01,TLS,Sarawak,0,0,0
2022-09-01,TLS,Selangor,193,118,75
2022-09-01,TON,Johor,0,0,0
2022-09-01,TON,Pulau Pinang,1,1,0
2022-09-01,TON,Sarawak,0,0,0
2022-09-01,TON,Selangor,13,7,6
2022-09-01,TTO,Johor,1,1,0
2022-09-01,TTO,Kedah,0,0,0
2022-09-01,TTO,Pahang,0,0,0
2022-09-01,TTO,Pulau Pinang,1,1,0
2022-09-01,TTO,Sabah,0,0,0
2022-09-01,TTO,Sarawak,1,0,1
2022-09-01,TTO,Selangor,13,7,6
2022-09-01,TUN,Johor,8,4,4
2022-09-01,TUN,Kedah,1,1,0
2022-09-01,TUN,Kelantan,0,0,0
2022-09-01,TUN,Melaka,0,0,0
2022-09-01,TUN,Perak,0,0,0
2022-09-01,TUN,Perlis,0,0,0
2022-09-01,TUN,Pulau Pinang,5,5,0
2022-09-01,TUN,Sabah,0,0,0
2022-09-01,TUN,Sarawak,1,0,1
2022-09-01,TUN,Selangor,530,276,254
2022-09-01,TUN,W.P. Labuan,0,0,0
2022-09-01,TUR,Johor,159,119,40
2022-09-01,TUR,Kedah,16,11,5
2022-09-01,TUR,Kelantan,2,2,0
2022-09-01,TUR,Melaka,0,0,0
2022-09-01,TUR,Negeri Sembilan,2,1,1
2022-09-01,TUR,Pahang,0,0,0
2022-09-01,TUR,Perak,0,0,0
2022-09-01,TUR,Perlis,15,13,2
2022-09-01,TUR,Pulau Pinang,22,16,6
2022-09-01,TUR,Sabah,3,2,1
2022-09-01,TUR,Sarawak,11,8,3
2022-09-01,TUR,Selangor,737,517,220
2022-09-01,TUR,W.P. Labuan,0,0,0
2022-09-01,TUV,Selangor,0,0,0
2022-09-01,TWN,Johor,2649,1117,1532
2022-09-01,TWN,Kedah,53,25,28
2022-09-01,TWN,Kelantan,0,0,0
2022-09-01,TWN,Melaka,0,0,0
2022-09-01,TWN,Negeri Sembilan,1,0,1
2022-09-01,TWN,Pahang,0,0,0
2022-09-01,TWN,Perak,37,19,18
2022-09-01,TWN,Perlis,13,7,6
2022-09-01,TWN,Pulau Pinang,599,341,258
2022-09-01,TWN,Sabah,74,40,34
2022-09-01,TWN,Sarawak,123,65,58
2022-09-01,TWN,Selangor,5370,2555,2815
2022-09-01,TWN,W.P. Labuan,0,0,0
2022-09-01,TZA,Johor,7,2,5
2022-09-01,TZA,Kedah,0,0,0
2022-09-01,TZA,Perak,0,0,0
2022-09-01,TZA,Perlis,0,0,0
2022-09-01,TZA,Pulau Pinang,0,0,0
2022-09-01,TZA,Sabah,0,0,0
2022-09-01,TZA,Sarawak,0,0,0
2022-09-01,TZA,Selangor,143,85,58
2022-09-01,UGA,Johor,3,1,2
2022-09-01,UGA,Kedah,0,0,0
2022-09-01,UGA,Perak,0,0,0
2022-09-01,UGA,Perlis,0,0,0
2022-09-01,UGA,Pulau Pinang,1,0,1
2022-09-01,UGA,Sabah,0,0,0
2022-09-01,UGA,Sarawak,0,0,0
2022-09-01,UGA,Selangor,62,33,29
2022-09-01,UKR,Johor,71,37,34
2022-09-01,UKR,Kedah,27,15,12
2022-09-01,UKR,Kelantan,1,0,1
2022-09-01,UKR,Melaka,0,0,0
2022-09-01,UKR,Negeri Sembilan,0,0,0
2022-09-01,UKR,Pahang,2,2,0
2022-09-01,UKR,Perak,0,0,0
2022-09-01,UKR,Perlis,11,7,4
2022-09-01,UKR,Pulau Pinang,30,11,19
2022-09-01,UKR,Sabah,2,1,1
2022-09-01,UKR,Sarawak,3,3,0
2022-09-01,UKR,Selangor,485,260,225
2022-09-01,UKR,W.P. Labuan,0,0,0
2022-09-01,URY,Johor,7,3,4
2022-09-01,URY,Kedah,0,0,0
2022-09-01,URY,Kelantan,0,0,0
2022-09-01,URY,Perak,0,0,0
2022-09-01,URY,Perlis,0,0,0
2022-09-01,URY,Pulau Pinang,0,0,0
2022-09-01,URY,Sabah,0,0,0
2022-09-01,URY,Sarawak,0,0,0
2022-09-01,URY,Selangor,13,7,6
2022-09-01,URY,W.P. Labuan,0,0,0
2022-09-01,USA,Johor,2801,1763,1038
2022-09-01,USA,Kedah,224,122,102
2022-09-01,USA,Kelantan,4,1,3
2022-09-01,USA,Melaka,3,1,2
2022-09-01,USA,Negeri Sembilan,0,0,0
2022-09-01,USA,Pahang,8,4,4
2022-09-01,USA,Perak,61,37,24
2022-09-01,USA,Perlis,55,44,11
2022-09-01,USA,Pulau Pinang,1243,814,429
2022-09-01,USA,Sabah,253,156,97
2022-09-01,USA,Sarawak,229,134,95
2022-09-01,USA,Selangor,8891,5502,3389
2022-09-01,USA,Terengganu,0,0,0
2022-09-01,USA,W.P. Labuan,6,3,3
2022-09-01,UZB,Johor,63,32,31
2022-09-01,UZB,Kedah,5,3,2
2022-09-01,UZB,Kelantan,0,0,0
2022-09-01,UZB,Perak,0,0,0
2022-09-01,UZB,Perlis,1,1,0
2022-09-01,UZB,Pulau Pinang,10,6,4
2022-09-01,UZB,Sabah,30,28,2
2022-09-01,UZB,Sarawak,0,0,0
2022-09-01,UZB,Selangor,700,440,260
2022-09-01,VAT,Johor,0,0,0
2022-09-01,VAT,Sarawak,0,0,0
2022-09-01,VAT,Selangor,2,2,0
2022-09-01,VCT,Johor,1,1,0
2022-09-01,VCT,Kedah,0,0,0
2022-09-01,VCT,Pulau Pinang,0,0,0
2022-09-01,VCT,Sarawak,0,0,0
2022-09-01,VCT,Selangor,0,0,0
2022-09-01,VEN,Johor,8,6,2
2022-09-01,VEN,Kedah,1,0,1
2022-09-01,VEN,Kelantan,0,0,0
2022-09-01,VEN,Melaka,0,0,0
2022-09-01,VEN,Perak,0,0,0
2022-09-01,VEN,Perlis,0,0,0
2022-09-01,VEN,Pulau Pinang,3,2,1
2022-09-01,VEN,Sabah,3,1,2
2022-09-01,VEN,Sarawak,5,2,3
2022-09-01,VEN,Selangor,40,27,13
2022-09-01,VEN,W.P. Labuan,0,0,0
2022-09-01,VNM,Johor,12050,3771,8279
2022-09-01,VNM,Kedah,173,24,149
2022-09-01,VNM,Kelantan,7,6,1
2022-09-01,VNM,Melaka,0,0,0
2022-09-01,VNM,Negeri Sembilan,0,0,0
2022-09-01,VNM,Pahang,0,0,0
2022-09-01,VNM,Perak,77,2,75
2022-09-01,VNM,Perlis,190,21,169
2022-09-01,VNM,Pulau Pinang,1174,386,788
2022-09-01,VNM,Sabah,20,6,14
2022-09-01,VNM,Sarawak,90,19,71
2022-09-01,VNM,Selangor,12531,4317,8214
2022-09-01,VNM,Terengganu,1,1,0
2022-09-01,VNM,W.P. Labuan,0,0,0
2022-09-01,VUT,Johor,15,12,3
2022-09-01,VUT,Kedah,0,0,0
2022-09-01,VUT,Pulau Pinang,3,3,0
2022-09-01,VUT,Sabah,1,1,0
2022-09-01,VUT,Sarawak,0,0,0
2022-09-01,VUT,Selangor,46,35,11
2022-09-01,WSM,Johor,0,0,0
2022-09-01,WSM,Sarawak,0,0,0
2022-09-01,WSM,Selangor,7,5,2
2022-09-01,XXX,Johor,142,82,60
2022-09-01,XXX,Kedah,12,7,5
2022-09-01,XXX,Kelantan,0,0,0
2022-09-01,XXX,Melaka,0,0,0
2022-09-01,XXX,Pahang,0,0,0
2022-09-01,XXX,Perak,1,1,0
2022-09-01,XXX,Perlis,4,4,0
2022-09-01,XXX,Pulau Pinang,29,18,11
2022-09-01,XXX,Sabah,4,3,1
2022-09-01,XXX,Sarawak,15,13,2
2022-09-01,XXX,Selangor,280,166,114
2022-09-01,XXX,W.P. Labuan,1,1,0
2022-09-01,YEM,Johor,40,28,12
2022-09-01,YEM,Kedah,4,3,1
2022-09-01,YEM,Kelantan,0,0,0
2022-09-01,YEM,Melaka,0,0,0
2022-09-01,YEM,Pahang,0,0,0
2022-09-01,YEM,Perak,0,0,0
2022-09-01,YEM,Perlis,5,4,1
2022-09-01,YEM,Pulau Pinang,1,1,0
2022-09-01,YEM,Sabah,1,1,0
2022-09-01,YEM,Sarawak,7,5,2
2022-09-01,YEM,Selangor,1251,874,377
2022-09-01,YEM,W.P. Labuan,0,0,0
2022-09-01,ZAF,Johor,171,116,55
2022-09-01,ZAF,Kedah,14,9,5
2022-09-01,ZAF,Kelantan,0,0,0
2022-09-01,ZAF,Melaka,1,1,0
2022-09-01,ZAF,Pahang,0,0,0
2022-09-01,ZAF,Perak,1,1,0
2022-09-01,ZAF,Perlis,6,4,2
2022-09-01,ZAF,Pulau Pinang,44,24,20
2022-09-01,ZAF,Sabah,17,6,11
2022-09-01,ZAF,Sarawak,80,36,44
2022-09-01,ZAF,Selangor,614,359,255
2022-09-01,ZAF,Terengganu,0,0,0
2022-09-01,ZAF,W.P. Labuan,22,10,12
2022-09-01,ZAR,Selangor,0,0,0
2022-09-01,ZMB,Johor,3,3,0
2022-09-01,ZMB,Kedah,0,0,0
2022-09-01,ZMB,Perak,0,0,0
2022-09-01,ZMB,Perlis,0,0,0
2022-09-01,ZMB,Pulau Pinang,0,0,0
2022-09-01,ZMB,Sabah,0,0,0
2022-09-01,ZMB,Sarawak,0,0,0
2022-09-01,ZMB,Selangor,73,47,26
2022-09-01,ZWE,Johor,6,3,3
2022-09-01,ZWE,Kedah,0,0,0
2022-09-01,ZWE,Kelantan,0,0,0
2022-09-01,ZWE,Perak,0,0,0
2022-09-01,ZWE,Perlis,0,0,0
2022-09-01,ZWE,Pulau Pinang,1,1,0
2022-09-01,ZWE,Sabah,1,0,1
2022-09-01,ZWE,Sarawak,2,0,2
2022-09-01,ZWE,Selangor,87,48,39
2022-10-01,ABW,Kedah,0,0,0
2022-10-01,ABW,Pulau Pinang,0,0,0
2022-10-01,AFG,Johor,0,0,0
2022-10-01,AFG,Kedah,0,0,0
2022-10-01,AFG,Perlis,0,0,0
2022-10-01,AFG,Pulau Pinang,0,0,0
2022-10-01,AFG,Sarawak,0,0,0
2022-10-01,AFG,Selangor,48,31,17
2022-10-01,AGO,Johor,0,0,0
2022-10-01,AGO,Kedah,1,0,1
2022-10-01,AGO,Sabah,0,0,0
2022-10-01,AGO,Selangor,5,5,0
2022-10-01,AIA,Selangor,0,0,0
2022-10-01,ALB,Johor,24,18,6
2022-10-01,ALB,Kedah,1,1,0
2022-10-01,ALB,Perak,0,0,0
2022-10-01,ALB,Perlis,0,0,0
2022-10-01,ALB,Pulau Pinang,1,0,1
2022-10-01,ALB,Sabah,0,0,0
2022-10-01,ALB,Sarawak,0,0,0
2022-10-01,ALB,Selangor,38,28,10
2022-10-01,AND,Johor,0,0,0
2022-10-01,AND,Kedah,0,0,0
2022-10-01,AND,Perlis,0,0,0
2022-10-01,AND,Pulau Pinang,0,0,0
2022-10-01,AND,Selangor,6,3,3
2022-10-01,ANT,Selangor,0,0,0
2022-10-01,ARE,Johor,40,28,12
2022-10-01,ARE,Kedah,0,0,0
2022-10-01,ARE,Kelantan,0,0,0
2022-10-01,ARE,Perak,1,0,1
2022-10-01,ARE,Perlis,2,2,0
2022-10-01,ARE,Pulau Pinang,2,1,1
2022-10-01,ARE,Sabah,0,0,0
2022-10-01,ARE,Sarawak,0,0,0
2022-10-01,ARE,Selangor,311,228,83
2022-10-01,ARG,Johor,61,32,29
2022-10-01,ARG,Kedah,17,11,6
2022-10-01,ARG,Kelantan,0,0,0
2022-10-01,ARG,Melaka,0,0,0
2022-10-01,ARG,Perak,2,1,1
2022-10-01,ARG,Perlis,3,2,1
2022-10-01,ARG,Pulau Pinang,12,6,6
2022-10-01,ARG,Sabah,2,1,1
2022-10-01,ARG,Sarawak,2,1,1
2022-10-01,ARG,Selangor,282,157,125
2022-10-01,ARG,W.P. Labuan,0,0,0
2022-10-01,ARM,Johor,6,5,1
2022-10-01,ARM,Kedah,6,4,2
2022-10-01,ARM,Kelantan,0,0,0
2022-10-01,ARM,Perak,0,0,0
2022-10-01,ARM,Perlis,0,0,0
2022-10-01,ARM,Pulau Pinang,3,3,0
2022-10-01,ARM,Sabah,0,0,0
2022-10-01,ARM,Sarawak,0,0,0
2022-10-01,ARM,Selangor,19,9,10
2022-10-01,ATA,Selangor,0,0,0
2022-10-01,ATG,Johor,7,3,4
2022-10-01,ATG,Kedah,0,0,0
2022-10-01,ATG,Pulau Pinang,1,0,1
2022-10-01,ATG,Sarawak,0,0,0
2022-10-01,ATG,Selangor,23,15,8
2022-10-01,AUS,Johor,4493,2669,1824
2022-10-01,AUS,Kedah,445,244,201
2022-10-01,AUS,Kelantan,2,2,0
2022-10-01,AUS,Melaka,1,1,0
2022-10-01,AUS,Negeri Sembilan,0,0,0
2022-10-01,AUS,Pahang,2,2,0
2022-10-01,AUS,Perak,196,100,96
2022-10-01,AUS,Perlis,51,37,14
2022-10-01,AUS,Pulau Pinang,1343,763,580
2022-10-01,AUS,Sabah,424,233,191
2022-10-01,AUS,Sarawak,470,252,218
2022-10-01,AUS,Selangor,16736,10152,6584
2022-10-01,AUS,Terengganu,0,0,0
2022-10-01,AUS,W.P. Labuan,6,5,1
2022-10-01,AUT,Johor,153,117,36
2022-10-01,AUT,Kedah,13,9,4
2022-10-01,AUT,Kelantan,2,2,0
2022-10-01,AUT,Melaka,0,0,0
2022-10-01,AUT,Negeri Sembilan,0,0,0
2022-10-01,AUT,Pahang,0,0,0
2022-10-01,AUT,Perak,5,2,3
2022-10-01,AUT,Perlis,7,3,4
2022-10-01,AUT,Pulau Pinang,74,59,15
2022-10-01,AUT,Sabah,12,8,4
2022-10-01,AUT,Sarawak,11,7,4
2022-10-01,AUT,Selangor,546,374,172
2022-10-01,AUT,Terengganu,0,0,0
2022-10-01,AUT,W.P. Labuan,2,1,1
2022-10-01,AZE,Johor,4,3,1
2022-10-01,AZE,Kedah,5,3,2
2022-10-01,AZE,Kelantan,0,0,0
2022-10-01,AZE,Melaka,0,0,0
2022-10-01,AZE,Perlis,0,0,0
2022-10-01,AZE,Pulau Pinang,0,0,0
2022-10-01,AZE,Sabah,1,0,1
2022-10-01,AZE,Sarawak,1,1,0
2022-10-01,AZE,Selangor,72,46,26
2022-10-01,AZE,W.P. Labuan,0,0,0
2022-10-01,BDI,Pulau Pinang,0,0,0
2022-10-01,BDI,Sarawak,0,0,0
2022-10-01,BDI,Selangor,7,5,2
2022-10-01,BEL,Johor,213,136,77
2022-10-01,BEL,Kedah,22,11,11
2022-10-01,BEL,Kelantan,2,2,0
2022-10-01,BEL,Melaka,0,0,0
2022-10-01,BEL,Negeri Sembilan,0,0,0
2022-10-01,BEL,Pahang,0,0,0
2022-10-01,BEL,Perak,2,1,1
2022-10-01,BEL,Perlis,7,3,4
2022-10-01,BEL,Pulau Pinang,33,25,8
2022-10-01,BEL,Sabah,20,12,8
2022-10-01,BEL,Sarawak,24,10,14
2022-10-01,BEL,Selangor,875,558,317
2022-10-01,BEL,W.P. Labuan,0,0,0
2022-10-01,BEN,Johor,0,0,0
2022-10-01,BEN,Kedah,0,0,0
2022-10-01,BEN,Perak,2,1,1
2022-10-01,BEN,Pulau Pinang,1,1,0
2022-10-01,BEN,Sabah,0,0,0
2022-10-01,BEN,Sarawak,0,0,0
2022-10-01,BEN,Selangor,16,13,3
2022-10-01,BFA,Perak,1,0,1
2022-10-01,BFA,Pulau Pinang,0,0,0
2022-10-01,BFA,Selangor,14,10,4
2022-10-01,BGD,Johor,2043,1687,356
2022-10-01,BGD,Kedah,45,34,11
2022-10-01,BGD,Kelantan,0,0,0
2022-10-01,BGD,Melaka,0,0,0
2022-10-01,BGD,Negeri Sembilan,0,0,0
2022-10-01,BGD,Pahang,0,0,0
2022-10-01,BGD,Perak,0,0,0
2022-10-01,BGD,Perlis,11,8,3
2022-10-01,BGD,Pulau Pinang,238,226,12
2022-10-01,BGD,Sabah,2,1,1
2022-10-01,BGD,Sarawak,26,21,5
2022-10-01,BGD,Selangor,31159,29530,1629
2022-10-01,BGD,W.P. Labuan,0,0,0
2022-10-01,BGR,Johor,62,40,22
2022-10-01,BGR,Kedah,2,0,2
2022-10-01,BGR,Kelantan,0,0,0
2022-10-01,BGR,Pahang,0,0,0
2022-10-01,BGR,Perak,2,0,2
2022-10-01,BGR,Perlis,0,0,0
2022-10-01,BGR,Pulau Pinang,19,6,13
2022-10-01,BGR,Sabah,1,1,0
2022-10-01,BGR,Sarawak,1,0,1
2022-10-01,BGR,Selangor,122,86,36
2022-10-01,BGR,W.P. Labuan,0,0,0
2022-10-01,BHR,Johor,2,1,1
2022-10-01,BHR,Kedah,0,0,0
2022-10-01,BHR,Kelantan,0,0,0
2022-10-01,BHR,Perlis,1,1,0
2022-10-01,BHR,Pulau Pinang,7,3,4
2022-10-01,BHR,Sabah,1,1,0
2022-10-01,BHR,Sarawak,0,0,0
2022-10-01,BHR,Selangor,132,84,48
2022-10-01,BHS,Johor,0,0,0
2022-10-01,BHS,Kedah,0,0,0
2022-10-01,BHS,Perak,0,0,0
2022-10-01,BHS,Sabah,0,0,0
2022-10-01,BHS,Sarawak,0,0,0
2022-10-01,BHS,Selangor,8,4,4
2022-10-01,BIH,Johor,8,5,3
2022-10-01,BIH,Kedah,0,0,0
2022-10-01,BIH,Perlis,0,0,0
2022-10-01,BIH,Pulau Pinang,1,1,0
2022-10-01,BIH,Sabah,0,0,0
2022-10-01,BIH,Sarawak,2,2,0
2022-10-01,BIH,Selangor,44,25,19
2022-10-01,BLR,Johor,13,9,4
2022-10-01,BLR,Kedah,19,8,11
2022-10-01,BLR,Kelantan,2,1,1
2022-10-01,BLR,Pahang,0,0,0
2022-10-01,BLR,Perak,2,0,2
2022-10-01,BLR,Perlis,0,0,0
2022-10-01,BLR,Pulau Pinang,4,3,1
2022-10-01,BLR,Sabah,0,0,0
2022-10-01,BLR,Sarawak,5,2,3
2022-10-01,BLR,Selangor,196,89,107
2022-10-01,BLR,W.P. Labuan,0,0,0
2022-10-01,BLZ,Johor,3,1,2
2022-10-01,BLZ,Pulau Pinang,0,0,0
2022-10-01,BLZ,Sarawak,0,0,0
2022-10-01,BLZ,Selangor,2,1,1
2022-10-01,BMU,Selangor,0,0,0
2022-10-01,BOL,Johor,1,0,1
2022-10-01,BOL,Kedah,0,0,0
2022-10-01,BOL,Melaka,0,0,0
2022-10-01,BOL,Perak,1,1,0
2022-10-01,BOL,Perlis,0,0,0
2022-10-01,BOL,Pulau Pinang,2,1,1
2022-10-01,BOL,Sabah,0,0,0
2022-10-01,BOL,Sarawak,4,2,2
2022-10-01,BOL,Selangor,16,10,6
2022-10-01,BRA,Johor,245,130,115
2022-10-01,BRA,Kedah,22,10,12
2022-10-01,BRA,Kelantan,0,0,0
2022-10-01,BRA,Melaka,0,0,0
2022-10-01,BRA,Pahang,0,0,0
2022-10-01,BRA,Perak,3,2,1
2022-10-01,BRA,Perlis,5,2,3
2022-10-01,BRA,Pulau Pinang,14,9,5
2022-10-01,BRA,Sabah,1,1,0
2022-10-01,BRA,Sarawak,13,7,6
2022-10-01,BRA,Selangor,658,402,256
2022-10-01,BRA,W.P. Labuan,0,0,0
2022-10-01,BRB,Johor,1,0,1
2022-10-01,BRB,Kedah,0,0,0
2022-10-01,BRB,Perlis,0,0,0
2022-10-01,BRB,Pulau Pinang,0,0,0
2022-10-01,BRB,Selangor,10,4,6
2022-10-01,BRN,Johor,294,151,143
2022-10-01,BRN,Kedah,12,7,5
2022-10-01,BRN,Kelantan,0,0,0
2022-10-01,BRN,Melaka,0,0,0
2022-10-01,BRN,Pahang,0,0,0
2022-10-01,BRN,Perak,2,1,1
2022-10-01,BRN,Perlis,6,4,2
2022-10-01,BRN,Pulau Pinang,11,4,7
2022-10-01,BRN,Sabah,638,291,347
2022-10-01,BRN,Sarawak,58681,31932,26749
2022-10-01,BRN,Selangor,3683,1866,1817
2022-10-01,BRN,W.P. Labuan,714,513,201
2022-10-01,BTN,Johor,0,0,0
2022-10-01,BTN,Kedah,1,1,0
2022-10-01,BTN,Perak,0,0,0
2022-10-01,BTN,Perlis,0,0,0
2022-10-01,BTN,Pulau Pinang,2,2,0
2022-10-01,BTN,Sabah,0,0,0
2022-10-01,BTN,Sarawak,0,0,0
2022-10-01,BTN,Selangor,20,15,5
2022-10-01,BWA,Johor,5,2,3
2022-10-01,BWA,Kedah,0,0,0
2022-10-01,BWA,Perlis,0,0,0
2022-10-01,BWA,Pulau Pinang,0,0,0
2022-10-01,BWA,Sabah,0,0,0
2022-10-01,BWA,Sarawak,1,1,0
2022-10-01,BWA,Selangor,17,10,7
2022-10-01,CAF,Kedah,0,0,0
2022-10-01,CAF,Selangor,0,0,0
2022-10-01,CAN,Johor,1146,682,464
2022-10-01,CAN,Kedah,111,61,50
2022-10-01,CAN,Kelantan,1,0,1
2022-10-01,CAN,Melaka,0,0,0
2022-10-01,CAN,Negeri Sembilan,0,0,0
2022-10-01,CAN,Pahang,0,0,0
2022-10-01,CAN,Perak,23,12,11
2022-10-01,CAN,Perlis,26,17,9
2022-10-01,CAN,Pulau Pinang,317,200,117
2022-10-01,CAN,Sabah,151,90,61
2022-10-01,CAN,Sarawak,228,125,103
2022-10-01,CAN,Selangor,3401,2047,1354
2022-10-01,CAN,Terengganu,0,0,0
2022-10-01,CAN,W.P. Labuan,5,4,1
2022-10-01,CCK,Selangor,0,0,0
2022-10-01,CHE,Johor,510,309,201
2022-10-01,CHE,Kedah,71,41,30
2022-10-01,CHE,Kelantan,3,2,1
2022-10-01,CHE,Melaka,0,0,0
2022-10-01,CHE,Negeri Sembilan,0,0,0
2022-10-01,CHE,Pahang,0,0,0
2022-10-01,CHE,Perak,6,4,2
2022-10-01,CHE,Perlis,13,10,3
2022-10-01,CHE,Pulau Pinang,110,67,43
2022-10-01,CHE,Sabah,46,27,19
2022-10-01,CHE,Sarawak,32,15,17
2022-10-01,CHE,Selangor,984,605,379
2022-10-01,CHE,W.P. Labuan,3,2,1
2022-10-01,CHL,Johor,33,22,11
2022-10-01,CHL,Kedah,7,3,4
2022-10-01,CHL,Kelantan,0,0,0
2022-10-01,CHL,Melaka,2,1,1
2022-10-01,CHL,Pahang,0,0,0
2022-10-01,CHL,Perak,2,0,2
2022-10-01,CHL,Perlis,6,5,1
2022-10-01,CHL,Pulau Pinang,7,5,2
2022-10-01,CHL,Sabah,2,1,1
2022-10-01,CHL,Sarawak,2,1,1
2022-10-01,CHL,Selangor,125,71,54
2022-10-01,CHN,Johor,21525,8935,12590
2022-10-01,CHN,Kedah,473,189,284
2022-10-01,CHN,Kelantan,9,6,3
2022-10-01,CHN,Melaka,2,1,1
2022-10-01,CHN,Pahang,0,0,0
2022-10-01,CHN,Perak,123,44,79
2022-10-01,CHN,Perlis,55,33,22
2022-10-01,CHN,Pulau Pinang,1206,578,628
2022-10-01,CHN,Sabah,384,170,214
2022-10-01,CHN,Sarawak,410,213,197
2022-10-01,CHN,Selangor,16993,9798,7195
2022-10-01,CHN,Terengganu,0,0,0
2022-10-01,CHN,W.P. Labuan,7,4,3
2022-10-01,CIV,Johor,5,3,2
2022-10-01,CIV,Kedah,0,0,0
2022-10-01,CIV,Pulau Pinang,1,1,0
2022-10-01,CIV,Sabah,0,0,0
2022-10-01,CIV,Sarawak,0,0,0
2022-10-01,CIV,Selangor,52,38,14
2022-10-01,CMR,Johor,1,1,0
2022-10-01,CMR,Kedah,0,0,0
2022-10-01,CMR,Pulau Pinang,3,2,1
2022-10-01,CMR,Sabah,0,0,0
2022-10-01,CMR,Sarawak,0,0,0
2022-10-01,CMR,Selangor,51,27,24
2022-10-01,COD,Johor,1,1,0
2022-10-01,COD,Pulau Pinang,0,0,0
2022-10-01,COD,Sarawak,0,0,0
2022-10-01,COD,Selangor,4,4,0
2022-10-01,COG,Johor,0,0,0
2022-10-01,COG,Kedah,0,0,0
2022-10-01,COG,Selangor,1,1,0
2022-10-01,COK,Selangor,0,0,0
2022-10-01,COL,Johor,23,10,13
2022-10-01,COL,Kedah,0,0,0
2022-10-01,COL,Perak,0,0,0
2022-10-01,COL,Pulau Pinang,0,0,0
2022-10-01,COL,Sabah,2,1,1
2022-10-01,COL,Sarawak,1,0,1
2022-10-01,COL,Selangor,218,112,106
2022-10-01,COL,W.P. Labuan,0,0,0
2022-10-01,COM,Johor,0,0,0
2022-10-01,COM,Kedah,0,0,0
2022-10-01,COM,Selangor,10,8,2
2022-10-01,CPV,Johor,0,0,0
2022-10-01,CPV,Kedah,0,0,0
2022-10-01,CPV,Pulau Pinang,0,0,0
2022-10-01,CPV,Sabah,0,0,0
2022-10-01,CPV,Selangor,5,2,3
2022-10-01,CRI,Johor,9,5,4
2022-10-01,CRI,Kedah,0,0,0
2022-10-01,CRI,Perak,2,1,1
2022-10-01,CRI,Perlis,0,0,0
2022-10-01,CRI,Pulau Pinang,11,7,4
2022-10-01,CRI,Sabah,1,1,0
2022-10-01,CRI,Sarawak,0,0,0
2022-10-01,CRI,Selangor,71,34,37
2022-10-01,CUB,Johor,7,5,2
2022-10-01,CUB,Kedah,0,0,0
2022-10-01,CUB,Perlis,0,0,0
2022-10-01,CUB,Pulau Pinang,1,1,0
2022-10-01,CUB,Sabah,0,0,0
2022-10-01,CUB,Sarawak,0,0,0
2022-10-01,CUB,Selangor,32,17,15
2022-10-01,CYP,Johor,8,5,3
2022-10-01,CYP,Kedah,0,0,0
2022-10-01,CYP,Perak,0,0,0
2022-10-01,CYP,Perlis,0,0,0
2022-10-01,CYP,Pulau Pinang,3,2,1
2022-10-01,CYP,Sabah,0,0,0
2022-10-01,CYP,Sarawak,4,1,3
2022-10-01,CYP,Selangor,28,20,8
2022-10-01,CZE,Johor,63,36,27
2022-10-01,CZE,Kedah,39,13,26
2022-10-01,CZE,Kelantan,4,2,2
2022-10-01,CZE,Melaka,0,0,0
2022-10-01,CZE,Negeri Sembilan,0,0,0
2022-10-01,CZE,Perak,0,0,0
2022-10-01,CZE,Perlis,14,7,7
2022-10-01,CZE,Pulau Pinang,17,12,5
2022-10-01,CZE,Sabah,9,4,5
2022-10-01,CZE,Sarawak,4,2,2
2022-10-01,CZE,Selangor,346,223,123
2022-10-01,CZE,W.P. Labuan,0,0,0
2022-10-01,DEU,Johor,2013,1307,706
2022-10-01,DEU,Kedah,349,184,165
2022-10-01,DEU,Kelantan,4,3,1
2022-10-01,DEU,Melaka,1,0,1
2022-10-01,DEU,Negeri Sembilan,0,0,0
2022-10-01,DEU,Pahang,4,3,1
2022-10-01,DEU,Perak,16,10,6
2022-10-01,DEU,Perlis,69,43,26
2022-10-01,DEU,Pulau Pinang,529,391,138
2022-10-01,DEU,Sabah,126,78,48
2022-10-01,DEU,Sarawak,214,129,85
2022-10-01,DEU,Selangor,5474,3458,2016
2022-10-01,DEU,Terengganu,0,0,0
2022-10-01,DEU,W.P. Labuan,12,7,5
2022-10-01,DJI,Johor,0,0,0
2022-10-01,DJI,Selangor,24,21,3
2022-10-01,DMA,Johor,5,5,0
2022-10-01,DMA,Kedah,0,0,0
2022-10-01,DMA,Pulau Pinang,1,1,0
2022-10-01,DMA,Sabah,0,0,0
2022-10-01,DMA,Sarawak,0,0,0
2022-10-01,DMA,Selangor,30,24,6
2022-10-01,DMA,W.P. Labuan,0,0,0
2022-10-01,DNK,Johor,318,216,102
2022-10-01,DNK,Kedah,37,19,18
2022-10-01,DNK,Kelantan,0,0,0
2022-10-01,DNK,Melaka,0,0,0
2022-10-01,DNK,Negeri Sembilan,0,0,0
2022-10-01,DNK,Pahang,0,0,0
2022-10-01,DNK,Perak,6,4,2
2022-10-01,DNK,Perlis,9,6,3
2022-10-01,DNK,Pulau Pinang,49,31,18
2022-10-01,DNK,Sabah,39,24,15
2022-10-01,DNK,Sarawak,26,12,14
2022-10-01,DNK,Selangor,735,465,270
2022-10-01,DNK,W.P. Labuan,0,0,0
2022-10-01,DOM,Johor,3,2,1
2022-10-01,DOM,Kedah,0,0,0
2022-10-01,DOM,Perak,1,0,1
2022-10-01,DOM,Perlis,1,0,1
2022-10-01,DOM,Pulau Pinang,0,0,0
2022-10-01,DOM,Sabah,0,0,0
2022-10-01,DOM,Sarawak,0,0,0
2022-10-01,DOM,Selangor,37,18,19
2022-10-01,DZA,Johor,17,16,1
2022-10-01,DZA,Kedah,2,1,1
2022-10-01,DZA,Kelantan,0,0,0
2022-10-01,DZA,Melaka,0,0,0
2022-10-01,DZA,Perak,0,0,0
2022-10-01,DZA,Perlis,0,0,0
2022-10-01,DZA,Pulau Pinang,4,4,0
2022-10-01,DZA,Sabah,3,3,0
2022-10-01,DZA,Sarawak,1,1,0
2022-10-01,DZA,Selangor,424,288,136
2022-10-01,DZA,W.P. Labuan,0,0,0
2022-10-01,ECU,Johor,19,10,9
2022-10-01,ECU,Kedah,0,0,0
2022-10-01,ECU,Perak,2,1,1
2022-10-01,ECU,Perlis,0,0,0
2022-10-01,ECU,Pulau Pinang,1,0,1
2022-10-01,ECU,Sabah,1,0,1
2022-10-01,ECU,Sarawak,4,2,2
2022-10-01,ECU,Selangor,72,44,28
2022-10-01,EGY,Johor,218,177,41
2022-10-01,EGY,Kedah,7,5,2
2022-10-01,EGY,Kelantan,0,0,0
2022-10-01,EGY,Melaka,0,0,0
2022-10-01,EGY,Pahang,0,0,0
2022-10-01,EGY,Perak,1,1,0
2022-10-01,EGY,Perlis,1,1,0
2022-10-01,EGY,Pulau Pinang,13,9,4
2022-10-01,EGY,Sabah,5,5,0
2022-10-01,EGY,Sarawak,136,95,41
2022-10-01,EGY,Selangor,1692,1151,541
2022-10-01,EGY,Terengganu,0,0,0
2022-10-01,EGY,W.P. Labuan,0,0,0
2022-10-01,ERI,Johor,0,0,0
2022-10-01,ERI,Pulau Pinang,0,0,0
2022-10-01,ERI,Sabah,0,0,0
2022-10-01,ERI,Selangor,19,15,4
2022-10-01,ESP,Johor,459,266,193
2022-10-01,ESP,Kedah,80,49,31
2022-10-01,ESP,Kelantan,3,0,3
2022-10-01,ESP,Melaka,0,0,0
2022-10-01,ESP,Negeri Sembilan,0,0,0
2022-10-01,ESP,Pahang,1,1,0
2022-10-01,ESP,Perak,2,0,2
2022-10-01,ESP,Perlis,21,17,4
2022-10-01,ESP,Pulau Pinang,69,45,24
2022-10-01,ESP,Sabah,27,14,13
2022-10-01,ESP,Sarawak,45,27,18
2022-10-01,ESP,Selangor,3003,1913,1090
2022-10-01,ESP,W.P. Labuan,2,1,1
2022-10-01,EST,Johor,19,13,6
2022-10-01,EST,Kedah,21,15,6
2022-10-01,EST,Kelantan,0,0,0
2022-10-01,EST,Pahang,0,0,0
2022-10-01,EST,Perak,1,1,0
2022-10-01,EST,Perlis,0,0,0
2022-10-01,EST,Pulau Pinang,6,1,5
2022-10-01,EST,Sabah,11,7,4
2022-10-01,EST,Sarawak,0,0,0
2022-10-01,EST,Selangor,103,53,50
2022-10-01,EST,W.P. Labuan,0,0,0
2022-10-01,ETH,Johor,3,3,0
2022-10-01,ETH,Kedah,0,0,0
2022-10-01,ETH,Pulau Pinang,0,0,0
2022-10-01,ETH,Sarawak,3,2,1
2022-10-01,ETH,Selangor,54,47,7
2022-10-01,FIN,Johor,175,96,79
2022-10-01,FIN,Kedah,47,27,20
2022-10-01,FIN,Kelantan,0,0,0
2022-10-01,FIN,Melaka,0,0,0
2022-10-01,FIN,Negeri Sembilan,0,0,0
2022-10-01,FIN,Pahang,0,0,0
2022-10-01,FIN,Perak,1,1,0
2022-10-01,FIN,Perlis,3,3,0
2022-10-01,FIN,Pulau Pinang,48,27,21
2022-10-01,FIN,Sabah,9,6,3
2022-10-01,FIN,Sarawak,9,7,2
2022-10-01,FIN,Selangor,421,248,173
2022-10-01,FIN,W.P. Labuan,2,2,0
2022-10-01,FJI,Johor,55,22,33
2022-10-01,FJI,Kedah,0,0,0
2022-10-01,FJI,Kelantan,0,0,0
2022-10-01,FJI,Perak,4,3,1
2022-10-01,FJI,Perlis,0,0,0
2022-10-01,FJI,Pulau Pinang,6,1,5
2022-10-01,FJI,Sabah,0,0,0
2022-10-01,FJI,Sarawak,0,0,0
2022-10-01,FJI,Selangor,116,73,43
2022-10-01,FRA,Johor,2074,1292,782
2022-10-01,FRA,Kedah,283,154,129
2022-10-01,FRA,Kelantan,14,10,4
2022-10-01,FRA,Melaka,0,0,0
2022-10-01,FRA,Negeri Sembilan,1,0,1
2022-10-01,FRA,Pahang,0,0,0
2022-10-01,FRA,Perak,32,20,12
2022-10-01,FRA,Perlis,49,34,15
2022-10-01,FRA,Pulau Pinang,278,185,93
2022-10-01,FRA,Sabah,150,87,63
2022-10-01,FRA,Sarawak,133,76,57
2022-10-01,FRA,Selangor,6356,3892,2464
2022-10-01,FRA,Terengganu,2,1,1
2022-10-01,FRA,W.P. Labuan,1,1,0
2022-10-01,FSM,Johor,0,0,0
2022-10-01,FSM,Pulau Pinang,0,0,0
2022-10-01,FSM,Selangor,1,1,0
2022-10-01,GAB,Johor,0,0,0
2022-10-01,GAB,Pulau Pinang,0,0,0
2022-10-01,GAB,Sarawak,0,0,0
2022-10-01,GAB,Selangor,14,8,6
2022-10-01,GBR,Johor,4645,2909,1736
2022-10-01,GBR,Kedah,773,445,328
2022-10-01,GBR,Kelantan,10,5,5
2022-10-01,GBR,Melaka,1,1,0
2022-10-01,GBR,Negeri Sembilan,0,0,0
2022-10-01,GBR,Pahang,8,7,1
2022-10-01,GBR,Perak,62,34,28
2022-10-01,GBR,Perlis,73,47,26
2022-10-01,GBR,Pulau Pinang,1199,700,499
2022-10-01,GBR,Sabah,552,284,268
2022-10-01,GBR,Sarawak,1475,872,603
2022-10-01,GBR,Selangor,14629,9069,5560
2022-10-01,GBR,Terengganu,0,0,0
2022-10-01,GBR,W.P. Labuan,54,42,12
2022-10-01,GEO,Johor,8,7,1
2022-10-01,GEO,Kedah,0,0,0
2022-10-01,GEO,Melaka,0,0,0
2022-10-01,GEO,Perak,1,0,1
2022-10-01,GEO,Perlis,1,1,0
2022-10-01,GEO,Pulau Pinang,0,0,0
2022-10-01,GEO,Sabah,0,0,0
2022-10-01,GEO,Sarawak,0,0,0
2022-10-01,GEO,Selangor,45,28,17
2022-10-01,GHA,Johor,11,3,8
2022-10-01,GHA,Kedah,0,0,0
2022-10-01,GHA,Kelantan,0,0,0
2022-10-01,GHA,Pulau Pinang,3,2,1
2022-10-01,GHA,Sabah,0,0,0
2022-10-01,GHA,Sarawak,1,1,0
2022-10-01,GHA,Selangor,90,68,22
2022-10-01,GIB,Johor,0,0,0
2022-10-01,GIB,Sarawak,0,0,0
2022-10-01,GIN,Johor,4,3,1
2022-10-01,GIN,Kedah,0,0,0
2022-10-01,GIN,Kelantan,0,0,0
2022-10-01,GIN,Perlis,5,2,3
2022-10-01,GIN,Pulau Pinang,0,0,0
2022-10-01,GIN,Sabah,0,0,0
2022-10-01,GIN,Sarawak,0,0,0
2022-10-01,GIN,Selangor,59,42,17
2022-10-01,GLP,Selangor,0,0,0
2022-10-01,GMB,Johor,10,6,4
2022-10-01,GMB,Kedah,0,0,0
2022-10-01,GMB,Kelantan,0,0,0
2022-10-01,GMB,Pulau Pinang,1,1,0
2022-10-01,GMB,Sabah,0,0,0
2022-10-01,GMB,Sarawak,0,0,0
2022-10-01,GMB,Selangor,30,29,1
2022-10-01,GNB,Johor,0,0,0
2022-10-01,GNB,Selangor,2,1,1
2022-10-01,GNQ,Johor,0,0,0
2022-10-01,GNQ,Selangor,0,0,0
2022-10-01,GRC,Johor,60,44,16
2022-10-01,GRC,Kedah,6,3,3
2022-10-01,GRC,Kelantan,0,0,0
2022-10-01,GRC,Melaka,0,0,0
2022-10-01,GRC,Negeri Sembilan,0,0,0
2022-10-01,GRC,Pahang,0,0,0
2022-10-01,GRC,Perak,2,1,1
2022-10-01,GRC,Perlis,1,1,0
2022-10-01,GRC,Pulau Pinang,5,4,1
2022-10-01,GRC,Sabah,0,0,0
2022-10-01,GRC,Sarawak,1,0,1
2022-10-01,GRC,Selangor,139,96,43
2022-10-01,GRD,Johor,7,4,3
2022-10-01,GRD,Kedah,0,0,0
2022-10-01,GRD,Pulau Pinang,0,0,0
2022-10-01,GRD,Sabah,6,3,3
2022-10-01,GRD,Sarawak,1,1,0
2022-10-01,GRD,Selangor,4,3,1
2022-10-01,GRL,Johor,0,0,0
2022-10-01,GRL,Selangor,0,0,0
2022-10-01,GTM,Johor,1,1,0
2022-10-01,GTM,Kedah,0,0,0
2022-10-01,GTM,Pahang,0,0,0
2022-10-01,GTM,Perak,2,1,1
2022-10-01,GTM,Pulau Pinang,1,1,0
2022-10-01,GTM,Sabah,0,0,0
2022-10-01,GTM,Sarawak,0,0,0
2022-10-01,GTM,Selangor,9,3,6
2022-10-01,GTM,W.P. Labuan,0,0,0
2022-10-01,GUY,Johor,1,0,1
2022-10-01,GUY,Kedah,0,0,0
2022-10-01,GUY,Pulau Pinang,0,0,0
2022-10-01,GUY,Sarawak,0,0,0
2022-10-01,GUY,Selangor,2,1,1
2022-10-01,HKG,Johor,3,1,2
2022-10-01,HKG,Kedah,0,0,0
2022-10-01,HKG,Kelantan,0,0,0
2022-10-01,HKG,Pahang,0,0,0
2022-10-01,HKG,Perak,29,15,14
2022-10-01,HKG,Perlis,0,0,0
2022-10-01,HKG,Pulau Pinang,0,0,0
2022-10-01,HKG,Sabah,8,5,3
2022-10-01,HKG,Sarawak,0,0,0
2022-10-01,HKG,Selangor,74,41,33
2022-10-01,HKG,Terengganu,0,0,0
2022-10-01,HMD,Johor,0,0,0
2022-10-01,HND,Johor,8,3,5
2022-10-01,HND,Kedah,1,0,1
2022-10-01,HND,Perak,2,1,1
2022-10-01,HND,Pulau Pinang,2,1,1
2022-10-01,HND,Sabah,1,1,0
2022-10-01,HND,Sarawak,0,0,0
2022-10-01,HND,Selangor,7,4,3
2022-10-01,HRV,Johor,28,20,8
2022-10-01,HRV,Kedah,0,0,0
2022-10-01,HRV,Kelantan,0,0,0
2022-10-01,HRV,Melaka,0,0,0
2022-10-01,HRV,Pahang,0,0,0
2022-10-01,HRV,Perak,0,0,0
2022-10-01,HRV,Perlis,0,0,0
2022-10-01,HRV,Pulau Pinang,6,4,2
2022-10-01,HRV,Sabah,1,1,0
2022-10-01,HRV,Sarawak,3,2,1
2022-10-01,HRV,Selangor,113,89,24
2022-10-01,HTI,Johor,3,1,2
2022-10-01,HTI,Kedah,1,0,1
2022-10-01,HTI,Kelantan,0,0,0
2022-10-01,HTI,Perak,1,1,0
2022-10-01,HTI,Pulau Pinang,0,0,0
2022-10-01,HTI,Sabah,0,0,0
2022-10-01,HTI,Selangor,0,0,0
2022-10-01,HUN,Johor,104,72,32
2022-10-01,HUN,Kedah,8,6,2
2022-10-01,HUN,Kelantan,0,0,0
2022-10-01,HUN,Pahang,0,0,0
2022-10-01,HUN,Perak,1,0,1
2022-10-01,HUN,Perlis,1,1,0
2022-10-01,HUN,Pulau Pinang,15,11,4
2022-10-01,HUN,Sabah,1,1,0
2022-10-01,HUN,Sarawak,2,1,1
2022-10-01,HUN,Selangor,335,186,149
2022-10-01,HUN,W.P. Labuan,0,0,0
2022-10-01,IDN,Johor,92684,50940,41744
2022-10-01,IDN,Kedah,3570,1231,2339
2022-10-01,IDN,Kelantan,151,112,39
2022-10-01,IDN,Melaka,6724,3080,3644
2022-10-01,IDN,Negeri Sembilan,7349,5041,2308
2022-10-01,IDN,Pahang,3,3,0
2022-10-01,IDN,Perak,143,44,99
2022-10-01,IDN,Perlis,431,158,273
2022-10-01,IDN,Pulau Pinang,25298,9479,15819
2022-10-01,IDN,Sabah,3405,1685,1720
2022-10-01,IDN,Sarawak,27248,15616,11632
2022-10-01,IDN,Selangor,81534,41146,40388
2022-10-01,IDN,Terengganu,0,0,0
2022-10-01,IDN,W.P. Labuan,21,13,8
2022-10-01,IND,Johor,16054,10877,5177
2022-10-01,IND,Kedah,789,457,332
2022-10-01,IND,Kelantan,1,1,0
2022-10-01,IND,Melaka,1,1,0
2022-10-01,IND,Negeri Sembilan,2,2,0
2022-10-01,IND,Pahang,0,0,0
2022-10-01,IND,Perak,242,210,32
2022-10-01,IND,Perlis,80,71,9
2022-10-01,IND,Pulau Pinang,1888,1416,472
2022-10-01,IND,Sabah,208,124,84
2022-10-01,IND,Sarawak,444,336,108
2022-10-01,IND,Selangor,48579,34881,13698
2022-10-01,IND,Terengganu,0,0,0
2022-10-01,IND,W.P. Labuan,27,21,6
2022-10-01,IOT,Pulau Pinang,1,1,0
2022-10-01,IOT,Selangor,0,0,0
2022-10-01,IRL,Johor,291,182,109
2022-10-01,IRL,Kedah,73,41,32
2022-10-01,IRL,Kelantan,0,0,0
2022-10-01,IRL,Negeri Sembilan,0,0,0
2022-10-01,IRL,Pahang,0,0,0
2022-10-01,IRL,Perak,7,2,5
2022-10-01,IRL,Perlis,11,9,2
2022-10-01,IRL,Pulau Pinang,105,69,36
2022-10-01,IRL,Sabah,23,13,10
2022-10-01,IRL,Sarawak,39,20,19
2022-10-01,IRL,Selangor,1296,757,539
2022-10-01,IRL,Terengganu,0,0,0
2022-10-01,IRL,W.P. Labuan,0,0,0
2022-10-01,IRN,Johor,93,64,29
2022-10-01,IRN,Kedah,3,1,2
2022-10-01,IRN,Kelantan,0,0,0
2022-10-01,IRN,Perak,0,0,0
2022-10-01,IRN,Perlis,7,6,1
2022-10-01,IRN,Pulau Pinang,8,6,2
2022-10-01,IRN,Sabah,1,1,0
2022-10-01,IRN,Sarawak,1,1,0
2022-10-01,IRN,Selangor,857,498,359
2022-10-01,IRN,W.P. Labuan,0,0,0
2022-10-01,IRQ,Johor,12,11,1
2022-10-01,IRQ,Kedah,2,1,1
2022-10-01,IRQ,Kelantan,0,0,0
2022-10-01,IRQ,Melaka,0,0,0
2022-10-01,IRQ,Pahang,0,0,0
2022-10-01,IRQ,Perak,0,0,0
2022-10-01,IRQ,Perlis,0,0,0
2022-10-01,IRQ,Pulau Pinang,2,2,0
2022-10-01,IRQ,Sabah,0,0,0
2022-10-01,IRQ,Sarawak,1,0,1
2022-10-01,IRQ,Selangor,705,498,207
2022-10-01,ISL,Johor,3,3,0
2022-10-01,ISL,Kedah,0,0,0
2022-10-01,ISL,Kelantan,0,0,0
2022-10-01,ISL,Perak,2,1,1
2022-10-01,ISL,Perlis,0,0,0
2022-10-01,ISL,Pulau Pinang,2,2,0
2022-10-01,ISL,Sabah,8,4,4
2022-10-01,ISL,Sarawak,0,0,0
2022-10-01,ISL,Selangor,24,13,11
2022-10-01,ISL,W.P. Labuan,0,0,0
2022-10-01,ISR,Pulau Pinang,0,0,0
2022-10-01,ITA,Johor,450,324,126
2022-10-01,ITA,Kedah,63,40,23
2022-10-01,ITA,Kelantan,3,1,2
2022-10-01,ITA,Melaka,0,0,0
2022-10-01,ITA,Negeri Sembilan,0,0,0
2022-10-01,ITA,Pahang,1,1,0
2022-10-01,ITA,Perak,2,2,0
2022-10-01,ITA,Perlis,14,9,5
2022-10-01,ITA,Pulau Pinang,78,53,25
2022-10-01,ITA,Sabah,24,14,10
2022-10-01,ITA,Sarawak,19,13,6
2022-10-01,ITA,Selangor,2226,1671,555
2022-10-01,ITA,W.P. Labuan,0,0,0
2022-10-01,JAM,Johor,8,1,7
2022-10-01,JAM,Kedah,0,0,0
2022-10-01,JAM,Perak,1,0,1
2022-10-01,JAM,Pulau Pinang,2,1,1
2022-10-01,JAM,Sabah,0,0,0
2022-10-01,JAM,Sarawak,0,0,0
2022-10-01,JAM,Selangor,12,7,5
2022-10-01,JAM,W.P. Labuan,0,0,0
2022-10-01,JOR,Johor,9,8,1
2022-10-01,JOR,Kedah,10,6,4
2022-10-01,JOR,Kelantan,0,0,0
2022-10-01,JOR,Melaka,0,0,0
2022-10-01,JOR,Perlis,2,2,0
2022-10-01,JOR,Pulau Pinang,5,3,2
2022-10-01,JOR,Sabah,1,1,0
2022-10-01,JOR,Sarawak,4,4,0
2022-10-01,JOR,Selangor,630,400,230
2022-10-01,JOR,W.P. Labuan,0,0,0
2022-10-01,JPN,Johor,4801,3430,1371
2022-10-01,JPN,Kedah,148,75,73
2022-10-01,JPN,Kelantan,3,3,0
2022-10-01,JPN,Melaka,1,1,0
2022-10-01,JPN,Negeri Sembilan,0,0,0
2022-10-01,JPN,Pahang,1,0,1
2022-10-01,JPN,Perak,38,26,12
2022-10-01,JPN,Perlis,53,37,16
2022-10-01,JPN,Pulau Pinang,808,617,191
2022-10-01,JPN,Sabah,201,109,92
2022-10-01,JPN,Sarawak,138,86,52
2022-10-01,JPN,Selangor,10744,7300,3444
2022-10-01,JPN,W.P. Labuan,4,3,1
2022-10-01,KAZ,Johor,39,21,18
2022-10-01,KAZ,Kedah,13,6,7
2022-10-01,KAZ,Kelantan,0,0,0
2022-10-01,KAZ,Melaka,0,0,0
2022-10-01,KAZ,Perak,0,0,0
2022-10-01,KAZ,Perlis,3,2,1
2022-10-01,KAZ,Pulau Pinang,6,2,4
2022-10-01,KAZ,Sabah,2,2,0
2022-10-01,KAZ,Sarawak,3,1,2
2022-10-01,KAZ,Selangor,464,164,300
2022-10-01,KAZ,W.P. Labuan,0,0,0
2022-10-01,KEN,Johor,65,29,36
2022-10-01,KEN,Kedah,2,1,1
2022-10-01,KEN,Kelantan,1,0,1
2022-10-01,KEN,Perak,2,1,1
2022-10-01,KEN,Perlis,1,1,0
2022-10-01,KEN,Pulau Pinang,3,1,2
2022-10-01,KEN,Sabah,1,1,0
2022-10-01,KEN,Sarawak,0,0,0
2022-10-01,KEN,Selangor,230,119,111
2022-10-01,KGZ,Johor,15,4,11
2022-10-01,KGZ,Kedah,1,1,0
2022-10-01,KGZ,Kelantan,0,0,0
2022-10-01,KGZ,Perak,0,0,0
2022-10-01,KGZ,Perlis,0,0,0
2022-10-01,KGZ,Pulau Pinang,0,0,0
2022-10-01,KGZ,Sabah,0,0,0
2022-10-01,KGZ,Sarawak,0,0,0
2022-10-01,KGZ,Selangor,89,50,39
2022-10-01,KHM,Johor,1402,560,842
2022-10-01,KHM,Kedah,195,155,40
2022-10-01,KHM,Kelantan,766,443,323
2022-10-01,KHM,Melaka,8,4,4
2022-10-01,KHM,Negeri Sembilan,0,0,0
2022-10-01,KHM,Pahang,0,0,0
2022-10-01,KHM,Perak,12,6,6
2022-10-01,KHM,Perlis,948,611,337
2022-10-01,KHM,Pulau Pinang,33,17,16
2022-10-01,KHM,Sabah,1,1,0
2022-10-01,KHM,Sarawak,2,1,1
2022-10-01,KHM,Selangor,3696,1847,1849
2022-10-01,KHM,W.P. Labuan,0,0,0
2022-10-01,KIR,Johor,0,0,0
2022-10-01,KIR,Sabah,0,0,0
2022-10-01,KIR,Selangor,0,0,0
2022-10-01,KNA,Johor,27,16,11
2022-10-01,KNA,Kedah,0,0,0
2022-10-01,KNA,Perlis,0,0,0
2022-10-01,KNA,Pulau Pinang,4,4,0
2022-10-01,KNA,Sabah,0,0,0
2022-10-01,KNA,Selangor,50,40,10
2022-10-01,KNA,W.P. Labuan,0,0,0
2022-10-01,KOR,Johor,8235,4746,3489
2022-10-01,KOR,Kedah,116,53,63
2022-10-01,KOR,Kelantan,0,0,0
2022-10-01,KOR,Melaka,0,0,0
2022-10-01,KOR,Negeri Sembilan,0,0,0
2022-10-01,KOR,Pahang,0,0,0
2022-10-01,KOR,Perak,9,6,3
2022-10-01,KOR,Perlis,57,40,17
2022-10-01,KOR,Pulau Pinang,373,220,153
2022-10-01,KOR,Sabah,6038,2652,3386
2022-10-01,KOR,Sarawak,160,87,73
2022-10-01,KOR,Selangor,8670,5104,3566
2022-10-01,KOR,Terengganu,0,0,0
2022-10-01,KOR,W.P. Labuan,0,0,0
2022-10-01,KWT,Johor,12,3,9
2022-10-01,KWT,Kedah,3,3,0
2022-10-01,KWT,Kelantan,1,1,0
2022-10-01,KWT,Perak,0,0,0
2022-10-01,KWT,Perlis,0,0,0
2022-10-01,KWT,Pulau Pinang,6,3,3
2022-10-01,KWT,Sabah,0,0,0
2022-10-01,KWT,Sarawak,0,0,0
2022-10-01,KWT,Selangor,294,191,103
2022-10-01,KWT,W.P. Labuan,0,0,0
2022-10-01,LAO,Johor,89,29,60
2022-10-01,LAO,Kedah,885,93,792
2022-10-01,LAO,Kelantan,85,5,80
2022-10-01,LAO,Melaka,0,0,0
2022-10-01,LAO,Perak,14,1,13
2022-10-01,LAO,Perlis,135,37,98
2022-10-01,LAO,Pulau Pinang,16,1,15
2022-10-01,LAO,Sabah,2,0,2
2022-10-01,LAO,Sarawak,5,5,0
2022-10-01,LAO,Selangor,284,124,160
2022-10-01,LAO,W.P. Labuan,0,0,0
2022-10-01,LBN,Johor,16,8,8
2022-10-01,LBN,Kedah,5,2,3
2022-10-01,LBN,Kelantan,0,0,0
2022-10-01,LBN,Pahang,0,0,0
2022-10-01,LBN,Perak,0,0,0
2022-10-01,LBN,Perlis,0,0,0
2022-10-01,LBN,Pulau Pinang,5,5,0
2022-10-01,LBN,Sabah,1,1,0
2022-10-01,LBN,Sarawak,1,1,0
2022-10-01,LBN,Selangor,176,123,53
2022-10-01,LBN,W.P. Labuan,0,0,0
2022-10-01,LBR,Johor,1,1,0
2022-10-01,LBR,Kedah,0,0,0
2022-10-01,LBR,Sabah,1,1,0
2022-10-01,LBR,Sarawak,0,0,0
2022-10-01,LBR,Selangor,23,17,6
2022-10-01,LBY,Johor,0,0,0
2022-10-01,LBY,Kedah,0,0,0
2022-10-01,LBY,Perlis,0,0,0
2022-10-01,LBY,Pulau Pinang,2,2,0
2022-10-01,LBY,Sabah,1,1,0
2022-10-01,LBY,Sarawak,0,0,0
2022-10-01,LBY,Selangor,318,216,102
2022-10-01,LCA,Johor,11,7,4
2022-10-01,LCA,Kedah,0,0,0
2022-10-01,LCA,Pulau Pinang,0,0,0
2022-10-01,LCA,Sarawak,0,0,0
2022-10-01,LCA,Selangor,4,4,0
2022-10-01,LIE,Johor,3,3,0
2022-10-01,LIE,Kedah,0,0,0
2022-10-01,LIE,Perlis,0,0,0
2022-10-01,LIE,Pulau Pinang,0,0,0
2022-10-01,LIE,Sabah,0,0,0
2022-10-01,LIE,Sarawak,0,0,0
2022-10-01,LIE,Selangor,3,3,0
2022-10-01,LKA,Johor,953,689,264
2022-10-01,LKA,Kedah,27,15,12
2022-10-01,LKA,Kelantan,0,0,0
2022-10-01,LKA,Melaka,0,0,0
2022-10-01,LKA,Pahang,0,0,0
2022-10-01,LKA,Perak,5,3,2
2022-10-01,LKA,Perlis,0,0,0
2022-10-01,LKA,Pulau Pinang,26,17,9
2022-10-01,LKA,Sabah,12,7,5
2022-10-01,LKA,Sarawak,20,13,7
2022-10-01,LKA,Selangor,2950,1946,1004
2022-10-01,LKA,W.P. Labuan,0,0,0
2022-10-01,LSO,Johor,0,0,0
2022-10-01,LSO,Kedah,0,0,0
2022-10-01,LSO,Pulau Pinang,0,0,0
2022-10-01,LSO,Sarawak,0,0,0
2022-10-01,LSO,Selangor,1,1,0
2022-10-01,LTU,Johor,34,11,23
2022-10-01,LTU,Kedah,9,4,5
2022-10-01,LTU,Kelantan,0,0,0
2022-10-01,LTU,Pahang,0,0,0
2022-10-01,LTU,Perak,6,2,4
2022-10-01,LTU,Perlis,0,0,0
2022-10-01,LTU,Pulau Pinang,16,7,9
2022-10-01,LTU,Sabah,11,7,4
2022-10-01,LTU,Sarawak,5,2,3
2022-10-01,LTU,Selangor,148,91,57
2022-10-01,LTU,W.P. Labuan,0,0,0
2022-10-01,LUX,Johor,6,2,4
2022-10-01,LUX,Kedah,2,2,0
2022-10-01,LUX,Kelantan,0,0,0
2022-10-01,LUX,Perak,0,0,0
2022-10-01,LUX,Perlis,0,0,0
2022-10-01,LUX,Pulau Pinang,2,1,1
2022-10-01,LUX,Sabah,0,0,0
2022-10-01,LUX,Sarawak,1,1,0
2022-10-01,LUX,Selangor,29,18,11
2022-10-01,LVA,Johor,48,19,29
2022-10-01,LVA,Kedah,31,12,19
2022-10-01,LVA,Kelantan,0,0,0
2022-10-01,LVA,Pahang,0,0,0
2022-10-01,LVA,Perak,0,0,0
2022-10-01,LVA,Perlis,2,1,1
2022-10-01,LVA,Pulau Pinang,5,1,4
2022-10-01,LVA,Sabah,5,3,2
2022-10-01,LVA,Sarawak,8,4,4
2022-10-01,LVA,Selangor,100,44,56
2022-10-01,LVA,W.P. Labuan,13,6,7
2022-10-01,MAC,Johor,1,0,1
2022-10-01,MAC,Pahang,0,0,0
2022-10-01,MAC,Perak,0,0,0
2022-10-01,MAC,Selangor,3,0,3
2022-10-01,MAC,W.P. Labuan,0,0,0
2022-10-01,MAR,Johor,91,57,34
2022-10-01,MAR,Kedah,2,1,1
2022-10-01,MAR,Kelantan,2,2,0
2022-10-01,MAR,Melaka,0,0,0
2022-10-01,MAR,Pahang,0,0,0
2022-10-01,MAR,Perak,0,0,0
2022-10-01,MAR,Perlis,2,2,0
2022-10-01,MAR,Pulau Pinang,7,6,1
2022-10-01,MAR,Sabah,4,1,3
2022-10-01,MAR,Sarawak,4,4,0
2022-10-01,MAR,Selangor,880,454,426
2022-10-01,MAR,W.P. Labuan,0,0,0
2022-10-01,MCO,Johor,0,0,0
2022-10-01,MCO,Kedah,0,0,0
2022-10-01,MCO,Sabah,0,0,0
2022-10-01,MCO,Selangor,2,1,1
2022-10-01,MDA,Johor,0,0,0
2022-10-01,MDA,Kedah,0,0,0
2022-10-01,MDA,Kelantan,0,0,0
2022-10-01,MDA,Negeri Sembilan,0,0,0
2022-10-01,MDA,Perlis,0,0,0
2022-10-01,MDA,Pulau Pinang,1,1,0
2022-10-01,MDA,Sabah,0,0,0
2022-10-01,MDA,Sarawak,0,0,0
2022-10-01,MDA,Selangor,16,13,3
2022-10-01,MDG,Johor,5,2,3
2022-10-01,MDG,Kedah,0,0,0
2022-10-01,MDG,Perak,2,0,2
2022-10-01,MDG,Perlis,0,0,0
2022-10-01,MDG,Pulau Pinang,0,0,0
2022-10-01,MDG,Sabah,0,0,0
2022-10-01,MDG,Sarawak,0,0,0
2022-10-01,MDG,Selangor,9,3,6
2022-10-01,MDV,Johor,93,61,32
2022-10-01,MDV,Kedah,1,1,0
2022-10-01,MDV,Kelantan,0,0,0
2022-10-01,MDV,Perak,2,1,1
2022-10-01,MDV,Perlis,0,0,0
2022-10-01,MDV,Pulau Pinang,3,3,0
2022-10-01,MDV,Sabah,0,0,0
2022-10-01,MDV,Sarawak,2,2,0
2022-10-01,MDV,Selangor,1838,984,854
2022-10-01,MEX,Johor,181,77,104
2022-10-01,MEX,Kedah,6,1,5
2022-10-01,MEX,Kelantan,0,0,0
2022-10-01,MEX,Pahang,0,0,0
2022-10-01,MEX,Perak,1,0,1
2022-10-01,MEX,Perlis,3,2,1
2022-10-01,MEX,Pulau Pinang,39,30,9
2022-10-01,MEX,Sabah,8,5,3
2022-10-01,MEX,Sarawak,7,3,4
2022-10-01,MEX,Selangor,550,292,258
2022-10-01,MEX,W.P. Labuan,0,0,0
2022-10-01,MHL,Johor,0,0,0
2022-10-01,MHL,Kedah,1,1,0
2022-10-01,MHL,Perak,0,0,0
2022-10-01,MHL,Pulau Pinang,0,0,0
2022-10-01,MHL,Sabah,0,0,0
2022-10-01,MHL,Selangor,3,2,1
2022-10-01,MKD,Johor,7,2,5
2022-10-01,MKD,Kedah,0,0,0
2022-10-01,MKD,Perak,2,0,2
2022-10-01,MKD,Pulau Pinang,3,3,0
2022-10-01,MKD,Sabah,0,0,0
2022-10-01,MKD,Sarawak,1,0,1
2022-10-01,MKD,Selangor,30,17,13
2022-10-01,MLI,Johor,0,0,0
2022-10-01,MLI,Sabah,0,0,0
2022-10-01,MLI,Selangor,10,7,3
2022-10-01,MLT,Johor,9,7,2
2022-10-01,MLT,Kedah,2,2,0
2022-10-01,MLT,Kelantan,0,0,0
2022-10-01,MLT,Perak,0,0,0
2022-10-01,MLT,Perlis,1,1,0
2022-10-01,MLT,Pulau Pinang,2,2,0
2022-10-01,MLT,Sabah,0,0,0
2022-10-01,MLT,Sarawak,0,0,0
2022-10-01,MLT,Selangor,26,15,11
2022-10-01,MLT,W.P. Labuan,0,0,0
2022-10-01,MMR,Johor,3212,914,2298
2022-10-01,MMR,Kedah,46,9,37
2022-10-01,MMR,Kelantan,2,0,2
2022-10-01,MMR,Negeri Sembilan,0,0,0
2022-10-01,MMR,Pahang,0,0,0
2022-10-01,MMR,Perak,15,8,7
2022-10-01,MMR,Perlis,7,3,4
2022-10-01,MMR,Pulau Pinang,112,50,62
2022-10-01,MMR,Sabah,10,2,8
2022-10-01,MMR,Sarawak,38,17,21
2022-10-01,MMR,Selangor,7530,5036,2494
2022-10-01,MMR,Terengganu,0,0,0
2022-10-01,MMR,W.P. Labuan,0,0,0
2022-10-01,MNE,Johor,0,0,0
2022-10-01,MNE,Kedah,0,0,0
2022-10-01,MNE,Pulau Pinang,0,0,0
2022-10-01,MNE,Sabah,0,0,0
2022-10-01,MNE,Sarawak,0,0,0
2022-10-01,MNE,Selangor,11,9,2
2022-10-01,MNG,Johor,87,43,44
2022-10-01,MNG,Kedah,2,0,2
2022-10-01,MNG,Kelantan,0,0,0
2022-10-01,MNG,Perak,0,0,0
2022-10-01,MNG,Perlis,0,0,0
2022-10-01,MNG,Pulau Pinang,5,1,4
2022-10-01,MNG,Sabah,3,2,1
2022-10-01,MNG,Sarawak,2,2,0
2022-10-01,MNG,Selangor,227,104,123
2022-10-01,MNP,Selangor,0,0,0
2022-10-01,MOZ,Johor,6,5,1
2022-10-01,MOZ,Kedah,0,0,0
2022-10-01,MOZ,Perak,0,0,0
2022-10-01,MOZ,Pulau Pinang,0,0,0
2022-10-01,MOZ,Sabah,0,0,0
2022-10-01,MOZ,Sarawak,0,0,0
2022-10-01,MOZ,Selangor,20,13,7
2022-10-01,MRT,Johor,0,0,0
2022-10-01,MRT,Kedah,0,0,0
2022-10-01,MRT,Pulau Pinang,0,0,0
2022-10-01,MRT,Sabah,1,1,0
2022-10-01,MRT,Sarawak,0,0,0
2022-10-01,MRT,Selangor,51,47,4
2022-10-01,MUS,Johor,75,42,33
2022-10-01,MUS,Kedah,6,3,3
2022-10-01,MUS,Kelantan,0,0,0
2022-10-01,MUS,Pahang,0,0,0
2022-10-01,MUS,Perak,0,0,0
2022-10-01,MUS,Perlis,0,0,0
2022-10-01,MUS,Pulau Pinang,3,3,0
2022-10-01,MUS,Sabah,0,0,0
2022-10-01,MUS,Sarawak,0,0,0
2022-10-01,MUS,Selangor,266,181,85
2022-10-01,MWI,Johor,0,0,0
2022-10-01,MWI,Pulau Pinang,0,0,0
2022-10-01,MWI,Sabah,0,0,0
2022-10-01,MWI,Sarawak,1,0,1
2022-10-01,MWI,Selangor,8,6,2
2022-10-01,MYT,Selangor,0,0,0
2022-10-01,NAM,Johor,0,0,0
2022-10-01,NAM,Kedah,0,0,0
2022-10-01,NAM,Perak,2,1,1
2022-10-01,NAM,Perlis,0,0,0
2022-10-01,NAM,Pulau Pinang,0,0,0
2022-10-01,NAM,Sabah,0,0,0
2022-10-01,NAM,Sarawak,0,0,0
2022-10-01,NAM,Selangor,18,5,13
2022-10-01,NCL,Selangor,0,0,0
2022-10-01,NER,Johor,0,0,0
2022-10-01,NER,Sabah,0,0,0
2022-10-01,NER,Selangor,1,1,0
2022-10-01,NGA,Johor,26,22,4
2022-10-01,NGA,Kedah,1,1,0
2022-10-01,NGA,Perlis,0,0,0
2022-10-01,NGA,Pulau Pinang,4,4,0
2022-10-01,NGA,Sabah,0,0,0
2022-10-01,NGA,Sarawak,17,10,7
2022-10-01,NGA,Selangor,341,272,69
2022-10-01,NIC,Johor,1,1,0
2022-10-01,NIC,Kedah,0,0,0
2022-10-01,NIC,Pulau Pinang,2,1,1
2022-10-01,NIC,Sabah,0,0,0
2022-10-01,NIC,Selangor,6,2,4
2022-10-01,NLD,Johor,986,642,344
2022-10-01,NLD,Kedah,129,69,60
2022-10-01,NLD,Kelantan,1,1,0
2022-10-01,NLD,Melaka,3,2,1
2022-10-01,NLD,Negeri Sembilan,1,1,0
2022-10-01,NLD,Pahang,0,0,0
2022-10-01,NLD,Perak,29,19,10
2022-10-01,NLD,Perlis,33,19,14
2022-10-01,NLD,Pulau Pinang,217,136,81
2022-10-01,NLD,Sabah,96,52,44
2022-10-01,NLD,Sarawak,165,93,72
2022-10-01,NLD,Selangor,2993,1859,1134
2022-10-01,NLD,Terengganu,0,0,0
2022-10-01,NLD,W.P. Labuan,3,1,2
2022-10-01,NOR,Johor,180,120,60
2022-10-01,NOR,Kedah,25,13,12
2022-10-01,NOR,Kelantan,0,0,0
2022-10-01,NOR,Melaka,0,0,0
2022-10-01,NOR,Pahang,0,0,0
2022-10-01,NOR,Perak,0,0,0
2022-10-01,NOR,Perlis,7,5,2
2022-10-01,NOR,Pulau Pinang,17,11,6
2022-10-01,NOR,Sabah,8,6,2
2022-10-01,NOR,Sarawak,14,11,3
2022-10-01,NOR,Selangor,544,355,189
2022-10-01,NOR,W.P. Labuan,0,0,0
2022-10-01,NPL,Johor,590,344,246
2022-10-01,NPL,Kedah,7,7,0
2022-10-01,NPL,Pahang,0,0,0
2022-10-01,NPL,Perak,0,0,0
2022-10-01,NPL,Perlis,1,1,0
2022-10-01,NPL,Pulau Pinang,27,18,9
2022-10-01,NPL,Sabah,1,1,0
2022-10-01,NPL,Sarawak,144,99,45
2022-10-01,NPL,Selangor,17666,16936,730
2022-10-01,NPL,W.P. Labuan,54,54,0
2022-10-01,NRU,Johor,0,0,0
2022-10-01,NRU,Pulau Pinang,0,0,0
2022-10-01,NRU,Selangor,2,2,0
2022-10-01,NZL,Johor,668,395,273
2022-10-01,NZL,Kedah,56,30,26
2022-10-01,NZL,Kelantan,1,1,0
2022-10-01,NZL,Melaka,1,1,0
2022-10-01,NZL,Negeri Sembilan,0,0,0
2022-10-01,NZL,Pahang,4,2,2
2022-10-01,NZL,Perak,19,8,11
2022-10-01,NZL,Perlis,10,6,4
2022-10-01,NZL,Pulau Pinang,157,93,64
2022-10-01,NZL,Sabah,69,35,34
2022-10-01,NZL,Sarawak,105,57,48
2022-10-01,NZL,Selangor,1990,1247,743
2022-10-01,NZL,Terengganu,0,0,0
2022-10-01,NZL,W.P. Labuan,7,4,3
2022-10-01,OMN,Johor,37,17,20
2022-10-01,OMN,Kedah,2,2,0
2022-10-01,OMN,Kelantan,0,0,0
2022-10-01,OMN,Melaka,0,0,0
2022-10-01,OMN,Perak,0,0,0
2022-10-01,OMN,Perlis,0,0,0
2022-10-01,OMN,Pulau Pinang,4,2,2
2022-10-01,OMN,Sabah,2,0,2
2022-10-01,OMN,Sarawak,28,15,13
2022-10-01,OMN,Selangor,852,670,182
2022-10-01,PAK,Johor,653,495,158
2022-10-01,PAK,Kedah,76,67,9
2022-10-01,PAK,Kelantan,12,12,0
2022-10-01,PAK,Melaka,0,0,0
2022-10-01,PAK,Negeri Sembilan,0,0,0
2022-10-01,PAK,Pahang,0,0,0
2022-10-01,PAK,Perak,39,37,2
2022-10-01,PAK,Perlis,27,23,4
2022-10-01,PAK,Pulau Pinang,44,43,1
2022-10-01,PAK,Sabah,8,7,1
2022-10-01,PAK,Sarawak,94,67,27
2022-10-01,PAK,Selangor,9561,8528,1033
2022-10-01,PAK,W.P. Labuan,8,6,2
2022-10-01,PAN,Johor,5,3,2
2022-10-01,PAN,Kedah,1,0,1
2022-10-01,PAN,Perak,0,0,0
2022-10-01,PAN,Perlis,0,0,0
2022-10-01,PAN,Pulau Pinang,1,0,1
2022-10-01,PAN,Sabah,0,0,0
2022-10-01,PAN,Sarawak,2,0,2
2022-10-01,PAN,Selangor,18,12,6
2022-10-01,PER,Johor,45,25,20
2022-10-01,PER,Kedah,4,1,3
2022-10-01,PER,Kelantan,0,0,0
2022-10-01,PER,Pahang,0,0,0
2022-10-01,PER,Perak,0,0,0
2022-10-01,PER,Perlis,0,0,0
2022-10-01,PER,Pulau Pinang,1,1,0
2022-10-01,PER,Sabah,0,0,0
2022-10-01,PER,Sarawak,3,1,2
2022-10-01,PER,Selangor,67,33,34
2022-10-01,PER,W.P. Labuan,0,0,0
2022-10-01,PHL,Johor,16343,5190,11153
2022-10-01,PHL,Kedah,407,162,245
2022-10-01,PHL,Kelantan,11,6,5
2022-10-01,PHL,Melaka,0,0,0
2022-10-01,PHL,Negeri Sembilan,0,0,0
2022-10-01,PHL,Pahang,4,4,0
2022-10-01,PHL,Perak,42,18,24
2022-10-01,PHL,Perlis,169,62,107
2022-10-01,PHL,Pulau Pinang,376,140,236
2022-10-01,PHL,Sabah,1117,521,596
2022-10-01,PHL,Sarawak,1061,406,655
2022-10-01,PHL,Selangor,15278,6319,8959
2022-10-01,PHL,Terengganu,0,0,0
2022-10-01,PHL,W.P. Labuan,38,15,23
2022-10-01,PLW,Johor,0,0,0
2022-10-01,PLW,Pulau Pinang,0,0,0
2022-10-01,PLW,Selangor,3,2,1
2022-10-01,PNG,Johor,15,11,4
2022-10-01,PNG,Kedah,0,0,0
2022-10-01,PNG,Kelantan,0,0,0
2022-10-01,PNG,Perak,0,0,0
2022-10-01,PNG,Pulau Pinang,1,0,1
2022-10-01,PNG,Sabah,0,0,0
2022-10-01,PNG,Sarawak,3,2,1
2022-10-01,PNG,Selangor,42,25,17
2022-10-01,POL,Johor,452,262,190
2022-10-01,POL,Kedah,50,20,30
2022-10-01,POL,Kelantan,0,0,0
2022-10-01,POL,Melaka,0,0,0
2022-10-01,POL,Negeri Sembilan,0,0,0
2022-10-01,POL,Pahang,0,0,0
2022-10-01,POL,Perak,1,0,1
2022-10-01,POL,Perlis,6,4,2
2022-10-01,POL,Pulau Pinang,46,23,23
2022-10-01,POL,Sabah,12,6,6
2022-10-01,POL,Sarawak,20,12,8
2022-10-01,POL,Selangor,834,482,352
2022-10-01,POL,Terengganu,0,0,0
2022-10-01,POL,W.P. Labuan,4,3,1
2022-10-01,PRK,Selangor,0,0,0
2022-10-01,PRT,Johor,137,67,70
2022-10-01,PRT,Kedah,17,10,7
2022-10-01,PRT,Kelantan,1,1,0
2022-10-01,PRT,Melaka,0,0,0
2022-10-01,PRT,Pahang,0,0,0
2022-10-01,PRT,Perak,2,2,0
2022-10-01,PRT,Perlis,1,1,0
2022-10-01,PRT,Pulau Pinang,25,14,11
2022-10-01,PRT,Sabah,24,13,11
2022-10-01,PRT,Sarawak,9,6,3
2022-10-01,PRT,Selangor,564,356,208
2022-10-01,PRT,W.P. Labuan,2,1,1
2022-10-01,PRY,Johor,2,1,1
2022-10-01,PRY,Kedah,0,0,0
2022-10-01,PRY,Perak,2,1,1
2022-10-01,PRY,Perlis,0,0,0
2022-10-01,PRY,Pulau Pinang,0,0,0
2022-10-01,PRY,Sabah,4,3,1
2022-10-01,PRY,Sarawak,0,0,0
2022-10-01,PRY,Selangor,4,3,1
2022-10-01,PSE,Johor,7,3,4
2022-10-01,PSE,Kedah,0,0,0
2022-10-01,PSE,Kelantan,0,0,0
2022-10-01,PSE,Melaka,0,0,0
2022-10-01,PSE,Perak,0,0,0
2022-10-01,PSE,Perlis,0,0,0
2022-10-01,PSE,Pulau Pinang,1,1,0
2022-10-01,PSE,Sabah,0,0,0
2022-10-01,PSE,Sarawak,1,1,0
2022-10-01,PSE,Selangor,299,212,87
2022-10-01,QAT,Johor,2,0,2
2022-10-01,QAT,Kedah,0,0,0
2022-10-01,QAT,Perlis,0,0,0
2022-10-01,QAT,Pulau Pinang,0,0,0
2022-10-01,QAT,Sabah,0,0,0
2022-10-01,QAT,Sarawak,2,1,1
2022-10-01,QAT,Selangor,81,66,15
2022-10-01,REU,Johor,0,0,0
2022-10-01,REU,Sarawak,0,0,0
2022-10-01,ROU,Johor,114,55,59
2022-10-01,ROU,Kedah,10,6,4
2022-10-01,ROU,Kelantan,0,0,0
2022-10-01,ROU,Negeri Sembilan,0,0,0
2022-10-01,ROU,Pahang,0,0,0
2022-10-01,ROU,Perak,6,3,3
2022-10-01,ROU,Perlis,1,1,0
2022-10-01,ROU,Pulau Pinang,13,7,6
2022-10-01,ROU,Sabah,2,1,1
2022-10-01,ROU,Sarawak,4,1,3
2022-10-01,ROU,Selangor,564,304,260
2022-10-01,ROU,W.P. Labuan,0,0,0
2022-10-01,RUS,Johor,303,168,135
2022-10-01,RUS,Kedah,537,274,263
2022-10-01,RUS,Kelantan,38,24,14
2022-10-01,RUS,Melaka,0,0,0
2022-10-01,RUS,Negeri Sembilan,0,0,0
2022-10-01,RUS,Pahang,2,0,2
2022-10-01,RUS,Perak,3,0,3
2022-10-01,RUS,Perlis,141,75,66
2022-10-01,RUS,Pulau Pinang,287,162,125
2022-10-01,RUS,Sabah,23,11,12
2022-10-01,RUS,Sarawak,55,28,27
2022-10-01,RUS,Selangor,4728,2680,2048
2022-10-01,RUS,W.P. Labuan,0,0,0
2022-10-01,RWA,Johor,0,0,0
2022-10-01,RWA,Kedah,0,0,0
2022-10-01,RWA,Pulau Pinang,0,0,0
2022-10-01,RWA,Selangor,13,9,4
2022-10-01,SAU,Johor,114,70,44
2022-10-01,SAU,Kedah,7,5,2
2022-10-01,SAU,Kelantan,10,6,4
2022-10-01,SAU,Melaka,2,2,0
2022-10-01,SAU,Perak,0,0,0
2022-10-01,SAU,Perlis,9,9,0
2022-10-01,SAU,Pulau Pinang,16,10,6
2022-10-01,SAU,Sabah,1,1,0
2022-10-01,SAU,Sarawak,17,14,3
2022-10-01,SAU,Selangor,2696,1653,1043
2022-10-01,SAU,W.P. Labuan,0,0,0
2022-10-01,SDN,Johor,6,6,0
2022-10-01,SDN,Kedah,1,1,0
2022-10-01,SDN,Kelantan,0,0,0
2022-10-01,SDN,Perlis,0,0,0
2022-10-01,SDN,Pulau Pinang,1,1,0
2022-10-01,SDN,Sabah,0,0,0
2022-10-01,SDN,Sarawak,2,1,1
2022-10-01,SDN,Selangor,804,480,324
2022-10-01,SDN,W.P. Labuan,1,1,0
2022-10-01,SEN,Johor,2,1,1
2022-10-01,SEN,Kedah,0,0,0
2022-10-01,SEN,Kelantan,0,0,0
2022-10-01,SEN,Perak,1,0,1
2022-10-01,SEN,Perlis,0,0,0
2022-10-01,SEN,Pulau Pinang,0,0,0
2022-10-01,SEN,Sabah,1,1,0
2022-10-01,SEN,Sarawak,0,0,0
2022-10-01,SEN,Selangor,40,30,10
2022-10-01,SGP,Johor,990235,571806,418429
2022-10-01,SGP,Kedah,3016,1647,1369
2022-10-01,SGP,Kelantan,43,33,10
2022-10-01,SGP,Melaka,11,9,2
2022-10-01,SGP,Negeri Sembilan,66,28,38
2022-10-01,SGP,Pahang,67,43,24
2022-10-01,SGP,Perak,4463,2066,2397
2022-10-01,SGP,Perlis,270,194,76
2022-10-01,SGP,Pulau Pinang,12616,6245,6371
2022-10-01,SGP,Sabah,2754,1367,1387
2022-10-01,SGP,Sarawak,3125,1814,1311
2022-10-01,SGP,Selangor,47043,23617,23426
2022-10-01,SGP,Terengganu,0,0,0
2022-10-01,SGP,W.P. Labuan,17,12,5
2022-10-01,SGS,Johor,0,0,0
2022-10-01,SGS,Sabah,0,0,0
2022-10-01,SGS,Selangor,0,0,0
2022-10-01,SHN,Sarawak,0,0,0
2022-10-01,SLB,Johor,2,2,0
2022-10-01,SLB,Perlis,0,0,0
2022-10-01,SLB,Pulau Pinang,0,0,0
2022-10-01,SLB,Sabah,2,2,0
2022-10-01,SLB,Sarawak,1,1,0
2022-10-01,SLB,Selangor,5,3,2
2022-10-01,SLB,W.P. Labuan,0,0,0
2022-10-01,SLE,Johor,2,0,2
2022-10-01,SLE,Kedah,0,0,0
2022-10-01,SLE,Perak,1,1,0
2022-10-01,SLE,Pulau Pinang,1,1,0
2022-10-01,SLE,Sabah,0,0,0
2022-10-01,SLE,Selangor,17,12,5
2022-10-01,SLV,Johor,3,1,2
2022-10-01,SLV,Kedah,0,0,0
2022-10-01,SLV,Perak,1,1,0
2022-10-01,SLV,Perlis,0,0,0
2022-10-01,SLV,Pulau Pinang,1,1,0
2022-10-01,SLV,Sabah,0,0,0
2022-10-01,SLV,Selangor,7,3,4
2022-10-01,SLV,W.P. Labuan,0,0,0
2022-10-01,SMR,Johor,0,0,0
2022-10-01,SMR,Selangor,2,2,0
2022-10-01,SOM,Johor,3,3,0
2022-10-01,SOM,Kedah,0,0,0
2022-10-01,SOM,Kelantan,0,0,0
2022-10-01,SOM,Perlis,0,0,0
2022-10-01,SOM,Sabah,0,0,0
2022-10-01,SOM,Sarawak,0,0,0
2022-10-01,SOM,Selangor,262,171,91
2022-10-01,SRB,Johor,8,6,2
2022-10-01,SRB,Kedah,2,1,1
2022-10-01,SRB,Kelantan,0,0,0
2022-10-01,SRB,Pahang,0,0,0
2022-10-01,SRB,Perak,1,0,1
2022-10-01,SRB,Perlis,0,0,0
2022-10-01,SRB,Pulau Pinang,2,1,1
2022-10-01,SRB,Sabah,0,0,0
2022-10-01,SRB,Sarawak,1,1,0
2022-10-01,SRB,Selangor,59,28,31
2022-10-01,SSD,Johor,0,0,0
2022-10-01,SSD,Kedah,0,0,0
2022-10-01,SSD,Sarawak,1,1,0
2022-10-01,SSD,Selangor,44,36,8
2022-10-01,SSD,W.P. Labuan,0,0,0
2022-10-01,STP,Selangor,0,0,0
2022-10-01,SUR,Johor,17,6,11
2022-10-01,SUR,Kedah,0,0,0
2022-10-01,SUR,Kelantan,0,0,0
2022-10-01,SUR,Perak,0,0,0
2022-10-01,SUR,Perlis,0,0,0
2022-10-01,SUR,Pulau Pinang,1,1,0
2022-10-01,SUR,Sabah,0,0,0
2022-10-01,SUR,Sarawak,0,0,0
2022-10-01,SUR,Selangor,26,12,14
2022-10-01,SVK,Johor,21,11,10
2022-10-01,SVK,Kedah,35,18,17
2022-10-01,SVK,Kelantan,0,0,0
2022-10-01,SVK,Negeri Sembilan,0,0,0
2022-10-01,SVK,Pahang,0,0,0
2022-10-01,SVK,Perak,0,0,0
2022-10-01,SVK,Perlis,2,1,1
2022-10-01,SVK,Pulau Pinang,10,8,2
2022-10-01,SVK,Sabah,4,2,2
2022-10-01,SVK,Sarawak,5,1,4
2022-10-01,SVK,Selangor,199,121,78
2022-10-01,SVK,W.P. Labuan,0,0,0
2022-10-01,SVN,Johor,14,9,5
2022-10-01,SVN,Kedah,7,6,1
2022-10-01,SVN,Kelantan,0,0,0
2022-10-01,SVN,Perak,1,0,1
2022-10-01,SVN,Perlis,0,0,0
2022-10-01,SVN,Pulau Pinang,7,5,2
2022-10-01,SVN,Sabah,4,2,2
2022-10-01,SVN,Sarawak,1,0,1
2022-10-01,SVN,Selangor,59,37,22
2022-10-01,SVN,W.P. Labuan,0,0,0
2022-10-01,SWE,Johor,225,125,100
2022-10-01,SWE,Kedah,65,29,36
2022-10-01,SWE,Kelantan,2,2,0
2022-10-01,SWE,Melaka,0,0,0
2022-10-01,SWE,Negeri Sembilan,1,1,0
2022-10-01,SWE,Pahang,0,0,0
2022-10-01,SWE,Perak,5,3,2
2022-10-01,SWE,Perlis,11,6,5
2022-10-01,SWE,Pulau Pinang,76,54,22
2022-10-01,SWE,Sabah,13,9,4
2022-10-01,SWE,Sarawak,21,14,7
2022-10-01,SWE,Selangor,805,492,313
2022-10-01,SWE,W.P. Labuan,0,0,0
2022-10-01,SWZ,Johor,1,1,0
2022-10-01,SWZ,Kedah,0,0,0
2022-10-01,SWZ,Pulau Pinang,0,0,0
2022-10-01,SWZ,Sabah,0,0,0
2022-10-01,SWZ,Selangor,12,5,7
2022-10-01,SYC,Johor,3,2,1
2022-10-01,SYC,Kedah,0,0,0
2022-10-01,SYC,Pulau Pinang,2,1,1
2022-10-01,SYC,Sabah,0,0,0
2022-10-01,SYC,Sarawak,2,2,0
2022-10-01,SYC,Selangor,32,12,20
2022-10-01,SYR,Johor,11,6,5
2022-10-01,SYR,Kedah,4,3,1
2022-10-01,SYR,Kelantan,0,0,0
2022-10-01,SYR,Pahang,2,2,0
2022-10-01,SYR,Perlis,2,1,1
2022-10-01,SYR,Pulau Pinang,1,1,0
2022-10-01,SYR,Sabah,0,0,0
2022-10-01,SYR,Sarawak,9,5,4
2022-10-01,SYR,Selangor,582,367,215
2022-10-01,SYR,W.P. Labuan,0,0,0
2022-10-01,TCA,Perlis,0,0,0
2022-10-01,TCD,Johor,2,2,0
2022-10-01,TCD,Kedah,0,0,0
2022-10-01,TCD,Perlis,0,0,0
2022-10-01,TCD,Selangor,8,6,2
2022-10-01,TGO,Johor,0,0,0
2022-10-01,TGO,Perak,2,2,0
2022-10-01,TGO,Pulau Pinang,0,0,0
2022-10-01,TGO,Selangor,14,12,2
2022-10-01,THA,Johor,7708,2249,5459
2022-10-01,THA,Kedah,62507,36255,26252
2022-10-01,THA,Kelantan,36906,18909,17997
2022-10-01,THA,Melaka,10,4,6
2022-10-01,THA,Negeri Sembilan,2,1,1
2022-10-01,THA,Pahang,27,21,6
2022-10-01,THA,Perak,8355,3861,4494
2022-10-01,THA,Perlis,55003,32227,22776
2022-10-01,THA,Pulau Pinang,2396,978,1418
2022-10-01,THA,Sabah,217,68,149
2022-10-01,THA,Sarawak,236,83,153
2022-10-01,THA,Selangor,12515,5152,7363
2022-10-01,THA,Terengganu,1,0,1
2022-10-01,THA,W.P. Labuan,5,4,1
2022-10-01,TJK,Johor,7,7,0
2022-10-01,TJK,Kedah,2,2,0
2022-10-01,TJK,Perlis,0,0,0
2022-10-01,TJK,Pulau Pinang,1,0,1
2022-10-01,TJK,Sabah,0,0,0
2022-10-01,TJK,Selangor,110,88,22
2022-10-01,TKL,Selangor,0,0,0
2022-10-01,TKM,Johor,1,0,1
2022-10-01,TKM,Kedah,2,1,1
2022-10-01,TKM,Kelantan,0,0,0
2022-10-01,TKM,Perlis,0,0,0
2022-10-01,TKM,Pulau Pinang,0,0,0
2022-10-01,TKM,Sabah,0,0,0
2022-10-01,TKM,Sarawak,0,0,0
2022-10-01,TKM,Selangor,54,32,22
2022-10-01,TLS,Johor,37,33,4
2022-10-01,TLS,Kedah,1,1,0
2022-10-01,TLS,Perlis,0,0,0
2022-10-01,TLS,Pulau Pinang,3,1,2
2022-10-01,TLS,Sabah,0,0,0
2022-10-01,TLS,Sarawak,1,0,1
2022-10-01,TLS,Selangor,212,132,80
2022-10-01,TON,Johor,2,1,1
2022-10-01,TON,Pulau Pinang,1,0,1
2022-10-01,TON,Sarawak,0,0,0
2022-10-01,TON,Selangor,11,6,5
2022-10-01,TTO,Johor,5,2,3
2022-10-01,TTO,Kedah,0,0,0
2022-10-01,TTO,Pahang,0,0,0
2022-10-01,TTO,Pulau Pinang,0,0,0
2022-10-01,TTO,Sabah,0,0,0
2022-10-01,TTO,Sarawak,2,2,0
2022-10-01,TTO,Selangor,40,32,8
2022-10-01,TUN,Johor,9,5,4
2022-10-01,TUN,Kedah,2,0,2
2022-10-01,TUN,Kelantan,0,0,0
2022-10-01,TUN,Melaka,0,0,0
2022-10-01,TUN,Perak,0,0,0
2022-10-01,TUN,Perlis,2,2,0
2022-10-01,TUN,Pulau Pinang,4,3,1
2022-10-01,TUN,Sabah,0,0,0
2022-10-01,TUN,Sarawak,0,0,0
2022-10-01,TUN,Selangor,445,267,178
2022-10-01,TUN,W.P. Labuan,0,0,0
2022-10-01,TUR,Johor,200,142,58
2022-10-01,TUR,Kedah,29,26,3
2022-10-01,TUR,Kelantan,4,4,0
2022-10-01,TUR,Melaka,1,1,0
2022-10-01,TUR,Negeri Sembilan,0,0,0
2022-10-01,TUR,Pahang,0,0,0
2022-10-01,TUR,Perak,1,0,1
2022-10-01,TUR,Perlis,10,5,5
2022-10-01,TUR,Pulau Pinang,19,8,11
2022-10-01,TUR,Sabah,10,5,5
2022-10-01,TUR,Sarawak,17,11,6
2022-10-01,TUR,Selangor,1055,735,320
2022-10-01,TUR,W.P. Labuan,0,0,0
2022-10-01,TUV,Selangor,0,0,0
2022-10-01,TWN,Johor,2694,1166,1528
2022-10-01,TWN,Kedah,53,33,20
2022-10-01,TWN,Kelantan,1,1,0
2022-10-01,TWN,Melaka,2,1,1
2022-10-01,TWN,Negeri Sembilan,0,0,0
2022-10-01,TWN,Pahang,1,0,1
2022-10-01,TWN,Perak,27,9,18
2022-10-01,TWN,Perlis,12,9,3
2022-10-01,TWN,Pulau Pinang,742,462,280
2022-10-01,TWN,Sabah,61,27,34
2022-10-01,TWN,Sarawak,152,70,82
2022-10-01,TWN,Selangor,4927,2620,2307
2022-10-01,TWN,W.P. Labuan,0,0,0
2022-10-01,TZA,Johor,15,11,4
2022-10-01,TZA,Kedah,0,0,0
2022-10-01,TZA,Perak,1,1,0
2022-10-01,TZA,Perlis,0,0,0
2022-10-01,TZA,Pulau Pinang,1,1,0
2022-10-01,TZA,Sabah,0,0,0
2022-10-01,TZA,Sarawak,0,0,0
2022-10-01,TZA,Selangor,173,100,73
2022-10-01,UGA,Johor,10,7,3
2022-10-01,UGA,Kedah,3,1,2
2022-10-01,UGA,Perak,2,1,1
2022-10-01,UGA,Perlis,3,1,2
2022-10-01,UGA,Pulau Pinang,1,0,1
2022-10-01,UGA,Sabah,0,0,0
2022-10-01,UGA,Sarawak,0,0,0
2022-10-01,UGA,Selangor,88,45,43
2022-10-01,UKR,Johor,96,64,32
2022-10-01,UKR,Kedah,30,13,17
2022-10-01,UKR,Kelantan,0,0,0
2022-10-01,UKR,Melaka,0,0,0
2022-10-01,UKR,Negeri Sembilan,0,0,0
2022-10-01,UKR,Pahang,1,1,0
2022-10-01,UKR,Perak,1,1,0
2022-10-01,UKR,Perlis,21,11,10
2022-10-01,UKR,Pulau Pinang,19,7,12
2022-10-01,UKR,Sabah,1,1,0
2022-10-01,UKR,Sarawak,2,1,1
2022-10-01,UKR,Selangor,577,296,281
2022-10-01,UKR,W.P. Labuan,0,0,0
2022-10-01,URY,Johor,8,3,5
2022-10-01,URY,Kedah,0,0,0
2022-10-01,URY,Kelantan,0,0,0
2022-10-01,URY,Perak,2,1,1
2022-10-01,URY,Perlis,0,0,0
2022-10-01,URY,Pulau Pinang,1,0,1
2022-10-01,URY,Sabah,0,0,0
2022-10-01,URY,Sarawak,2,1,1
2022-10-01,URY,Selangor,47,19,28
2022-10-01,URY,W.P. Labuan,0,0,0
2022-10-01,USA,Johor,3458,2136,1322
2022-10-01,USA,Kedah,307,193,114
2022-10-01,USA,Kelantan,8,5,3
2022-10-01,USA,Melaka,5,2,3
2022-10-01,USA,Negeri Sembilan,0,0,0
2022-10-01,USA,Pahang,3,3,0
2022-10-01,USA,Perak,66,42,24
2022-10-01,USA,Perlis,79,50,29
2022-10-01,USA,Pulau Pinang,1461,891,570
2022-10-01,USA,Sabah,372,187,185
2022-10-01,USA,Sarawak,309,175,134
2022-10-01,USA,Selangor,10799,6652,4147
2022-10-01,USA,Terengganu,1,1,0
2022-10-01,USA,W.P. Labuan,13,9,4
2022-10-01,UZB,Johor,54,36,18
2022-10-01,UZB,Kedah,10,4,6
2022-10-01,UZB,Kelantan,0,0,0
2022-10-01,UZB,Perak,0,0,0
2022-10-01,UZB,Perlis,2,2,0
2022-10-01,UZB,Pulau Pinang,6,1,5
2022-10-01,UZB,Sabah,18,17,1
2022-10-01,UZB,Sarawak,1,1,0
2022-10-01,UZB,Selangor,529,323,206
2022-10-01,VAT,Johor,0,0,0
2022-10-01,VAT,Sarawak,0,0,0
2022-10-01,VAT,Selangor,0,0,0
2022-10-01,VCT,Johor,0,0,0
2022-10-01,VCT,Kedah,0,0,0
2022-10-01,VCT,Pulau Pinang,0,0,0
2022-10-01,VCT,Sarawak,0,0,0
2022-10-01,VCT,Selangor,0,0,0
2022-10-01,VEN,Johor,8,7,1
2022-10-01,VEN,Kedah,1,1,0
2022-10-01,VEN,Kelantan,0,0,0
2022-10-01,VEN,Melaka,0,0,0
2022-10-01,VEN,Perak,0,0,0
2022-10-01,VEN,Perlis,0,0,0
2022-10-01,VEN,Pulau Pinang,0,0,0
2022-10-01,VEN,Sabah,1,1,0
2022-10-01,VEN,Sarawak,7,5,2
2022-10-01,VEN,Selangor,71,48,23
2022-10-01,VEN,W.P. Labuan,0,0,0
2022-10-01,VNM,Johor,11524,3625,7899
2022-10-01,VNM,Kedah,260,53,207
2022-10-01,VNM,Kelantan,20,12,8
2022-10-01,VNM,Melaka,0,0,0
2022-10-01,VNM,Negeri Sembilan,0,0,0
2022-10-01,VNM,Pahang,0,0,0
2022-10-01,VNM,Perak,98,11,87
2022-10-01,VNM,Perlis,241,25,216
2022-10-01,VNM,Pulau Pinang,1774,451,1323
2022-10-01,VNM,Sabah,22,9,13
2022-10-01,VNM,Sarawak,96,14,82
2022-10-01,VNM,Selangor,12642,4646,7996
2022-10-01,VNM,Terengganu,0,0,0
2022-10-01,VNM,W.P. Labuan,1,0,1
2022-10-01,VUT,Johor,28,17,11
2022-10-01,VUT,Kedah,0,0,0
2022-10-01,VUT,Pulau Pinang,0,0,0
2022-10-01,VUT,Sabah,0,0,0
2022-10-01,VUT,Sarawak,0,0,0
2022-10-01,VUT,Selangor,44,35,9
2022-10-01,WSM,Johor,2,2,0
2022-10-01,WSM,Sarawak,0,0,0
2022-10-01,WSM,Selangor,8,3,5
2022-10-01,XXX,Johor,150,85,65
2022-10-01,XXX,Kedah,6,4,2
2022-10-01,XXX,Kelantan,0,0,0
2022-10-01,XXX,Melaka,0,0,0
2022-10-01,XXX,Pahang,0,0,0
2022-10-01,XXX,Perak,3,3,0
2022-10-01,XXX,Perlis,4,3,1
2022-10-01,XXX,Pulau Pinang,21,13,8
2022-10-01,XXX,Sabah,10,5,5
2022-10-01,XXX,Sarawak,14,11,3
2022-10-01,XXX,Selangor,343,209,134
2022-10-01,XXX,W.P. Labuan,0,0,0
2022-10-01,YEM,Johor,30,21,9
2022-10-01,YEM,Kedah,3,2,1
2022-10-01,YEM,Kelantan,1,1,0
2022-10-01,YEM,Melaka,0,0,0
2022-10-01,YEM,Pahang,0,0,0
2022-10-01,YEM,Perak,4,2,2
2022-10-01,YEM,Perlis,3,3,0
2022-10-01,YEM,Pulau Pinang,7,7,0
2022-10-01,YEM,Sabah,0,0,0
2022-10-01,YEM,Sarawak,2,2,0
2022-10-01,YEM,Selangor,1180,894,286
2022-10-01,YEM,W.P. Labuan,0,0,0
2022-10-01,ZAF,Johor,308,202,106
2022-10-01,ZAF,Kedah,54,29,25
2022-10-01,ZAF,Kelantan,0,0,0
2022-10-01,ZAF,Melaka,2,1,1
2022-10-01,ZAF,Pahang,1,1,0
2022-10-01,ZAF,Perak,4,3,1
2022-10-01,ZAF,Perlis,11,6,5
2022-10-01,ZAF,Pulau Pinang,55,29,26
2022-10-01,ZAF,Sabah,17,11,6
2022-10-01,ZAF,Sarawak,66,37,29
2022-10-01,ZAF,Selangor,892,579,313
2022-10-01,ZAF,Terengganu,0,0,0
2022-10-01,ZAF,W.P. Labuan,0,0,0
2022-10-01,ZAR,Selangor,0,0,0
2022-10-01,ZMB,Johor,2,1,1
2022-10-01,ZMB,Kedah,0,0,0
2022-10-01,ZMB,Perak,2,0,2
2022-10-01,ZMB,Perlis,0,0,0
2022-10-01,ZMB,Pulau Pinang,1,1,0
2022-10-01,ZMB,Sabah,0,0,0
2022-10-01,ZMB,Sarawak,2,2,0
2022-10-01,ZMB,Selangor,37,22,15
2022-10-01,ZWE,Johor,16,3,13
2022-10-01,ZWE,Kedah,0,0,0
2022-10-01,ZWE,Kelantan,0,0,0
2022-10-01,ZWE,Perak,0,0,0
2022-10-01,ZWE,Perlis,0,0,0
2022-10-01,ZWE,Pulau Pinang,0,0,0
2022-10-01,ZWE,Sabah,1,1,0
2022-10-01,ZWE,Sarawak,2,1,1
2022-10-01,ZWE,Selangor,127,57,70
2022-11-01,ABW,Kedah,0,0,0
2022-11-01,ABW,Pulau Pinang,0,0,0
2022-11-01,AFG,Johor,1,1,0
2022-11-01,AFG,Kedah,0,0,0
2022-11-01,AFG,Perlis,0,0,0
2022-11-01,AFG,Pulau Pinang,0,0,0
2022-11-01,AFG,Sarawak,1,0,1
2022-11-01,AFG,Selangor,25,20,5
2022-11-01,AGO,Johor,1,1,0
2022-11-01,AGO,Kedah,0,0,0
2022-11-01,AGO,Sabah,0,0,0
2022-11-01,AGO,Selangor,3,3,0
2022-11-01,AIA,Selangor,1,1,0
2022-11-01,ALB,Johor,16,14,2
2022-11-01,ALB,Kedah,0,0,0
2022-11-01,ALB,Perak,0,0,0
2022-11-01,ALB,Perlis,0,0,0
2022-11-01,ALB,Pulau Pinang,0,0,0
2022-11-01,ALB,Sabah,0,0,0
2022-11-01,ALB,Sarawak,0,0,0
2022-11-01,ALB,Selangor,25,13,12
2022-11-01,AND,Johor,0,0,0
2022-11-01,AND,Kedah,0,0,0
2022-11-01,AND,Perlis,0,0,0
2022-11-01,AND,Pulau Pinang,0,0,0
2022-11-01,AND,Selangor,4,1,3
2022-11-01,ANT,Selangor,0,0,0
2022-11-01,ARE,Johor,37,29,8
2022-11-01,ARE,Kedah,2,2,0
2022-11-01,ARE,Kelantan,0,0,0
2022-11-01,ARE,Perak,0,0,0
2022-11-01,ARE,Perlis,0,0,0
2022-11-01,ARE,Pulau Pinang,2,1,1
2022-11-01,ARE,Sabah,0,0,0
2022-11-01,ARE,Sarawak,0,0,0
2022-11-01,ARE,Selangor,363,246,117
2022-11-01,ARG,Johor,53,33,20
2022-11-01,ARG,Kedah,29,17,12
2022-11-01,ARG,Kelantan,0,0,0
2022-11-01,ARG,Melaka,0,0,0
2022-11-01,ARG,Perak,0,0,0
2022-11-01,ARG,Perlis,1,1,0
2022-11-01,ARG,Pulau Pinang,7,5,2
2022-11-01,ARG,Sabah,2,0,2
2022-11-01,ARG,Sarawak,0,0,0
2022-11-01,ARG,Selangor,269,164,105
2022-11-01,ARG,W.P. Labuan,0,0,0
2022-11-01,ARM,Johor,4,3,1
2022-11-01,ARM,Kedah,0,0,0
2022-11-01,ARM,Kelantan,0,0,0
2022-11-01,ARM,Perak,0,0,0
2022-11-01,ARM,Perlis,0,0,0
2022-11-01,ARM,Pulau Pinang,0,0,0
2022-11-01,ARM,Sabah,0,0,0
2022-11-01,ARM,Sarawak,0,0,0
2022-11-01,ARM,Selangor,28,9,19
2022-11-01,ATA,Selangor,0,0,0
2022-11-01,ATG,Johor,4,4,0
2022-11-01,ATG,Kedah,0,0,0
2022-11-01,ATG,Pulau Pinang,0,0,0
2022-11-01,ATG,Sarawak,0,0,0
2022-11-01,ATG,Selangor,5,5,0
2022-11-01,AUS,Johor,3879,2312,1567
2022-11-01,AUS,Kedah,457,255,202
2022-11-01,AUS,Kelantan,4,3,1
2022-11-01,AUS,Melaka,1,1,0
2022-11-01,AUS,Negeri Sembilan,2,1,1
2022-11-01,AUS,Pahang,0,0,0
2022-11-01,AUS,Perak,143,80,63
2022-11-01,AUS,Perlis,60,40,20
2022-11-01,AUS,Pulau Pinang,1382,748,634
2022-11-01,AUS,Sabah,315,162,153
2022-11-01,AUS,Sarawak,536,296,240
2022-11-01,AUS,Selangor,18721,10988,7733
2022-11-01,AUS,Terengganu,0,0,0
2022-11-01,AUS,W.P. Labuan,21,14,7
2022-11-01,AUT,Johor,147,100,47
2022-11-01,AUT,Kedah,43,20,23
2022-11-01,AUT,Kelantan,0,0,0
2022-11-01,AUT,Melaka,0,0,0
2022-11-01,AUT,Negeri Sembilan,0,0,0
2022-11-01,AUT,Pahang,0,0,0
2022-11-01,AUT,Perak,2,1,1
2022-11-01,AUT,Perlis,17,12,5
2022-11-01,AUT,Pulau Pinang,75,52,23
2022-11-01,AUT,Sabah,15,10,5
2022-11-01,AUT,Sarawak,6,5,1
2022-11-01,AUT,Selangor,679,445,234
2022-11-01,AUT,Terengganu,0,0,0
2022-11-01,AUT,W.P. Labuan,0,0,0
2022-11-01,AZE,Johor,2,2,0
2022-11-01,AZE,Kedah,0,0,0
2022-11-01,AZE,Kelantan,0,0,0
2022-11-01,AZE,Melaka,0,0,0
2022-11-01,AZE,Perlis,0,0,0
2022-11-01,AZE,Pulau Pinang,0,0,0
2022-11-01,AZE,Sabah,1,1,0
2022-11-01,AZE,Sarawak,0,0,0
2022-11-01,AZE,Selangor,74,44,30
2022-11-01,AZE,W.P. Labuan,0,0,0
2022-11-01,BDI,Pulau Pinang,0,0,0
2022-11-01,BDI,Sarawak,0,0,0
2022-11-01,BDI,Selangor,6,4,2
2022-11-01,BEL,Johor,210,147,63
2022-11-01,BEL,Kedah,51,31,20
2022-11-01,BEL,Kelantan,5,4,1
2022-11-01,BEL,Melaka,0,0,0
2022-11-01,BEL,Negeri Sembilan,0,0,0
2022-11-01,BEL,Pahang,0,0,0
2022-11-01,BEL,Perak,3,2,1
2022-11-01,BEL,Perlis,9,8,1
2022-11-01,BEL,Pulau Pinang,56,43,13
2022-11-01,BEL,Sabah,15,9,6
2022-11-01,BEL,Sarawak,24,19,5
2022-11-01,BEL,Selangor,684,454,230
2022-11-01,BEL,W.P. Labuan,0,0,0
2022-11-01,BEN,Johor,2,0,2
2022-11-01,BEN,Kedah,0,0,0
2022-11-01,BEN,Perak,0,0,0
2022-11-01,BEN,Pulau Pinang,0,0,0
2022-11-01,BEN,Sabah,0,0,0
2022-11-01,BEN,Sarawak,0,0,0
2022-11-01,BEN,Selangor,6,5,1
2022-11-01,BFA,Perak,0,0,0
2022-11-01,BFA,Pulau Pinang,0,0,0
2022-11-01,BFA,Selangor,2,2,0
2022-11-01,BGD,Johor,1734,1456,278
2022-11-01,BGD,Kedah,38,23,15
2022-11-01,BGD,Kelantan,0,0,0
2022-11-01,BGD,Melaka,0,0,0
2022-11-01,BGD,Negeri Sembilan,0,0,0
2022-11-01,BGD,Pahang,0,0,0
2022-11-01,BGD,Perak,3,3,0
2022-11-01,BGD,Perlis,7,6,1
2022-11-01,BGD,Pulau Pinang,414,402,12
2022-11-01,BGD,Sabah,0,0,0
2022-11-01,BGD,Sarawak,59,53,6
2022-11-01,BGD,Selangor,34670,33433,1237
2022-11-01,BGD,W.P. Labuan,3,3,0
2022-11-01,BGR,Johor,51,25,26
2022-11-01,BGR,Kedah,7,4,3
2022-11-01,BGR,Kelantan,1,0,1
2022-11-01,BGR,Pahang,0,0,0
2022-11-01,BGR,Perak,0,0,0
2022-11-01,BGR,Perlis,1,0,1
2022-11-01,BGR,Pulau Pinang,7,5,2
2022-11-01,BGR,Sabah,1,0,1
2022-11-01,BGR,Sarawak,0,0,0
2022-11-01,BGR,Selangor,163,98,65
2022-11-01,BGR,W.P. Labuan,0,0,0
2022-11-01,BHR,Johor,0,0,0
2022-11-01,BHR,Kedah,2,2,0
2022-11-01,BHR,Kelantan,1,1,0
2022-11-01,BHR,Perlis,0,0,0
2022-11-01,BHR,Pulau Pinang,3,3,0
2022-11-01,BHR,Sabah,0,0,0
2022-11-01,BHR,Sarawak,0,0,0
2022-11-01,BHR,Selangor,90,55,35
2022-11-01,BHS,Johor,0,0,0
2022-11-01,BHS,Kedah,0,0,0
2022-11-01,BHS,Perak,0,0,0
2022-11-01,BHS,Sabah,0,0,0
2022-11-01,BHS,Sarawak,0,0,0
2022-11-01,BHS,Selangor,6,0,6
2022-11-01,BIH,Johor,3,3,0
2022-11-01,BIH,Kedah,0,0,0
2022-11-01,BIH,Perlis,0,0,0
2022-11-01,BIH,Pulau Pinang,2,1,1
2022-11-01,BIH,Sabah,0,0,0
2022-11-01,BIH,Sarawak,2,2,0
2022-11-01,BIH,Selangor,30,16,14
2022-11-01,BLR,Johor,7,3,4
2022-11-01,BLR,Kedah,4,1,3
2022-11-01,BLR,Kelantan,2,0,2
2022-11-01,BLR,Pahang,0,0,0
2022-11-01,BLR,Perak,0,0,0
2022-11-01,BLR,Perlis,0,0,0
2022-11-01,BLR,Pulau Pinang,2,1,1
2022-11-01,BLR,Sabah,1,1,0
2022-11-01,BLR,Sarawak,2,1,1
2022-11-01,BLR,Selangor,238,113,125
2022-11-01,BLR,W.P. Labuan,0,0,0
2022-11-01,BLZ,Johor,2,1,1
2022-11-01,BLZ,Pulau Pinang,0,0,0
2022-11-01,BLZ,Sarawak,1,1,0
2022-11-01,BLZ,Selangor,5,1,4
2022-11-01,BMU,Selangor,0,0,0
2022-11-01,BOL,Johor,6,2,4
2022-11-01,BOL,Kedah,0,0,0
2022-11-01,BOL,Melaka,0,0,0
2022-11-01,BOL,Perak,0,0,0
2022-11-01,BOL,Perlis,0,0,0
2022-11-01,BOL,Pulau Pinang,0,0,0
2022-11-01,BOL,Sabah,0,0,0
2022-11-01,BOL,Sarawak,5,3,2
2022-11-01,BOL,Selangor,21,13,8
2022-11-01,BRA,Johor,140,78,62
2022-11-01,BRA,Kedah,16,8,8
2022-11-01,BRA,Kelantan,0,0,0
2022-11-01,BRA,Melaka,0,0,0
2022-11-01,BRA,Pahang,0,0,0
2022-11-01,BRA,Perak,2,2,0
2022-11-01,BRA,Perlis,9,4,5
2022-11-01,BRA,Pulau Pinang,15,11,4
2022-11-01,BRA,Sabah,3,2,1
2022-11-01,BRA,Sarawak,4,2,2
2022-11-01,BRA,Selangor,676,374,302
2022-11-01,BRA,W.P. Labuan,1,0,1
2022-11-01,BRB,Johor,0,0,0
2022-11-01,BRB,Kedah,0,0,0
2022-11-01,BRB,Perlis,0,0,0
2022-11-01,BRB,Pulau Pinang,0,0,0
2022-11-01,BRB,Selangor,6,5,1
2022-11-01,BRN,Johor,279,144,135
2022-11-01,BRN,Kedah,16,8,8
2022-11-01,BRN,Kelantan,0,0,0
2022-11-01,BRN,Melaka,0,0,0
2022-11-01,BRN,Pahang,0,0,0
2022-11-01,BRN,Perak,1,1,0
2022-11-01,BRN,Perlis,7,4,3
2022-11-01,BRN,Pulau Pinang,15,6,9
2022-11-01,BRN,Sabah,823,393,430
2022-11-01,BRN,Sarawak,59481,32252,27229
2022-11-01,BRN,Selangor,4130,2057,2073
2022-11-01,BRN,W.P. Labuan,788,556,232
2022-11-01,BTN,Johor,0,0,0
2022-11-01,BTN,Kedah,0,0,0
2022-11-01,BTN,Perak,0,0,0
2022-11-01,BTN,Perlis,0,0,0
2022-11-01,BTN,Pulau Pinang,0,0,0
2022-11-01,BTN,Sabah,1,1,0
2022-11-01,BTN,Sarawak,0,0,0
2022-11-01,BTN,Selangor,23,17,6
2022-11-01,BWA,Johor,1,0,1
2022-11-01,BWA,Kedah,1,1,0
2022-11-01,BWA,Perlis,0,0,0
2022-11-01,BWA,Pulau Pinang,0,0,0
2022-11-01,BWA,Sabah,0,0,0
2022-11-01,BWA,Sarawak,0,0,0
2022-11-01,BWA,Selangor,3,2,1
2022-11-01,CAF,Kedah,0,0,0
2022-11-01,CAF,Selangor,0,0,0
2022-11-01,CAN,Johor,1233,716,517
2022-11-01,CAN,Kedah,113,63,50
2022-11-01,CAN,Kelantan,0,0,0
2022-11-01,CAN,Melaka,0,0,0
2022-11-01,CAN,Negeri Sembilan,0,0,0
2022-11-01,CAN,Pahang,0,0,0
2022-11-01,CAN,Perak,39,21,18
2022-11-01,CAN,Perlis,50,32,18
2022-11-01,CAN,Pulau Pinang,375,215,160
2022-11-01,CAN,Sabah,110,60,50
2022-11-01,CAN,Sarawak,302,156,146
2022-11-01,CAN,Selangor,3503,2121,1382
2022-11-01,CAN,Terengganu,0,0,0
2022-11-01,CAN,W.P. Labuan,5,4,1
2022-11-01,CCK,Selangor,1,1,0
2022-11-01,CHE,Johor,300,189,111
2022-11-01,CHE,Kedah,124,71,53
2022-11-01,CHE,Kelantan,2,2,0
2022-11-01,CHE,Melaka,0,0,0
2022-11-01,CHE,Negeri Sembilan,0,0,0
2022-11-01,CHE,Pahang,0,0,0
2022-11-01,CHE,Perak,7,5,2
2022-11-01,CHE,Perlis,21,15,6
2022-11-01,CHE,Pulau Pinang,130,90,40
2022-11-01,CHE,Sabah,27,18,9
2022-11-01,CHE,Sarawak,28,15,13
2022-11-01,CHE,Selangor,987,657,330
2022-11-01,CHE,W.P. Labuan,1,1,0
2022-11-01,CHL,Johor,16,10,6
2022-11-01,CHL,Kedah,6,4,2
2022-11-01,CHL,Kelantan,0,0,0
2022-11-01,CHL,Melaka,0,0,0
2022-11-01,CHL,Pahang,0,0,0
2022-11-01,CHL,Perak,0,0,0
2022-11-01,CHL,Perlis,1,1,0
2022-11-01,CHL,Pulau Pinang,0,0,0
2022-11-01,CHL,Sabah,2,2,0
2022-11-01,CHL,Sarawak,0,0,0
2022-11-01,CHL,Selangor,143,87,56
2022-11-01,CHN,Johor,19263,7672,11591
2022-11-01,CHN,Kedah,418,178,240
2022-11-01,CHN,Kelantan,5,2,3
2022-11-01,CHN,Melaka,5,4,1
2022-11-01,CHN,Pahang,0,0,0
2022-11-01,CHN,Perak,145,61,84
2022-11-01,CHN,Perlis,40,27,13
2022-11-01,CHN,Pulau Pinang,1465,777,688
2022-11-01,CHN,Sabah,358,152,206
2022-11-01,CHN,Sarawak,371,180,191
2022-11-01,CHN,Selangor,19273,11464,7809
2022-11-01,CHN,Terengganu,0,0,0
2022-11-01,CHN,W.P. Labuan,17,10,7
2022-11-01,CIV,Johor,0,0,0
2022-11-01,CIV,Kedah,0,0,0
2022-11-01,CIV,Pulau Pinang,0,0,0
2022-11-01,CIV,Sabah,0,0,0
2022-11-01,CIV,Sarawak,0,0,0
2022-11-01,CIV,Selangor,17,14,3
2022-11-01,CMR,Johor,4,4,0
2022-11-01,CMR,Kedah,0,0,0
2022-11-01,CMR,Pulau Pinang,0,0,0
2022-11-01,CMR,Sabah,0,0,0
2022-11-01,CMR,Sarawak,0,0,0
2022-11-01,CMR,Selangor,16,12,4
2022-11-01,COD,Johor,0,0,0
2022-11-01,COD,Pulau Pinang,0,0,0
2022-11-01,COD,Sarawak,0,0,0
2022-11-01,COD,Selangor,2,2,0
2022-11-01,COG,Johor,0,0,0
2022-11-01,COG,Kedah,0,0,0
2022-11-01,COG,Selangor,6,3,3
2022-11-01,COK,Selangor,0,0,0
2022-11-01,COL,Johor,19,9,10
2022-11-01,COL,Kedah,1,0,1
2022-11-01,COL,Perak,0,0,0
2022-11-01,COL,Pulau Pinang,3,0,3
2022-11-01,COL,Sabah,0,0,0
2022-11-01,COL,Sarawak,0,0,0
2022-11-01,COL,Selangor,130,76,54
2022-11-01,COL,W.P. Labuan,0,0,0
2022-11-01,COM,Johor,0,0,0
2022-11-01,COM,Kedah,0,0,0
2022-11-01,COM,Selangor,16,10,6
2022-11-01,CPV,Johor,1,1,0
2022-11-01,CPV,Kedah,0,0,0
2022-11-01,CPV,Pulau Pinang,1,0,1
2022-11-01,CPV,Sabah,0,0,0
2022-11-01,CPV,Selangor,2,1,1
2022-11-01,CRI,Johor,8,7,1
2022-11-01,CRI,Kedah,0,0,0
2022-11-01,CRI,Perak,0,0,0
2022-11-01,CRI,Perlis,0,0,0
2022-11-01,CRI,Pulau Pinang,4,3,1
2022-11-01,CRI,Sabah,0,0,0
2022-11-01,CRI,Sarawak,0,0,0
2022-11-01,CRI,Selangor,41,20,21
2022-11-01,CUB,Johor,2,1,1
2022-11-01,CUB,Kedah,1,1,0
2022-11-01,CUB,Perlis,0,0,0
2022-11-01,CUB,Pulau Pinang,0,0,0
2022-11-01,CUB,Sabah,0,0,0
2022-11-01,CUB,Sarawak,0,0,0
2022-11-01,CUB,Selangor,25,15,10
2022-11-01,CYP,Johor,7,3,4
2022-11-01,CYP,Kedah,1,1,0
2022-11-01,CYP,Perak,0,0,0
2022-11-01,CYP,Perlis,0,0,0
2022-11-01,CYP,Pulau Pinang,3,2,1
2022-11-01,CYP,Sabah,1,0,1
2022-11-01,CYP,Sarawak,1,0,1
2022-11-01,CYP,Selangor,50,36,14
2022-11-01,CZE,Johor,131,77,54
2022-11-01,CZE,Kedah,76,34,42
2022-11-01,CZE,Kelantan,1,1,0
2022-11-01,CZE,Melaka,0,0,0
2022-11-01,CZE,Negeri Sembilan,0,0,0
2022-11-01,CZE,Perak,0,0,0
2022-11-01,CZE,Perlis,15,8,7
2022-11-01,CZE,Pulau Pinang,22,15,7
2022-11-01,CZE,Sabah,9,7,2
2022-11-01,CZE,Sarawak,7,5,2
2022-11-01,CZE,Selangor,422,272,150
2022-11-01,CZE,W.P. Labuan,1,0,1
2022-11-01,DEU,Johor,1907,1242,665
2022-11-01,DEU,Kedah,460,234,226
2022-11-01,DEU,Kelantan,11,9,2
2022-11-01,DEU,Melaka,3,2,1
2022-11-01,DEU,Negeri Sembilan,1,1,0
2022-11-01,DEU,Pahang,1,1,0
2022-11-01,DEU,Perak,19,14,5
2022-11-01,DEU,Perlis,95,62,33
2022-11-01,DEU,Pulau Pinang,601,449,152
2022-11-01,DEU,Sabah,87,55,32
2022-11-01,DEU,Sarawak,150,99,51
2022-11-01,DEU,Selangor,5193,3520,1673
2022-11-01,DEU,Terengganu,0,0,0
2022-11-01,DEU,W.P. Labuan,2,1,1
2022-11-01,DJI,Johor,0,0,0
2022-11-01,DJI,Selangor,7,4,3
2022-11-01,DMA,Johor,5,4,1
2022-11-01,DMA,Kedah,0,0,0
2022-11-01,DMA,Pulau Pinang,0,0,0
2022-11-01,DMA,Sabah,0,0,0
2022-11-01,DMA,Sarawak,0,0,0
2022-11-01,DMA,Selangor,21,18,3
2022-11-01,DMA,W.P. Labuan,0,0,0
2022-11-01,DNK,Johor,265,180,85
2022-11-01,DNK,Kedah,56,28,28
2022-11-01,DNK,Kelantan,0,0,0
2022-11-01,DNK,Melaka,0,0,0
2022-11-01,DNK,Negeri Sembilan,0,0,0
2022-11-01,DNK,Pahang,0,0,0
2022-11-01,DNK,Perak,3,3,0
2022-11-01,DNK,Perlis,10,6,4
2022-11-01,DNK,Pulau Pinang,62,39,23
2022-11-01,DNK,Sabah,15,11,4
2022-11-01,DNK,Sarawak,16,10,6
2022-11-01,DNK,Selangor,790,527,263
2022-11-01,DNK,W.P. Labuan,1,1,0
2022-11-01,DOM,Johor,0,0,0
2022-11-01,DOM,Kedah,0,0,0
2022-11-01,DOM,Perak,0,0,0
2022-11-01,DOM,Perlis,0,0,0
2022-11-01,DOM,Pulau Pinang,0,0,0
2022-11-01,DOM,Sabah,0,0,0
2022-11-01,DOM,Sarawak,0,0,0
2022-11-01,DOM,Selangor,8,8,0
2022-11-01,DZA,Johor,54,38,16
2022-11-01,DZA,Kedah,3,3,0
2022-11-01,DZA,Kelantan,1,1,0
2022-11-01,DZA,Melaka,0,0,0
2022-11-01,DZA,Perak,0,0,0
2022-11-01,DZA,Perlis,2,2,0
2022-11-01,DZA,Pulau Pinang,1,1,0
2022-11-01,DZA,Sabah,1,1,0
2022-11-01,DZA,Sarawak,1,1,0
2022-11-01,DZA,Selangor,428,312,116
2022-11-01,DZA,W.P. Labuan,0,0,0
2022-11-01,ECU,Johor,4,4,0
2022-11-01,ECU,Kedah,0,0,0
2022-11-01,ECU,Perak,0,0,0
2022-11-01,ECU,Perlis,0,0,0
2022-11-01,ECU,Pulau Pinang,1,0,1
2022-11-01,ECU,Sabah,0,0,0
2022-11-01,ECU,Sarawak,0,0,0
2022-11-01,ECU,Selangor,45,24,21
2022-11-01,EGY,Johor,143,116,27
2022-11-01,EGY,Kedah,3,3,0
2022-11-01,EGY,Kelantan,0,0,0
2022-11-01,EGY,Melaka,1,0,1
2022-11-01,EGY,Pahang,0,0,0
2022-11-01,EGY,Perak,0,0,0
2022-11-01,EGY,Perlis,0,0,0
2022-11-01,EGY,Pulau Pinang,9,7,2
2022-11-01,EGY,Sabah,5,5,0
2022-11-01,EGY,Sarawak,91,69,22
2022-11-01,EGY,Selangor,1273,844,429
2022-11-01,EGY,Terengganu,0,0,0
2022-11-01,EGY,W.P. Labuan,0,0,0
2022-11-01,ERI,Johor,0,0,0
2022-11-01,ERI,Pulau Pinang,0,0,0
2022-11-01,ERI,Sabah,0,0,0
2022-11-01,ERI,Selangor,17,9,8
2022-11-01,ESP,Johor,434,267,167
2022-11-01,ESP,Kedah,191,93,98
2022-11-01,ESP,Kelantan,1,1,0
2022-11-01,ESP,Melaka,0,0,0
2022-11-01,ESP,Negeri Sembilan,0,0,0
2022-11-01,ESP,Pahang,0,0,0
2022-11-01,ESP,Perak,1,0,1
2022-11-01,ESP,Perlis,21,12,9
2022-11-01,ESP,Pulau Pinang,92,52,40
2022-11-01,ESP,Sabah,32,15,17
2022-11-01,ESP,Sarawak,34,25,9
2022-11-01,ESP,Selangor,2000,1184,816
2022-11-01,ESP,W.P. Labuan,2,1,1
2022-11-01,EST,Johor,32,16,16
2022-11-01,EST,Kedah,9,7,2
2022-11-01,EST,Kelantan,0,0,0
2022-11-01,EST,Pahang,0,0,0
2022-11-01,EST,Perak,0,0,0
2022-11-01,EST,Perlis,4,2,2
2022-11-01,EST,Pulau Pinang,5,3,2
2022-11-01,EST,Sabah,0,0,0
2022-11-01,EST,Sarawak,0,0,0
2022-11-01,EST,Selangor,122,71,51
2022-11-01,EST,W.P. Labuan,0,0,0
2022-11-01,ETH,Johor,0,0,0
2022-11-01,ETH,Kedah,0,0,0
2022-11-01,ETH,Pulau Pinang,0,0,0
2022-11-01,ETH,Sarawak,1,0,1
2022-11-01,ETH,Selangor,34,22,12
2022-11-01,FIN,Johor,166,99,67
2022-11-01,FIN,Kedah,67,26,41
2022-11-01,FIN,Kelantan,0,0,0
2022-11-01,FIN,Melaka,0,0,0
2022-11-01,FIN,Negeri Sembilan,0,0,0
2022-11-01,FIN,Pahang,0,0,0
2022-11-01,FIN,Perak,4,1,3
2022-11-01,FIN,Perlis,5,3,2
2022-11-01,FIN,Pulau Pinang,44,22,22
2022-11-01,FIN,Sabah,10,4,6
2022-11-01,FIN,Sarawak,13,5,8
2022-11-01,FIN,Selangor,597,342,255
2022-11-01,FIN,W.P. Labuan,0,0,0
2022-11-01,FJI,Johor,29,18,11
2022-11-01,FJI,Kedah,0,0,0
2022-11-01,FJI,Kelantan,0,0,0
2022-11-01,FJI,Perak,1,1,0
2022-11-01,FJI,Perlis,1,0,1
2022-11-01,FJI,Pulau Pinang,3,2,1
2022-11-01,FJI,Sabah,0,0,0
2022-11-01,FJI,Sarawak,4,3,1
2022-11-01,FJI,Selangor,71,44,27
2022-11-01,FRA,Johor,1435,958,477
2022-11-01,FRA,Kedah,285,167,118
2022-11-01,FRA,Kelantan,4,3,1
2022-11-01,FRA,Melaka,3,1,2
2022-11-01,FRA,Negeri Sembilan,0,0,0
2022-11-01,FRA,Pahang,3,3,0
2022-11-01,FRA,Perak,25,16,9
2022-11-01,FRA,Perlis,67,49,18
2022-11-01,FRA,Pulau Pinang,264,178,86
2022-11-01,FRA,Sabah,61,38,23
2022-11-01,FRA,Sarawak,91,60,31
2022-11-01,FRA,Selangor,4797,3181,1616
2022-11-01,FRA,Terengganu,0,0,0
2022-11-01,FRA,W.P. Labuan,11,9,2
2022-11-01,FSM,Johor,0,0,0
2022-11-01,FSM,Pulau Pinang,0,0,0
2022-11-01,FSM,Selangor,0,0,0
2022-11-01,GAB,Johor,0,0,0
2022-11-01,GAB,Pulau Pinang,0,0,0
2022-11-01,GAB,Sarawak,0,0,0
2022-11-01,GAB,Selangor,1,1,0
2022-11-01,GBR,Johor,3760,2446,1314
2022-11-01,GBR,Kedah,791,446,345
2022-11-01,GBR,Kelantan,4,3,1
2022-11-01,GBR,Melaka,3,3,0
2022-11-01,GBR,Negeri Sembilan,2,0,2
2022-11-01,GBR,Pahang,2,2,0
2022-11-01,GBR,Perak,64,36,28
2022-11-01,GBR,Perlis,154,93,61
2022-11-01,GBR,Pulau Pinang,1110,690,420
2022-11-01,GBR,Sabah,226,141,85
2022-11-01,GBR,Sarawak,864,561,303
2022-11-01,GBR,Selangor,13386,8520,4866
2022-11-01,GBR,Terengganu,1,1,0
2022-11-01,GBR,W.P. Labuan,49,34,15
2022-11-01,GEO,Johor,13,13,0
2022-11-01,GEO,Kedah,1,1,0
2022-11-01,GEO,Melaka,0,0,0
2022-11-01,GEO,Perak,0,0,0
2022-11-01,GEO,Perlis,2,1,1
2022-11-01,GEO,Pulau Pinang,0,0,0
2022-11-01,GEO,Sabah,0,0,0
2022-11-01,GEO,Sarawak,1,0,1
2022-11-01,GEO,Selangor,28,17,11
2022-11-01,GHA,Johor,24,6,18
2022-11-01,GHA,Kedah,0,0,0
2022-11-01,GHA,Kelantan,0,0,0
2022-11-01,GHA,Pulau Pinang,0,0,0
2022-11-01,GHA,Sabah,1,0,1
2022-11-01,GHA,Sarawak,0,0,0
2022-11-01,GHA,Selangor,64,36,28
2022-11-01,GIB,Johor,0,0,0
2022-11-01,GIB,Sarawak,0,0,0
2022-11-01,GIN,Johor,3,2,1
2022-11-01,GIN,Kedah,0,0,0
2022-11-01,GIN,Kelantan,0,0,0
2022-11-01,GIN,Perlis,2,2,0
2022-11-01,GIN,Pulau Pinang,0,0,0
2022-11-01,GIN,Sabah,0,0,0
2022-11-01,GIN,Sarawak,0,0,0
2022-11-01,GIN,Selangor,46,35,11
2022-11-01,GLP,Selangor,0,0,0
2022-11-01,GMB,Johor,2,2,0
2022-11-01,GMB,Kedah,0,0,0
2022-11-01,GMB,Kelantan,0,0,0
2022-11-01,GMB,Pulau Pinang,0,0,0
2022-11-01,GMB,Sabah,0,0,0
2022-11-01,GMB,Sarawak,0,0,0
2022-11-01,GMB,Selangor,11,5,6
2022-11-01,GNB,Johor,0,0,0
2022-11-01,GNB,Selangor,0,0,0
2022-11-01,GNQ,Johor,0,0,0
2022-11-01,GNQ,Selangor,1,1,0
2022-11-01,GRC,Johor,45,37,8
2022-11-01,GRC,Kedah,6,4,2
2022-11-01,GRC,Kelantan,0,0,0
2022-11-01,GRC,Melaka,0,0,0
2022-11-01,GRC,Negeri Sembilan,0,0,0
2022-11-01,GRC,Pahang,0,0,0
2022-11-01,GRC,Perak,1,1,0
2022-11-01,GRC,Perlis,1,0,1
2022-11-01,GRC,Pulau Pinang,5,5,0
2022-11-01,GRC,Sabah,2,1,1
2022-11-01,GRC,Sarawak,2,1,1
2022-11-01,GRC,Selangor,221,168,53
2022-11-01,GRD,Johor,6,4,2
2022-11-01,GRD,Kedah,0,0,0
2022-11-01,GRD,Pulau Pinang,1,0,1
2022-11-01,GRD,Sabah,0,0,0
2022-11-01,GRD,Sarawak,1,1,0
2022-11-01,GRD,Selangor,7,7,0
2022-11-01,GRL,Johor,0,0,0
2022-11-01,GRL,Selangor,0,0,0
2022-11-01,GTM,Johor,0,0,0
2022-11-01,GTM,Kedah,0,0,0
2022-11-01,GTM,Pahang,0,0,0
2022-11-01,GTM,Perak,0,0,0
2022-11-01,GTM,Pulau Pinang,0,0,0
2022-11-01,GTM,Sabah,0,0,0
2022-11-01,GTM,Sarawak,0,0,0
2022-11-01,GTM,Selangor,16,10,6
2022-11-01,GTM,W.P. Labuan,0,0,0
2022-11-01,GUY,Johor,0,0,0
2022-11-01,GUY,Kedah,0,0,0
2022-11-01,GUY,Pulau Pinang,0,0,0
2022-11-01,GUY,Sarawak,0,0,0
2022-11-01,GUY,Selangor,4,3,1
2022-11-01,HKG,Johor,1,0,1
2022-11-01,HKG,Kedah,0,0,0
2022-11-01,HKG,Kelantan,0,0,0
2022-11-01,HKG,Pahang,0,0,0
2022-11-01,HKG,Perak,30,17,13
2022-11-01,HKG,Perlis,2,2,0
2022-11-01,HKG,Pulau Pinang,0,0,0
2022-11-01,HKG,Sabah,1,0,1
2022-11-01,HKG,Sarawak,0,0,0
2022-11-01,HKG,Selangor,24,12,12
2022-11-01,HKG,Terengganu,0,0,0
2022-11-01,HMD,Johor,0,0,0
2022-11-01,HND,Johor,2,2,0
2022-11-01,HND,Kedah,0,0,0
2022-11-01,HND,Perak,0,0,0
2022-11-01,HND,Pulau Pinang,2,1,1
2022-11-01,HND,Sabah,0,0,0
2022-11-01,HND,Sarawak,0,0,0
2022-11-01,HND,Selangor,9,5,4
2022-11-01,HRV,Johor,24,22,2
2022-11-01,HRV,Kedah,6,3,3
2022-11-01,HRV,Kelantan,0,0,0
2022-11-01,HRV,Melaka,0,0,0
2022-11-01,HRV,Pahang,0,0,0
2022-11-01,HRV,Perak,0,0,0
2022-11-01,HRV,Perlis,0,0,0
2022-11-01,HRV,Pulau Pinang,2,2,0
2022-11-01,HRV,Sabah,2,1,1
2022-11-01,HRV,Sarawak,5,4,1
2022-11-01,HRV,Selangor,141,96,45
2022-11-01,HTI,Johor,0,0,0
2022-11-01,HTI,Kedah,0,0,0
2022-11-01,HTI,Kelantan,0,0,0
2022-11-01,HTI,Perak,0,0,0
2022-11-01,HTI,Pulau Pinang,0,0,0
2022-11-01,HTI,Sabah,0,0,0
2022-11-01,HTI,Selangor,6,2,4
2022-11-01,HUN,Johor,98,58,40
2022-11-01,HUN,Kedah,9,5,4
2022-11-01,HUN,Kelantan,0,0,0
2022-11-01,HUN,Pahang,0,0,0
2022-11-01,HUN,Perak,0,0,0
2022-11-01,HUN,Perlis,4,2,2
2022-11-01,HUN,Pulau Pinang,13,10,3
2022-11-01,HUN,Sabah,7,5,2
2022-11-01,HUN,Sarawak,6,4,2
2022-11-01,HUN,Selangor,372,206,166
2022-11-01,HUN,W.P. Labuan,0,0,0
2022-11-01,IDN,Johor,96592,52990,43602
2022-11-01,IDN,Kedah,3884,1470,2414
2022-11-01,IDN,Kelantan,181,155,26
2022-11-01,IDN,Melaka,5119,2322,2797
2022-11-01,IDN,Negeri Sembilan,6786,4580,2206
2022-11-01,IDN,Pahang,3,3,0
2022-11-01,IDN,Perak,200,100,100
2022-11-01,IDN,Perlis,354,175,179
2022-11-01,IDN,Pulau Pinang,23905,8712,15193
2022-11-01,IDN,Sabah,3585,1822,1763
2022-11-01,IDN,Sarawak,28333,15737,12596
2022-11-01,IDN,Selangor,83310,41495,41815
2022-11-01,IDN,Terengganu,1,1,0
2022-11-01,IDN,W.P. Labuan,85,50,35
2022-11-01,IND,Johor,14093,9759,4334
2022-11-01,IND,Kedah,482,290,192
2022-11-01,IND,Kelantan,1,1,0
2022-11-01,IND,Melaka,0,0,0
2022-11-01,IND,Negeri Sembilan,0,0,0
2022-11-01,IND,Pahang,0,0,0
2022-11-01,IND,Perak,269,196,73
2022-11-01,IND,Perlis,14,11,3
2022-11-01,IND,Pulau Pinang,564,437,127
2022-11-01,IND,Sabah,161,128,33
2022-11-01,IND,Sarawak,646,515,131
2022-11-01,IND,Selangor,44374,32516,11858
2022-11-01,IND,Terengganu,1,1,0
2022-11-01,IND,W.P. Labuan,31,26,5
2022-11-01,IOT,Pulau Pinang,0,0,0
2022-11-01,IOT,Selangor,1,1,0
2022-11-01,IRL,Johor,270,182,88
2022-11-01,IRL,Kedah,66,35,31
2022-11-01,IRL,Kelantan,0,0,0
2022-11-01,IRL,Negeri Sembilan,0,0,0
2022-11-01,IRL,Pahang,1,1,0
2022-11-01,IRL,Perak,5,4,1
2022-11-01,IRL,Perlis,18,13,5
2022-11-01,IRL,Pulau Pinang,91,60,31
2022-11-01,IRL,Sabah,9,3,6
2022-11-01,IRL,Sarawak,24,19,5
2022-11-01,IRL,Selangor,896,543,353
2022-11-01,IRL,Terengganu,0,0,0
2022-11-01,IRL,W.P. Labuan,1,1,0
2022-11-01,IRN,Johor,78,54,24
2022-11-01,IRN,Kedah,12,9,3
2022-11-01,IRN,Kelantan,0,0,0
2022-11-01,IRN,Perak,1,1,0
2022-11-01,IRN,Perlis,0,0,0
2022-11-01,IRN,Pulau Pinang,7,3,4
2022-11-01,IRN,Sabah,1,1,0
2022-11-01,IRN,Sarawak,6,3,3
2022-11-01,IRN,Selangor,876,479,397
2022-11-01,IRN,W.P. Labuan,0,0,0
2022-11-01,IRQ,Johor,25,24,1
2022-11-01,IRQ,Kedah,2,1,1
2022-11-01,IRQ,Kelantan,0,0,0
2022-11-01,IRQ,Melaka,0,0,0
2022-11-01,IRQ,Pahang,0,0,0
2022-11-01,IRQ,Perak,0,0,0
2022-11-01,IRQ,Perlis,1,1,0
2022-11-01,IRQ,Pulau Pinang,0,0,0
2022-11-01,IRQ,Sabah,0,0,0
2022-11-01,IRQ,Sarawak,0,0,0
2022-11-01,IRQ,Selangor,939,732,207
2022-11-01,ISL,Johor,6,1,5
2022-11-01,ISL,Kedah,1,1,0
2022-11-01,ISL,Kelantan,0,0,0
2022-11-01,ISL,Perak,0,0,0
2022-11-01,ISL,Perlis,1,1,0
2022-11-01,ISL,Pulau Pinang,3,1,2
2022-11-01,ISL,Sabah,0,0,0
2022-11-01,ISL,Sarawak,1,0,1
2022-11-01,ISL,Selangor,26,19,7
2022-11-01,ISL,W.P. Labuan,0,0,0
2022-11-01,ISR,Pulau Pinang,1,1,0
2022-11-01,ITA,Johor,444,346,98
2022-11-01,ITA,Kedah,98,59,39
2022-11-01,ITA,Kelantan,5,4,1
2022-11-01,ITA,Melaka,1,1,0
2022-11-01,ITA,Negeri Sembilan,0,0,0
2022-11-01,ITA,Pahang,0,0,0
2022-11-01,ITA,Perak,3,3,0
2022-11-01,ITA,Perlis,13,10,3
2022-11-01,ITA,Pulau Pinang,73,59,14
2022-11-01,ITA,Sabah,28,21,7
2022-11-01,ITA,Sarawak,120,80,40
2022-11-01,ITA,Selangor,1756,1288,468
2022-11-01,ITA,W.P. Labuan,0,0,0
2022-11-01,JAM,Johor,4,3,1
2022-11-01,JAM,Kedah,0,0,0
2022-11-01,JAM,Perak,0,0,0
2022-11-01,JAM,Pulau Pinang,1,1,0
2022-11-01,JAM,Sabah,0,0,0
2022-11-01,JAM,Sarawak,0,0,0
2022-11-01,JAM,Selangor,16,9,7
2022-11-01,JAM,W.P. Labuan,0,0,0
2022-11-01,JOR,Johor,12,8,4
2022-11-01,JOR,Kedah,0,0,0
2022-11-01,JOR,Kelantan,0,0,0
2022-11-01,JOR,Melaka,0,0,0
2022-11-01,JOR,Perlis,1,1,0
2022-11-01,JOR,Pulau Pinang,1,1,0
2022-11-01,JOR,Sabah,0,0,0
2022-11-01,JOR,Sarawak,3,3,0
2022-11-01,JOR,Selangor,600,374,226
2022-11-01,JOR,W.P. Labuan,0,0,0
2022-11-01,JPN,Johor,4561,3295,1266
2022-11-01,JPN,Kedah,200,107,93
2022-11-01,JPN,Kelantan,6,3,3
2022-11-01,JPN,Melaka,1,0,1
2022-11-01,JPN,Negeri Sembilan,0,0,0
2022-11-01,JPN,Pahang,0,0,0
2022-11-01,JPN,Perak,43,31,12
2022-11-01,JPN,Perlis,38,27,11
2022-11-01,JPN,Pulau Pinang,913,726,187
2022-11-01,JPN,Sabah,157,98,59
2022-11-01,JPN,Sarawak,171,108,63
2022-11-01,JPN,Selangor,11128,7760,3368
2022-11-01,JPN,W.P. Labuan,4,3,1
2022-11-01,KAZ,Johor,49,26,23
2022-11-01,KAZ,Kedah,11,7,4
2022-11-01,KAZ,Kelantan,7,3,4
2022-11-01,KAZ,Melaka,0,0,0
2022-11-01,KAZ,Perak,1,1,0
2022-11-01,KAZ,Perlis,9,6,3
2022-11-01,KAZ,Pulau Pinang,5,4,1
2022-11-01,KAZ,Sabah,2,2,0
2022-11-01,KAZ,Sarawak,6,1,5
2022-11-01,KAZ,Selangor,431,177,254
2022-11-01,KAZ,W.P. Labuan,0,0,0
2022-11-01,KEN,Johor,62,30,32
2022-11-01,KEN,Kedah,1,1,0
2022-11-01,KEN,Kelantan,0,0,0
2022-11-01,KEN,Perak,0,0,0
2022-11-01,KEN,Perlis,0,0,0
2022-11-01,KEN,Pulau Pinang,3,1,2
2022-11-01,KEN,Sabah,1,0,1
2022-11-01,KEN,Sarawak,1,1,0
2022-11-01,KEN,Selangor,278,144,134
2022-11-01,KGZ,Johor,17,9,8
2022-11-01,KGZ,Kedah,0,0,0
2022-11-01,KGZ,Kelantan,0,0,0
2022-11-01,KGZ,Perak,0,0,0
2022-11-01,KGZ,Perlis,0,0,0
2022-11-01,KGZ,Pulau Pinang,0,0,0
2022-11-01,KGZ,Sabah,0,0,0
2022-11-01,KGZ,Sarawak,1,0,1
2022-11-01,KGZ,Selangor,127,68,59
2022-11-01,KHM,Johor,2587,1117,1470
2022-11-01,KHM,Kedah,308,259,49
2022-11-01,KHM,Kelantan,428,235,193
2022-11-01,KHM,Melaka,0,0,0
2022-11-01,KHM,Negeri Sembilan,0,0,0
2022-11-01,KHM,Pahang,0,0,0
2022-11-01,KHM,Perak,7,6,1
2022-11-01,KHM,Perlis,760,513,247
2022-11-01,KHM,Pulau Pinang,26,11,15
2022-11-01,KHM,Sabah,0,0,0
2022-11-01,KHM,Sarawak,8,4,4
2022-11-01,KHM,Selangor,4934,2349,2585
2022-11-01,KHM,W.P. Labuan,0,0,0
2022-11-01,KIR,Johor,0,0,0
2022-11-01,KIR,Sabah,1,0,1
2022-11-01,KIR,Selangor,3,2,1
2022-11-01,KNA,Johor,16,10,6
2022-11-01,KNA,Kedah,0,0,0
2022-11-01,KNA,Perlis,0,0,0
2022-11-01,KNA,Pulau Pinang,1,1,0
2022-11-01,KNA,Sabah,1,0,1
2022-11-01,KNA,Selangor,39,28,11
2022-11-01,KNA,W.P. Labuan,0,0,0
2022-11-01,KOR,Johor,6743,3831,2912
2022-11-01,KOR,Kedah,141,68,73
2022-11-01,KOR,Kelantan,0,0,0
2022-11-01,KOR,Melaka,4,3,1
2022-11-01,KOR,Negeri Sembilan,0,0,0
2022-11-01,KOR,Pahang,1,1,0
2022-11-01,KOR,Perak,18,10,8
2022-11-01,KOR,Perlis,52,35,17
2022-11-01,KOR,Pulau Pinang,360,233,127
2022-11-01,KOR,Sabah,9595,4219,5376
2022-11-01,KOR,Sarawak,133,83,50
2022-11-01,KOR,Selangor,8143,4862,3281
2022-11-01,KOR,Terengganu,0,0,0
2022-11-01,KOR,W.P. Labuan,2,2,0
2022-11-01,KWT,Johor,14,7,7
2022-11-01,KWT,Kedah,2,1,1
2022-11-01,KWT,Kelantan,0,0,0
2022-11-01,KWT,Perak,0,0,0
2022-11-01,KWT,Perlis,0,0,0
2022-11-01,KWT,Pulau Pinang,0,0,0
2022-11-01,KWT,Sabah,1,0,1
2022-11-01,KWT,Sarawak,5,3,2
2022-11-01,KWT,Selangor,306,203,103
2022-11-01,KWT,W.P. Labuan,0,0,0
2022-11-01,LAO,Johor,135,34,101
2022-11-01,LAO,Kedah,747,51,696
2022-11-01,LAO,Kelantan,104,9,95
2022-11-01,LAO,Melaka,0,0,0
2022-11-01,LAO,Perak,6,1,5
2022-11-01,LAO,Perlis,246,74,172
2022-11-01,LAO,Pulau Pinang,18,5,13
2022-11-01,LAO,Sabah,3,1,2
2022-11-01,LAO,Sarawak,3,1,2
2022-11-01,LAO,Selangor,246,90,156
2022-11-01,LAO,W.P. Labuan,0,0,0
2022-11-01,LBN,Johor,7,7,0
2022-11-01,LBN,Kedah,0,0,0
2022-11-01,LBN,Kelantan,0,0,0
2022-11-01,LBN,Pahang,0,0,0
2022-11-01,LBN,Perak,0,0,0
2022-11-01,LBN,Perlis,0,0,0
2022-11-01,LBN,Pulau Pinang,2,1,1
2022-11-01,LBN,Sabah,0,0,0
2022-11-01,LBN,Sarawak,2,2,0
2022-11-01,LBN,Selangor,178,125,53
2022-11-01,LBN,W.P. Labuan,0,0,0
2022-11-01,LBR,Johor,0,0,0
2022-11-01,LBR,Kedah,0,0,0
2022-11-01,LBR,Sabah,0,0,0
2022-11-01,LBR,Sarawak,0,0,0
2022-11-01,LBR,Selangor,4,3,1
2022-11-01,LBY,Johor,2,0,2
2022-11-01,LBY,Kedah,0,0,0
2022-11-01,LBY,Perlis,0,0,0
2022-11-01,LBY,Pulau Pinang,1,1,0
2022-11-01,LBY,Sabah,1,1,0
2022-11-01,LBY,Sarawak,4,2,2
2022-11-01,LBY,Selangor,251,173,78
2022-11-01,LCA,Johor,6,6,0
2022-11-01,LCA,Kedah,0,0,0
2022-11-01,LCA,Pulau Pinang,0,0,0
2022-11-01,LCA,Sarawak,0,0,0
2022-11-01,LCA,Selangor,5,4,1
2022-11-01,LIE,Johor,3,2,1
2022-11-01,LIE,Kedah,0,0,0
2022-11-01,LIE,Perlis,0,0,0
2022-11-01,LIE,Pulau Pinang,3,2,1
2022-11-01,LIE,Sabah,0,0,0
2022-11-01,LIE,Sarawak,0,0,0
2022-11-01,LIE,Selangor,4,3,1
2022-11-01,LKA,Johor,773,509,264
2022-11-01,LKA,Kedah,19,11,8
2022-11-01,LKA,Kelantan,0,0,0
2022-11-01,LKA,Melaka,0,0,0
2022-11-01,LKA,Pahang,0,0,0
2022-11-01,LKA,Perak,1,1,0
2022-11-01,LKA,Perlis,0,0,0
2022-11-01,LKA,Pulau Pinang,9,9,0
2022-11-01,LKA,Sabah,0,0,0
2022-11-01,LKA,Sarawak,17,12,5
2022-11-01,LKA,Selangor,3272,2140,1132
2022-11-01,LKA,W.P. Labuan,0,0,0
2022-11-01,LSO,Johor,1,1,0
2022-11-01,LSO,Kedah,0,0,0
2022-11-01,LSO,Pulau Pinang,0,0,0
2022-11-01,LSO,Sarawak,0,0,0
2022-11-01,LSO,Selangor,5,2,3
2022-11-01,LTU,Johor,44,20,24
2022-11-01,LTU,Kedah,6,3,3
2022-11-01,LTU,Kelantan,0,0,0
2022-11-01,LTU,Pahang,0,0,0
2022-11-01,LTU,Perak,0,0,0
2022-11-01,LTU,Perlis,5,4,1
2022-11-01,LTU,Pulau Pinang,6,4,2
2022-11-01,LTU,Sabah,1,1,0
2022-11-01,LTU,Sarawak,5,3,2
2022-11-01,LTU,Selangor,220,118,102
2022-11-01,LTU,W.P. Labuan,0,0,0
2022-11-01,LUX,Johor,11,3,8
2022-11-01,LUX,Kedah,1,1,0
2022-11-01,LUX,Kelantan,0,0,0
2022-11-01,LUX,Perak,0,0,0
2022-11-01,LUX,Perlis,0,0,0
2022-11-01,LUX,Pulau Pinang,2,1,1
2022-11-01,LUX,Sabah,0,0,0
2022-11-01,LUX,Sarawak,1,0,1
2022-11-01,LUX,Selangor,29,16,13
2022-11-01,LVA,Johor,15,12,3
2022-11-01,LVA,Kedah,1,0,1
2022-11-01,LVA,Kelantan,0,0,0
2022-11-01,LVA,Pahang,0,0,0
2022-11-01,LVA,Perak,0,0,0
2022-11-01,LVA,Perlis,0,0,0
2022-11-01,LVA,Pulau Pinang,1,1,0
2022-11-01,LVA,Sabah,1,0,1
2022-11-01,LVA,Sarawak,7,3,4
2022-11-01,LVA,Selangor,106,51,55
2022-11-01,LVA,W.P. Labuan,0,0,0
2022-11-01,MAC,Johor,0,0,0
2022-11-01,MAC,Pahang,0,0,0
2022-11-01,MAC,Perak,1,0,1
2022-11-01,MAC,Selangor,0,0,0
2022-11-01,MAC,W.P. Labuan,1,1,0
2022-11-01,MAR,Johor,64,43,21
2022-11-01,MAR,Kedah,5,3,2
2022-11-01,MAR,Kelantan,0,0,0
2022-11-01,MAR,Melaka,0,0,0
2022-11-01,MAR,Pahang,0,0,0
2022-11-01,MAR,Perak,0,0,0
2022-11-01,MAR,Perlis,1,1,0
2022-11-01,MAR,Pulau Pinang,13,7,6
2022-11-01,MAR,Sabah,1,0,1
2022-11-01,MAR,Sarawak,3,2,1
2022-11-01,MAR,Selangor,491,284,207
2022-11-01,MAR,W.P. Labuan,0,0,0
2022-11-01,MCO,Johor,1,1,0
2022-11-01,MCO,Kedah,0,0,0
2022-11-01,MCO,Sabah,0,0,0
2022-11-01,MCO,Selangor,3,0,3
2022-11-01,MDA,Johor,1,1,0
2022-11-01,MDA,Kedah,2,1,1
2022-11-01,MDA,Kelantan,0,0,0
2022-11-01,MDA,Negeri Sembilan,0,0,0
2022-11-01,MDA,Perlis,0,0,0
2022-11-01,MDA,Pulau Pinang,0,0,0
2022-11-01,MDA,Sabah,1,0,1
2022-11-01,MDA,Sarawak,1,0,1
2022-11-01,MDA,Selangor,41,23,18
2022-11-01,MDG,Johor,10,2,8
2022-11-01,MDG,Kedah,0,0,0
2022-11-01,MDG,Perak,0,0,0
2022-11-01,MDG,Perlis,0,0,0
2022-11-01,MDG,Pulau Pinang,1,0,1
2022-11-01,MDG,Sabah,0,0,0
2022-11-01,MDG,Sarawak,0,0,0
2022-11-01,MDG,Selangor,43,13,30
2022-11-01,MDV,Johor,122,67,55
2022-11-01,MDV,Kedah,2,1,1
2022-11-01,MDV,Kelantan,0,0,0
2022-11-01,MDV,Perak,0,0,0
2022-11-01,MDV,Perlis,3,3,0
2022-11-01,MDV,Pulau Pinang,8,8,0
2022-11-01,MDV,Sabah,0,0,0
2022-11-01,MDV,Sarawak,1,1,0
2022-11-01,MDV,Selangor,1739,913,826
2022-11-01,MEX,Johor,95,53,42
2022-11-01,MEX,Kedah,10,3,7
2022-11-01,MEX,Kelantan,0,0,0
2022-11-01,MEX,Pahang,0,0,0
2022-11-01,MEX,Perak,0,0,0
2022-11-01,MEX,Perlis,0,0,0
2022-11-01,MEX,Pulau Pinang,37,26,11
2022-11-01,MEX,Sabah,1,0,1
2022-11-01,MEX,Sarawak,2,1,1
2022-11-01,MEX,Selangor,456,236,220
2022-11-01,MEX,W.P. Labuan,0,0,0
2022-11-01,MHL,Johor,0,0,0
2022-11-01,MHL,Kedah,0,0,0
2022-11-01,MHL,Perak,0,0,0
2022-11-01,MHL,Pulau Pinang,0,0,0
2022-11-01,MHL,Sabah,0,0,0
2022-11-01,MHL,Selangor,4,3,1
2022-11-01,MKD,Johor,7,4,3
2022-11-01,MKD,Kedah,0,0,0
2022-11-01,MKD,Perak,0,0,0
2022-11-01,MKD,Pulau Pinang,0,0,0
2022-11-01,MKD,Sabah,0,0,0
2022-11-01,MKD,Sarawak,0,0,0
2022-11-01,MKD,Selangor,17,14,3
2022-11-01,MLI,Johor,0,0,0
2022-11-01,MLI,Sabah,0,0,0
2022-11-01,MLI,Selangor,3,3,0
2022-11-01,MLT,Johor,6,2,4
2022-11-01,MLT,Kedah,3,2,1
2022-11-01,MLT,Kelantan,0,0,0
2022-11-01,MLT,Perak,0,0,0
2022-11-01,MLT,Perlis,0,0,0
2022-11-01,MLT,Pulau Pinang,39,22,17
2022-11-01,MLT,Sabah,1,1,0
2022-11-01,MLT,Sarawak,0,0,0
2022-11-01,MLT,Selangor,34,21,13
2022-11-01,MLT,W.P. Labuan,0,0,0
2022-11-01,MMR,Johor,3107,895,2212
2022-11-01,MMR,Kedah,40,9,31
2022-11-01,MMR,Kelantan,1,1,0
2022-11-01,MMR,Negeri Sembilan,0,0,0
2022-11-01,MMR,Pahang,0,0,0
2022-11-01,MMR,Perak,21,4,17
2022-11-01,MMR,Perlis,6,0,6
2022-11-01,MMR,Pulau Pinang,172,89,83
2022-11-01,MMR,Sabah,17,3,14
2022-11-01,MMR,Sarawak,74,33,41
2022-11-01,MMR,Selangor,8499,6288,2211
2022-11-01,MMR,Terengganu,0,0,0
2022-11-01,MMR,W.P. Labuan,0,0,0
2022-11-01,MNE,Johor,1,1,0
2022-11-01,MNE,Kedah,0,0,0
2022-11-01,MNE,Pulau Pinang,0,0,0
2022-11-01,MNE,Sabah,0,0,0
2022-11-01,MNE,Sarawak,0,0,0
2022-11-01,MNE,Selangor,10,10,0
2022-11-01,MNG,Johor,119,62,57
2022-11-01,MNG,Kedah,3,1,2
2022-11-01,MNG,Kelantan,0,0,0
2022-11-01,MNG,Perak,1,0,1
2022-11-01,MNG,Perlis,8,6,2
2022-11-01,MNG,Pulau Pinang,1,0,1
2022-11-01,MNG,Sabah,3,2,1
2022-11-01,MNG,Sarawak,2,2,0
2022-11-01,MNG,Selangor,263,115,148
2022-11-01,MNP,Selangor,0,0,0
2022-11-01,MOZ,Johor,0,0,0
2022-11-01,MOZ,Kedah,0,0,0
2022-11-01,MOZ,Perak,0,0,0
2022-11-01,MOZ,Pulau Pinang,0,0,0
2022-11-01,MOZ,Sabah,0,0,0
2022-11-01,MOZ,Sarawak,0,0,0
2022-11-01,MOZ,Selangor,14,10,4
2022-11-01,MRT,Johor,2,2,0
2022-11-01,MRT,Kedah,0,0,0
2022-11-01,MRT,Pulau Pinang,0,0,0
2022-11-01,MRT,Sabah,0,0,0
2022-11-01,MRT,Sarawak,0,0,0
2022-11-01,MRT,Selangor,24,22,2
2022-11-01,MUS,Johor,175,100,75
2022-11-01,MUS,Kedah,3,1,2
2022-11-01,MUS,Kelantan,0,0,0
2022-11-01,MUS,Pahang,0,0,0
2022-11-01,MUS,Perak,3,1,2
2022-11-01,MUS,Perlis,0,0,0
2022-11-01,MUS,Pulau Pinang,13,9,4
2022-11-01,MUS,Sabah,0,0,0
2022-11-01,MUS,Sarawak,0,0,0
2022-11-01,MUS,Selangor,2044,1015,1029
2022-11-01,MWI,Johor,0,0,0
2022-11-01,MWI,Pulau Pinang,0,0,0
2022-11-01,MWI,Sabah,1,0,1
2022-11-01,MWI,Sarawak,2,0,2
2022-11-01,MWI,Selangor,37,19,18
2022-11-01,MYT,Selangor,0,0,0
2022-11-01,NAM,Johor,0,0,0
2022-11-01,NAM,Kedah,1,0,1
2022-11-01,NAM,Perak,0,0,0
2022-11-01,NAM,Perlis,1,0,1
2022-11-01,NAM,Pulau Pinang,0,0,0
2022-11-01,NAM,Sabah,0,0,0
2022-11-01,NAM,Sarawak,0,0,0
2022-11-01,NAM,Selangor,12,5,7
2022-11-01,NCL,Selangor,0,0,0
2022-11-01,NER,Johor,0,0,0
2022-11-01,NER,Sabah,0,0,0
2022-11-01,NER,Selangor,0,0,0
2022-11-01,NGA,Johor,36,30,6
2022-11-01,NGA,Kedah,2,2,0
2022-11-01,NGA,Perlis,0,0,0
2022-11-01,NGA,Pulau Pinang,2,2,0
2022-11-01,NGA,Sabah,0,0,0
2022-11-01,NGA,Sarawak,4,2,2
2022-11-01,NGA,Selangor,469,383,86
2022-11-01,NIC,Johor,0,0,0
2022-11-01,NIC,Kedah,0,0,0
2022-11-01,NIC,Pulau Pinang,1,1,0
2022-11-01,NIC,Sabah,0,0,0
2022-11-01,NIC,Selangor,10,3,7
2022-11-01,NLD,Johor,777,537,240
2022-11-01,NLD,Kedah,204,101,103
2022-11-01,NLD,Kelantan,0,0,0
2022-11-01,NLD,Melaka,3,2,1
2022-11-01,NLD,Negeri Sembilan,4,3,1
2022-11-01,NLD,Pahang,0,0,0
2022-11-01,NLD,Perak,10,3,7
2022-11-01,NLD,Perlis,31,18,13
2022-11-01,NLD,Pulau Pinang,181,124,57
2022-11-01,NLD,Sabah,43,25,18
2022-11-01,NLD,Sarawak,120,76,44
2022-11-01,NLD,Selangor,3078,1885,1193
2022-11-01,NLD,Terengganu,0,0,0
2022-11-01,NLD,W.P. Labuan,0,0,0
2022-11-01,NOR,Johor,97,64,33
2022-11-01,NOR,Kedah,20,13,7
2022-11-01,NOR,Kelantan,0,0,0
2022-11-01,NOR,Melaka,0,0,0
2022-11-01,NOR,Pahang,0,0,0
2022-11-01,NOR,Perak,0,0,0
2022-11-01,NOR,Perlis,11,7,4
2022-11-01,NOR,Pulau Pinang,16,11,5
2022-11-01,NOR,Sabah,14,9,5
2022-11-01,NOR,Sarawak,9,9,0
2022-11-01,NOR,Selangor,561,375,186
2022-11-01,NOR,W.P. Labuan,0,0,0
2022-11-01,NPL,Johor,145,113,32
2022-11-01,NPL,Kedah,3,3,0
2022-11-01,NPL,Pahang,0,0,0
2022-11-01,NPL,Perak,0,0,0
2022-11-01,NPL,Perlis,0,0,0
2022-11-01,NPL,Pulau Pinang,14,14,0
2022-11-01,NPL,Sabah,8,3,5
2022-11-01,NPL,Sarawak,200,136,64
2022-11-01,NPL,Selangor,29515,28227,1288
2022-11-01,NPL,W.P. Labuan,59,56,3
2022-11-01,NRU,Johor,0,0,0
2022-11-01,NRU,Pulau Pinang,0,0,0
2022-11-01,NRU,Selangor,5,4,1
2022-11-01,NZL,Johor,627,350,277
2022-11-01,NZL,Kedah,55,31,24
2022-11-01,NZL,Kelantan,0,0,0
2022-11-01,NZL,Melaka,0,0,0
2022-11-01,NZL,Negeri Sembilan,0,0,0
2022-11-01,NZL,Pahang,0,0,0
2022-11-01,NZL,Perak,13,9,4
2022-11-01,NZL,Perlis,13,10,3
2022-11-01,NZL,Pulau Pinang,140,83,57
2022-11-01,NZL,Sabah,31,20,11
2022-11-01,NZL,Sarawak,86,54,32
2022-11-01,NZL,Selangor,2223,1325,898
2022-11-01,NZL,Terengganu,0,0,0
2022-11-01,NZL,W.P. Labuan,0,0,0
2022-11-01,OMN,Johor,43,28,15
2022-11-01,OMN,Kedah,1,1,0
2022-11-01,OMN,Kelantan,0,0,0
2022-11-01,OMN,Melaka,0,0,0
2022-11-01,OMN,Perak,0,0,0
2022-11-01,OMN,Perlis,0,0,0
2022-11-01,OMN,Pulau Pinang,6,5,1
2022-11-01,OMN,Sabah,2,0,2
2022-11-01,OMN,Sarawak,12,7,5
2022-11-01,OMN,Selangor,591,390,201
2022-11-01,PAK,Johor,828,630,198
2022-11-01,PAK,Kedah,112,94,18
2022-11-01,PAK,Kelantan,8,7,1
2022-11-01,PAK,Melaka,0,0,0
2022-11-01,PAK,Negeri Sembilan,0,0,0
2022-11-01,PAK,Pahang,0,0,0
2022-11-01,PAK,Perak,36,36,0
2022-11-01,PAK,Perlis,22,21,1
2022-11-01,PAK,Pulau Pinang,31,27,4
2022-11-01,PAK,Sabah,4,4,0
2022-11-01,PAK,Sarawak,91,73,18
2022-11-01,PAK,Selangor,9096,7952,1144
2022-11-01,PAK,W.P. Labuan,3,3,0
2022-11-01,PAN,Johor,4,1,3
2022-11-01,PAN,Kedah,0,0,0
2022-11-01,PAN,Perak,0,0,0
2022-11-01,PAN,Perlis,0,0,0
2022-11-01,PAN,Pulau Pinang,0,0,0
2022-11-01,PAN,Sabah,0,0,0
2022-11-01,PAN,Sarawak,1,1,0
2022-11-01,PAN,Selangor,20,8,12
2022-11-01,PER,Johor,20,11,9
2022-11-01,PER,Kedah,1,1,0
2022-11-01,PER,Kelantan,0,0,0
2022-11-01,PER,Pahang,0,0,0
2022-11-01,PER,Perak,0,0,0
2022-11-01,PER,Perlis,1,0,1
2022-11-01,PER,Pulau Pinang,0,0,0
2022-11-01,PER,Sabah,0,0,0
2022-11-01,PER,Sarawak,0,0,0
2022-11-01,PER,Selangor,100,49,51
2022-11-01,PER,W.P. Labuan,0,0,0
2022-11-01,PHL,Johor,16889,5358,11531
2022-11-01,PHL,Kedah,432,165,267
2022-11-01,PHL,Kelantan,23,10,13
2022-11-01,PHL,Melaka,1,0,1
2022-11-01,PHL,Negeri Sembilan,1,1,0
2022-11-01,PHL,Pahang,1,1,0
2022-11-01,PHL,Perak,62,23,39
2022-11-01,PHL,Perlis,103,36,67
2022-11-01,PHL,Pulau Pinang,383,131,252
2022-11-01,PHL,Sabah,1243,551,692
2022-11-01,PHL,Sarawak,1160,451,709
2022-11-01,PHL,Selangor,15381,5931,9450
2022-11-01,PHL,Terengganu,1,1,0
2022-11-01,PHL,W.P. Labuan,86,29,57
2022-11-01,PLW,Johor,1,1,0
2022-11-01,PLW,Pulau Pinang,0,0,0
2022-11-01,PLW,Selangor,0,0,0
2022-11-01,PNG,Johor,13,6,7
2022-11-01,PNG,Kedah,0,0,0
2022-11-01,PNG,Kelantan,0,0,0
2022-11-01,PNG,Perak,0,0,0
2022-11-01,PNG,Pulau Pinang,0,0,0
2022-11-01,PNG,Sabah,0,0,0
2022-11-01,PNG,Sarawak,3,1,2
2022-11-01,PNG,Selangor,42,25,17
2022-11-01,POL,Johor,338,176,162
2022-11-01,POL,Kedah,94,47,47
2022-11-01,POL,Kelantan,1,1,0
2022-11-01,POL,Melaka,0,0,0
2022-11-01,POL,Negeri Sembilan,0,0,0
2022-11-01,POL,Pahang,0,0,0
2022-11-01,POL,Perak,5,4,1
2022-11-01,POL,Perlis,11,7,4
2022-11-01,POL,Pulau Pinang,128,74,54
2022-11-01,POL,Sabah,36,23,13
2022-11-01,POL,Sarawak,53,19,34
2022-11-01,POL,Selangor,1235,669,566
2022-11-01,POL,Terengganu,0,0,0
2022-11-01,POL,W.P. Labuan,8,4,4
2022-11-01,PRK,Selangor,0,0,0
2022-11-01,PRT,Johor,129,78,51
2022-11-01,PRT,Kedah,14,8,6
2022-11-01,PRT,Kelantan,0,0,0
2022-11-01,PRT,Melaka,0,0,0
2022-11-01,PRT,Pahang,0,0,0
2022-11-01,PRT,Perak,2,2,0
2022-11-01,PRT,Perlis,4,3,1
2022-11-01,PRT,Pulau Pinang,25,17,8
2022-11-01,PRT,Sabah,8,4,4
2022-11-01,PRT,Sarawak,9,8,1
2022-11-01,PRT,Selangor,568,344,224
2022-11-01,PRT,W.P. Labuan,1,0,1
2022-11-01,PRY,Johor,0,0,0
2022-11-01,PRY,Kedah,0,0,0
2022-11-01,PRY,Perak,0,0,0
2022-11-01,PRY,Perlis,0,0,0
2022-11-01,PRY,Pulau Pinang,0,0,0
2022-11-01,PRY,Sabah,0,0,0
2022-11-01,PRY,Sarawak,0,0,0
2022-11-01,PRY,Selangor,6,4,2
2022-11-01,PSE,Johor,2,2,0
2022-11-01,PSE,Kedah,1,1,0
2022-11-01,PSE,Kelantan,0,0,0
2022-11-01,PSE,Melaka,0,0,0
2022-11-01,PSE,Perak,0,0,0
2022-11-01,PSE,Perlis,2,2,0
2022-11-01,PSE,Pulau Pinang,2,2,0
2022-11-01,PSE,Sabah,0,0,0
2022-11-01,PSE,Sarawak,7,5,2
2022-11-01,PSE,Selangor,254,172,82
2022-11-01,QAT,Johor,18,14,4
2022-11-01,QAT,Kedah,0,0,0
2022-11-01,QAT,Perlis,0,0,0
2022-11-01,QAT,Pulau Pinang,4,3,1
2022-11-01,QAT,Sabah,0,0,0
2022-11-01,QAT,Sarawak,5,3,2
2022-11-01,QAT,Selangor,65,34,31
2022-11-01,REU,Johor,0,0,0
2022-11-01,REU,Sarawak,0,0,0
2022-11-01,ROU,Johor,93,53,40
2022-11-01,ROU,Kedah,13,6,7
2022-11-01,ROU,Kelantan,0,0,0
2022-11-01,ROU,Negeri Sembilan,0,0,0
2022-11-01,ROU,Pahang,0,0,0
2022-11-01,ROU,Perak,2,0,2
2022-11-01,ROU,Perlis,3,2,1
2022-11-01,ROU,Pulau Pinang,24,15,9
2022-11-01,ROU,Sabah,4,2,2
2022-11-01,ROU,Sarawak,3,2,1
2022-11-01,ROU,Selangor,536,284,252
2022-11-01,ROU,W.P. Labuan,0,0,0
2022-11-01,RUS,Johor,292,151,141
2022-11-01,RUS,Kedah,291,169,122
2022-11-01,RUS,Kelantan,57,34,23
2022-11-01,RUS,Melaka,0,0,0
2022-11-01,RUS,Negeri Sembilan,0,0,0
2022-11-01,RUS,Pahang,0,0,0
2022-11-01,RUS,Perak,2,0,2
2022-11-01,RUS,Perlis,517,320,197
2022-11-01,RUS,Pulau Pinang,321,180,141
2022-11-01,RUS,Sabah,15,9,6
2022-11-01,RUS,Sarawak,46,22,24
2022-11-01,RUS,Selangor,7928,4540,3388
2022-11-01,RUS,W.P. Labuan,3,1,2
2022-11-01,RWA,Johor,2,2,0
2022-11-01,RWA,Kedah,0,0,0
2022-11-01,RWA,Pulau Pinang,0,0,0
2022-11-01,RWA,Selangor,9,3,6
2022-11-01,SAU,Johor,101,59,42
2022-11-01,SAU,Kedah,11,6,5
2022-11-01,SAU,Kelantan,0,0,0
2022-11-01,SAU,Melaka,0,0,0
2022-11-01,SAU,Perak,0,0,0
2022-11-01,SAU,Perlis,6,6,0
2022-11-01,SAU,Pulau Pinang,2,2,0
2022-11-01,SAU,Sabah,0,0,0
2022-11-01,SAU,Sarawak,27,19,8
2022-11-01,SAU,Selangor,3877,2132,1745
2022-11-01,SAU,W.P. Labuan,0,0,0
2022-11-01,SDN,Johor,9,5,4
2022-11-01,SDN,Kedah,0,0,0
2022-11-01,SDN,Kelantan,0,0,0
2022-11-01,SDN,Perlis,1,0,1
2022-11-01,SDN,Pulau Pinang,2,1,1
2022-11-01,SDN,Sabah,0,0,0
2022-11-01,SDN,Sarawak,4,4,0
2022-11-01,SDN,Selangor,784,470,314
2022-11-01,SDN,W.P. Labuan,1,1,0
2022-11-01,SEN,Johor,1,1,0
2022-11-01,SEN,Kedah,0,0,0
2022-11-01,SEN,Kelantan,0,0,0
2022-11-01,SEN,Perak,0,0,0
2022-11-01,SEN,Perlis,0,0,0
2022-11-01,SEN,Pulau Pinang,0,0,0
2022-11-01,SEN,Sabah,0,0,0
2022-11-01,SEN,Sarawak,0,0,0
2022-11-01,SEN,Selangor,19,13,6
2022-11-01,SGP,Johor,1005465,577797,427668
2022-11-01,SGP,Kedah,4114,2177,1937
2022-11-01,SGP,Kelantan,32,18,14
2022-11-01,SGP,Melaka,15,14,1
2022-11-01,SGP,Negeri Sembilan,4,3,1
2022-11-01,SGP,Pahang,35,12,23
2022-11-01,SGP,Perak,5710,2658,3052
2022-11-01,SGP,Perlis,229,136,93
2022-11-01,SGP,Pulau Pinang,15815,7828,7987
2022-11-01,SGP,Sabah,3584,1811,1773
2022-11-01,SGP,Sarawak,3972,2178,1794
2022-11-01,SGP,Selangor,53185,26212,26973
2022-11-01,SGP,Terengganu,0,0,0
2022-11-01,SGP,W.P. Labuan,23,18,5
2022-11-01,SGS,Johor,0,0,0
2022-11-01,SGS,Sabah,0,0,0
2022-11-01,SGS,Selangor,0,0,0
2022-11-01,SHN,Sarawak,0,0,0
2022-11-01,SLB,Johor,1,1,0
2022-11-01,SLB,Perlis,0,0,0
2022-11-01,SLB,Pulau Pinang,0,0,0
2022-11-01,SLB,Sabah,0,0,0
2022-11-01,SLB,Sarawak,6,3,3
2022-11-01,SLB,Selangor,13,6,7
2022-11-01,SLB,W.P. Labuan,0,0,0
2022-11-01,SLE,Johor,1,0,1
2022-11-01,SLE,Kedah,0,0,0
2022-11-01,SLE,Perak,0,0,0
2022-11-01,SLE,Pulau Pinang,1,1,0
2022-11-01,SLE,Sabah,0,0,0
2022-11-01,SLE,Selangor,23,19,4
2022-11-01,SLV,Johor,6,4,2
2022-11-01,SLV,Kedah,1,1,0
2022-11-01,SLV,Perak,0,0,0
2022-11-01,SLV,Perlis,0,0,0
2022-11-01,SLV,Pulau Pinang,0,0,0
2022-11-01,SLV,Sabah,0,0,0
2022-11-01,SLV,Selangor,14,7,7
2022-11-01,SLV,W.P. Labuan,0,0,0
2022-11-01,SMR,Johor,0,0,0
2022-11-01,SMR,Selangor,0,0,0
2022-11-01,SOM,Johor,0,0,0
2022-11-01,SOM,Kedah,0,0,0
2022-11-01,SOM,Kelantan,0,0,0
2022-11-01,SOM,Perlis,0,0,0
2022-11-01,SOM,Sabah,0,0,0
2022-11-01,SOM,Sarawak,1,1,0
2022-11-01,SOM,Selangor,247,156,91
2022-11-01,SRB,Johor,9,9,0
2022-11-01,SRB,Kedah,0,0,0
2022-11-01,SRB,Kelantan,0,0,0
2022-11-01,SRB,Pahang,0,0,0
2022-11-01,SRB,Perak,0,0,0
2022-11-01,SRB,Perlis,0,0,0
2022-11-01,SRB,Pulau Pinang,2,1,1
2022-11-01,SRB,Sabah,0,0,0
2022-11-01,SRB,Sarawak,0,0,0
2022-11-01,SRB,Selangor,54,32,22
2022-11-01,SSD,Johor,1,0,1
2022-11-01,SSD,Kedah,0,0,0
2022-11-01,SSD,Sarawak,0,0,0
2022-11-01,SSD,Selangor,30,19,11
2022-11-01,SSD,W.P. Labuan,0,0,0
2022-11-01,STP,Selangor,2,0,2
2022-11-01,SUR,Johor,3,1,2
2022-11-01,SUR,Kedah,1,1,0
2022-11-01,SUR,Kelantan,0,0,0
2022-11-01,SUR,Perak,0,0,0
2022-11-01,SUR,Perlis,0,0,0
2022-11-01,SUR,Pulau Pinang,1,1,0
2022-11-01,SUR,Sabah,0,0,0
2022-11-01,SUR,Sarawak,0,0,0
2022-11-01,SUR,Selangor,9,6,3
2022-11-01,SVK,Johor,25,16,9
2022-11-01,SVK,Kedah,56,29,27
2022-11-01,SVK,Kelantan,0,0,0
2022-11-01,SVK,Negeri Sembilan,0,0,0
2022-11-01,SVK,Pahang,0,0,0
2022-11-01,SVK,Perak,0,0,0
2022-11-01,SVK,Perlis,3,2,1
2022-11-01,SVK,Pulau Pinang,12,8,4
2022-11-01,SVK,Sabah,4,1,3
2022-11-01,SVK,Sarawak,1,1,0
2022-11-01,SVK,Selangor,254,141,113
2022-11-01,SVK,W.P. Labuan,0,0,0
2022-11-01,SVN,Johor,8,5,3
2022-11-01,SVN,Kedah,11,5,6
2022-11-01,SVN,Kelantan,0,0,0
2022-11-01,SVN,Perak,0,0,0
2022-11-01,SVN,Perlis,1,0,1
2022-11-01,SVN,Pulau Pinang,4,2,2
2022-11-01,SVN,Sabah,0,0,0
2022-11-01,SVN,Sarawak,0,0,0
2022-11-01,SVN,Selangor,70,44,26
2022-11-01,SVN,W.P. Labuan,0,0,0
2022-11-01,SWE,Johor,236,144,92
2022-11-01,SWE,Kedah,136,66,70
2022-11-01,SWE,Kelantan,5,1,4
2022-11-01,SWE,Melaka,0,0,0
2022-11-01,SWE,Negeri Sembilan,0,0,0
2022-11-01,SWE,Pahang,1,1,0
2022-11-01,SWE,Perak,4,2,2
2022-11-01,SWE,Perlis,9,7,2
2022-11-01,SWE,Pulau Pinang,69,51,18
2022-11-01,SWE,Sabah,13,7,6
2022-11-01,SWE,Sarawak,20,16,4
2022-11-01,SWE,Selangor,967,601,366
2022-11-01,SWE,W.P. Labuan,5,5,0
2022-11-01,SWZ,Johor,0,0,0
2022-11-01,SWZ,Kedah,0,0,0
2022-11-01,SWZ,Pulau Pinang,0,0,0
2022-11-01,SWZ,Sabah,0,0,0
2022-11-01,SWZ,Selangor,12,5,7
2022-11-01,SYC,Johor,1,0,1
2022-11-01,SYC,Kedah,0,0,0
2022-11-01,SYC,Pulau Pinang,4,2,2
2022-11-01,SYC,Sabah,0,0,0
2022-11-01,SYC,Sarawak,1,1,0
2022-11-01,SYC,Selangor,37,12,25
2022-11-01,SYR,Johor,5,2,3
2022-11-01,SYR,Kedah,0,0,0
2022-11-01,SYR,Kelantan,0,0,0
2022-11-01,SYR,Pahang,4,4,0
2022-11-01,SYR,Perlis,0,0,0
2022-11-01,SYR,Pulau Pinang,1,1,0
2022-11-01,SYR,Sabah,0,0,0
2022-11-01,SYR,Sarawak,1,0,1
2022-11-01,SYR,Selangor,512,332,180
2022-11-01,SYR,W.P. Labuan,0,0,0
2022-11-01,TCA,Perlis,0,0,0
2022-11-01,TCD,Johor,5,5,0
2022-11-01,TCD,Kedah,0,0,0
2022-11-01,TCD,Perlis,0,0,0
2022-11-01,TCD,Selangor,17,16,1
2022-11-01,TGO,Johor,1,0,1
2022-11-01,TGO,Perak,0,0,0
2022-11-01,TGO,Pulau Pinang,0,0,0
2022-11-01,TGO,Selangor,1,1,0
2022-11-01,THA,Johor,4704,1275,3429
2022-11-01,THA,Kedah,58809,35945,22864
2022-11-01,THA,Kelantan,32286,17194,15092
2022-11-01,THA,Melaka,32,12,20
2022-11-01,THA,Negeri Sembilan,5,1,4
2022-11-01,THA,Pahang,2,2,0
2022-11-01,THA,Perak,8321,3933,4388
2022-11-01,THA,Perlis,51813,32080,19733
2022-11-01,THA,Pulau Pinang,1764,730,1034
2022-11-01,THA,Sabah,157,35,122
2022-11-01,THA,Sarawak,221,86,135
2022-11-01,THA,Selangor,10163,4287,5876
2022-11-01,THA,Terengganu,0,0,0
2022-11-01,THA,W.P. Labuan,5,2,3
2022-11-01,TJK,Johor,0,0,0
2022-11-01,TJK,Kedah,0,0,0
2022-11-01,TJK,Perlis,0,0,0
2022-11-01,TJK,Pulau Pinang,0,0,0
2022-11-01,TJK,Sabah,2,1,1
2022-11-01,TJK,Selangor,103,73,30
2022-11-01,TKL,Selangor,0,0,0
2022-11-01,TKM,Johor,1,0,1
2022-11-01,TKM,Kedah,0,0,0
2022-11-01,TKM,Kelantan,0,0,0
2022-11-01,TKM,Perlis,0,0,0
2022-11-01,TKM,Pulau Pinang,0,0,0
2022-11-01,TKM,Sabah,1,1,0
2022-11-01,TKM,Sarawak,0,0,0
2022-11-01,TKM,Selangor,48,25,23
2022-11-01,TLS,Johor,6,6,0
2022-11-01,TLS,Kedah,0,0,0
2022-11-01,TLS,Perlis,0,0,0
2022-11-01,TLS,Pulau Pinang,0,0,0
2022-11-01,TLS,Sabah,3,2,1
2022-11-01,TLS,Sarawak,2,0,2
2022-11-01,TLS,Selangor,143,83,60
2022-11-01,TON,Johor,1,1,0
2022-11-01,TON,Pulau Pinang,2,0,2
2022-11-01,TON,Sarawak,0,0,0
2022-11-01,TON,Selangor,8,4,4
2022-11-01,TTO,Johor,5,2,3
2022-11-01,TTO,Kedah,2,1,1
2022-11-01,TTO,Pahang,0,0,0
2022-11-01,TTO,Pulau Pinang,0,0,0
2022-11-01,TTO,Sabah,0,0,0
2022-11-01,TTO,Sarawak,0,0,0
2022-11-01,TTO,Selangor,36,20,16
2022-11-01,TUN,Johor,14,8,6
2022-11-01,TUN,Kedah,3,1,2
2022-11-01,TUN,Kelantan,0,0,0
2022-11-01,TUN,Melaka,1,1,0
2022-11-01,TUN,Perak,0,0,0
2022-11-01,TUN,Perlis,1,0,1
2022-11-01,TUN,Pulau Pinang,1,1,0
2022-11-01,TUN,Sabah,0,0,0
2022-11-01,TUN,Sarawak,2,0,2
2022-11-01,TUN,Selangor,320,174,146
2022-11-01,TUN,W.P. Labuan,0,0,0
2022-11-01,TUR,Johor,275,186,89
2022-11-01,TUR,Kedah,13,10,3
2022-11-01,TUR,Kelantan,2,2,0
2022-11-01,TUR,Melaka,0,0,0
2022-11-01,TUR,Negeri Sembilan,0,0,0
2022-11-01,TUR,Pahang,0,0,0
2022-11-01,TUR,Perak,1,1,0
2022-11-01,TUR,Perlis,12,11,1
2022-11-01,TUR,Pulau Pinang,15,12,3
2022-11-01,TUR,Sabah,7,5,2
2022-11-01,TUR,Sarawak,16,9,7
2022-11-01,TUR,Selangor,883,649,234
2022-11-01,TUR,W.P. Labuan,0,0,0
2022-11-01,TUV,Selangor,0,0,0
2022-11-01,TWN,Johor,2713,1231,1482
2022-11-01,TWN,Kedah,72,42,30
2022-11-01,TWN,Kelantan,1,1,0
2022-11-01,TWN,Melaka,1,1,0
2022-11-01,TWN,Negeri Sembilan,0,0,0
2022-11-01,TWN,Pahang,0,0,0
2022-11-01,TWN,Perak,28,12,16
2022-11-01,TWN,Perlis,8,3,5
2022-11-01,TWN,Pulau Pinang,769,466,303
2022-11-01,TWN,Sabah,74,28,46
2022-11-01,TWN,Sarawak,191,83,108
2022-11-01,TWN,Selangor,5291,2922,2369
2022-11-01,TWN,W.P. Labuan,3,3,0
2022-11-01,TZA,Johor,6,3,3
2022-11-01,TZA,Kedah,0,0,0
2022-11-01,TZA,Perak,0,0,0
2022-11-01,TZA,Perlis,0,0,0
2022-11-01,TZA,Pulau Pinang,0,0,0
2022-11-01,TZA,Sabah,0,0,0
2022-11-01,TZA,Sarawak,1,1,0
2022-11-01,TZA,Selangor,143,64,79
2022-11-01,UGA,Johor,25,15,10
2022-11-01,UGA,Kedah,0,0,0
2022-11-01,UGA,Perak,0,0,0
2022-11-01,UGA,Perlis,3,3,0
2022-11-01,UGA,Pulau Pinang,0,0,0
2022-11-01,UGA,Sabah,0,0,0
2022-11-01,UGA,Sarawak,0,0,0
2022-11-01,UGA,Selangor,68,40,28
2022-11-01,UKR,Johor,80,39,41
2022-11-01,UKR,Kedah,23,9,14
2022-11-01,UKR,Kelantan,3,2,1
2022-11-01,UKR,Melaka,5,5,0
2022-11-01,UKR,Negeri Sembilan,0,0,0
2022-11-01,UKR,Pahang,0,0,0
2022-11-01,UKR,Perak,0,0,0
2022-11-01,UKR,Perlis,22,9,13
2022-11-01,UKR,Pulau Pinang,37,17,20
2022-11-01,UKR,Sabah,7,6,1
2022-11-01,UKR,Sarawak,1,0,1
2022-11-01,UKR,Selangor,736,369,367
2022-11-01,UKR,W.P. Labuan,1,0,1
2022-11-01,URY,Johor,8,2,6
2022-11-01,URY,Kedah,0,0,0
2022-11-01,URY,Kelantan,0,0,0
2022-11-01,URY,Perak,0,0,0
2022-11-01,URY,Perlis,0,0,0
2022-11-01,URY,Pulau Pinang,1,0,1
2022-11-01,URY,Sabah,1,1,0
2022-11-01,URY,Sarawak,0,0,0
2022-11-01,URY,Selangor,40,17,23
2022-11-01,URY,W.P. Labuan,0,0,0
2022-11-01,USA,Johor,3279,1972,1307
2022-11-01,USA,Kedah,358,219,139
2022-11-01,USA,Kelantan,6,5,1
2022-11-01,USA,Melaka,3,2,1
2022-11-01,USA,Negeri Sembilan,0,0,0
2022-11-01,USA,Pahang,3,3,0
2022-11-01,USA,Perak,101,51,50
2022-11-01,USA,Perlis,113,75,38
2022-11-01,USA,Pulau Pinang,1480,906,574
2022-11-01,USA,Sabah,265,153,112
2022-11-01,USA,Sarawak,225,126,99
2022-11-01,USA,Selangor,11399,6830,4569
2022-11-01,USA,Terengganu,0,0,0
2022-11-01,USA,W.P. Labuan,7,7,0
2022-11-01,UZB,Johor,68,50,18
2022-11-01,UZB,Kedah,4,2,2
2022-11-01,UZB,Kelantan,0,0,0
2022-11-01,UZB,Perak,1,1,0
2022-11-01,UZB,Perlis,6,3,3
2022-11-01,UZB,Pulau Pinang,1,1,0
2022-11-01,UZB,Sabah,54,52,2
2022-11-01,UZB,Sarawak,0,0,0
2022-11-01,UZB,Selangor,968,617,351
2022-11-01,VAT,Johor,1,1,0
2022-11-01,VAT,Sarawak,0,0,0
2022-11-01,VAT,Selangor,1,1,0
2022-11-01,VCT,Johor,0,0,0
2022-11-01,VCT,Kedah,0,0,0
2022-11-01,VCT,Pulau Pinang,0,0,0
2022-11-01,VCT,Sarawak,0,0,0
2022-11-01,VCT,Selangor,1,0,1
2022-11-01,VEN,Johor,11,4,7
2022-11-01,VEN,Kedah,0,0,0
2022-11-01,VEN,Kelantan,0,0,0
2022-11-01,VEN,Melaka,0,0,0
2022-11-01,VEN,Perak,0,0,0
2022-11-01,VEN,Perlis,0,0,0
2022-11-01,VEN,Pulau Pinang,0,0,0
2022-11-01,VEN,Sabah,0,0,0
2022-11-01,VEN,Sarawak,0,0,0
2022-11-01,VEN,Selangor,45,27,18
2022-11-01,VEN,W.P. Labuan,0,0,0
2022-11-01,VNM,Johor,10491,3145,7346
2022-11-01,VNM,Kedah,221,40,181
2022-11-01,VNM,Kelantan,9,6,3
2022-11-01,VNM,Melaka,0,0,0
2022-11-01,VNM,Negeri Sembilan,0,0,0
2022-11-01,VNM,Pahang,2,2,0
2022-11-01,VNM,Perak,110,9,101
2022-11-01,VNM,Perlis,206,21,185
2022-11-01,VNM,Pulau Pinang,1158,335,823
2022-11-01,VNM,Sabah,15,6,9
2022-11-01,VNM,Sarawak,135,19,116
2022-11-01,VNM,Selangor,11063,3967,7096
2022-11-01,VNM,Terengganu,0,0,0
2022-11-01,VNM,W.P. Labuan,1,0,1
2022-11-01,VUT,Johor,19,14,5
2022-11-01,VUT,Kedah,0,0,0
2022-11-01,VUT,Pulau Pinang,1,1,0
2022-11-01,VUT,Sabah,1,1,0
2022-11-01,VUT,Sarawak,0,0,0
2022-11-01,VUT,Selangor,46,41,5
2022-11-01,WSM,Johor,0,0,0
2022-11-01,WSM,Sarawak,0,0,0
2022-11-01,WSM,Selangor,8,6,2
2022-11-01,XXX,Johor,134,82,52
2022-11-01,XXX,Kedah,5,2,3
2022-11-01,XXX,Kelantan,0,0,0
2022-11-01,XXX,Melaka,0,0,0
2022-11-01,XXX,Pahang,0,0,0
2022-11-01,XXX,Perak,2,2,0
2022-11-01,XXX,Perlis,3,2,1
2022-11-01,XXX,Pulau Pinang,20,11,9
2022-11-01,XXX,Sabah,8,4,4
2022-11-01,XXX,Sarawak,20,15,5
2022-11-01,XXX,Selangor,335,195,140
2022-11-01,XXX,W.P. Labuan,1,1,0
2022-11-01,YEM,Johor,34,25,9
2022-11-01,YEM,Kedah,0,0,0
2022-11-01,YEM,Kelantan,2,2,0
2022-11-01,YEM,Melaka,0,0,0
2022-11-01,YEM,Pahang,0,0,0
2022-11-01,YEM,Perak,0,0,0
2022-11-01,YEM,Perlis,0,0,0
2022-11-01,YEM,Pulau Pinang,3,3,0
2022-11-01,YEM,Sabah,0,0,0
2022-11-01,YEM,Sarawak,2,2,0
2022-11-01,YEM,Selangor,1254,866,388
2022-11-01,YEM,W.P. Labuan,1,1,0
2022-11-01,ZAF,Johor,221,133,88
2022-11-01,ZAF,Kedah,25,13,12
2022-11-01,ZAF,Kelantan,0,0,0
2022-11-01,ZAF,Melaka,0,0,0
2022-11-01,ZAF,Pahang,0,0,0
2022-11-01,ZAF,Perak,2,1,1
2022-11-01,ZAF,Perlis,7,5,2
2022-11-01,ZAF,Pulau Pinang,47,35,12
2022-11-01,ZAF,Sabah,12,8,4
2022-11-01,ZAF,Sarawak,85,51,34
2022-11-01,ZAF,Selangor,689,420,269
2022-11-01,ZAF,Terengganu,0,0,0
2022-11-01,ZAF,W.P. Labuan,0,0,0
2022-11-01,ZAR,Selangor,0,0,0
2022-11-01,ZMB,Johor,1,1,0
2022-11-01,ZMB,Kedah,0,0,0
2022-11-01,ZMB,Perak,0,0,0
2022-11-01,ZMB,Perlis,0,0,0
2022-11-01,ZMB,Pulau Pinang,1,0,1
2022-11-01,ZMB,Sabah,0,0,0
2022-11-01,ZMB,Sarawak,0,0,0
2022-11-01,ZMB,Selangor,41,21,20
2022-11-01,ZWE,Johor,4,1,3
2022-11-01,ZWE,Kedah,0,0,0
2022-11-01,ZWE,Kelantan,0,0,0
2022-11-01,ZWE,Perak,0,0,0
2022-11-01,ZWE,Perlis,0,0,0
2022-11-01,ZWE,Pulau Pinang,1,0,1
2022-11-01,ZWE,Sabah,1,0,1
2022-11-01,ZWE,Sarawak,0,0,0
2022-11-01,ZWE,Selangor,93,36,57
2022-12-01,ABW,Kedah,0,0,0
2022-12-01,ABW,Pulau Pinang,0,0,0
2022-12-01,AFG,Johor,1,1,0
2022-12-01,AFG,Kedah,0,0,0
2022-12-01,AFG,Perlis,0,0,0
2022-12-01,AFG,Pulau Pinang,0,0,0
2022-12-01,AFG,Sarawak,1,1,0
2022-12-01,AFG,Selangor,33,27,6
2022-12-01,AGO,Johor,1,1,0
2022-12-01,AGO,Kedah,0,0,0
2022-12-01,AGO,Sabah,1,1,0
2022-12-01,AGO,Selangor,1,1,0
2022-12-01,AIA,Selangor,0,0,0
2022-12-01,ALB,Johor,7,7,0
2022-12-01,ALB,Kedah,0,0,0
2022-12-01,ALB,Perak,0,0,0
2022-12-01,ALB,Perlis,0,0,0
2022-12-01,ALB,Pulau Pinang,4,3,1
2022-12-01,ALB,Sabah,0,0,0
2022-12-01,ALB,Sarawak,0,0,0
2022-12-01,ALB,Selangor,42,22,20
2022-12-01,AND,Johor,0,0,0
2022-12-01,AND,Kedah,0,0,0
2022-12-01,AND,Perlis,0,0,0
2022-12-01,AND,Pulau Pinang,0,0,0
2022-12-01,AND,Selangor,0,0,0
2022-12-01,ANT,Selangor,0,0,0
2022-12-01,ARE,Johor,55,29,26
2022-12-01,ARE,Kedah,5,2,3
2022-12-01,ARE,Kelantan,0,0,0
2022-12-01,ARE,Perak,0,0,0
2022-12-01,ARE,Perlis,0,0,0
2022-12-01,ARE,Pulau Pinang,1,1,0
2022-12-01,ARE,Sabah,0,0,0
2022-12-01,ARE,Sarawak,0,0,0
2022-12-01,ARE,Selangor,673,345,328
2022-12-01,ARG,Johor,29,17,12
2022-12-01,ARG,Kedah,32,16,16
2022-12-01,ARG,Kelantan,1,1,0
2022-12-01,ARG,Melaka,0,0,0
2022-12-01,ARG,Perak,1,1,0
2022-12-01,ARG,Perlis,5,2,3
2022-12-01,ARG,Pulau Pinang,10,6,4
2022-12-01,ARG,Sabah,0,0,0
2022-12-01,ARG,Sarawak,4,2,2
2022-12-01,ARG,Selangor,229,119,110
2022-12-01,ARG,W.P. Labuan,0,0,0
2022-12-01,ARM,Johor,11,6,5
2022-12-01,ARM,Kedah,1,0,1
2022-12-01,ARM,Kelantan,0,0,0
2022-12-01,ARM,Perak,0,0,0
2022-12-01,ARM,Perlis,0,0,0
2022-12-01,ARM,Pulau Pinang,1,1,0
2022-12-01,ARM,Sabah,3,1,2
2022-12-01,ARM,Sarawak,0,0,0
2022-12-01,ARM,Selangor,39,18,21
2022-12-01,ATA,Selangor,0,0,0
2022-12-01,ATG,Johor,3,1,2
2022-12-01,ATG,Kedah,0,0,0
2022-12-01,ATG,Pulau Pinang,1,1,0
2022-12-01,ATG,Sarawak,0,0,0
2022-12-01,ATG,Selangor,12,5,7
2022-12-01,AUS,Johor,5212,2921,2291
2022-12-01,AUS,Kedah,538,302,236
2022-12-01,AUS,Kelantan,3,3,0
2022-12-01,AUS,Melaka,5,3,2
2022-12-01,AUS,Negeri Sembilan,0,0,0
2022-12-01,AUS,Pahang,21,9,12
2022-12-01,AUS,Perak,190,95,95
2022-12-01,AUS,Perlis,53,36,17
2022-12-01,AUS,Pulau Pinang,1929,1010,919
2022-12-01,AUS,Sabah,479,245,234
2022-12-01,AUS,Sarawak,706,391,315
2022-12-01,AUS,Selangor,30838,16944,13894
2022-12-01,AUS,Terengganu,0,0,0
2022-12-01,AUS,W.P. Labuan,28,14,14
2022-12-01,AUT,Johor,113,74,39
2022-12-01,AUT,Kedah,61,34,27
2022-12-01,AUT,Kelantan,0,0,0
2022-12-01,AUT,Melaka,0,0,0
2022-12-01,AUT,Negeri Sembilan,0,0,0
2022-12-01,AUT,Pahang,0,0,0
2022-12-01,AUT,Perak,3,2,1
2022-12-01,AUT,Perlis,12,7,5
2022-12-01,AUT,Pulau Pinang,67,43,24
2022-12-01,AUT,Sabah,6,3,3
2022-12-01,AUT,Sarawak,18,15,3
2022-12-01,AUT,Selangor,767,457,310
2022-12-01,AUT,Terengganu,0,0,0
2022-12-01,AUT,W.P. Labuan,0,0,0
2022-12-01,AZE,Johor,10,6,4
2022-12-01,AZE,Kedah,3,3,0
2022-12-01,AZE,Kelantan,0,0,0
2022-12-01,AZE,Melaka,0,0,0
2022-12-01,AZE,Perlis,0,0,0
2022-12-01,AZE,Pulau Pinang,1,0,1
2022-12-01,AZE,Sabah,1,0,1
2022-12-01,AZE,Sarawak,0,0,0
2022-12-01,AZE,Selangor,103,57,46
2022-12-01,AZE,W.P. Labuan,0,0,0
2022-12-01,BDI,Pulau Pinang,0,0,0
2022-12-01,BDI,Sarawak,0,0,0
2022-12-01,BDI,Selangor,1,0,1
2022-12-01,BEL,Johor,166,111,55
2022-12-01,BEL,Kedah,60,35,25
2022-12-01,BEL,Kelantan,1,1,0
2022-12-01,BEL,Melaka,0,0,0
2022-12-01,BEL,Negeri Sembilan,0,0,0
2022-12-01,BEL,Pahang,0,0,0
2022-12-01,BEL,Perak,0,0,0
2022-12-01,BEL,Perlis,5,4,1
2022-12-01,BEL,Pulau Pinang,50,30,20
2022-12-01,BEL,Sabah,10,7,3
2022-12-01,BEL,Sarawak,18,8,10
2022-12-01,BEL,Selangor,612,408,204
2022-12-01,BEL,W.P. Labuan,3,2,1
2022-12-01,BEN,Johor,0,0,0
2022-12-01,BEN,Kedah,0,0,0
2022-12-01,BEN,Perak,0,0,0
2022-12-01,BEN,Pulau Pinang,0,0,0
2022-12-01,BEN,Sabah,1,1,0
2022-12-01,BEN,Sarawak,0,0,0
2022-12-01,BEN,Selangor,10,6,4
2022-12-01,BFA,Perak,0,0,0
2022-12-01,BFA,Pulau Pinang,1,1,0
2022-12-01,BFA,Selangor,2,2,0
2022-12-01,BGD,Johor,2184,1774,410
2022-12-01,BGD,Kedah,45,29,16
2022-12-01,BGD,Kelantan,2,2,0
2022-12-01,BGD,Melaka,0,0,0
2022-12-01,BGD,Negeri Sembilan,0,0,0
2022-12-01,BGD,Pahang,0,0,0
2022-12-01,BGD,Perak,0,0,0
2022-12-01,BGD,Perlis,2,2,0
2022-12-01,BGD,Pulau Pinang,317,306,11
2022-12-01,BGD,Sabah,6,4,2
2022-12-01,BGD,Sarawak,64,53,11
2022-12-01,BGD,Selangor,37198,35338,1860
2022-12-01,BGD,W.P. Labuan,2,2,0
2022-12-01,BGR,Johor,46,31,15
2022-12-01,BGR,Kedah,12,5,7
2022-12-01,BGR,Kelantan,0,0,0
2022-12-01,BGR,Pahang,2,2,0
2022-12-01,BGR,Perak,0,0,0
2022-12-01,BGR,Perlis,3,1,2
2022-12-01,BGR,Pulau Pinang,4,3,1
2022-12-01,BGR,Sabah,4,3,1
2022-12-01,BGR,Sarawak,0,0,0
2022-12-01,BGR,Selangor,201,105,96
2022-12-01,BGR,W.P. Labuan,0,0,0
2022-12-01,BHR,Johor,14,7,7
2022-12-01,BHR,Kedah,0,0,0
2022-12-01,BHR,Kelantan,0,0,0
2022-12-01,BHR,Perlis,2,2,0
2022-12-01,BHR,Pulau Pinang,0,0,0
2022-12-01,BHR,Sabah,0,0,0
2022-12-01,BHR,Sarawak,1,1,0
2022-12-01,BHR,Selangor,102,57,45
2022-12-01,BHS,Johor,2,2,0
2022-12-01,BHS,Kedah,0,0,0
2022-12-01,BHS,Perak,0,0,0
2022-12-01,BHS,Sabah,0,0,0
2022-12-01,BHS,Sarawak,0,0,0
2022-12-01,BHS,Selangor,2,0,2
2022-12-01,BIH,Johor,3,2,1
2022-12-01,BIH,Kedah,0,0,0
2022-12-01,BIH,Perlis,0,0,0
2022-12-01,BIH,Pulau Pinang,2,1,1
2022-12-01,BIH,Sabah,0,0,0
2022-12-01,BIH,Sarawak,1,1,0
2022-12-01,BIH,Selangor,35,24,11
2022-12-01,BLR,Johor,17,8,9
2022-12-01,BLR,Kedah,5,1,4
2022-12-01,BLR,Kelantan,0,0,0
2022-12-01,BLR,Pahang,0,0,0
2022-12-01,BLR,Perak,0,0,0
2022-12-01,BLR,Perlis,0,0,0
2022-12-01,BLR,Pulau Pinang,10,5,5
2022-12-01,BLR,Sabah,0,0,0
2022-12-01,BLR,Sarawak,8,3,5
2022-12-01,BLR,Selangor,245,121,124
2022-12-01,BLR,W.P. Labuan,0,0,0
2022-12-01,BLZ,Johor,5,1,4
2022-12-01,BLZ,Pulau Pinang,0,0,0
2022-12-01,BLZ,Sarawak,0,0,0
2022-12-01,BLZ,Selangor,7,4,3
2022-12-01,BMU,Selangor,0,0,0
2022-12-01,BOL,Johor,1,1,0
2022-12-01,BOL,Kedah,0,0,0
2022-12-01,BOL,Melaka,0,0,0
2022-12-01,BOL,Perak,0,0,0
2022-12-01,BOL,Perlis,0,0,0
2022-12-01,BOL,Pulau Pinang,0,0,0
2022-12-01,BOL,Sabah,0,0,0
2022-12-01,BOL,Sarawak,0,0,0
2022-12-01,BOL,Selangor,20,15,5
2022-12-01,BRA,Johor,147,85,62
2022-12-01,BRA,Kedah,56,31,25
2022-12-01,BRA,Kelantan,0,0,0
2022-12-01,BRA,Melaka,0,0,0
2022-12-01,BRA,Pahang,0,0,0
2022-12-01,BRA,Perak,1,1,0
2022-12-01,BRA,Perlis,13,8,5
2022-12-01,BRA,Pulau Pinang,16,10,6
2022-12-01,BRA,Sabah,9,5,4
2022-12-01,BRA,Sarawak,6,4,2
2022-12-01,BRA,Selangor,669,377,292
2022-12-01,BRA,W.P. Labuan,0,0,0
2022-12-01,BRB,Johor,0,0,0
2022-12-01,BRB,Kedah,0,0,0
2022-12-01,BRB,Perlis,0,0,0
2022-12-01,BRB,Pulau Pinang,0,0,0
2022-12-01,BRB,Selangor,7,4,3
2022-12-01,BRN,Johor,1033,497,536
2022-12-01,BRN,Kedah,45,21,24
2022-12-01,BRN,Kelantan,13,13,0
2022-12-01,BRN,Melaka,0,0,0
2022-12-01,BRN,Pahang,0,0,0
2022-12-01,BRN,Perak,9,2,7
2022-12-01,BRN,Perlis,57,30,27
2022-12-01,BRN,Pulau Pinang,11,7,4
2022-12-01,BRN,Sabah,1587,706,881
2022-12-01,BRN,Sarawak,137530,71458,66072
2022-12-01,BRN,Selangor,7873,3867,4006
2022-12-01,BRN,W.P. Labuan,1769,1033,736
2022-12-01,BTN,Johor,4,3,1
2022-12-01,BTN,Kedah,1,0,1
2022-12-01,BTN,Perak,0,0,0
2022-12-01,BTN,Perlis,0,0,0
2022-12-01,BTN,Pulau Pinang,17,8,9
2022-12-01,BTN,Sabah,0,0,0
2022-12-01,BTN,Sarawak,0,0,0
2022-12-01,BTN,Selangor,36,17,19
2022-12-01,BWA,Johor,1,1,0
2022-12-01,BWA,Kedah,1,1,0
2022-12-01,BWA,Perlis,0,0,0
2022-12-01,BWA,Pulau Pinang,2,2,0
2022-12-01,BWA,Sabah,1,1,0
2022-12-01,BWA,Sarawak,0,0,0
2022-12-01,BWA,Selangor,15,5,10
2022-12-01,CAF,Kedah,0,0,0
2022-12-01,CAF,Selangor,0,0,0
2022-12-01,CAN,Johor,1219,728,491
2022-12-01,CAN,Kedah,142,84,58
2022-12-01,CAN,Kelantan,4,2,2
2022-12-01,CAN,Melaka,2,2,0
2022-12-01,CAN,Negeri Sembilan,0,0,0
2022-12-01,CAN,Pahang,3,2,1
2022-12-01,CAN,Perak,25,18,7
2022-12-01,CAN,Perlis,31,22,9
2022-12-01,CAN,Pulau Pinang,407,217,190
2022-12-01,CAN,Sabah,111,66,45
2022-12-01,CAN,Sarawak,303,148,155
2022-12-01,CAN,Selangor,3657,2089,1568
2022-12-01,CAN,Terengganu,0,0,0
2022-12-01,CAN,W.P. Labuan,4,3,1
2022-12-01,CCK,Selangor,1,1,0
2022-12-01,CHE,Johor,256,152,104
2022-12-01,CHE,Kedah,112,67,45
2022-12-01,CHE,Kelantan,2,1,1
2022-12-01,CHE,Melaka,2,1,1
2022-12-01,CHE,Negeri Sembilan,0,0,0
2022-12-01,CHE,Pahang,0,0,0
2022-12-01,CHE,Perak,1,1,0
2022-12-01,CHE,Perlis,22,15,7
2022-12-01,CHE,Pulau Pinang,55,35,20
2022-12-01,CHE,Sabah,29,16,13
2022-12-01,CHE,Sarawak,27,12,15
2022-12-01,CHE,Selangor,1086,673,413
2022-12-01,CHE,W.P. Labuan,1,1,0
2022-12-01,CHL,Johor,20,9,11
2022-12-01,CHL,Kedah,11,4,7
2022-12-01,CHL,Kelantan,0,0,0
2022-12-01,CHL,Melaka,0,0,0
2022-12-01,CHL,Pahang,0,0,0
2022-12-01,CHL,Perak,0,0,0
2022-12-01,CHL,Perlis,3,2,1
2022-12-01,CHL,Pulau Pinang,5,0,5
2022-12-01,CHL,Sabah,0,0,0
2022-12-01,CHL,Sarawak,0,0,0
2022-12-01,CHL,Selangor,113,67,46
2022-12-01,CHN,Johor,26433,10442,15991
2022-12-01,CHN,Kedah,607,236,371
2022-12-01,CHN,Kelantan,5,4,1
2022-12-01,CHN,Melaka,2,0,2
2022-12-01,CHN,Pahang,20,10,10
2022-12-01,CHN,Perak,206,86,120
2022-12-01,CHN,Perlis,59,19,40
2022-12-01,CHN,Pulau Pinang,2723,1364,1359
2022-12-01,CHN,Sabah,590,264,326
2022-12-01,CHN,Sarawak,653,272,381
2022-12-01,CHN,Selangor,22674,12268,10406
2022-12-01,CHN,Terengganu,0,0,0
2022-12-01,CHN,W.P. Labuan,26,22,4
2022-12-01,CIV,Johor,0,0,0
2022-12-01,CIV,Kedah,0,0,0
2022-12-01,CIV,Pulau Pinang,0,0,0
2022-12-01,CIV,Sabah,0,0,0
2022-12-01,CIV,Sarawak,0,0,0
2022-12-01,CIV,Selangor,11,9,2
2022-12-01,CMR,Johor,6,6,0
2022-12-01,CMR,Kedah,0,0,0
2022-12-01,CMR,Pulau Pinang,0,0,0
2022-12-01,CMR,Sabah,0,0,0
2022-12-01,CMR,Sarawak,0,0,0
2022-12-01,CMR,Selangor,10,8,2
2022-12-01,COD,Johor,0,0,0
2022-12-01,COD,Pulau Pinang,0,0,0
2022-12-01,COD,Sarawak,0,0,0
2022-12-01,COD,Selangor,4,3,1
2022-12-01,COG,Johor,0,0,0
2022-12-01,COG,Kedah,0,0,0
2022-12-01,COG,Selangor,5,5,0
2022-12-01,COK,Selangor,0,0,0
2022-12-01,COL,Johor,26,12,14
2022-12-01,COL,Kedah,4,1,3
2022-12-01,COL,Perak,0,0,0
2022-12-01,COL,Pulau Pinang,1,0,1
2022-12-01,COL,Sabah,1,0,1
2022-12-01,COL,Sarawak,0,0,0
2022-12-01,COL,Selangor,120,65,55
2022-12-01,COL,W.P. Labuan,0,0,0
2022-12-01,COM,Johor,1,0,1
2022-12-01,COM,Kedah,0,0,0
2022-12-01,COM,Selangor,17,11,6
2022-12-01,CPV,Johor,0,0,0
2022-12-01,CPV,Kedah,0,0,0
2022-12-01,CPV,Pulau Pinang,0,0,0
2022-12-01,CPV,Sabah,0,0,0
2022-12-01,CPV,Selangor,1,0,1
2022-12-01,CRI,Johor,6,3,3
2022-12-01,CRI,Kedah,1,0,1
2022-12-01,CRI,Perak,0,0,0
2022-12-01,CRI,Perlis,0,0,0
2022-12-01,CRI,Pulau Pinang,3,0,3
2022-12-01,CRI,Sabah,0,0,0
2022-12-01,CRI,Sarawak,0,0,0
2022-12-01,CRI,Selangor,33,19,14
2022-12-01,CUB,Johor,14,12,2
2022-12-01,CUB,Kedah,2,1,1
2022-12-01,CUB,Perlis,0,0,0
2022-12-01,CUB,Pulau Pinang,1,0,1
2022-12-01,CUB,Sabah,0,0,0
2022-12-01,CUB,Sarawak,0,0,0
2022-12-01,CUB,Selangor,38,23,15
2022-12-01,CYP,Johor,9,5,4
2022-12-01,CYP,Kedah,0,0,0
2022-12-01,CYP,Perak,0,0,0
2022-12-01,CYP,Perlis,0,0,0
2022-12-01,CYP,Pulau Pinang,1,1,0
2022-12-01,CYP,Sabah,0,0,0
2022-12-01,CYP,Sarawak,0,0,0
2022-12-01,CYP,Selangor,70,40,30
2022-12-01,CZE,Johor,60,36,24
2022-12-01,CZE,Kedah,62,33,29
2022-12-01,CZE,Kelantan,1,1,0
2022-12-01,CZE,Melaka,0,0,0
2022-12-01,CZE,Negeri Sembilan,0,0,0
2022-12-01,CZE,Perak,1,0,1
2022-12-01,CZE,Perlis,15,9,6
2022-12-01,CZE,Pulau Pinang,17,7,10
2022-12-01,CZE,Sabah,5,3,2
2022-12-01,CZE,Sarawak,7,3,4
2022-12-01,CZE,Selangor,401,238,163
2022-12-01,CZE,W.P. Labuan,1,0,1
2022-12-01,DEU,Johor,1413,930,483
2022-12-01,DEU,Kedah,540,302,238
2022-12-01,DEU,Kelantan,6,4,2
2022-12-01,DEU,Melaka,2,1,1
2022-12-01,DEU,Negeri Sembilan,0,0,0
2022-12-01,DEU,Pahang,0,0,0
2022-12-01,DEU,Perak,23,17,6
2022-12-01,DEU,Perlis,102,68,34
2022-12-01,DEU,Pulau Pinang,424,301,123
2022-12-01,DEU,Sabah,96,61,35
2022-12-01,DEU,Sarawak,180,119,61
2022-12-01,DEU,Selangor,8908,5055,3853
2022-12-01,DEU,Terengganu,0,0,0
2022-12-01,DEU,W.P. Labuan,5,4,1
2022-12-01,DJI,Johor,0,0,0
2022-12-01,DJI,Selangor,25,12,13
2022-12-01,DMA,Johor,9,8,1
2022-12-01,DMA,Kedah,0,0,0
2022-12-01,DMA,Pulau Pinang,1,0,1
2022-12-01,DMA,Sabah,0,0,0
2022-12-01,DMA,Sarawak,2,1,1
2022-12-01,DMA,Selangor,12,11,1
2022-12-01,DMA,W.P. Labuan,0,0,0
2022-12-01,DNK,Johor,225,156,69
2022-12-01,DNK,Kedah,96,52,44
2022-12-01,DNK,Kelantan,0,0,0
2022-12-01,DNK,Melaka,0,0,0
2022-12-01,DNK,Negeri Sembilan,0,0,0
2022-12-01,DNK,Pahang,0,0,0
2022-12-01,DNK,Perak,3,2,1
2022-12-01,DNK,Perlis,8,7,1
2022-12-01,DNK,Pulau Pinang,49,30,19
2022-12-01,DNK,Sabah,29,18,11
2022-12-01,DNK,Sarawak,10,7,3
2022-12-01,DNK,Selangor,666,385,281
2022-12-01,DNK,W.P. Labuan,0,0,0
2022-12-01,DOM,Johor,2,1,1
2022-12-01,DOM,Kedah,0,0,0
2022-12-01,DOM,Perak,0,0,0
2022-12-01,DOM,Perlis,0,0,0
2022-12-01,DOM,Pulau Pinang,0,0,0
2022-12-01,DOM,Sabah,0,0,0
2022-12-01,DOM,Sarawak,0,0,0
2022-12-01,DOM,Selangor,12,5,7
2022-12-01,DZA,Johor,45,36,9
2022-12-01,DZA,Kedah,3,3,0
2022-12-01,DZA,Kelantan,2,2,0
2022-12-01,DZA,Melaka,0,0,0
2022-12-01,DZA,Perak,0,0,0
2022-12-01,DZA,Perlis,3,2,1
2022-12-01,DZA,Pulau Pinang,0,0,0
2022-12-01,DZA,Sabah,6,4,2
2022-12-01,DZA,Sarawak,1,1,0
2022-12-01,DZA,Selangor,262,171,91
2022-12-01,DZA,W.P. Labuan,0,0,0
2022-12-01,ECU,Johor,6,3,3
2022-12-01,ECU,Kedah,1,0,1
2022-12-01,ECU,Perak,0,0,0
2022-12-01,ECU,Perlis,0,0,0
2022-12-01,ECU,Pulau Pinang,1,1,0
2022-12-01,ECU,Sabah,0,0,0
2022-12-01,ECU,Sarawak,0,0,0
2022-12-01,ECU,Selangor,43,18,25
2022-12-01,EGY,Johor,223,164,59
2022-12-01,EGY,Kedah,1,0,1
2022-12-01,EGY,Kelantan,0,0,0
2022-12-01,EGY,Melaka,0,0,0
2022-12-01,EGY,Pahang,0,0,0
2022-12-01,EGY,Perak,0,0,0
2022-12-01,EGY,Perlis,2,2,0
2022-12-01,EGY,Pulau Pinang,7,6,1
2022-12-01,EGY,Sabah,5,2,3
2022-12-01,EGY,Sarawak,189,126,63
2022-12-01,EGY,Selangor,1207,730,477
2022-12-01,EGY,Terengganu,0,0,0
2022-12-01,EGY,W.P. Labuan,0,0,0
2022-12-01,ERI,Johor,1,0,1
2022-12-01,ERI,Pulau Pinang,0,0,0
2022-12-01,ERI,Sabah,0,0,0
2022-12-01,ERI,Selangor,12,6,6
2022-12-01,ESP,Johor,254,150,104
2022-12-01,ESP,Kedah,156,86,70
2022-12-01,ESP,Kelantan,2,1,1
2022-12-01,ESP,Melaka,0,0,0
2022-12-01,ESP,Negeri Sembilan,0,0,0
2022-12-01,ESP,Pahang,0,0,0
2022-12-01,ESP,Perak,1,1,0
2022-12-01,ESP,Perlis,16,8,8
2022-12-01,ESP,Pulau Pinang,60,35,25
2022-12-01,ESP,Sabah,19,16,3
2022-12-01,ESP,Sarawak,27,19,8
2022-12-01,ESP,Selangor,1458,830,628
2022-12-01,ESP,W.P. Labuan,0,0,0
2022-12-01,EST,Johor,22,12,10
2022-12-01,EST,Kedah,43,16,27
2022-12-01,EST,Kelantan,0,0,0
2022-12-01,EST,Pahang,0,0,0
2022-12-01,EST,Perak,1,0,1
2022-12-01,EST,Perlis,4,4,0
2022-12-01,EST,Pulau Pinang,4,0,4
2022-12-01,EST,Sabah,3,1,2
2022-12-01,EST,Sarawak,0,0,0
2022-12-01,EST,Selangor,228,100,128
2022-12-01,EST,W.P. Labuan,0,0,0
2022-12-01,ETH,Johor,1,0,1
2022-12-01,ETH,Kedah,0,0,0
2022-12-01,ETH,Pulau Pinang,1,1,0
2022-12-01,ETH,Sarawak,0,0,0
2022-12-01,ETH,Selangor,18,12,6
2022-12-01,FIN,Johor,167,108,59
2022-12-01,FIN,Kedah,73,38,35
2022-12-01,FIN,Kelantan,0,0,0
2022-12-01,FIN,Melaka,0,0,0
2022-12-01,FIN,Negeri Sembilan,0,0,0
2022-12-01,FIN,Pahang,0,0,0
2022-12-01,FIN,Perak,2,1,1
2022-12-01,FIN,Perlis,3,2,1
2022-12-01,FIN,Pulau Pinang,32,19,13
2022-12-01,FIN,Sabah,13,10,3
2022-12-01,FIN,Sarawak,15,5,10
2022-12-01,FIN,Selangor,576,311,265
2022-12-01,FIN,W.P. Labuan,0,0,0
2022-12-01,FJI,Johor,41,21,20
2022-12-01,FJI,Kedah,2,2,0
2022-12-01,FJI,Kelantan,0,0,0
2022-12-01,FJI,Perak,0,0,0
2022-12-01,FJI,Perlis,0,0,0
2022-12-01,FJI,Pulau Pinang,1,0,1
2022-12-01,FJI,Sabah,2,2,0
2022-12-01,FJI,Sarawak,6,5,1
2022-12-01,FJI,Selangor,115,63,52
2022-12-01,FRA,Johor,1417,914,503
2022-12-01,FRA,Kedah,492,270,222
2022-12-01,FRA,Kelantan,9,6,3
2022-12-01,FRA,Melaka,2,1,1
2022-12-01,FRA,Negeri Sembilan,1,0,1
2022-12-01,FRA,Pahang,11,3,8
2022-12-01,FRA,Perak,24,17,7
2022-12-01,FRA,Perlis,58,38,20
2022-12-01,FRA,Pulau Pinang,297,193,104
2022-12-01,FRA,Sabah,94,54,40
2022-12-01,FRA,Sarawak,66,55,11
2022-12-01,FRA,Selangor,4793,2871,1922
2022-12-01,FRA,Terengganu,0,0,0
2022-12-01,FRA,W.P. Labuan,3,1,2
2022-12-01,FSM,Johor,0,0,0
2022-12-01,FSM,Pulau Pinang,0,0,0
2022-12-01,FSM,Selangor,0,0,0
2022-12-01,GAB,Johor,0,0,0
2022-12-01,GAB,Pulau Pinang,0,0,0
2022-12-01,GAB,Sarawak,0,0,0
2022-12-01,GAB,Selangor,6,0,6
2022-12-01,GBR,Johor,3852,2420,1432
2022-12-01,GBR,Kedah,1113,628,485
2022-12-01,GBR,Kelantan,8,6,2
2022-12-01,GBR,Melaka,2,1,1
2022-12-01,GBR,Negeri Sembilan,0,0,0
2022-12-01,GBR,Pahang,11,6,5
2022-12-01,GBR,Perak,99,62,37
2022-12-01,GBR,Perlis,108,67,41
2022-12-01,GBR,Pulau Pinang,1292,739,553
2022-12-01,GBR,Sabah,383,223,160
2022-12-01,GBR,Sarawak,1526,900,626
2022-12-01,GBR,Selangor,13980,8282,5698
2022-12-01,GBR,Terengganu,0,0,0
2022-12-01,GBR,W.P. Labuan,29,13,16
2022-12-01,GEO,Johor,6,5,1
2022-12-01,GEO,Kedah,0,0,0
2022-12-01,GEO,Melaka,0,0,0
2022-12-01,GEO,Perak,0,0,0
2022-12-01,GEO,Perlis,2,2,0
2022-12-01,GEO,Pulau Pinang,1,0,1
2022-12-01,GEO,Sabah,0,0,0
2022-12-01,GEO,Sarawak,0,0,0
2022-12-01,GEO,Selangor,48,26,22
2022-12-01,GHA,Johor,7,3,4
2022-12-01,GHA,Kedah,0,0,0
2022-12-01,GHA,Kelantan,0,0,0
2022-12-01,GHA,Pulau Pinang,1,0,1
2022-12-01,GHA,Sabah,0,0,0
2022-12-01,GHA,Sarawak,1,1,0
2022-12-01,GHA,Selangor,64,41,23
2022-12-01,GIB,Johor,0,0,0
2022-12-01,GIB,Sarawak,0,0,0
2022-12-01,GIN,Johor,4,2,2
2022-12-01,GIN,Kedah,0,0,0
2022-12-01,GIN,Kelantan,1,1,0
2022-12-01,GIN,Perlis,0,0,0
2022-12-01,GIN,Pulau Pinang,0,0,0
2022-12-01,GIN,Sabah,0,0,0
2022-12-01,GIN,Sarawak,0,0,0
2022-12-01,GIN,Selangor,36,24,12
2022-12-01,GLP,Selangor,0,0,0
2022-12-01,GMB,Johor,0,0,0
2022-12-01,GMB,Kedah,0,0,0
2022-12-01,GMB,Kelantan,0,0,0
2022-12-01,GMB,Pulau Pinang,0,0,0
2022-12-01,GMB,Sabah,0,0,0
2022-12-01,GMB,Sarawak,0,0,0
2022-12-01,GMB,Selangor,16,10,6
2022-12-01,GNB,Johor,0,0,0
2022-12-01,GNB,Selangor,0,0,0
2022-12-01,GNQ,Johor,0,0,0
2022-12-01,GNQ,Selangor,0,0,0
2022-12-01,GRC,Johor,39,26,13
2022-12-01,GRC,Kedah,20,11,9
2022-12-01,GRC,Kelantan,0,0,0
2022-12-01,GRC,Melaka,0,0,0
2022-12-01,GRC,Negeri Sembilan,0,0,0
2022-12-01,GRC,Pahang,0,0,0
2022-12-01,GRC,Perak,0,0,0
2022-12-01,GRC,Perlis,4,3,1
2022-12-01,GRC,Pulau Pinang,5,4,1
2022-12-01,GRC,Sabah,2,2,0
2022-12-01,GRC,Sarawak,1,1,0
2022-12-01,GRC,Selangor,159,106,53
2022-12-01,GRD,Johor,9,7,2
2022-12-01,GRD,Kedah,1,1,0
2022-12-01,GRD,Pulau Pinang,1,1,0
2022-12-01,GRD,Sabah,0,0,0
2022-12-01,GRD,Sarawak,1,0,1
2022-12-01,GRD,Selangor,3,3,0
2022-12-01,GRL,Johor,0,0,0
2022-12-01,GRL,Selangor,0,0,0
2022-12-01,GTM,Johor,1,1,0
2022-12-01,GTM,Kedah,0,0,0
2022-12-01,GTM,Pahang,0,0,0
2022-12-01,GTM,Perak,0,0,0
2022-12-01,GTM,Pulau Pinang,1,1,0
2022-12-01,GTM,Sabah,0,0,0
2022-12-01,GTM,Sarawak,0,0,0
2022-12-01,GTM,Selangor,14,8,6
2022-12-01,GTM,W.P. Labuan,0,0,0
2022-12-01,GUY,Johor,0,0,0
2022-12-01,GUY,Kedah,0,0,0
2022-12-01,GUY,Pulau Pinang,0,0,0
2022-12-01,GUY,Sarawak,0,0,0
2022-12-01,GUY,Selangor,6,4,2
2022-12-01,HKG,Johor,5,3,2
2022-12-01,HKG,Kedah,3,3,0
2022-12-01,HKG,Kelantan,0,0,0
2022-12-01,HKG,Pahang,9,6,3
2022-12-01,HKG,Perak,45,22,23
2022-12-01,HKG,Perlis,3,1,2
2022-12-01,HKG,Pulau Pinang,0,0,0
2022-12-01,HKG,Sabah,4,2,2
2022-12-01,HKG,Sarawak,2,1,1
2022-12-01,HKG,Selangor,53,30,23
2022-12-01,HKG,Terengganu,0,0,0
2022-12-01,HMD,Johor,0,0,0
2022-12-01,HND,Johor,4,3,1
2022-12-01,HND,Kedah,0,0,0
2022-12-01,HND,Perak,0,0,0
2022-12-01,HND,Pulau Pinang,1,1,0
2022-12-01,HND,Sabah,0,0,0
2022-12-01,HND,Sarawak,0,0,0
2022-12-01,HND,Selangor,8,2,6
2022-12-01,HRV,Johor,36,32,4
2022-12-01,HRV,Kedah,4,1,3
2022-12-01,HRV,Kelantan,0,0,0
2022-12-01,HRV,Melaka,0,0,0
2022-12-01,HRV,Pahang,0,0,0
2022-12-01,HRV,Perak,0,0,0
2022-12-01,HRV,Perlis,0,0,0
2022-12-01,HRV,Pulau Pinang,3,2,1
2022-12-01,HRV,Sabah,0,0,0
2022-12-01,HRV,Sarawak,2,1,1
2022-12-01,HRV,Selangor,133,77,56
2022-12-01,HTI,Johor,0,0,0
2022-12-01,HTI,Kedah,0,0,0
2022-12-01,HTI,Kelantan,0,0,0
2022-12-01,HTI,Perak,0,0,0
2022-12-01,HTI,Pulau Pinang,0,0,0
2022-12-01,HTI,Sabah,0,0,0
2022-12-01,HTI,Selangor,4,3,1
2022-12-01,HUN,Johor,108,66,42
2022-12-01,HUN,Kedah,42,19,23
2022-12-01,HUN,Kelantan,1,1,0
2022-12-01,HUN,Pahang,3,2,1
2022-12-01,HUN,Perak,0,0,0
2022-12-01,HUN,Perlis,6,4,2
2022-12-01,HUN,Pulau Pinang,42,19,23
2022-12-01,HUN,Sabah,59,29,30
2022-12-01,HUN,Sarawak,6,5,1
2022-12-01,HUN,Selangor,427,213,214
2022-12-01,HUN,W.P. Labuan,0,0,0
2022-12-01,IDN,Johor,109403,54653,54750
2022-12-01,IDN,Kedah,3686,1512,2174
2022-12-01,IDN,Kelantan,101,69,32
2022-12-01,IDN,Melaka,7953,3512,4441
2022-12-01,IDN,Negeri Sembilan,7001,4507,2494
2022-12-01,IDN,Pahang,14,3,11
2022-12-01,IDN,Perak,186,57,129
2022-12-01,IDN,Perlis,435,161,274
2022-12-01,IDN,Pulau Pinang,27822,11043,16779
2022-12-01,IDN,Sabah,5497,2483,3014
2022-12-01,IDN,Sarawak,39388,18824,20564
2022-12-01,IDN,Selangor,95045,45009,50036
2022-12-01,IDN,Terengganu,0,0,0
2022-12-01,IDN,W.P. Labuan,82,46,36
2022-12-01,IND,Johor,17995,11880,6115
2022-12-01,IND,Kedah,459,249,210
2022-12-01,IND,Kelantan,3,3,0
2022-12-01,IND,Melaka,3,2,1
2022-12-01,IND,Negeri Sembilan,0,0,0
2022-12-01,IND,Pahang,9,5,4
2022-12-01,IND,Perak,214,159,55
2022-12-01,IND,Perlis,42,35,7
2022-12-01,IND,Pulau Pinang,633,414,219
2022-12-01,IND,Sabah,199,131,68
2022-12-01,IND,Sarawak,1235,954,281
2022-12-01,IND,Selangor,41083,27944,13139
2022-12-01,IND,Terengganu,0,0,0
2022-12-01,IND,W.P. Labuan,72,58,14
2022-12-01,IOT,Pulau Pinang,0,0,0
2022-12-01,IOT,Selangor,0,0,0
2022-12-01,IRL,Johor,206,130,76
2022-12-01,IRL,Kedah,86,45,41
2022-12-01,IRL,Kelantan,0,0,0
2022-12-01,IRL,Negeri Sembilan,0,0,0
2022-12-01,IRL,Pahang,1,0,1
2022-12-01,IRL,Perak,3,1,2
2022-12-01,IRL,Perlis,7,5,2
2022-12-01,IRL,Pulau Pinang,55,35,20
2022-12-01,IRL,Sabah,21,13,8
2022-12-01,IRL,Sarawak,31,20,11
2022-12-01,IRL,Selangor,920,542,378
2022-12-01,IRL,Terengganu,0,0,0
2022-12-01,IRL,W.P. Labuan,0,0,0
2022-12-01,IRN,Johor,62,46,16
2022-12-01,IRN,Kedah,6,4,2
2022-12-01,IRN,Kelantan,0,0,0
2022-12-01,IRN,Perak,0,0,0
2022-12-01,IRN,Perlis,0,0,0
2022-12-01,IRN,Pulau Pinang,13,8,5
2022-12-01,IRN,Sabah,5,4,1
2022-12-01,IRN,Sarawak,5,3,2
2022-12-01,IRN,Selangor,854,474,380
2022-12-01,IRN,W.P. Labuan,0,0,0
2022-12-01,IRQ,Johor,15,9,6
2022-12-01,IRQ,Kedah,3,1,2
2022-12-01,IRQ,Kelantan,0,0,0
2022-12-01,IRQ,Melaka,0,0,0
2022-12-01,IRQ,Pahang,0,0,0
2022-12-01,IRQ,Perak,0,0,0
2022-12-01,IRQ,Perlis,0,0,0
2022-12-01,IRQ,Pulau Pinang,3,3,0
2022-12-01,IRQ,Sabah,0,0,0
2022-12-01,IRQ,Sarawak,0,0,0
2022-12-01,IRQ,Selangor,728,502,226
2022-12-01,ISL,Johor,12,8,4
2022-12-01,ISL,Kedah,1,1,0
2022-12-01,ISL,Kelantan,0,0,0
2022-12-01,ISL,Perak,0,0,0
2022-12-01,ISL,Perlis,0,0,0
2022-12-01,ISL,Pulau Pinang,2,1,1
2022-12-01,ISL,Sabah,12,7,5
2022-12-01,ISL,Sarawak,0,0,0
2022-12-01,ISL,Selangor,7,3,4
2022-12-01,ISL,W.P. Labuan,0,0,0
2022-12-01,ISR,Pulau Pinang,0,0,0
2022-12-01,ITA,Johor,352,260,92
2022-12-01,ITA,Kedah,170,105,65
2022-12-01,ITA,Kelantan,0,0,0
2022-12-01,ITA,Melaka,0,0,0
2022-12-01,ITA,Negeri Sembilan,0,0,0
2022-12-01,ITA,Pahang,3,2,1
2022-12-01,ITA,Perak,12,10,2
2022-12-01,ITA,Perlis,23,12,11
2022-12-01,ITA,Pulau Pinang,83,55,28
2022-12-01,ITA,Sabah,24,16,8
2022-12-01,ITA,Sarawak,39,28,11
2022-12-01,ITA,Selangor,1657,1051,606
2022-12-01,ITA,W.P. Labuan,2,1,1
2022-12-01,JAM,Johor,1,0,1
2022-12-01,JAM,Kedah,2,0,2
2022-12-01,JAM,Perak,0,0,0
2022-12-01,JAM,Pulau Pinang,0,0,0
2022-12-01,JAM,Sabah,6,4,2
2022-12-01,JAM,Sarawak,0,0,0
2022-12-01,JAM,Selangor,14,11,3
2022-12-01,JAM,W.P. Labuan,0,0,0
2022-12-01,JOR,Johor,23,10,13
2022-12-01,JOR,Kedah,2,2,0
2022-12-01,JOR,Kelantan,0,0,0
2022-12-01,JOR,Melaka,0,0,0
2022-12-01,JOR,Perlis,0,0,0
2022-12-01,JOR,Pulau Pinang,2,2,0
2022-12-01,JOR,Sabah,0,0,0
2022-12-01,JOR,Sarawak,0,0,0
2022-12-01,JOR,Selangor,496,300,196
2022-12-01,JOR,W.P. Labuan,0,0,0
2022-12-01,JPN,Johor,4606,3182,1424
2022-12-01,JPN,Kedah,380,199,181
2022-12-01,JPN,Kelantan,2,2,0
2022-12-01,JPN,Melaka,1,1,0
2022-12-01,JPN,Negeri Sembilan,0,0,0
2022-12-01,JPN,Pahang,10,5,5
2022-12-01,JPN,Perak,52,30,22
2022-12-01,JPN,Perlis,54,39,15
2022-12-01,JPN,Pulau Pinang,1076,711,365
2022-12-01,JPN,Sabah,449,239,210
2022-12-01,JPN,Sarawak,178,94,84
2022-12-01,JPN,Selangor,12123,7561,4562
2022-12-01,JPN,W.P. Labuan,7,5,2
2022-12-01,KAZ,Johor,44,16,28
2022-12-01,KAZ,Kedah,11,7,4
2022-12-01,KAZ,Kelantan,1,0,1
2022-12-01,KAZ,Melaka,0,0,0
2022-12-01,KAZ,Perak,0,0,0
2022-12-01,KAZ,Perlis,17,8,9
2022-12-01,KAZ,Pulau Pinang,14,7,7
2022-12-01,KAZ,Sabah,2,1,1
2022-12-01,KAZ,Sarawak,7,0,7
2022-12-01,KAZ,Selangor,460,188,272
2022-12-01,KAZ,W.P. Labuan,0,0,0
2022-12-01,KEN,Johor,68,33,35
2022-12-01,KEN,Kedah,8,4,4
2022-12-01,KEN,Kelantan,0,0,0
2022-12-01,KEN,Perak,0,0,0
2022-12-01,KEN,Perlis,0,0,0
2022-12-01,KEN,Pulau Pinang,2,1,1
2022-12-01,KEN,Sabah,4,2,2
2022-12-01,KEN,Sarawak,2,0,2
2022-12-01,KEN,Selangor,363,187,176
2022-12-01,KGZ,Johor,21,7,14
2022-12-01,KGZ,Kedah,1,1,0
2022-12-01,KGZ,Kelantan,0,0,0
2022-12-01,KGZ,Perak,0,0,0
2022-12-01,KGZ,Perlis,0,0,0
2022-12-01,KGZ,Pulau Pinang,1,1,0
2022-12-01,KGZ,Sabah,0,0,0
2022-12-01,KGZ,Sarawak,0,0,0
2022-12-01,KGZ,Selangor,156,68,88
2022-12-01,KHM,Johor,2035,824,1211
2022-12-01,KHM,Kedah,179,134,45
2022-12-01,KHM,Kelantan,495,280,215
2022-12-01,KHM,Melaka,0,0,0
2022-12-01,KHM,Negeri Sembilan,0,0,0
2022-12-01,KHM,Pahang,0,0,0
2022-12-01,KHM,Perak,13,7,6
2022-12-01,KHM,Perlis,513,285,228
2022-12-01,KHM,Pulau Pinang,12,4,8
2022-12-01,KHM,Sabah,2,1,1
2022-12-01,KHM,Sarawak,4,1,3
2022-12-01,KHM,Selangor,3427,1557,1870
2022-12-01,KHM,W.P. Labuan,0,0,0
2022-12-01,KIR,Johor,0,0,0
2022-12-01,KIR,Sabah,0,0,0
2022-12-01,KIR,Selangor,0,0,0
2022-12-01,KNA,Johor,9,6,3
2022-12-01,KNA,Kedah,5,2,3
2022-12-01,KNA,Perlis,0,0,0
2022-12-01,KNA,Pulau Pinang,9,8,1
2022-12-01,KNA,Sabah,1,1,0
2022-12-01,KNA,Selangor,58,37,21
2022-12-01,KNA,W.P. Labuan,0,0,0
2022-12-01,KOR,Johor,9911,5334,4577
2022-12-01,KOR,Kedah,243,114,129
2022-12-01,KOR,Kelantan,0,0,0
2022-12-01,KOR,Melaka,0,0,0
2022-12-01,KOR,Negeri Sembilan,0,0,0
2022-12-01,KOR,Pahang,10,3,7
2022-12-01,KOR,Perak,10,2,8
2022-12-01,KOR,Perlis,85,65,20
2022-12-01,KOR,Pulau Pinang,387,215,172
2022-12-01,KOR,Sabah,12363,5398,6965
2022-12-01,KOR,Sarawak,230,132,98
2022-12-01,KOR,Selangor,11169,6041,5128
2022-12-01,KOR,Terengganu,0,0,0
2022-12-01,KOR,W.P. Labuan,7,6,1
2022-12-01,KWT,Johor,9,6,3
2022-12-01,KWT,Kedah,1,0,1
2022-12-01,KWT,Kelantan,0,0,0
2022-12-01,KWT,Perak,0,0,0
2022-12-01,KWT,Perlis,0,0,0
2022-12-01,KWT,Pulau Pinang,1,1,0
2022-12-01,KWT,Sabah,0,0,0
2022-12-01,KWT,Sarawak,4,2,2
2022-12-01,KWT,Selangor,444,270,174
2022-12-01,KWT,W.P. Labuan,0,0,0
2022-12-01,LAO,Johor,158,46,112
2022-12-01,LAO,Kedah,749,73,676
2022-12-01,LAO,Kelantan,121,12,109
2022-12-01,LAO,Melaka,0,0,0
2022-12-01,LAO,Perak,17,4,13
2022-12-01,LAO,Perlis,217,76,141
2022-12-01,LAO,Pulau Pinang,11,0,11
2022-12-01,LAO,Sabah,1,0,1
2022-12-01,LAO,Sarawak,11,2,9
2022-12-01,LAO,Selangor,211,84,127
2022-12-01,LAO,W.P. Labuan,0,0,0
2022-12-01,LBN,Johor,23,12,11
2022-12-01,LBN,Kedah,1,0,1
2022-12-01,LBN,Kelantan,0,0,0
2022-12-01,LBN,Pahang,0,0,0
2022-12-01,LBN,Perak,0,0,0
2022-12-01,LBN,Perlis,1,1,0
2022-12-01,LBN,Pulau Pinang,4,4,0
2022-12-01,LBN,Sabah,0,0,0
2022-12-01,LBN,Sarawak,1,1,0
2022-12-01,LBN,Selangor,233,137,96
2022-12-01,LBN,W.P. Labuan,0,0,0
2022-12-01,LBR,Johor,1,1,0
2022-12-01,LBR,Kedah,0,0,0
2022-12-01,LBR,Sabah,0,0,0
2022-12-01,LBR,Sarawak,0,0,0
2022-12-01,LBR,Selangor,12,11,1
2022-12-01,LBY,Johor,0,0,0
2022-12-01,LBY,Kedah,1,1,0
2022-12-01,LBY,Perlis,0,0,0
2022-12-01,LBY,Pulau Pinang,1,1,0
2022-12-01,LBY,Sabah,0,0,0
2022-12-01,LBY,Sarawak,1,1,0
2022-12-01,LBY,Selangor,200,138,62
2022-12-01,LCA,Johor,2,2,0
2022-12-01,LCA,Kedah,0,0,0
2022-12-01,LCA,Pulau Pinang,1,0,1
2022-12-01,LCA,Sarawak,6,3,3
2022-12-01,LCA,Selangor,9,7,2
2022-12-01,LIE,Johor,1,1,0
2022-12-01,LIE,Kedah,5,3,2
2022-12-01,LIE,Perlis,0,0,0
2022-12-01,LIE,Pulau Pinang,0,0,0
2022-12-01,LIE,Sabah,0,0,0
2022-12-01,LIE,Sarawak,0,0,0
2022-12-01,LIE,Selangor,5,3,2
2022-12-01,LKA,Johor,1116,675,441
2022-12-01,LKA,Kedah,11,5,6
2022-12-01,LKA,Kelantan,0,0,0
2022-12-01,LKA,Melaka,0,0,0
2022-12-01,LKA,Pahang,0,0,0
2022-12-01,LKA,Perak,10,4,6
2022-12-01,LKA,Perlis,1,1,0
2022-12-01,LKA,Pulau Pinang,15,13,2
2022-12-01,LKA,Sabah,12,7,5
2022-12-01,LKA,Sarawak,29,17,12
2022-12-01,LKA,Selangor,3681,2244,1437
2022-12-01,LKA,W.P. Labuan,2,2,0
2022-12-01,LSO,Johor,0,0,0
2022-12-01,LSO,Kedah,0,0,0
2022-12-01,LSO,Pulau Pinang,0,0,0
2022-12-01,LSO,Sarawak,0,0,0
2022-12-01,LSO,Selangor,6,3,3
2022-12-01,LTU,Johor,37,18,19
2022-12-01,LTU,Kedah,25,9,16
2022-12-01,LTU,Kelantan,0,0,0
2022-12-01,LTU,Pahang,0,0,0
2022-12-01,LTU,Perak,0,0,0
2022-12-01,LTU,Perlis,9,4,5
2022-12-01,LTU,Pulau Pinang,6,6,0
2022-12-01,LTU,Sabah,5,4,1
2022-12-01,LTU,Sarawak,7,4,3
2022-12-01,LTU,Selangor,205,101,104
2022-12-01,LTU,W.P. Labuan,0,0,0
2022-12-01,LUX,Johor,2,1,1
2022-12-01,LUX,Kedah,4,2,2
2022-12-01,LUX,Kelantan,0,0,0
2022-12-01,LUX,Perak,0,0,0
2022-12-01,LUX,Perlis,0,0,0
2022-12-01,LUX,Pulau Pinang,3,1,2
2022-12-01,LUX,Sabah,2,1,1
2022-12-01,LUX,Sarawak,0,0,0
2022-12-01,LUX,Selangor,39,19,20
2022-12-01,LVA,Johor,19,12,7
2022-12-01,LVA,Kedah,10,4,6
2022-12-01,LVA,Kelantan,0,0,0
2022-12-01,LVA,Pahang,0,0,0
2022-12-01,LVA,Perak,1,1,0
2022-12-01,LVA,Perlis,6,3,3
2022-12-01,LVA,Pulau Pinang,3,2,1
2022-12-01,LVA,Sabah,0,0,0
2022-12-01,LVA,Sarawak,8,3,5
2022-12-01,LVA,Selangor,120,65,55
2022-12-01,LVA,W.P. Labuan,0,0,0
2022-12-01,MAC,Johor,0,0,0
2022-12-01,MAC,Pahang,0,0,0
2022-12-01,MAC,Perak,3,2,1
2022-12-01,MAC,Selangor,6,2,4
2022-12-01,MAC,W.P. Labuan,0,0,0
2022-12-01,MAR,Johor,60,29,31
2022-12-01,MAR,Kedah,5,3,2
2022-12-01,MAR,Kelantan,0,0,0
2022-12-01,MAR,Melaka,1,0,1
2022-12-01,MAR,Pahang,0,0,0
2022-12-01,MAR,Perak,0,0,0
2022-12-01,MAR,Perlis,1,0,1
2022-12-01,MAR,Pulau Pinang,15,14,1
2022-12-01,MAR,Sabah,3,3,0
2022-12-01,MAR,Sarawak,10,7,3
2022-12-01,MAR,Selangor,386,211,175
2022-12-01,MAR,W.P. Labuan,1,1,0
2022-12-01,MCO,Johor,1,1,0
2022-12-01,MCO,Kedah,0,0,0
2022-12-01,MCO,Sabah,0,0,0
2022-12-01,MCO,Selangor,0,0,0
2022-12-01,MDA,Johor,8,3,5
2022-12-01,MDA,Kedah,0,0,0
2022-12-01,MDA,Kelantan,0,0,0
2022-12-01,MDA,Negeri Sembilan,0,0,0
2022-12-01,MDA,Perlis,0,0,0
2022-12-01,MDA,Pulau Pinang,3,3,0
2022-12-01,MDA,Sabah,0,0,0
2022-12-01,MDA,Sarawak,0,0,0
2022-12-01,MDA,Selangor,13,8,5
2022-12-01,MDG,Johor,3,1,2
2022-12-01,MDG,Kedah,0,0,0
2022-12-01,MDG,Perak,0,0,0
2022-12-01,MDG,Perlis,0,0,0
2022-12-01,MDG,Pulau Pinang,1,0,1
2022-12-01,MDG,Sabah,0,0,0
2022-12-01,MDG,Sarawak,0,0,0
2022-12-01,MDG,Selangor,32,14,18
2022-12-01,MDV,Johor,174,86,88
2022-12-01,MDV,Kedah,0,0,0
2022-12-01,MDV,Kelantan,0,0,0
2022-12-01,MDV,Perak,2,1,1
2022-12-01,MDV,Perlis,5,2,3
2022-12-01,MDV,Pulau Pinang,2,1,1
2022-12-01,MDV,Sabah,0,0,0
2022-12-01,MDV,Sarawak,1,0,1
2022-12-01,MDV,Selangor,2847,1392,1455
2022-12-01,MEX,Johor,101,47,54
2022-12-01,MEX,Kedah,7,4,3
2022-12-01,MEX,Kelantan,0,0,0
2022-12-01,MEX,Pahang,0,0,0
2022-12-01,MEX,Perak,3,2,1
2022-12-01,MEX,Perlis,1,0,1
2022-12-01,MEX,Pulau Pinang,22,17,5
2022-12-01,MEX,Sabah,7,4,3
2022-12-01,MEX,Sarawak,3,2,1
2022-12-01,MEX,Selangor,338,185,153
2022-12-01,MEX,W.P. Labuan,0,0,0
2022-12-01,MHL,Johor,0,0,0
2022-12-01,MHL,Kedah,0,0,0
2022-12-01,MHL,Perak,0,0,0
2022-12-01,MHL,Pulau Pinang,0,0,0
2022-12-01,MHL,Sabah,0,0,0
2022-12-01,MHL,Selangor,0,0,0
2022-12-01,MKD,Johor,5,2,3
2022-12-01,MKD,Kedah,1,1,0
2022-12-01,MKD,Perak,0,0,0
2022-12-01,MKD,Pulau Pinang,0,0,0
2022-12-01,MKD,Sabah,0,0,0
2022-12-01,MKD,Sarawak,1,0,1
2022-12-01,MKD,Selangor,21,9,12
2022-12-01,MLI,Johor,5,5,0
2022-12-01,MLI,Sabah,0,0,0
2022-12-01,MLI,Selangor,3,3,0
2022-12-01,MLT,Johor,6,5,1
2022-12-01,MLT,Kedah,7,4,3
2022-12-01,MLT,Kelantan,0,0,0
2022-12-01,MLT,Perak,0,0,0
2022-12-01,MLT,Perlis,0,0,0
2022-12-01,MLT,Pulau Pinang,2,1,1
2022-12-01,MLT,Sabah,0,0,0
2022-12-01,MLT,Sarawak,1,1,0
2022-12-01,MLT,Selangor,39,25,14
2022-12-01,MLT,W.P. Labuan,0,0,0
2022-12-01,MMR,Johor,4608,1237,3371
2022-12-01,MMR,Kedah,72,8,64
2022-12-01,MMR,Kelantan,2,1,1
2022-12-01,MMR,Negeri Sembilan,0,0,0
2022-12-01,MMR,Pahang,0,0,0
2022-12-01,MMR,Perak,32,5,27
2022-12-01,MMR,Perlis,14,2,12
2022-12-01,MMR,Pulau Pinang,176,61,115
2022-12-01,MMR,Sabah,21,4,17
2022-12-01,MMR,Sarawak,108,37,71
2022-12-01,MMR,Selangor,8288,5817,2471
2022-12-01,MMR,Terengganu,0,0,0
2022-12-01,MMR,W.P. Labuan,1,1,0
2022-12-01,MNE,Johor,1,1,0
2022-12-01,MNE,Kedah,0,0,0
2022-12-01,MNE,Pulau Pinang,0,0,0
2022-12-01,MNE,Sabah,0,0,0
2022-12-01,MNE,Sarawak,0,0,0
2022-12-01,MNE,Selangor,6,6,0
2022-12-01,MNG,Johor,264,121,143
2022-12-01,MNG,Kedah,10,3,7
2022-12-01,MNG,Kelantan,0,0,0
2022-12-01,MNG,Perak,0,0,0
2022-12-01,MNG,Perlis,7,5,2
2022-12-01,MNG,Pulau Pinang,19,10,9
2022-12-01,MNG,Sabah,30,14,16
2022-12-01,MNG,Sarawak,0,0,0
2022-12-01,MNG,Selangor,350,128,222
2022-12-01,MNP,Selangor,0,0,0
2022-12-01,MOZ,Johor,2,1,1
2022-12-01,MOZ,Kedah,11,7,4
2022-12-01,MOZ,Perak,0,0,0
2022-12-01,MOZ,Pulau Pinang,0,0,0
2022-12-01,MOZ,Sabah,0,0,0
2022-12-01,MOZ,Sarawak,0,0,0
2022-12-01,MOZ,Selangor,9,2,7
2022-12-01,MRT,Johor,3,3,0
2022-12-01,MRT,Kedah,0,0,0
2022-12-01,MRT,Pulau Pinang,0,0,0
2022-12-01,MRT,Sabah,0,0,0
2022-12-01,MRT,Sarawak,0,0,0
2022-12-01,MRT,Selangor,12,8,4
2022-12-01,MUS,Johor,266,142,124
2022-12-01,MUS,Kedah,1,0,1
2022-12-01,MUS,Kelantan,0,0,0
2022-12-01,MUS,Pahang,0,0,0
2022-12-01,MUS,Perak,4,1,3
2022-12-01,MUS,Perlis,5,3,2
2022-12-01,MUS,Pulau Pinang,17,7,10
2022-12-01,MUS,Sabah,1,1,0
2022-12-01,MUS,Sarawak,1,1,0
2022-12-01,MUS,Selangor,1985,932,1053
2022-12-01,MWI,Johor,10,4,6
2022-12-01,MWI,Pulau Pinang,1,1,0
2022-12-01,MWI,Sabah,0,0,0
2022-12-01,MWI,Sarawak,0,0,0
2022-12-01,MWI,Selangor,10,4,6
2022-12-01,MYT,Selangor,0,0,0
2022-12-01,NAM,Johor,1,0,1
2022-12-01,NAM,Kedah,0,0,0
2022-12-01,NAM,Perak,0,0,0
2022-12-01,NAM,Perlis,0,0,0
2022-12-01,NAM,Pulau Pinang,0,0,0
2022-12-01,NAM,Sabah,0,0,0
2022-12-01,NAM,Sarawak,0,0,0
2022-12-01,NAM,Selangor,16,6,10
2022-12-01,NCL,Selangor,0,0,0
2022-12-01,NER,Johor,0,0,0
2022-12-01,NER,Sabah,0,0,0
2022-12-01,NER,Selangor,3,1,2
2022-12-01,NGA,Johor,30,26,4
2022-12-01,NGA,Kedah,4,4,0
2022-12-01,NGA,Perlis,0,0,0
2022-12-01,NGA,Pulau Pinang,2,1,1
2022-12-01,NGA,Sabah,0,0,0
2022-12-01,NGA,Sarawak,13,8,5
2022-12-01,NGA,Selangor,242,178,64
2022-12-01,NIC,Johor,1,1,0
2022-12-01,NIC,Kedah,0,0,0
2022-12-01,NIC,Pulau Pinang,0,0,0
2022-12-01,NIC,Sabah,0,0,0
2022-12-01,NIC,Selangor,5,2,3
2022-12-01,NLD,Johor,788,541,247
2022-12-01,NLD,Kedah,240,124,116
2022-12-01,NLD,Kelantan,2,2,0
2022-12-01,NLD,Melaka,0,0,0
2022-12-01,NLD,Negeri Sembilan,2,1,1
2022-12-01,NLD,Pahang,6,5,1
2022-12-01,NLD,Perak,12,9,3
2022-12-01,NLD,Perlis,24,17,7
2022-12-01,NLD,Pulau Pinang,167,100,67
2022-12-01,NLD,Sabah,33,20,13
2022-12-01,NLD,Sarawak,132,82,50
2022-12-01,NLD,Selangor,2656,1615,1041
2022-12-01,NLD,Terengganu,0,0,0
2022-12-01,NLD,W.P. Labuan,1,1,0
2022-12-01,NOR,Johor,147,94,53
2022-12-01,NOR,Kedah,40,24,16
2022-12-01,NOR,Kelantan,0,0,0
2022-12-01,NOR,Melaka,0,0,0
2022-12-01,NOR,Pahang,0,0,0
2022-12-01,NOR,Perak,0,0,0
2022-12-01,NOR,Perlis,10,7,3
2022-12-01,NOR,Pulau Pinang,16,12,4
2022-12-01,NOR,Sabah,5,4,1
2022-12-01,NOR,Sarawak,19,12,7
2022-12-01,NOR,Selangor,562,348,214
2022-12-01,NOR,W.P. Labuan,1,1,0
2022-12-01,NPL,Johor,486,404,82
2022-12-01,NPL,Kedah,18,11,7
2022-12-01,NPL,Pahang,0,0,0
2022-12-01,NPL,Perak,0,0,0
2022-12-01,NPL,Perlis,2,2,0
2022-12-01,NPL,Pulau Pinang,25,24,1
2022-12-01,NPL,Sabah,6,4,2
2022-12-01,NPL,Sarawak,457,318,139
2022-12-01,NPL,Selangor,25621,24929,692
2022-12-01,NPL,W.P. Labuan,77,75,2
2022-12-01,NRU,Johor,0,0,0
2022-12-01,NRU,Pulau Pinang,0,0,0
2022-12-01,NRU,Selangor,1,1,0
2022-12-01,NZL,Johor,773,437,336
2022-12-01,NZL,Kedah,75,39,36
2022-12-01,NZL,Kelantan,3,0,3
2022-12-01,NZL,Melaka,0,0,0
2022-12-01,NZL,Negeri Sembilan,0,0,0
2022-12-01,NZL,Pahang,0,0,0
2022-12-01,NZL,Perak,32,20,12
2022-12-01,NZL,Perlis,10,4,6
2022-12-01,NZL,Pulau Pinang,222,124,98
2022-12-01,NZL,Sabah,64,27,37
2022-12-01,NZL,Sarawak,157,83,74
2022-12-01,NZL,Selangor,3309,1852,1457
2022-12-01,NZL,Terengganu,0,0,0
2022-12-01,NZL,W.P. Labuan,2,2,0
2022-12-01,OMN,Johor,31,22,9
2022-12-01,OMN,Kedah,1,1,0
2022-12-01,OMN,Kelantan,2,1,1
2022-12-01,OMN,Melaka,0,0,0
2022-12-01,OMN,Perak,0,0,0
2022-12-01,OMN,Perlis,0,0,0
2022-12-01,OMN,Pulau Pinang,5,3,2
2022-12-01,OMN,Sabah,3,3,0
2022-12-01,OMN,Sarawak,6,3,3
2022-12-01,OMN,Selangor,533,325,208
2022-12-01,PAK,Johor,779,554,225
2022-12-01,PAK,Kedah,123,86,37
2022-12-01,PAK,Kelantan,4,4,0
2022-12-01,PAK,Melaka,0,0,0
2022-12-01,PAK,Negeri Sembilan,1,1,0
2022-12-01,PAK,Pahang,5,2,3
2022-12-01,PAK,Perak,41,41,0
2022-12-01,PAK,Perlis,30,28,2
2022-12-01,PAK,Pulau Pinang,49,46,3
2022-12-01,PAK,Sabah,34,31,3
2022-12-01,PAK,Sarawak,204,160,44
2022-12-01,PAK,Selangor,10196,8776,1420
2022-12-01,PAK,W.P. Labuan,8,6,2
2022-12-01,PAN,Johor,5,1,4
2022-12-01,PAN,Kedah,0,0,0
2022-12-01,PAN,Perak,0,0,0
2022-12-01,PAN,Perlis,0,0,0
2022-12-01,PAN,Pulau Pinang,0,0,0
2022-12-01,PAN,Sabah,1,1,0
2022-12-01,PAN,Sarawak,0,0,0
2022-12-01,PAN,Selangor,16,9,7
2022-12-01,PER,Johor,26,15,11
2022-12-01,PER,Kedah,1,0,1
2022-12-01,PER,Kelantan,0,0,0
2022-12-01,PER,Pahang,0,0,0
2022-12-01,PER,Perak,0,0,0
2022-12-01,PER,Perlis,3,0,3
2022-12-01,PER,Pulau Pinang,3,2,1
2022-12-01,PER,Sabah,0,0,0
2022-12-01,PER,Sarawak,0,0,0
2022-12-01,PER,Selangor,89,46,43
2022-12-01,PER,W.P. Labuan,0,0,0
2022-12-01,PHL,Johor,19506,6147,13359
2022-12-01,PHL,Kedah,426,141,285
2022-12-01,PHL,Kelantan,19,13,6
2022-12-01,PHL,Melaka,0,0,0
2022-12-01,PHL,Negeri Sembilan,0,0,0
2022-12-01,PHL,Pahang,5,2,3
2022-12-01,PHL,Perak,100,31,69
2022-12-01,PHL,Perlis,88,29,59
2022-12-01,PHL,Pulau Pinang,399,114,285
2022-12-01,PHL,Sabah,1705,695,1010
2022-12-01,PHL,Sarawak,2342,847,1495
2022-12-01,PHL,Selangor,15026,5792,9234
2022-12-01,PHL,Terengganu,0,0,0
2022-12-01,PHL,W.P. Labuan,140,49,91
2022-12-01,PLW,Johor,3,3,0
2022-12-01,PLW,Pulau Pinang,0,0,0
2022-12-01,PLW,Selangor,0,0,0
2022-12-01,PNG,Johor,13,7,6
2022-12-01,PNG,Kedah,0,0,0
2022-12-01,PNG,Kelantan,0,0,0
2022-12-01,PNG,Perak,0,0,0
2022-12-01,PNG,Pulau Pinang,0,0,0
2022-12-01,PNG,Sabah,1,0,1
2022-12-01,PNG,Sarawak,7,3,4
2022-12-01,PNG,Selangor,33,17,16
2022-12-01,POL,Johor,272,159,113
2022-12-01,POL,Kedah,98,44,54
2022-12-01,POL,Kelantan,2,1,1
2022-12-01,POL,Melaka,0,0,0
2022-12-01,POL,Negeri Sembilan,0,0,0
2022-12-01,POL,Pahang,0,0,0
2022-12-01,POL,Perak,1,1,0
2022-12-01,POL,Perlis,22,14,8
2022-12-01,POL,Pulau Pinang,55,27,28
2022-12-01,POL,Sabah,22,13,9
2022-12-01,POL,Sarawak,28,14,14
2022-12-01,POL,Selangor,668,357,311
2022-12-01,POL,Terengganu,0,0,0
2022-12-01,POL,W.P. Labuan,2,1,1
2022-12-01,PRK,Selangor,0,0,0
2022-12-01,PRT,Johor,128,72,56
2022-12-01,PRT,Kedah,40,21,19
2022-12-01,PRT,Kelantan,0,0,0
2022-12-01,PRT,Melaka,0,0,0
2022-12-01,PRT,Pahang,0,0,0
2022-12-01,PRT,Perak,6,2,4
2022-12-01,PRT,Perlis,0,0,0
2022-12-01,PRT,Pulau Pinang,13,6,7
2022-12-01,PRT,Sabah,3,2,1
2022-12-01,PRT,Sarawak,5,1,4
2022-12-01,PRT,Selangor,456,261,195
2022-12-01,PRT,W.P. Labuan,0,0,0
2022-12-01,PRY,Johor,1,1,0
2022-12-01,PRY,Kedah,0,0,0
2022-12-01,PRY,Perak,0,0,0
2022-12-01,PRY,Perlis,0,0,0
2022-12-01,PRY,Pulau Pinang,6,6,0
2022-12-01,PRY,Sabah,0,0,0
2022-12-01,PRY,Sarawak,0,0,0
2022-12-01,PRY,Selangor,5,3,2
2022-12-01,PSE,Johor,6,5,1
2022-12-01,PSE,Kedah,0,0,0
2022-12-01,PSE,Kelantan,3,2,1
2022-12-01,PSE,Melaka,0,0,0
2022-12-01,PSE,Perak,0,0,0
2022-12-01,PSE,Perlis,0,0,0
2022-12-01,PSE,Pulau Pinang,2,1,1
2022-12-01,PSE,Sabah,0,0,0
2022-12-01,PSE,Sarawak,1,1,0
2022-12-01,PSE,Selangor,207,137,70
2022-12-01,QAT,Johor,12,4,8
2022-12-01,QAT,Kedah,0,0,0
2022-12-01,QAT,Perlis,0,0,0
2022-12-01,QAT,Pulau Pinang,0,0,0
2022-12-01,QAT,Sabah,0,0,0
2022-12-01,QAT,Sarawak,0,0,0
2022-12-01,QAT,Selangor,54,32,22
2022-12-01,REU,Johor,0,0,0
2022-12-01,REU,Sarawak,0,0,0
2022-12-01,ROU,Johor,141,77,64
2022-12-01,ROU,Kedah,34,21,13
2022-12-01,ROU,Kelantan,0,0,0
2022-12-01,ROU,Negeri Sembilan,0,0,0
2022-12-01,ROU,Pahang,0,0,0
2022-12-01,ROU,Perak,4,3,1
2022-12-01,ROU,Perlis,4,3,1
2022-12-01,ROU,Pulau Pinang,20,9,11
2022-12-01,ROU,Sabah,5,2,3
2022-12-01,ROU,Sarawak,22,13,9
2022-12-01,ROU,Selangor,553,290,263
2022-12-01,ROU,W.P. Labuan,0,0,0
2022-12-01,RUS,Johor,448,221,227
2022-12-01,RUS,Kedah,569,312,257
2022-12-01,RUS,Kelantan,39,26,13
2022-12-01,RUS,Melaka,2,1,1
2022-12-01,RUS,Negeri Sembilan,0,0,0
2022-12-01,RUS,Pahang,0,0,0
2022-12-01,RUS,Perak,10,5,5
2022-12-01,RUS,Perlis,552,320,232
2022-12-01,RUS,Pulau Pinang,329,173,156
2022-12-01,RUS,Sabah,53,27,26
2022-12-01,RUS,Sarawak,69,35,34
2022-12-01,RUS,Selangor,10820,5835,4985
2022-12-01,RUS,W.P. Labuan,0,0,0
2022-12-01,RWA,Johor,1,0,1
2022-12-01,RWA,Kedah,0,0,0
2022-12-01,RWA,Pulau Pinang,0,0,0
2022-12-01,RWA,Selangor,5,2,3
2022-12-01,SAU,Johor,73,53,20
2022-12-01,SAU,Kedah,15,7,8
2022-12-01,SAU,Kelantan,0,0,0
2022-12-01,SAU,Melaka,0,0,0
2022-12-01,SAU,Perak,0,0,0
2022-12-01,SAU,Perlis,7,4,3
2022-12-01,SAU,Pulau Pinang,4,3,1
2022-12-01,SAU,Sabah,5,3,2
2022-12-01,SAU,Sarawak,15,9,6
2022-12-01,SAU,Selangor,2309,1305,1004
2022-12-01,SAU,W.P. Labuan,1,1,0
2022-12-01,SDN,Johor,8,2,6
2022-12-01,SDN,Kedah,1,1,0
2022-12-01,SDN,Kelantan,0,0,0
2022-12-01,SDN,Perlis,0,0,0
2022-12-01,SDN,Pulau Pinang,1,0,1
2022-12-01,SDN,Sabah,0,0,0
2022-12-01,SDN,Sarawak,5,4,1
2022-12-01,SDN,Selangor,835,468,367
2022-12-01,SDN,W.P. Labuan,0,0,0
2022-12-01,SEN,Johor,3,1,2
2022-12-01,SEN,Kedah,0,0,0
2022-12-01,SEN,Kelantan,0,0,0
2022-12-01,SEN,Perak,0,0,0
2022-12-01,SEN,Perlis,0,0,0
2022-12-01,SEN,Pulau Pinang,0,0,0
2022-12-01,SEN,Sabah,0,0,0
2022-12-01,SEN,Sarawak,0,0,0
2022-12-01,SEN,Selangor,12,9,3
2022-12-01,SGP,Johor,1151986,631496,520490
2022-12-01,SGP,Kedah,6597,3389,3208
2022-12-01,SGP,Kelantan,46,28,18
2022-12-01,SGP,Melaka,16,14,2
2022-12-01,SGP,Negeri Sembilan,1,1,0
2022-12-01,SGP,Pahang,564,281,283
2022-12-01,SGP,Perak,7950,3875,4075
2022-12-01,SGP,Perlis,571,279,292
2022-12-01,SGP,Pulau Pinang,20185,9923,10262
2022-12-01,SGP,Sabah,4405,2210,2195
2022-12-01,SGP,Sarawak,6115,3114,3001
2022-12-01,SGP,Selangor,68868,33621,35247
2022-12-01,SGP,Terengganu,0,0,0
2022-12-01,SGP,W.P. Labuan,18,15,3
2022-12-01,SGS,Johor,0,0,0
2022-12-01,SGS,Sabah,0,0,0
2022-12-01,SGS,Selangor,0,0,0
2022-12-01,SHN,Sarawak,0,0,0
2022-12-01,SLB,Johor,0,0,0
2022-12-01,SLB,Perlis,0,0,0
2022-12-01,SLB,Pulau Pinang,0,0,0
2022-12-01,SLB,Sabah,0,0,0
2022-12-01,SLB,Sarawak,3,3,0
2022-12-01,SLB,Selangor,6,4,2
2022-12-01,SLB,W.P. Labuan,0,0,0
2022-12-01,SLE,Johor,1,1,0
2022-12-01,SLE,Kedah,0,0,0
2022-12-01,SLE,Perak,0,0,0
2022-12-01,SLE,Pulau Pinang,0,0,0
2022-12-01,SLE,Sabah,0,0,0
2022-12-01,SLE,Selangor,12,10,2
2022-12-01,SLV,Johor,0,0,0
2022-12-01,SLV,Kedah,1,1,0
2022-12-01,SLV,Perak,0,0,0
2022-12-01,SLV,Perlis,0,0,0
2022-12-01,SLV,Pulau Pinang,2,2,0
2022-12-01,SLV,Sabah,0,0,0
2022-12-01,SLV,Selangor,11,7,4
2022-12-01,SLV,W.P. Labuan,0,0,0
2022-12-01,SMR,Johor,0,0,0
2022-12-01,SMR,Selangor,0,0,0
2022-12-01,SOM,Johor,0,0,0
2022-12-01,SOM,Kedah,0,0,0
2022-12-01,SOM,Kelantan,0,0,0
2022-12-01,SOM,Perlis,0,0,0
2022-12-01,SOM,Sabah,0,0,0
2022-12-01,SOM,Sarawak,0,0,0
2022-12-01,SOM,Selangor,174,117,57
2022-12-01,SRB,Johor,10,5,5
2022-12-01,SRB,Kedah,0,0,0
2022-12-01,SRB,Kelantan,0,0,0
2022-12-01,SRB,Pahang,0,0,0
2022-12-01,SRB,Perak,0,0,0
2022-12-01,SRB,Perlis,0,0,0
2022-12-01,SRB,Pulau Pinang,0,0,0
2022-12-01,SRB,Sabah,1,1,0
2022-12-01,SRB,Sarawak,0,0,0
2022-12-01,SRB,Selangor,69,41,28
2022-12-01,SSD,Johor,0,0,0
2022-12-01,SSD,Kedah,0,0,0
2022-12-01,SSD,Sarawak,1,1,0
2022-12-01,SSD,Selangor,31,28,3
2022-12-01,SSD,W.P. Labuan,0,0,0
2022-12-01,STP,Selangor,1,1,0
2022-12-01,SUR,Johor,1,1,0
2022-12-01,SUR,Kedah,0,0,0
2022-12-01,SUR,Kelantan,0,0,0
2022-12-01,SUR,Perak,0,0,0
2022-12-01,SUR,Perlis,0,0,0
2022-12-01,SUR,Pulau Pinang,0,0,0
2022-12-01,SUR,Sabah,0,0,0
2022-12-01,SUR,Sarawak,0,0,0
2022-12-01,SUR,Selangor,19,8,11
2022-12-01,SVK,Johor,30,15,15
2022-12-01,SVK,Kedah,55,28,27
2022-12-01,SVK,Kelantan,1,0,1
2022-12-01,SVK,Negeri Sembilan,0,0,0
2022-12-01,SVK,Pahang,0,0,0
2022-12-01,SVK,Perak,0,0,0
2022-12-01,SVK,Perlis,1,0,1
2022-12-01,SVK,Pulau Pinang,8,8,0
2022-12-01,SVK,Sabah,9,5,4
2022-12-01,SVK,Sarawak,7,3,4
2022-12-01,SVK,Selangor,232,115,117
2022-12-01,SVK,W.P. Labuan,0,0,0
2022-12-01,SVN,Johor,7,2,5
2022-12-01,SVN,Kedah,13,7,6
2022-12-01,SVN,Kelantan,0,0,0
2022-12-01,SVN,Perak,0,0,0
2022-12-01,SVN,Perlis,2,2,0
2022-12-01,SVN,Pulau Pinang,0,0,0
2022-12-01,SVN,Sabah,0,0,0
2022-12-01,SVN,Sarawak,1,0,1
2022-12-01,SVN,Selangor,67,40,27
2022-12-01,SVN,W.P. Labuan,0,0,0
2022-12-01,SWE,Johor,256,139,117
2022-12-01,SWE,Kedah,189,99,90
2022-12-01,SWE,Kelantan,0,0,0
2022-12-01,SWE,Melaka,0,0,0
2022-12-01,SWE,Negeri Sembilan,0,0,0
2022-12-01,SWE,Pahang,0,0,0
2022-12-01,SWE,Perak,7,3,4
2022-12-01,SWE,Perlis,26,18,8
2022-12-01,SWE,Pulau Pinang,72,43,29
2022-12-01,SWE,Sabah,39,21,18
2022-12-01,SWE,Sarawak,32,23,9
2022-12-01,SWE,Selangor,1159,663,496
2022-12-01,SWE,W.P. Labuan,0,0,0
2022-12-01,SWZ,Johor,1,1,0
2022-12-01,SWZ,Kedah,0,0,0
2022-12-01,SWZ,Pulau Pinang,0,0,0
2022-12-01,SWZ,Sabah,0,0,0
2022-12-01,SWZ,Selangor,22,14,8
2022-12-01,SYC,Johor,3,3,0
2022-12-01,SYC,Kedah,0,0,0
2022-12-01,SYC,Pulau Pinang,0,0,0
2022-12-01,SYC,Sabah,0,0,0
2022-12-01,SYC,Sarawak,0,0,0
2022-12-01,SYC,Selangor,71,24,47
2022-12-01,SYR,Johor,23,8,15
2022-12-01,SYR,Kedah,0,0,0
2022-12-01,SYR,Kelantan,0,0,0
2022-12-01,SYR,Pahang,0,0,0
2022-12-01,SYR,Perlis,0,0,0
2022-12-01,SYR,Pulau Pinang,1,1,0
2022-12-01,SYR,Sabah,0,0,0
2022-12-01,SYR,Sarawak,14,10,4
2022-12-01,SYR,Selangor,439,284,155
2022-12-01,SYR,W.P. Labuan,2,2,0
2022-12-01,TCA,Perlis,0,0,0
2022-12-01,TCD,Johor,1,1,0
2022-12-01,TCD,Kedah,0,0,0
2022-12-01,TCD,Perlis,0,0,0
2022-12-01,TCD,Selangor,18,10,8
2022-12-01,TGO,Johor,2,1,1
2022-12-01,TGO,Perak,0,0,0
2022-12-01,TGO,Pulau Pinang,0,0,0
2022-12-01,TGO,Selangor,3,3,0
2022-12-01,THA,Johor,5450,1568,3882
2022-12-01,THA,Kedah,57007,33206,23801
2022-12-01,THA,Kelantan,25530,12900,12630
2022-12-01,THA,Melaka,2,0,2
2022-12-01,THA,Negeri Sembilan,2,1,1
2022-12-01,THA,Pahang,0,0,0
2022-12-01,THA,Perak,8624,4023,4601
2022-12-01,THA,Perlis,50271,30816,19455
2022-12-01,THA,Pulau Pinang,1651,647,1004
2022-12-01,THA,Sabah,113,26,87
2022-12-01,THA,Sarawak,345,127,218
2022-12-01,THA,Selangor,10889,4288,6601
2022-12-01,THA,Terengganu,0,0,0
2022-12-01,THA,W.P. Labuan,2,2,0
2022-12-01,TJK,Johor,1,1,0
2022-12-01,TJK,Kedah,1,0,1
2022-12-01,TJK,Perlis,0,0,0
2022-12-01,TJK,Pulau Pinang,0,0,0
2022-12-01,TJK,Sabah,0,0,0
2022-12-01,TJK,Selangor,98,66,32
2022-12-01,TKL,Selangor,0,0,0
2022-12-01,TKM,Johor,1,1,0
2022-12-01,TKM,Kedah,0,0,0
2022-12-01,TKM,Kelantan,0,0,0
2022-12-01,TKM,Perlis,0,0,0
2022-12-01,TKM,Pulau Pinang,0,0,0
2022-12-01,TKM,Sabah,0,0,0
2022-12-01,TKM,Sarawak,0,0,0
2022-12-01,TKM,Selangor,56,38,18
2022-12-01,TLS,Johor,12,7,5
2022-12-01,TLS,Kedah,0,0,0
2022-12-01,TLS,Perlis,0,0,0
2022-12-01,TLS,Pulau Pinang,6,3,3
2022-12-01,TLS,Sabah,1,0,1
2022-12-01,TLS,Sarawak,2,0,2
2022-12-01,TLS,Selangor,219,112,107
2022-12-01,TON,Johor,0,0,0
2022-12-01,TON,Pulau Pinang,1,0,1
2022-12-01,TON,Sarawak,0,0,0
2022-12-01,TON,Selangor,6,6,0
2022-12-01,TTO,Johor,1,1,0
2022-12-01,TTO,Kedah,0,0,0
2022-12-01,TTO,Pahang,0,0,0
2022-12-01,TTO,Pulau Pinang,0,0,0
2022-12-01,TTO,Sabah,0,0,0
2022-12-01,TTO,Sarawak,5,4,1
2022-12-01,TTO,Selangor,27,15,12
2022-12-01,TUN,Johor,32,16,16
2022-12-01,TUN,Kedah,2,1,1
2022-12-01,TUN,Kelantan,0,0,0
2022-12-01,TUN,Melaka,0,0,0
2022-12-01,TUN,Perak,0,0,0
2022-12-01,TUN,Perlis,0,0,0
2022-12-01,TUN,Pulau Pinang,4,3,1
2022-12-01,TUN,Sabah,1,1,0
2022-12-01,TUN,Sarawak,1,1,0
2022-12-01,TUN,Selangor,286,148,138
2022-12-01,TUN,W.P. Labuan,0,0,0
2022-12-01,TUR,Johor,198,124,74
2022-12-01,TUR,Kedah,27,17,10
2022-12-01,TUR,Kelantan,2,1,1
2022-12-01,TUR,Melaka,0,0,0
2022-12-01,TUR,Negeri Sembilan,0,0,0
2022-12-01,TUR,Pahang,0,0,0
2022-12-01,TUR,Perak,1,1,0
2022-12-01,TUR,Perlis,10,8,2
2022-12-01,TUR,Pulau Pinang,30,18,12
2022-12-01,TUR,Sabah,5,4,1
2022-12-01,TUR,Sarawak,35,22,13
2022-12-01,TUR,Selangor,888,625,263
2022-12-01,TUR,W.P. Labuan,0,0,0
2022-12-01,TUV,Selangor,0,0,0
2022-12-01,TWN,Johor,2844,1176,1668
2022-12-01,TWN,Kedah,73,37,36
2022-12-01,TWN,Kelantan,1,0,1
2022-12-01,TWN,Melaka,0,0,0
2022-12-01,TWN,Negeri Sembilan,0,0,0
2022-12-01,TWN,Pahang,4,2,2
2022-12-01,TWN,Perak,35,18,17
2022-12-01,TWN,Perlis,12,6,6
2022-12-01,TWN,Pulau Pinang,1388,789,599
2022-12-01,TWN,Sabah,429,216,213
2022-12-01,TWN,Sarawak,233,105,128
2022-12-01,TWN,Selangor,5564,3004,2560
2022-12-01,TWN,W.P. Labuan,3,1,2
2022-12-01,TZA,Johor,42,22,20
2022-12-01,TZA,Kedah,0,0,0
2022-12-01,TZA,Perak,0,0,0
2022-12-01,TZA,Perlis,0,0,0
2022-12-01,TZA,Pulau Pinang,0,0,0
2022-12-01,TZA,Sabah,3,2,1
2022-12-01,TZA,Sarawak,3,3,0
2022-12-01,TZA,Selangor,154,67,87
2022-12-01,UGA,Johor,13,7,6
2022-12-01,UGA,Kedah,7,3,4
2022-12-01,UGA,Perak,0,0,0
2022-12-01,UGA,Perlis,1,1,0
2022-12-01,UGA,Pulau Pinang,0,0,0
2022-12-01,UGA,Sabah,2,1,1
2022-12-01,UGA,Sarawak,0,0,0
2022-12-01,UGA,Selangor,114,52,62
2022-12-01,UKR,Johor,100,49,51
2022-12-01,UKR,Kedah,35,15,20
2022-12-01,UKR,Kelantan,6,2,4
2022-12-01,UKR,Melaka,6,6,0
2022-12-01,UKR,Negeri Sembilan,0,0,0
2022-12-01,UKR,Pahang,3,0,3
2022-12-01,UKR,Perak,1,0,1
2022-12-01,UKR,Perlis,32,10,22
2022-12-01,UKR,Pulau Pinang,26,9,17
2022-12-01,UKR,Sabah,3,2,1
2022-12-01,UKR,Sarawak,6,3,3
2022-12-01,UKR,Selangor,728,371,357
2022-12-01,UKR,W.P. Labuan,1,0,1
2022-12-01,URY,Johor,5,2,3
2022-12-01,URY,Kedah,6,3,3
2022-12-01,URY,Kelantan,0,0,0
2022-12-01,URY,Perak,0,0,0
2022-12-01,URY,Perlis,0,0,0
2022-12-01,URY,Pulau Pinang,0,0,0
2022-12-01,URY,Sabah,1,1,0
2022-12-01,URY,Sarawak,0,0,0
2022-12-01,URY,Selangor,37,20,17
2022-12-01,URY,W.P. Labuan,0,0,0
2022-12-01,USA,Johor,3784,2252,1532
2022-12-01,USA,Kedah,430,238,192
2022-12-01,USA,Kelantan,5,4,1
2022-12-01,USA,Melaka,2,2,0
2022-12-01,USA,Negeri Sembilan,1,1,0
2022-12-01,USA,Pahang,5,3,2
2022-12-01,USA,Perak,140,79,61
2022-12-01,USA,Perlis,78,48,30
2022-12-01,USA,Pulau Pinang,1698,991,707
2022-12-01,USA,Sabah,348,203,145
2022-12-01,USA,Sarawak,326,177,149
2022-12-01,USA,Selangor,12311,7090,5221
2022-12-01,USA,Terengganu,0,0,0
2022-12-01,USA,W.P. Labuan,9,8,1
2022-12-01,UZB,Johor,95,75,20
2022-12-01,UZB,Kedah,39,18,21
2022-12-01,UZB,Kelantan,0,0,0
2022-12-01,UZB,Perak,0,0,0
2022-12-01,UZB,Perlis,5,3,2
2022-12-01,UZB,Pulau Pinang,15,5,10
2022-12-01,UZB,Sabah,13,7,6
2022-12-01,UZB,Sarawak,1,0,1
2022-12-01,UZB,Selangor,1492,873,619
2022-12-01,VAT,Johor,1,1,0
2022-12-01,VAT,Sarawak,1,1,0
2022-12-01,VAT,Selangor,0,0,0
2022-12-01,VCT,Johor,0,0,0
2022-12-01,VCT,Kedah,0,0,0
2022-12-01,VCT,Pulau Pinang,0,0,0
2022-12-01,VCT,Sarawak,0,0,0
2022-12-01,VCT,Selangor,1,1,0
2022-12-01,VEN,Johor,16,8,8
2022-12-01,VEN,Kedah,1,0,1
2022-12-01,VEN,Kelantan,0,0,0
2022-12-01,VEN,Melaka,0,0,0
2022-12-01,VEN,Perak,0,0,0
2022-12-01,VEN,Perlis,0,0,0
2022-12-01,VEN,Pulau Pinang,0,0,0
2022-12-01,VEN,Sabah,0,0,0
2022-12-01,VEN,Sarawak,11,6,5
2022-12-01,VEN,Selangor,44,21,23
2022-12-01,VEN,W.P. Labuan,0,0,0
2022-12-01,VNM,Johor,9714,2706,7008
2022-12-01,VNM,Kedah,216,21,195
2022-12-01,VNM,Kelantan,6,4,2
2022-12-01,VNM,Melaka,1,0,1
2022-12-01,VNM,Negeri Sembilan,0,0,0
2022-12-01,VNM,Pahang,1,1,0
2022-12-01,VNM,Perak,100,10,90
2022-12-01,VNM,Perlis,208,10,198
2022-12-01,VNM,Pulau Pinang,998,235,763
2022-12-01,VNM,Sabah,13,3,10
2022-12-01,VNM,Sarawak,180,35,145
2022-12-01,VNM,Selangor,10936,3507,7429
2022-12-01,VNM,Terengganu,0,0,0
2022-12-01,VNM,W.P. Labuan,2,1,1
2022-12-01,VUT,Johor,23,13,10
2022-12-01,VUT,Kedah,0,0,0
2022-12-01,VUT,Pulau Pinang,5,2,3
2022-12-01,VUT,Sabah,3,2,1
2022-12-01,VUT,Sarawak,0,0,0
2022-12-01,VUT,Selangor,50,40,10
2022-12-01,WSM,Johor,0,0,0
2022-12-01,WSM,Sarawak,0,0,0
2022-12-01,WSM,Selangor,2,0,2
2022-12-01,XXX,Johor,186,103,83
2022-12-01,XXX,Kedah,8,4,4
2022-12-01,XXX,Kelantan,1,0,1
2022-12-01,XXX,Melaka,0,0,0
2022-12-01,XXX,Pahang,0,0,0
2022-12-01,XXX,Perak,2,1,1
2022-12-01,XXX,Perlis,3,2,1
2022-12-01,XXX,Pulau Pinang,42,25,17
2022-12-01,XXX,Sabah,6,5,1
2022-12-01,XXX,Sarawak,42,25,17
2022-12-01,XXX,Selangor,295,183,112
2022-12-01,XXX,W.P. Labuan,1,1,0
2022-12-01,YEM,Johor,33,25,8
2022-12-01,YEM,Kedah,1,1,0
2022-12-01,YEM,Kelantan,0,0,0
2022-12-01,YEM,Melaka,2,2,0
2022-12-01,YEM,Pahang,1,1,0
2022-12-01,YEM,Perak,0,0,0
2022-12-01,YEM,Perlis,3,3,0
2022-12-01,YEM,Pulau Pinang,1,1,0
2022-12-01,YEM,Sabah,2,2,0
2022-12-01,YEM,Sarawak,3,2,1
2022-12-01,YEM,Selangor,878,609,269
2022-12-01,YEM,W.P. Labuan,0,0,0
2022-12-01,ZAF,Johor,394,230,164
2022-12-01,ZAF,Kedah,41,22,19
2022-12-01,ZAF,Kelantan,0,0,0
2022-12-01,ZAF,Melaka,1,1,0
2022-12-01,ZAF,Pahang,0,0,0
2022-12-01,ZAF,Perak,1,1,0
2022-12-01,ZAF,Perlis,15,8,7
2022-12-01,ZAF,Pulau Pinang,61,31,30
2022-12-01,ZAF,Sabah,19,7,12
2022-12-01,ZAF,Sarawak,172,69,103
2022-12-01,ZAF,Selangor,1913,986,927
2022-12-01,ZAF,Terengganu,0,0,0
2022-12-01,ZAF,W.P. Labuan,1,0,1
2022-12-01,ZAR,Selangor,1,0,1
2022-12-01,ZMB,Johor,1,0,1
2022-12-01,ZMB,Kedah,1,0,1
2022-12-01,ZMB,Perak,0,0,0
2022-12-01,ZMB,Perlis,0,0,0
2022-12-01,ZMB,Pulau Pinang,1,1,0
2022-12-01,ZMB,Sabah,1,1,0
2022-12-01,ZMB,Sarawak,0,0,0
2022-12-01,ZMB,Selangor,59,32,27
2022-12-01,ZWE,Johor,30,13,17
2022-12-01,ZWE,Kedah,0,0,0
2022-12-01,ZWE,Kelantan,0,0,0
2022-12-01,ZWE,Perak,0,0,0
2022-12-01,ZWE,Perlis,0,0,0
2022-12-01,ZWE,Pulau Pinang,5,3,2
2022-12-01,ZWE,Sabah,0,0,0
2022-12-01,ZWE,Sarawak,1,1,0
2022-12-01,ZWE,Selangor,135,49,86
2023-01-01,ABW,Kedah,0,0,0
2023-01-01,ABW,Pulau Pinang,0,0,0
2023-01-01,AFG,Johor,3,3,0
2023-01-01,AFG,Kedah,0,0,0
2023-01-01,AFG,Perlis,0,0,0
2023-01-01,AFG,Pulau Pinang,0,0,0
2023-01-01,AFG,Sarawak,0,0,0
2023-01-01,AFG,Selangor,57,46,11
2023-01-01,AGO,Johor,0,0,0
2023-01-01,AGO,Kedah,0,0,0
2023-01-01,AGO,Sabah,0,0,0
2023-01-01,AGO,Selangor,1,1,0
2023-01-01,AIA,Selangor,0,0,0
2023-01-01,ALB,Johor,21,13,8
2023-01-01,ALB,Kedah,2,2,0
2023-01-01,ALB,Perak,0,0,0
2023-01-01,ALB,Perlis,0,0,0
2023-01-01,ALB,Pulau Pinang,1,0,1
2023-01-01,ALB,Sabah,0,0,0
2023-01-01,ALB,Sarawak,1,1,0
2023-01-01,ALB,Selangor,30,18,12
2023-01-01,AND,Johor,0,0,0
2023-01-01,AND,Kedah,1,0,1
2023-01-01,AND,Perlis,0,0,0
2023-01-01,AND,Pulau Pinang,0,0,0
2023-01-01,AND,Selangor,2,1,1
2023-01-01,ANT,Selangor,0,0,0
2023-01-01,ARE,Johor,10,8,2
2023-01-01,ARE,Kedah,0,0,0
2023-01-01,ARE,Kelantan,0,0,0
2023-01-01,ARE,Perak,0,0,0
2023-01-01,ARE,Perlis,0,0,0
2023-01-01,ARE,Pulau Pinang,1,1,0
2023-01-01,ARE,Sabah,0,0,0
2023-01-01,ARE,Sarawak,0,0,0
2023-01-01,ARE,Selangor,275,168,107
2023-01-01,ARG,Johor,90,54,36
2023-01-01,ARG,Kedah,163,82,81
2023-01-01,ARG,Kelantan,2,0,2
2023-01-01,ARG,Melaka,0,0,0
2023-01-01,ARG,Perak,0,0,0
2023-01-01,ARG,Perlis,1,0,1
2023-01-01,ARG,Pulau Pinang,10,6,4
2023-01-01,ARG,Sabah,0,0,0
2023-01-01,ARG,Sarawak,1,1,0
2023-01-01,ARG,Selangor,443,236,207
2023-01-01,ARG,W.P. Labuan,0,0,0
2023-01-01,ARM,Johor,6,3,3
2023-01-01,ARM,Kedah,0,0,0
2023-01-01,ARM,Kelantan,0,0,0
2023-01-01,ARM,Perak,0,0,0
2023-01-01,ARM,Perlis,0,0,0
2023-01-01,ARM,Pulau Pinang,1,0,1
2023-01-01,ARM,Sabah,0,0,0
2023-01-01,ARM,Sarawak,0,0,0
2023-01-01,ARM,Selangor,49,24,25
2023-01-01,ATA,Selangor,0,0,0
2023-01-01,ATG,Johor,9,5,4
2023-01-01,ATG,Kedah,0,0,0
2023-01-01,ATG,Pulau Pinang,0,0,0
2023-01-01,ATG,Sarawak,0,0,0
2023-01-01,ATG,Selangor,13,7,6
2023-01-01,AUS,Johor,6459,3580,2879
2023-01-01,AUS,Kedah,814,438,376
2023-01-01,AUS,Kelantan,5,5,0
2023-01-01,AUS,Melaka,0,0,0
2023-01-01,AUS,Negeri Sembilan,0,0,0
2023-01-01,AUS,Pahang,26,13,13
2023-01-01,AUS,Perak,348,173,175
2023-01-01,AUS,Perlis,122,75,47
2023-01-01,AUS,Pulau Pinang,2518,1325,1193
2023-01-01,AUS,Sabah,626,315,311
2023-01-01,AUS,Sarawak,900,464,436
2023-01-01,AUS,Selangor,31592,17342,14250
2023-01-01,AUS,Terengganu,0,0,0
2023-01-01,AUS,W.P. Labuan,11,11,0
2023-01-01,AUT,Johor,142,86,56
2023-01-01,AUT,Kedah,131,64,67
2023-01-01,AUT,Kelantan,3,3,0
2023-01-01,AUT,Melaka,0,0,0
2023-01-01,AUT,Negeri Sembilan,0,0,0
2023-01-01,AUT,Pahang,0,0,0
2023-01-01,AUT,Perak,0,0,0
2023-01-01,AUT,Perlis,19,14,5
2023-01-01,AUT,Pulau Pinang,92,60,32
2023-01-01,AUT,Sabah,9,7,2
2023-01-01,AUT,Sarawak,10,7,3
2023-01-01,AUT,Selangor,823,497,326
2023-01-01,AUT,Terengganu,0,0,0
2023-01-01,AUT,W.P. Labuan,1,1,0
2023-01-01,AZE,Johor,4,2,2
2023-01-01,AZE,Kedah,3,3,0
2023-01-01,AZE,Kelantan,0,0,0
2023-01-01,AZE,Melaka,0,0,0
2023-01-01,AZE,Perlis,0,0,0
2023-01-01,AZE,Pulau Pinang,0,0,0
2023-01-01,AZE,Sabah,0,0,0
2023-01-01,AZE,Sarawak,0,0,0
2023-01-01,AZE,Selangor,79,43,36
2023-01-01,AZE,W.P. Labuan,0,0,0
2023-01-01,BDI,Pulau Pinang,0,0,0
2023-01-01,BDI,Sarawak,1,1,0
2023-01-01,BDI,Selangor,9,4,5
2023-01-01,BEL,Johor,181,120,61
2023-01-01,BEL,Kedah,88,51,37
2023-01-01,BEL,Kelantan,0,0,0
2023-01-01,BEL,Melaka,0,0,0
2023-01-01,BEL,Negeri Sembilan,0,0,0
2023-01-01,BEL,Pahang,0,0,0
2023-01-01,BEL,Perak,6,4,2
2023-01-01,BEL,Perlis,32,18,14
2023-01-01,BEL,Pulau Pinang,42,29,13
2023-01-01,BEL,Sabah,12,7,5
2023-01-01,BEL,Sarawak,18,11,7
2023-01-01,BEL,Selangor,751,490,261
2023-01-01,BEL,W.P. Labuan,0,0,0
2023-01-01,BEN,Johor,0,0,0
2023-01-01,BEN,Kedah,0,0,0
2023-01-01,BEN,Perak,0,0,0
2023-01-01,BEN,Pulau Pinang,0,0,0
2023-01-01,BEN,Sabah,0,0,0
2023-01-01,BEN,Sarawak,0,0,0
2023-01-01,BEN,Selangor,10,6,4
2023-01-01,BFA,Perak,0,0,0
2023-01-01,BFA,Pulau Pinang,1,1,0
2023-01-01,BFA,Selangor,6,5,1
2023-01-01,BGD,Johor,5102,4614,488
2023-01-01,BGD,Kedah,64,38,26
2023-01-01,BGD,Kelantan,1,1,0
2023-01-01,BGD,Melaka,0,0,0
2023-01-01,BGD,Negeri Sembilan,0,0,0
2023-01-01,BGD,Pahang,1,1,0
2023-01-01,BGD,Perak,0,0,0
2023-01-01,BGD,Perlis,1,1,0
2023-01-01,BGD,Pulau Pinang,831,820,11
2023-01-01,BGD,Sabah,3,2,1
2023-01-01,BGD,Sarawak,35,31,4
2023-01-01,BGD,Selangor,45792,43860,1932
2023-01-01,BGD,W.P. Labuan,8,5,3
2023-01-01,BGR,Johor,41,25,16
2023-01-01,BGR,Kedah,12,7,5
2023-01-01,BGR,Kelantan,0,0,0
2023-01-01,BGR,Pahang,0,0,0
2023-01-01,BGR,Perak,1,1,0
2023-01-01,BGR,Perlis,4,3,1
2023-01-01,BGR,Pulau Pinang,13,10,3
2023-01-01,BGR,Sabah,9,4,5
2023-01-01,BGR,Sarawak,4,3,1
2023-01-01,BGR,Selangor,204,120,84
2023-01-01,BGR,W.P. Labuan,0,0,0
2023-01-01,BHR,Johor,40,23,17
2023-01-01,BHR,Kedah,1,0,1
2023-01-01,BHR,Kelantan,2,1,1
2023-01-01,BHR,Perlis,1,1,0
2023-01-01,BHR,Pulau Pinang,2,1,1
2023-01-01,BHR,Sabah,0,0,0
2023-01-01,BHR,Sarawak,0,0,0
2023-01-01,BHR,Selangor,193,116,77
2023-01-01,BHS,Johor,2,2,0
2023-01-01,BHS,Kedah,2,2,0
2023-01-01,BHS,Perak,0,0,0
2023-01-01,BHS,Sabah,0,0,0
2023-01-01,BHS,Sarawak,0,0,0
2023-01-01,BHS,Selangor,18,6,12
2023-01-01,BIH,Johor,3,2,1
2023-01-01,BIH,Kedah,2,2,0
2023-01-01,BIH,Perlis,0,0,0
2023-01-01,BIH,Pulau Pinang,3,2,1
2023-01-01,BIH,Sabah,0,0,0
2023-01-01,BIH,Sarawak,0,0,0
2023-01-01,BIH,Selangor,70,39,31
2023-01-01,BLR,Johor,20,6,14
2023-01-01,BLR,Kedah,23,13,10
2023-01-01,BLR,Kelantan,4,2,2
2023-01-01,BLR,Pahang,0,0,0
2023-01-01,BLR,Perak,0,0,0
2023-01-01,BLR,Perlis,1,0,1
2023-01-01,BLR,Pulau Pinang,7,4,3
2023-01-01,BLR,Sabah,4,1,3
2023-01-01,BLR,Sarawak,10,4,6
2023-01-01,BLR,Selangor,487,226,261
2023-01-01,BLR,W.P. Labuan,0,0,0
2023-01-01,BLZ,Johor,2,0,2
2023-01-01,BLZ,Pulau Pinang,0,0,0
2023-01-01,BLZ,Sarawak,0,0,0
2023-01-01,BLZ,Selangor,19,10,9
2023-01-01,BMU,Selangor,0,0,0
2023-01-01,BOL,Johor,6,4,2
2023-01-01,BOL,Kedah,0,0,0
2023-01-01,BOL,Melaka,1,1,0
2023-01-01,BOL,Perak,0,0,0
2023-01-01,BOL,Perlis,1,1,0
2023-01-01,BOL,Pulau Pinang,1,1,0
2023-01-01,BOL,Sabah,0,0,0
2023-01-01,BOL,Sarawak,1,0,1
2023-01-01,BOL,Selangor,39,23,16
2023-01-01,BRA,Johor,260,147,113
2023-01-01,BRA,Kedah,102,53,49
2023-01-01,BRA,Kelantan,0,0,0
2023-01-01,BRA,Melaka,0,0,0
2023-01-01,BRA,Pahang,0,0,0
2023-01-01,BRA,Perak,0,0,0
2023-01-01,BRA,Perlis,12,7,5
2023-01-01,BRA,Pulau Pinang,26,16,10
2023-01-01,BRA,Sabah,3,3,0
2023-01-01,BRA,Sarawak,4,3,1
2023-01-01,BRA,Selangor,848,456,392
2023-01-01,BRA,W.P. Labuan,0,0,0
2023-01-01,BRB,Johor,0,0,0
2023-01-01,BRB,Kedah,1,1,0
2023-01-01,BRB,Perlis,0,0,0
2023-01-01,BRB,Pulau Pinang,0,0,0
2023-01-01,BRB,Selangor,10,4,6
2023-01-01,BRN,Johor,308,160,148
2023-01-01,BRN,Kedah,17,8,9
2023-01-01,BRN,Kelantan,1,1,0
2023-01-01,BRN,Melaka,6,3,3
2023-01-01,BRN,Pahang,0,0,0
2023-01-01,BRN,Perak,2,1,1
2023-01-01,BRN,Perlis,19,13,6
2023-01-01,BRN,Pulau Pinang,10,2,8
2023-01-01,BRN,Sabah,686,308,378
2023-01-01,BRN,Sarawak,86761,47354,39407
2023-01-01,BRN,Selangor,4105,2054,2051
2023-01-01,BRN,W.P. Labuan,1210,846,364
2023-01-01,BTN,Johor,10,5,5
2023-01-01,BTN,Kedah,0,0,0
2023-01-01,BTN,Perak,0,0,0
2023-01-01,BTN,Perlis,2,1,1
2023-01-01,BTN,Pulau Pinang,2,2,0
2023-01-01,BTN,Sabah,0,0,0
2023-01-01,BTN,Sarawak,0,0,0
2023-01-01,BTN,Selangor,17,11,6
2023-01-01,BWA,Johor,1,0,1
2023-01-01,BWA,Kedah,0,0,0
2023-01-01,BWA,Perlis,0,0,0
2023-01-01,BWA,Pulau Pinang,0,0,0
2023-01-01,BWA,Sabah,0,0,0
2023-01-01,BWA,Sarawak,0,0,0
2023-01-01,BWA,Selangor,17,8,9
2023-01-01,CAF,Kedah,0,0,0
2023-01-01,CAF,Selangor,0,0,0
2023-01-01,CAN,Johor,1444,814,630
2023-01-01,CAN,Kedah,292,152,140
2023-01-01,CAN,Kelantan,3,1,2
2023-01-01,CAN,Melaka,1,1,0
2023-01-01,CAN,Negeri Sembilan,0,0,0
2023-01-01,CAN,Pahang,2,2,0
2023-01-01,CAN,Perak,34,18,16
2023-01-01,CAN,Perlis,78,48,30
2023-01-01,CAN,Pulau Pinang,554,312,242
2023-01-01,CAN,Sabah,169,76,93
2023-01-01,CAN,Sarawak,396,223,173
2023-01-01,CAN,Selangor,4335,2501,1834
2023-01-01,CAN,Terengganu,0,0,0
2023-01-01,CAN,W.P. Labuan,6,5,1
2023-01-01,CCK,Selangor,0,0,0
2023-01-01,CHE,Johor,322,200,122
2023-01-01,CHE,Kedah,215,117,98
2023-01-01,CHE,Kelantan,2,1,1
2023-01-01,CHE,Melaka,0,0,0
2023-01-01,CHE,Negeri Sembilan,0,0,0
2023-01-01,CHE,Pahang,4,3,1
2023-01-01,CHE,Perak,3,3,0
2023-01-01,CHE,Perlis,45,29,16
2023-01-01,CHE,Pulau Pinang,154,89,65
2023-01-01,CHE,Sabah,19,11,8
2023-01-01,CHE,Sarawak,20,11,9
2023-01-01,CHE,Selangor,1109,651,458
2023-01-01,CHE,W.P. Labuan,0,0,0
2023-01-01,CHL,Johor,31,15,16
2023-01-01,CHL,Kedah,30,17,13
2023-01-01,CHL,Kelantan,0,0,0
2023-01-01,CHL,Melaka,0,0,0
2023-01-01,CHL,Pahang,0,0,0
2023-01-01,CHL,Perak,0,0,0
2023-01-01,CHL,Perlis,6,4,2
2023-01-01,CHL,Pulau Pinang,7,6,1
2023-01-01,CHL,Sabah,1,1,0
2023-01-01,CHL,Sarawak,0,0,0
2023-01-01,CHL,Selangor,167,83,84
2023-01-01,CHN,Johor,22538,9459,13079
2023-01-01,CHN,Kedah,549,243,306
2023-01-01,CHN,Kelantan,17,7,10
2023-01-01,CHN,Melaka,1,1,0
2023-01-01,CHN,Pahang,17,8,9
2023-01-01,CHN,Perak,109,40,69
2023-01-01,CHN,Perlis,88,37,51
2023-01-01,CHN,Pulau Pinang,2863,1375,1488
2023-01-01,CHN,Sabah,1694,814,880
2023-01-01,CHN,Sarawak,614,274,340
2023-01-01,CHN,Selangor,28763,14551,14212
2023-01-01,CHN,Terengganu,0,0,0
2023-01-01,CHN,W.P. Labuan,37,34,3
2023-01-01,CIV,Johor,0,0,0
2023-01-01,CIV,Kedah,0,0,0
2023-01-01,CIV,Pulau Pinang,0,0,0
2023-01-01,CIV,Sabah,0,0,0
2023-01-01,CIV,Sarawak,0,0,0
2023-01-01,CIV,Selangor,8,6,2
2023-01-01,CMR,Johor,4,4,0
2023-01-01,CMR,Kedah,0,0,0
2023-01-01,CMR,Pulau Pinang,0,0,0
2023-01-01,CMR,Sabah,0,0,0
2023-01-01,CMR,Sarawak,0,0,0
2023-01-01,CMR,Selangor,19,14,5
2023-01-01,COD,Johor,0,0,0
2023-01-01,COD,Pulau Pinang,0,0,0
2023-01-01,COD,Sarawak,2,1,1
2023-01-01,COD,Selangor,12,8,4
2023-01-01,COG,Johor,0,0,0
2023-01-01,COG,Kedah,0,0,0
2023-01-01,COG,Selangor,0,0,0
2023-01-01,COK,Selangor,0,0,0
2023-01-01,COL,Johor,35,14,21
2023-01-01,COL,Kedah,0,0,0
2023-01-01,COL,Perak,1,1,0
2023-01-01,COL,Pulau Pinang,1,1,0
2023-01-01,COL,Sabah,0,0,0
2023-01-01,COL,Sarawak,1,1,0
2023-01-01,COL,Selangor,186,99,87
2023-01-01,COL,W.P. Labuan,0,0,0
2023-01-01,COM,Johor,1,0,1
2023-01-01,COM,Kedah,0,0,0
2023-01-01,COM,Selangor,15,11,4
2023-01-01,CPV,Johor,0,0,0
2023-01-01,CPV,Kedah,2,2,0
2023-01-01,CPV,Pulau Pinang,0,0,0
2023-01-01,CPV,Sabah,0,0,0
2023-01-01,CPV,Selangor,3,0,3
2023-01-01,CRI,Johor,15,9,6
2023-01-01,CRI,Kedah,1,0,1
2023-01-01,CRI,Perak,0,0,0
2023-01-01,CRI,Perlis,0,0,0
2023-01-01,CRI,Pulau Pinang,9,4,5
2023-01-01,CRI,Sabah,0,0,0
2023-01-01,CRI,Sarawak,0,0,0
2023-01-01,CRI,Selangor,48,26,22
2023-01-01,CUB,Johor,3,2,1
2023-01-01,CUB,Kedah,1,0,1
2023-01-01,CUB,Perlis,0,0,0
2023-01-01,CUB,Pulau Pinang,0,0,0
2023-01-01,CUB,Sabah,0,0,0
2023-01-01,CUB,Sarawak,0,0,0
2023-01-01,CUB,Selangor,19,5,14
2023-01-01,CYP,Johor,10,5,5
2023-01-01,CYP,Kedah,5,1,4
2023-01-01,CYP,Perak,0,0,0
2023-01-01,CYP,Perlis,0,0,0
2023-01-01,CYP,Pulau Pinang,4,3,1
2023-01-01,CYP,Sabah,0,0,0
2023-01-01,CYP,Sarawak,6,0,6
2023-01-01,CYP,Selangor,47,33,14
2023-01-01,CZE,Johor,93,53,40
2023-01-01,CZE,Kedah,112,68,44
2023-01-01,CZE,Kelantan,0,0,0
2023-01-01,CZE,Melaka,0,0,0
2023-01-01,CZE,Negeri Sembilan,0,0,0
2023-01-01,CZE,Perak,0,0,0
2023-01-01,CZE,Perlis,16,9,7
2023-01-01,CZE,Pulau Pinang,35,19,16
2023-01-01,CZE,Sabah,13,9,4
2023-01-01,CZE,Sarawak,6,4,2
2023-01-01,CZE,Selangor,515,285,230
2023-01-01,CZE,W.P. Labuan,0,0,0
2023-01-01,DEU,Johor,2128,1312,816
2023-01-01,DEU,Kedah,1174,630,544
2023-01-01,DEU,Kelantan,7,6,1
2023-01-01,DEU,Melaka,5,3,2
2023-01-01,DEU,Negeri Sembilan,0,0,0
2023-01-01,DEU,Pahang,3,2,1
2023-01-01,DEU,Perak,26,16,10
2023-01-01,DEU,Perlis,241,154,87
2023-01-01,DEU,Pulau Pinang,699,447,252
2023-01-01,DEU,Sabah,115,73,42
2023-01-01,DEU,Sarawak,188,114,74
2023-01-01,DEU,Selangor,7921,4583,3338
2023-01-01,DEU,Terengganu,0,0,0
2023-01-01,DEU,W.P. Labuan,5,3,2
2023-01-01,DJI,Johor,0,0,0
2023-01-01,DJI,Selangor,15,8,7
2023-01-01,DMA,Johor,3,3,0
2023-01-01,DMA,Kedah,1,1,0
2023-01-01,DMA,Pulau Pinang,0,0,0
2023-01-01,DMA,Sabah,0,0,0
2023-01-01,DMA,Sarawak,0,0,0
2023-01-01,DMA,Selangor,35,25,10
2023-01-01,DMA,W.P. Labuan,0,0,0
2023-01-01,DNK,Johor,278,187,91
2023-01-01,DNK,Kedah,231,119,112
2023-01-01,DNK,Kelantan,5,4,1
2023-01-01,DNK,Melaka,0,0,0
2023-01-01,DNK,Negeri Sembilan,0,0,0
2023-01-01,DNK,Pahang,0,0,0
2023-01-01,DNK,Perak,1,1,0
2023-01-01,DNK,Perlis,33,26,7
2023-01-01,DNK,Pulau Pinang,85,56,29
2023-01-01,DNK,Sabah,52,21,31
2023-01-01,DNK,Sarawak,13,8,5
2023-01-01,DNK,Selangor,1016,562,454
2023-01-01,DNK,W.P. Labuan,0,0,0
2023-01-01,DOM,Johor,2,1,1
2023-01-01,DOM,Kedah,0,0,0
2023-01-01,DOM,Perak,0,0,0
2023-01-01,DOM,Perlis,0,0,0
2023-01-01,DOM,Pulau Pinang,0,0,0
2023-01-01,DOM,Sabah,0,0,0
2023-01-01,DOM,Sarawak,0,0,0
2023-01-01,DOM,Selangor,12,8,4
2023-01-01,DZA,Johor,13,12,1
2023-01-01,DZA,Kedah,3,3,0
2023-01-01,DZA,Kelantan,0,0,0
2023-01-01,DZA,Melaka,0,0,0
2023-01-01,DZA,Perak,0,0,0
2023-01-01,DZA,Perlis,1,1,0
2023-01-01,DZA,Pulau Pinang,2,2,0
2023-01-01,DZA,Sabah,0,0,0
2023-01-01,DZA,Sarawak,12,10,2
2023-01-01,DZA,Selangor,469,308,161
2023-01-01,DZA,W.P. Labuan,0,0,0
2023-01-01,ECU,Johor,6,1,5
2023-01-01,ECU,Kedah,0,0,0
2023-01-01,ECU,Perak,0,0,0
2023-01-01,ECU,Perlis,0,0,0
2023-01-01,ECU,Pulau Pinang,1,1,0
2023-01-01,ECU,Sabah,1,0,1
2023-01-01,ECU,Sarawak,0,0,0
2023-01-01,ECU,Selangor,30,14,16
2023-01-01,EGY,Johor,168,133,35
2023-01-01,EGY,Kedah,3,3,0
2023-01-01,EGY,Kelantan,0,0,0
2023-01-01,EGY,Melaka,1,1,0
2023-01-01,EGY,Pahang,0,0,0
2023-01-01,EGY,Perak,0,0,0
2023-01-01,EGY,Perlis,2,1,1
2023-01-01,EGY,Pulau Pinang,10,8,2
2023-01-01,EGY,Sabah,6,6,0
2023-01-01,EGY,Sarawak,134,89,45
2023-01-01,EGY,Selangor,1345,903,442
2023-01-01,EGY,Terengganu,0,0,0
2023-01-01,EGY,W.P. Labuan,0,0,0
2023-01-01,ERI,Johor,0,0,0
2023-01-01,ERI,Pulau Pinang,0,0,0
2023-01-01,ERI,Sabah,0,0,0
2023-01-01,ERI,Selangor,12,7,5
2023-01-01,ESP,Johor,396,240,156
2023-01-01,ESP,Kedah,300,158,142
2023-01-01,ESP,Kelantan,5,2,3
2023-01-01,ESP,Melaka,0,0,0
2023-01-01,ESP,Negeri Sembilan,1,1,0
2023-01-01,ESP,Pahang,0,0,0
2023-01-01,ESP,Perak,1,1,0
2023-01-01,ESP,Perlis,43,33,10
2023-01-01,ESP,Pulau Pinang,60,40,20
2023-01-01,ESP,Sabah,35,21,14
2023-01-01,ESP,Sarawak,22,14,8
2023-01-01,ESP,Selangor,1744,1026,718
2023-01-01,ESP,W.P. Labuan,0,0,0
2023-01-01,EST,Johor,42,23,19
2023-01-01,EST,Kedah,54,26,28
2023-01-01,EST,Kelantan,0,0,0
2023-01-01,EST,Pahang,0,0,0
2023-01-01,EST,Perak,0,0,0
2023-01-01,EST,Perlis,5,3,2
2023-01-01,EST,Pulau Pinang,26,12,14
2023-01-01,EST,Sabah,9,4,5
2023-01-01,EST,Sarawak,2,1,1
2023-01-01,EST,Selangor,205,108,97
2023-01-01,EST,W.P. Labuan,0,0,0
2023-01-01,ETH,Johor,2,2,0
2023-01-01,ETH,Kedah,0,0,0
2023-01-01,ETH,Pulau Pinang,0,0,0
2023-01-01,ETH,Sarawak,0,0,0
2023-01-01,ETH,Selangor,34,21,13
2023-01-01,FIN,Johor,222,140,82
2023-01-01,FIN,Kedah,158,85,73
2023-01-01,FIN,Kelantan,2,0,2
2023-01-01,FIN,Melaka,0,0,0
2023-01-01,FIN,Negeri Sembilan,0,0,0
2023-01-01,FIN,Pahang,0,0,0
2023-01-01,FIN,Perak,3,2,1
2023-01-01,FIN,Perlis,16,13,3
2023-01-01,FIN,Pulau Pinang,61,38,23
2023-01-01,FIN,Sabah,24,13,11
2023-01-01,FIN,Sarawak,12,5,7
2023-01-01,FIN,Selangor,747,428,319
2023-01-01,FIN,W.P. Labuan,0,0,0
2023-01-01,FJI,Johor,41,16,25
2023-01-01,FJI,Kedah,0,0,0
2023-01-01,FJI,Kelantan,0,0,0
2023-01-01,FJI,Perak,1,1,0
2023-01-01,FJI,Perlis,1,0,1
2023-01-01,FJI,Pulau Pinang,3,2,1
2023-01-01,FJI,Sabah,2,2,0
2023-01-01,FJI,Sarawak,0,0,0
2023-01-01,FJI,Selangor,91,41,50
2023-01-01,FRA,Johor,1595,988,607
2023-01-01,FRA,Kedah,707,381,326
2023-01-01,FRA,Kelantan,11,7,4
2023-01-01,FRA,Melaka,4,2,2
2023-01-01,FRA,Negeri Sembilan,0,0,0
2023-01-01,FRA,Pahang,10,7,3
2023-01-01,FRA,Perak,15,10,5
2023-01-01,FRA,Perlis,145,93,52
2023-01-01,FRA,Pulau Pinang,324,216,108
2023-01-01,FRA,Sabah,109,59,50
2023-01-01,FRA,Sarawak,49,35,14
2023-01-01,FRA,Selangor,6034,3593,2441
2023-01-01,FRA,Terengganu,0,0,0
2023-01-01,FRA,W.P. Labuan,1,1,0
2023-01-01,FSM,Johor,0,0,0
2023-01-01,FSM,Pulau Pinang,0,0,0
2023-01-01,FSM,Selangor,0,0,0
2023-01-01,GAB,Johor,1,1,0
2023-01-01,GAB,Pulau Pinang,0,0,0
2023-01-01,GAB,Sarawak,0,0,0
2023-01-01,GAB,Selangor,10,6,4
2023-01-01,GBR,Johor,3944,2471,1473
2023-01-01,GBR,Kedah,1689,931,758
2023-01-01,GBR,Kelantan,10,7,3
2023-01-01,GBR,Melaka,8,6,2
2023-01-01,GBR,Negeri Sembilan,1,1,0
2023-01-01,GBR,Pahang,5,5,0
2023-01-01,GBR,Perak,73,44,29
2023-01-01,GBR,Perlis,244,158,86
2023-01-01,GBR,Pulau Pinang,1568,919,649
2023-01-01,GBR,Sabah,476,278,198
2023-01-01,GBR,Sarawak,1028,646,382
2023-01-01,GBR,Selangor,15954,9588,6366
2023-01-01,GBR,Terengganu,0,0,0
2023-01-01,GBR,W.P. Labuan,40,32,8
2023-01-01,GEO,Johor,6,6,0
2023-01-01,GEO,Kedah,1,1,0
2023-01-01,GEO,Melaka,0,0,0
2023-01-01,GEO,Perak,0,0,0
2023-01-01,GEO,Perlis,0,0,0
2023-01-01,GEO,Pulau Pinang,1,0,1
2023-01-01,GEO,Sabah,0,0,0
2023-01-01,GEO,Sarawak,0,0,0
2023-01-01,GEO,Selangor,49,27,22
2023-01-01,GHA,Johor,4,4,0
2023-01-01,GHA,Kedah,0,0,0
2023-01-01,GHA,Kelantan,0,0,0
2023-01-01,GHA,Pulau Pinang,2,1,1
2023-01-01,GHA,Sabah,0,0,0
2023-01-01,GHA,Sarawak,2,1,1
2023-01-01,GHA,Selangor,53,45,8
2023-01-01,GIB,Johor,0,0,0
2023-01-01,GIB,Sarawak,0,0,0
2023-01-01,GIN,Johor,4,3,1
2023-01-01,GIN,Kedah,1,1,0
2023-01-01,GIN,Kelantan,0,0,0
2023-01-01,GIN,Perlis,0,0,0
2023-01-01,GIN,Pulau Pinang,0,0,0
2023-01-01,GIN,Sabah,0,0,0
2023-01-01,GIN,Sarawak,0,0,0
2023-01-01,GIN,Selangor,49,35,14
2023-01-01,GLP,Selangor,0,0,0
2023-01-01,GMB,Johor,0,0,0
2023-01-01,GMB,Kedah,0,0,0
2023-01-01,GMB,Kelantan,0,0,0
2023-01-01,GMB,Pulau Pinang,1,1,0
2023-01-01,GMB,Sabah,0,0,0
2023-01-01,GMB,Sarawak,0,0,0
2023-01-01,GMB,Selangor,11,8,3
2023-01-01,GNB,Johor,0,0,0
2023-01-01,GNB,Selangor,0,0,0
2023-01-01,GNQ,Johor,0,0,0
2023-01-01,GNQ,Selangor,4,1,3
2023-01-01,GRC,Johor,60,41,19
2023-01-01,GRC,Kedah,19,10,9
2023-01-01,GRC,Kelantan,0,0,0
2023-01-01,GRC,Melaka,0,0,0
2023-01-01,GRC,Negeri Sembilan,1,1,0
2023-01-01,GRC,Pahang,0,0,0
2023-01-01,GRC,Perak,0,0,0
2023-01-01,GRC,Perlis,1,1,0
2023-01-01,GRC,Pulau Pinang,6,5,1
2023-01-01,GRC,Sabah,2,2,0
2023-01-01,GRC,Sarawak,1,0,1
2023-01-01,GRC,Selangor,219,161,58
2023-01-01,GRD,Johor,15,8,7
2023-01-01,GRD,Kedah,0,0,0
2023-01-01,GRD,Pulau Pinang,0,0,0
2023-01-01,GRD,Sabah,0,0,0
2023-01-01,GRD,Sarawak,0,0,0
2023-01-01,GRD,Selangor,17,10,7
2023-01-01,GRL,Johor,0,0,0
2023-01-01,GRL,Selangor,0,0,0
2023-01-01,GTM,Johor,1,1,0
2023-01-01,GTM,Kedah,1,0,1
2023-01-01,GTM,Pahang,0,0,0
2023-01-01,GTM,Perak,0,0,0
2023-01-01,GTM,Pulau Pinang,3,2,1
2023-01-01,GTM,Sabah,0,0,0
2023-01-01,GTM,Sarawak,0,0,0
2023-01-01,GTM,Selangor,15,8,7
2023-01-01,GTM,W.P. Labuan,0,0,0
2023-01-01,GUY,Johor,0,0,0
2023-01-01,GUY,Kedah,0,0,0
2023-01-01,GUY,Pulau Pinang,0,0,0
2023-01-01,GUY,Sarawak,0,0,0
2023-01-01,GUY,Selangor,0,0,0
2023-01-01,HKG,Johor,5,2,3
2023-01-01,HKG,Kedah,2,1,1
2023-01-01,HKG,Kelantan,0,0,0
2023-01-01,HKG,Pahang,1,0,1
2023-01-01,HKG,Perak,37,17,20
2023-01-01,HKG,Perlis,5,2,3
2023-01-01,HKG,Pulau Pinang,0,0,0
2023-01-01,HKG,Sabah,0,0,0
2023-01-01,HKG,Sarawak,0,0,0
2023-01-01,HKG,Selangor,14,10,4
2023-01-01,HKG,Terengganu,0,0,0
2023-01-01,HMD,Johor,0,0,0
2023-01-01,HND,Johor,4,1,3
2023-01-01,HND,Kedah,0,0,0
2023-01-01,HND,Perak,0,0,0
2023-01-01,HND,Pulau Pinang,3,1,2
2023-01-01,HND,Sabah,0,0,0
2023-01-01,HND,Sarawak,0,0,0
2023-01-01,HND,Selangor,21,10,11
2023-01-01,HRV,Johor,36,26,10
2023-01-01,HRV,Kedah,11,5,6
2023-01-01,HRV,Kelantan,0,0,0
2023-01-01,HRV,Melaka,0,0,0
2023-01-01,HRV,Pahang,0,0,0
2023-01-01,HRV,Perak,0,0,0
2023-01-01,HRV,Perlis,0,0,0
2023-01-01,HRV,Pulau Pinang,10,7,3
2023-01-01,HRV,Sabah,2,0,2
2023-01-01,HRV,Sarawak,3,3,0
2023-01-01,HRV,Selangor,175,107,68
2023-01-01,HTI,Johor,0,0,0
2023-01-01,HTI,Kedah,0,0,0
2023-01-01,HTI,Kelantan,0,0,0
2023-01-01,HTI,Perak,0,0,0
2023-01-01,HTI,Pulau Pinang,0,0,0
2023-01-01,HTI,Sabah,0,0,0
2023-01-01,HTI,Selangor,6,4,2
2023-01-01,HUN,Johor,90,63,27
2023-01-01,HUN,Kedah,49,22,27
2023-01-01,HUN,Kelantan,0,0,0
2023-01-01,HUN,Pahang,0,0,0
2023-01-01,HUN,Perak,0,0,0
2023-01-01,HUN,Perlis,5,3,2
2023-01-01,HUN,Pulau Pinang,31,17,14
2023-01-01,HUN,Sabah,1,1,0
2023-01-01,HUN,Sarawak,6,5,1
2023-01-01,HUN,Selangor,460,244,216
2023-01-01,HUN,W.P. Labuan,0,0,0
2023-01-01,IDN,Johor,105128,55208,49920
2023-01-01,IDN,Kedah,4720,1849,2871
2023-01-01,IDN,Kelantan,120,79,41
2023-01-01,IDN,Melaka,5322,2392,2930
2023-01-01,IDN,Negeri Sembilan,8075,5572,2503
2023-01-01,IDN,Pahang,7,2,5
2023-01-01,IDN,Perak,171,44,127
2023-01-01,IDN,Perlis,620,224,396
2023-01-01,IDN,Pulau Pinang,33065,11879,21186
2023-01-01,IDN,Sabah,5351,2675,2676
2023-01-01,IDN,Sarawak,40632,21623,19009
2023-01-01,IDN,Selangor,97722,46409,51313
2023-01-01,IDN,Terengganu,0,0,0
2023-01-01,IDN,W.P. Labuan,44,28,16
2023-01-01,IND,Johor,15320,10961,4359
2023-01-01,IND,Kedah,509,314,195
2023-01-01,IND,Kelantan,1,1,0
2023-01-01,IND,Melaka,0,0,0
2023-01-01,IND,Negeri Sembilan,0,0,0
2023-01-01,IND,Pahang,9,8,1
2023-01-01,IND,Perak,259,206,53
2023-01-01,IND,Perlis,61,55,6
2023-01-01,IND,Pulau Pinang,552,405,147
2023-01-01,IND,Sabah,201,149,52
2023-01-01,IND,Sarawak,903,722,181
2023-01-01,IND,Selangor,38155,26397,11758
2023-01-01,IND,Terengganu,0,0,0
2023-01-01,IND,W.P. Labuan,38,30,8
2023-01-01,IOT,Pulau Pinang,1,0,1
2023-01-01,IOT,Selangor,0,0,0
2023-01-01,IRL,Johor,249,163,86
2023-01-01,IRL,Kedah,120,68,52
2023-01-01,IRL,Kelantan,0,0,0
2023-01-01,IRL,Negeri Sembilan,0,0,0
2023-01-01,IRL,Pahang,0,0,0
2023-01-01,IRL,Perak,5,3,2
2023-01-01,IRL,Perlis,16,8,8
2023-01-01,IRL,Pulau Pinang,79,50,29
2023-01-01,IRL,Sabah,26,16,10
2023-01-01,IRL,Sarawak,28,14,14
2023-01-01,IRL,Selangor,1211,727,484
2023-01-01,IRL,Terengganu,0,0,0
2023-01-01,IRL,W.P. Labuan,0,0,0
2023-01-01,IRN,Johor,81,62,19
2023-01-01,IRN,Kedah,5,3,2
2023-01-01,IRN,Kelantan,0,0,0
2023-01-01,IRN,Perak,1,1,0
2023-01-01,IRN,Perlis,3,3,0
2023-01-01,IRN,Pulau Pinang,5,1,4
2023-01-01,IRN,Sabah,3,1,2
2023-01-01,IRN,Sarawak,7,3,4
2023-01-01,IRN,Selangor,879,499,380
2023-01-01,IRN,W.P. Labuan,0,0,0
2023-01-01,IRQ,Johor,23,20,3
2023-01-01,IRQ,Kedah,5,2,3
2023-01-01,IRQ,Kelantan,0,0,0
2023-01-01,IRQ,Melaka,0,0,0
2023-01-01,IRQ,Pahang,0,0,0
2023-01-01,IRQ,Perak,1,0,1
2023-01-01,IRQ,Perlis,0,0,0
2023-01-01,IRQ,Pulau Pinang,2,2,0
2023-01-01,IRQ,Sabah,0,0,0
2023-01-01,IRQ,Sarawak,0,0,0
2023-01-01,IRQ,Selangor,631,431,200
2023-01-01,ISL,Johor,3,3,0
2023-01-01,ISL,Kedah,0,0,0
2023-01-01,ISL,Kelantan,0,0,0
2023-01-01,ISL,Perak,2,1,1
2023-01-01,ISL,Perlis,0,0,0
2023-01-01,ISL,Pulau Pinang,2,0,2
2023-01-01,ISL,Sabah,1,1,0
2023-01-01,ISL,Sarawak,0,0,0
2023-01-01,ISL,Selangor,25,13,12
2023-01-01,ISL,W.P. Labuan,0,0,0
2023-01-01,ISR,Pulau Pinang,0,0,0
2023-01-01,ITA,Johor,538,360,178
2023-01-01,ITA,Kedah,617,345,272
2023-01-01,ITA,Kelantan,3,2,1
2023-01-01,ITA,Melaka,0,0,0
2023-01-01,ITA,Negeri Sembilan,0,0,0
2023-01-01,ITA,Pahang,0,0,0
2023-01-01,ITA,Perak,5,5,0
2023-01-01,ITA,Perlis,48,38,10
2023-01-01,ITA,Pulau Pinang,103,72,31
2023-01-01,ITA,Sabah,31,19,12
2023-01-01,ITA,Sarawak,33,26,7
2023-01-01,ITA,Selangor,2387,1555,832
2023-01-01,ITA,W.P. Labuan,1,1,0
2023-01-01,JAM,Johor,0,0,0
2023-01-01,JAM,Kedah,2,1,1
2023-01-01,JAM,Perak,0,0,0
2023-01-01,JAM,Pulau Pinang,1,0,1
2023-01-01,JAM,Sabah,0,0,0
2023-01-01,JAM,Sarawak,0,0,0
2023-01-01,JAM,Selangor,12,4,8
2023-01-01,JAM,W.P. Labuan,0,0,0
2023-01-01,JOR,Johor,6,3,3
2023-01-01,JOR,Kedah,1,1,0
2023-01-01,JOR,Kelantan,0,0,0
2023-01-01,JOR,Melaka,0,0,0
2023-01-01,JOR,Perlis,1,1,0
2023-01-01,JOR,Pulau Pinang,2,2,0
2023-01-01,JOR,Sabah,1,1,0
2023-01-01,JOR,Sarawak,0,0,0
2023-01-01,JOR,Selangor,776,469,307
2023-01-01,JOR,W.P. Labuan,0,0,0
2023-01-01,JPN,Johor,4873,3230,1643
2023-01-01,JPN,Kedah,569,283,286
2023-01-01,JPN,Kelantan,15,14,1
2023-01-01,JPN,Melaka,1,1,0
2023-01-01,JPN,Negeri Sembilan,0,0,0
2023-01-01,JPN,Pahang,32,19,13
2023-01-01,JPN,Perak,49,28,21
2023-01-01,JPN,Perlis,68,46,22
2023-01-01,JPN,Pulau Pinang,1145,765,380
2023-01-01,JPN,Sabah,371,189,182
2023-01-01,JPN,Sarawak,131,79,52
2023-01-01,JPN,Selangor,12107,7473,4634
2023-01-01,JPN,W.P. Labuan,11,5,6
2023-01-01,KAZ,Johor,35,19,16
2023-01-01,KAZ,Kedah,40,23,17
2023-01-01,KAZ,Kelantan,2,0,2
2023-01-01,KAZ,Melaka,0,0,0
2023-01-01,KAZ,Perak,0,0,0
2023-01-01,KAZ,Perlis,5,2,3
2023-01-01,KAZ,Pulau Pinang,10,5,5
2023-01-01,KAZ,Sabah,2,1,1
2023-01-01,KAZ,Sarawak,1,0,1
2023-01-01,KAZ,Selangor,552,231,321
2023-01-01,KAZ,W.P. Labuan,0,0,0
2023-01-01,KEN,Johor,35,15,20
2023-01-01,KEN,Kedah,1,0,1
2023-01-01,KEN,Kelantan,0,0,0
2023-01-01,KEN,Perak,0,0,0
2023-01-01,KEN,Perlis,2,1,1
2023-01-01,KEN,Pulau Pinang,3,0,3
2023-01-01,KEN,Sabah,1,1,0
2023-01-01,KEN,Sarawak,1,1,0
2023-01-01,KEN,Selangor,286,145,141
2023-01-01,KGZ,Johor,13,6,7
2023-01-01,KGZ,Kedah,5,5,0
2023-01-01,KGZ,Kelantan,0,0,0
2023-01-01,KGZ,Perak,0,0,0
2023-01-01,KGZ,Perlis,2,0,2
2023-01-01,KGZ,Pulau Pinang,6,2,4
2023-01-01,KGZ,Sabah,0,0,0
2023-01-01,KGZ,Sarawak,0,0,0
2023-01-01,KGZ,Selangor,232,138,94
2023-01-01,KHM,Johor,2470,1075,1395
2023-01-01,KHM,Kedah,298,263,35
2023-01-01,KHM,Kelantan,827,605,222
2023-01-01,KHM,Melaka,3,2,1
2023-01-01,KHM,Negeri Sembilan,0,0,0
2023-01-01,KHM,Pahang,0,0,0
2023-01-01,KHM,Perak,5,2,3
2023-01-01,KHM,Perlis,939,652,287
2023-01-01,KHM,Pulau Pinang,41,19,22
2023-01-01,KHM,Sabah,2,0,2
2023-01-01,KHM,Sarawak,11,1,10
2023-01-01,KHM,Selangor,3764,1716,2048
2023-01-01,KHM,W.P. Labuan,0,0,0
2023-01-01,KIR,Johor,0,0,0
2023-01-01,KIR,Sabah,0,0,0
2023-01-01,KIR,Selangor,0,0,0
2023-01-01,KNA,Johor,16,13,3
2023-01-01,KNA,Kedah,2,2,0
2023-01-01,KNA,Perlis,0,0,0
2023-01-01,KNA,Pulau Pinang,0,0,0
2023-01-01,KNA,Sabah,1,1,0
2023-01-01,KNA,Selangor,51,35,16
2023-01-01,KNA,W.P. Labuan,0,0,0
2023-01-01,KOR,Johor,17050,8543,8507
2023-01-01,KOR,Kedah,439,213,226
2023-01-01,KOR,Kelantan,3,1,2
2023-01-01,KOR,Melaka,0,0,0
2023-01-01,KOR,Negeri Sembilan,0,0,0
2023-01-01,KOR,Pahang,1,0,1
2023-01-01,KOR,Perak,18,8,10
2023-01-01,KOR,Perlis,101,72,29
2023-01-01,KOR,Pulau Pinang,547,302,245
2023-01-01,KOR,Sabah,21648,9448,12200
2023-01-01,KOR,Sarawak,286,147,139
2023-01-01,KOR,Selangor,16612,8423,8189
2023-01-01,KOR,Terengganu,0,0,0
2023-01-01,KOR,W.P. Labuan,5,1,4
2023-01-01,KWT,Johor,59,31,28
2023-01-01,KWT,Kedah,12,5,7
2023-01-01,KWT,Kelantan,0,0,0
2023-01-01,KWT,Perak,0,0,0
2023-01-01,KWT,Perlis,0,0,0
2023-01-01,KWT,Pulau Pinang,8,5,3
2023-01-01,KWT,Sabah,0,0,0
2023-01-01,KWT,Sarawak,5,2,3
2023-01-01,KWT,Selangor,1191,616,575
2023-01-01,KWT,W.P. Labuan,0,0,0
2023-01-01,LAO,Johor,151,55,96
2023-01-01,LAO,Kedah,951,137,814
2023-01-01,LAO,Kelantan,157,24,133
2023-01-01,LAO,Melaka,0,0,0
2023-01-01,LAO,Perak,19,2,17
2023-01-01,LAO,Perlis,299,143,156
2023-01-01,LAO,Pulau Pinang,26,8,18
2023-01-01,LAO,Sabah,4,2,2
2023-01-01,LAO,Sarawak,13,7,6
2023-01-01,LAO,Selangor,183,60,123
2023-01-01,LAO,W.P. Labuan,0,0,0
2023-01-01,LBN,Johor,12,9,3
2023-01-01,LBN,Kedah,3,1,2
2023-01-01,LBN,Kelantan,0,0,0
2023-01-01,LBN,Pahang,1,0,1
2023-01-01,LBN,Perak,0,0,0
2023-01-01,LBN,Perlis,0,0,0
2023-01-01,LBN,Pulau Pinang,3,3,0
2023-01-01,LBN,Sabah,1,1,0
2023-01-01,LBN,Sarawak,0,0,0
2023-01-01,LBN,Selangor,167,99,68
2023-01-01,LBN,W.P. Labuan,0,0,0
2023-01-01,LBR,Johor,2,2,0
2023-01-01,LBR,Kedah,0,0,0
2023-01-01,LBR,Sabah,0,0,0
2023-01-01,LBR,Sarawak,0,0,0
2023-01-01,LBR,Selangor,12,12,0
2023-01-01,LBY,Johor,3,2,1
2023-01-01,LBY,Kedah,2,2,0
2023-01-01,LBY,Perlis,0,0,0
2023-01-01,LBY,Pulau Pinang,1,1,0
2023-01-01,LBY,Sabah,0,0,0
2023-01-01,LBY,Sarawak,2,1,1
2023-01-01,LBY,Selangor,270,205,65
2023-01-01,LCA,Johor,12,7,5
2023-01-01,LCA,Kedah,0,0,0
2023-01-01,LCA,Pulau Pinang,1,0,1
2023-01-01,LCA,Sarawak,0,0,0
2023-01-01,LCA,Selangor,10,5,5
2023-01-01,LIE,Johor,0,0,0
2023-01-01,LIE,Kedah,1,0,1
2023-01-01,LIE,Perlis,0,0,0
2023-01-01,LIE,Pulau Pinang,0,0,0
2023-01-01,LIE,Sabah,0,0,0
2023-01-01,LIE,Sarawak,0,0,0
2023-01-01,LIE,Selangor,5,3,2
2023-01-01,LKA,Johor,1096,701,395
2023-01-01,LKA,Kedah,55,28,27
2023-01-01,LKA,Kelantan,0,0,0
2023-01-01,LKA,Melaka,0,0,0
2023-01-01,LKA,Pahang,0,0,0
2023-01-01,LKA,Perak,3,2,1
2023-01-01,LKA,Perlis,4,4,0
2023-01-01,LKA,Pulau Pinang,20,16,4
2023-01-01,LKA,Sabah,15,8,7
2023-01-01,LKA,Sarawak,29,18,11
2023-01-01,LKA,Selangor,2688,1708,980
2023-01-01,LKA,W.P. Labuan,0,0,0
2023-01-01,LSO,Johor,0,0,0
2023-01-01,LSO,Kedah,0,0,0
2023-01-01,LSO,Pulau Pinang,1,0,1
2023-01-01,LSO,Sarawak,0,0,0
2023-01-01,LSO,Selangor,4,3,1
2023-01-01,LTU,Johor,58,23,35
2023-01-01,LTU,Kedah,35,14,21
2023-01-01,LTU,Kelantan,0,0,0
2023-01-01,LTU,Pahang,0,0,0
2023-01-01,LTU,Perak,0,0,0
2023-01-01,LTU,Perlis,7,4,3
2023-01-01,LTU,Pulau Pinang,8,4,4
2023-01-01,LTU,Sabah,3,2,1
2023-01-01,LTU,Sarawak,1,0,1
2023-01-01,LTU,Selangor,330,171,159
2023-01-01,LTU,W.P. Labuan,0,0,0
2023-01-01,LUX,Johor,7,7,0
2023-01-01,LUX,Kedah,5,2,3
2023-01-01,LUX,Kelantan,0,0,0
2023-01-01,LUX,Perak,0,0,0
2023-01-01,LUX,Perlis,3,3,0
2023-01-01,LUX,Pulau Pinang,1,1,0
2023-01-01,LUX,Sabah,2,0,2
2023-01-01,LUX,Sarawak,0,0,0
2023-01-01,LUX,Selangor,50,33,17
2023-01-01,LVA,Johor,35,16,19
2023-01-01,LVA,Kedah,32,15,17
2023-01-01,LVA,Kelantan,0,0,0
2023-01-01,LVA,Pahang,0,0,0
2023-01-01,LVA,Perak,0,0,0
2023-01-01,LVA,Perlis,5,4,1
2023-01-01,LVA,Pulau Pinang,4,2,2
2023-01-01,LVA,Sabah,2,1,1
2023-01-01,LVA,Sarawak,8,2,6
2023-01-01,LVA,Selangor,200,101,99
2023-01-01,LVA,W.P. Labuan,0,0,0
2023-01-01,MAC,Johor,0,0,0
2023-01-01,MAC,Pahang,0,0,0
2023-01-01,MAC,Perak,0,0,0
2023-01-01,MAC,Selangor,2,1,1
2023-01-01,MAC,W.P. Labuan,0,0,0
2023-01-01,MAR,Johor,82,63,19
2023-01-01,MAR,Kedah,11,10,1
2023-01-01,MAR,Kelantan,0,0,0
2023-01-01,MAR,Melaka,0,0,0
2023-01-01,MAR,Pahang,0,0,0
2023-01-01,MAR,Perak,0,0,0
2023-01-01,MAR,Perlis,2,2,0
2023-01-01,MAR,Pulau Pinang,6,6,0
2023-01-01,MAR,Sabah,5,3,2
2023-01-01,MAR,Sarawak,3,3,0
2023-01-01,MAR,Selangor,430,259,171
2023-01-01,MAR,W.P. Labuan,0,0,0
2023-01-01,MCO,Johor,0,0,0
2023-01-01,MCO,Kedah,0,0,0
2023-01-01,MCO,Sabah,0,0,0
2023-01-01,MCO,Selangor,0,0,0
2023-01-01,MDA,Johor,1,1,0
2023-01-01,MDA,Kedah,0,0,0
2023-01-01,MDA,Kelantan,0,0,0
2023-01-01,MDA,Negeri Sembilan,0,0,0
2023-01-01,MDA,Perlis,1,1,0
2023-01-01,MDA,Pulau Pinang,2,2,0
2023-01-01,MDA,Sabah,0,0,0
2023-01-01,MDA,Sarawak,2,0,2
2023-01-01,MDA,Selangor,22,10,12
2023-01-01,MDG,Johor,6,2,4
2023-01-01,MDG,Kedah,0,0,0
2023-01-01,MDG,Perak,0,0,0
2023-01-01,MDG,Perlis,0,0,0
2023-01-01,MDG,Pulau Pinang,1,0,1
2023-01-01,MDG,Sabah,0,0,0
2023-01-01,MDG,Sarawak,0,0,0
2023-01-01,MDG,Selangor,20,13,7
2023-01-01,MDV,Johor,169,86,83
2023-01-01,MDV,Kedah,1,0,1
2023-01-01,MDV,Kelantan,0,0,0
2023-01-01,MDV,Perak,0,0,0
2023-01-01,MDV,Perlis,0,0,0
2023-01-01,MDV,Pulau Pinang,8,3,5
2023-01-01,MDV,Sabah,0,0,0
2023-01-01,MDV,Sarawak,0,0,0
2023-01-01,MDV,Selangor,2046,1045,1001
2023-01-01,MEX,Johor,95,62,33
2023-01-01,MEX,Kedah,8,2,6
2023-01-01,MEX,Kelantan,1,1,0
2023-01-01,MEX,Pahang,0,0,0
2023-01-01,MEX,Perak,2,1,1
2023-01-01,MEX,Perlis,7,3,4
2023-01-01,MEX,Pulau Pinang,20,11,9
2023-01-01,MEX,Sabah,4,2,2
2023-01-01,MEX,Sarawak,4,2,2
2023-01-01,MEX,Selangor,411,207,204
2023-01-01,MEX,W.P. Labuan,0,0,0
2023-01-01,MHL,Johor,2,2,0
2023-01-01,MHL,Kedah,0,0,0
2023-01-01,MHL,Perak,0,0,0
2023-01-01,MHL,Pulau Pinang,1,1,0
2023-01-01,MHL,Sabah,0,0,0
2023-01-01,MHL,Selangor,6,2,4
2023-01-01,MKD,Johor,1,1,0
2023-01-01,MKD,Kedah,3,1,2
2023-01-01,MKD,Perak,0,0,0
2023-01-01,MKD,Pulau Pinang,1,0,1
2023-01-01,MKD,Sabah,1,1,0
2023-01-01,MKD,Sarawak,1,0,1
2023-01-01,MKD,Selangor,24,12,12
2023-01-01,MLI,Johor,2,2,0
2023-01-01,MLI,Sabah,0,0,0
2023-01-01,MLI,Selangor,16,14,2
2023-01-01,MLT,Johor,10,6,4
2023-01-01,MLT,Kedah,1,0,1
2023-01-01,MLT,Kelantan,1,1,0
2023-01-01,MLT,Perak,0,0,0
2023-01-01,MLT,Perlis,0,0,0
2023-01-01,MLT,Pulau Pinang,3,2,1
2023-01-01,MLT,Sabah,2,1,1
2023-01-01,MLT,Sarawak,1,1,0
2023-01-01,MLT,Selangor,60,31,29
2023-01-01,MLT,W.P. Labuan,0,0,0
2023-01-01,MMR,Johor,4954,1508,3446
2023-01-01,MMR,Kedah,59,9,50
2023-01-01,MMR,Kelantan,4,1,3
2023-01-01,MMR,Negeri Sembilan,0,0,0
2023-01-01,MMR,Pahang,1,1,0
2023-01-01,MMR,Perak,24,6,18
2023-01-01,MMR,Perlis,12,1,11
2023-01-01,MMR,Pulau Pinang,212,100,112
2023-01-01,MMR,Sabah,23,6,17
2023-01-01,MMR,Sarawak,80,35,45
2023-01-01,MMR,Selangor,6605,4497,2108
2023-01-01,MMR,Terengganu,0,0,0
2023-01-01,MMR,W.P. Labuan,0,0,0
2023-01-01,MNE,Johor,1,1,0
2023-01-01,MNE,Kedah,0,0,0
2023-01-01,MNE,Pulau Pinang,0,0,0
2023-01-01,MNE,Sabah,0,0,0
2023-01-01,MNE,Sarawak,0,0,0
2023-01-01,MNE,Selangor,6,4,2
2023-01-01,MNG,Johor,575,271,304
2023-01-01,MNG,Kedah,17,8,9
2023-01-01,MNG,Kelantan,0,0,0
2023-01-01,MNG,Perak,0,0,0
2023-01-01,MNG,Perlis,14,10,4
2023-01-01,MNG,Pulau Pinang,24,11,13
2023-01-01,MNG,Sabah,17,8,9
2023-01-01,MNG,Sarawak,0,0,0
2023-01-01,MNG,Selangor,571,266,305
2023-01-01,MNP,Selangor,0,0,0
2023-01-01,MOZ,Johor,0,0,0
2023-01-01,MOZ,Kedah,3,3,0
2023-01-01,MOZ,Perak,0,0,0
2023-01-01,MOZ,Pulau Pinang,4,2,2
2023-01-01,MOZ,Sabah,0,0,0
2023-01-01,MOZ,Sarawak,0,0,0
2023-01-01,MOZ,Selangor,39,17,22
2023-01-01,MRT,Johor,0,0,0
2023-01-01,MRT,Kedah,0,0,0
2023-01-01,MRT,Pulau Pinang,0,0,0
2023-01-01,MRT,Sabah,0,0,0
2023-01-01,MRT,Sarawak,0,0,0
2023-01-01,MRT,Selangor,18,12,6
2023-01-01,MUS,Johor,132,69,63
2023-01-01,MUS,Kedah,4,1,3
2023-01-01,MUS,Kelantan,0,0,0
2023-01-01,MUS,Pahang,0,0,0
2023-01-01,MUS,Perak,1,1,0
2023-01-01,MUS,Perlis,0,0,0
2023-01-01,MUS,Pulau Pinang,14,5,9
2023-01-01,MUS,Sabah,1,1,0
2023-01-01,MUS,Sarawak,3,3,0
2023-01-01,MUS,Selangor,1266,653,613
2023-01-01,MWI,Johor,0,0,0
2023-01-01,MWI,Pulau Pinang,0,0,0
2023-01-01,MWI,Sabah,0,0,0
2023-01-01,MWI,Sarawak,0,0,0
2023-01-01,MWI,Selangor,19,12,7
2023-01-01,MYT,Selangor,0,0,0
2023-01-01,NAM,Johor,1,0,1
2023-01-01,NAM,Kedah,0,0,0
2023-01-01,NAM,Perak,0,0,0
2023-01-01,NAM,Perlis,0,0,0
2023-01-01,NAM,Pulau Pinang,0,0,0
2023-01-01,NAM,Sabah,0,0,0
2023-01-01,NAM,Sarawak,0,0,0
2023-01-01,NAM,Selangor,11,4,7
2023-01-01,NCL,Selangor,0,0,0
2023-01-01,NER,Johor,0,0,0
2023-01-01,NER,Sabah,0,0,0
2023-01-01,NER,Selangor,0,0,0
2023-01-01,NGA,Johor,26,26,0
2023-01-01,NGA,Kedah,1,1,0
2023-01-01,NGA,Perlis,0,0,0
2023-01-01,NGA,Pulau Pinang,0,0,0
2023-01-01,NGA,Sabah,0,0,0
2023-01-01,NGA,Sarawak,3,2,1
2023-01-01,NGA,Selangor,334,264,70
2023-01-01,NIC,Johor,4,0,4
2023-01-01,NIC,Kedah,0,0,0
2023-01-01,NIC,Pulau Pinang,0,0,0
2023-01-01,NIC,Sabah,0,0,0
2023-01-01,NIC,Selangor,6,1,5
2023-01-01,NLD,Johor,927,609,318
2023-01-01,NLD,Kedah,499,252,247
2023-01-01,NLD,Kelantan,5,5,0
2023-01-01,NLD,Melaka,1,1,0
2023-01-01,NLD,Negeri Sembilan,0,0,0
2023-01-01,NLD,Pahang,0,0,0
2023-01-01,NLD,Perak,11,9,2
2023-01-01,NLD,Perlis,42,30,12
2023-01-01,NLD,Pulau Pinang,245,156,89
2023-01-01,NLD,Sabah,75,47,28
2023-01-01,NLD,Sarawak,118,80,38
2023-01-01,NLD,Selangor,3524,2040,1484
2023-01-01,NLD,Terengganu,0,0,0
2023-01-01,NLD,W.P. Labuan,4,0,4
2023-01-01,NOR,Johor,162,104,58
2023-01-01,NOR,Kedah,104,53,51
2023-01-01,NOR,Kelantan,0,0,0
2023-01-01,NOR,Melaka,0,0,0
2023-01-01,NOR,Pahang,0,0,0
2023-01-01,NOR,Perak,0,0,0
2023-01-01,NOR,Perlis,21,13,8
2023-01-01,NOR,Pulau Pinang,45,28,17
2023-01-01,NOR,Sabah,15,14,1
2023-01-01,NOR,Sarawak,8,7,1
2023-01-01,NOR,Selangor,693,420,273
2023-01-01,NOR,W.P. Labuan,5,3,2
2023-01-01,NPL,Johor,1181,983,198
2023-01-01,NPL,Kedah,11,8,3
2023-01-01,NPL,Pahang,0,0,0
2023-01-01,NPL,Perak,0,0,0
2023-01-01,NPL,Perlis,0,0,0
2023-01-01,NPL,Pulau Pinang,26,26,0
2023-01-01,NPL,Sabah,3,3,0
2023-01-01,NPL,Sarawak,232,169,63
2023-01-01,NPL,Selangor,16929,16159,770
2023-01-01,NPL,W.P. Labuan,30,28,2
2023-01-01,NRU,Johor,0,0,0
2023-01-01,NRU,Pulau Pinang,0,0,0
2023-01-01,NRU,Selangor,1,1,0
2023-01-01,NZL,Johor,856,494,362
2023-01-01,NZL,Kedah,114,68,46
2023-01-01,NZL,Kelantan,1,1,0
2023-01-01,NZL,Melaka,1,1,0
2023-01-01,NZL,Negeri Sembilan,0,0,0
2023-01-01,NZL,Pahang,0,0,0
2023-01-01,NZL,Perak,29,16,13
2023-01-01,NZL,Perlis,33,19,14
2023-01-01,NZL,Pulau Pinang,224,139,85
2023-01-01,NZL,Sabah,86,47,39
2023-01-01,NZL,Sarawak,174,86,88
2023-01-01,NZL,Selangor,3031,1765,1266
2023-01-01,NZL,Terengganu,0,0,0
2023-01-01,NZL,W.P. Labuan,6,5,1
2023-01-01,OMN,Johor,48,22,26
2023-01-01,OMN,Kedah,0,0,0
2023-01-01,OMN,Kelantan,0,0,0
2023-01-01,OMN,Melaka,0,0,0
2023-01-01,OMN,Perak,0,0,0
2023-01-01,OMN,Perlis,0,0,0
2023-01-01,OMN,Pulau Pinang,5,4,1
2023-01-01,OMN,Sabah,0,0,0
2023-01-01,OMN,Sarawak,14,7,7
2023-01-01,OMN,Selangor,779,460,319
2023-01-01,PAK,Johor,665,486,179
2023-01-01,PAK,Kedah,97,76,21
2023-01-01,PAK,Kelantan,8,8,0
2023-01-01,PAK,Melaka,0,0,0
2023-01-01,PAK,Negeri Sembilan,0,0,0
2023-01-01,PAK,Pahang,0,0,0
2023-01-01,PAK,Perak,49,47,2
2023-01-01,PAK,Perlis,35,34,1
2023-01-01,PAK,Pulau Pinang,127,114,13
2023-01-01,PAK,Sabah,12,10,2
2023-01-01,PAK,Sarawak,90,67,23
2023-01-01,PAK,Selangor,11473,10061,1412
2023-01-01,PAK,W.P. Labuan,5,4,1
2023-01-01,PAN,Johor,25,10,15
2023-01-01,PAN,Kedah,0,0,0
2023-01-01,PAN,Perak,0,0,0
2023-01-01,PAN,Perlis,0,0,0
2023-01-01,PAN,Pulau Pinang,2,0,2
2023-01-01,PAN,Sabah,0,0,0
2023-01-01,PAN,Sarawak,0,0,0
2023-01-01,PAN,Selangor,13,3,10
2023-01-01,PER,Johor,27,16,11
2023-01-01,PER,Kedah,1,1,0
2023-01-01,PER,Kelantan,0,0,0
2023-01-01,PER,Pahang,0,0,0
2023-01-01,PER,Perak,1,1,0
2023-01-01,PER,Perlis,0,0,0
2023-01-01,PER,Pulau Pinang,1,1,0
2023-01-01,PER,Sabah,1,1,0
2023-01-01,PER,Sarawak,1,1,0
2023-01-01,PER,Selangor,110,56,54
2023-01-01,PER,W.P. Labuan,0,0,0
2023-01-01,PHL,Johor,15410,4502,10908
2023-01-01,PHL,Kedah,506,189,317
2023-01-01,PHL,Kelantan,14,4,10
2023-01-01,PHL,Melaka,1,0,1
2023-01-01,PHL,Negeri Sembilan,2,1,1
2023-01-01,PHL,Pahang,9,2,7
2023-01-01,PHL,Perak,56,12,44
2023-01-01,PHL,Perlis,129,40,89
2023-01-01,PHL,Pulau Pinang,429,159,270
2023-01-01,PHL,Sabah,1792,723,1069
2023-01-01,PHL,Sarawak,2200,831,1369
2023-01-01,PHL,Selangor,15849,5688,10161
2023-01-01,PHL,Terengganu,0,0,0
2023-01-01,PHL,W.P. Labuan,91,32,59
2023-01-01,PLW,Johor,0,0,0
2023-01-01,PLW,Pulau Pinang,0,0,0
2023-01-01,PLW,Selangor,0,0,0
2023-01-01,PNG,Johor,13,6,7
2023-01-01,PNG,Kedah,0,0,0
2023-01-01,PNG,Kelantan,0,0,0
2023-01-01,PNG,Perak,1,1,0
2023-01-01,PNG,Pulau Pinang,0,0,0
2023-01-01,PNG,Sabah,1,0,1
2023-01-01,PNG,Sarawak,7,1,6
2023-01-01,PNG,Selangor,55,31,24
2023-01-01,POL,Johor,610,327,283
2023-01-01,POL,Kedah,230,122,108
2023-01-01,POL,Kelantan,4,2,2
2023-01-01,POL,Melaka,0,0,0
2023-01-01,POL,Negeri Sembilan,0,0,0
2023-01-01,POL,Pahang,0,0,0
2023-01-01,POL,Perak,3,0,3
2023-01-01,POL,Perlis,40,24,16
2023-01-01,POL,Pulau Pinang,60,34,26
2023-01-01,POL,Sabah,37,17,20
2023-01-01,POL,Sarawak,28,12,16
2023-01-01,POL,Selangor,1183,632,551
2023-01-01,POL,Terengganu,0,0,0
2023-01-01,POL,W.P. Labuan,0,0,0
2023-01-01,PRK,Selangor,0,0,0
2023-01-01,PRT,Johor,112,63,49
2023-01-01,PRT,Kedah,58,35,23
2023-01-01,PRT,Kelantan,0,0,0
2023-01-01,PRT,Melaka,0,0,0
2023-01-01,PRT,Pahang,0,0,0
2023-01-01,PRT,Perak,3,3,0
2023-01-01,PRT,Perlis,3,3,0
2023-01-01,PRT,Pulau Pinang,18,7,11
2023-01-01,PRT,Sabah,3,1,2
2023-01-01,PRT,Sarawak,14,9,5
2023-01-01,PRT,Selangor,443,255,188
2023-01-01,PRT,W.P. Labuan,0,0,0
2023-01-01,PRY,Johor,9,6,3
2023-01-01,PRY,Kedah,0,0,0
2023-01-01,PRY,Perak,0,0,0
2023-01-01,PRY,Perlis,0,0,0
2023-01-01,PRY,Pulau Pinang,0,0,0
2023-01-01,PRY,Sabah,0,0,0
2023-01-01,PRY,Sarawak,0,0,0
2023-01-01,PRY,Selangor,19,12,7
2023-01-01,PSE,Johor,9,6,3
2023-01-01,PSE,Kedah,1,0,1
2023-01-01,PSE,Kelantan,1,1,0
2023-01-01,PSE,Melaka,0,0,0
2023-01-01,PSE,Perak,4,3,1
2023-01-01,PSE,Perlis,0,0,0
2023-01-01,PSE,Pulau Pinang,0,0,0
2023-01-01,PSE,Sabah,0,0,0
2023-01-01,PSE,Sarawak,2,2,0
2023-01-01,PSE,Selangor,257,177,80
2023-01-01,QAT,Johor,2,2,0
2023-01-01,QAT,Kedah,0,0,0
2023-01-01,QAT,Perlis,1,1,0
2023-01-01,QAT,Pulau Pinang,2,1,1
2023-01-01,QAT,Sabah,0,0,0
2023-01-01,QAT,Sarawak,3,2,1
2023-01-01,QAT,Selangor,64,41,23
2023-01-01,REU,Johor,0,0,0
2023-01-01,REU,Sarawak,0,0,0
2023-01-01,ROU,Johor,171,104,67
2023-01-01,ROU,Kedah,73,38,35
2023-01-01,ROU,Kelantan,0,0,0
2023-01-01,ROU,Negeri Sembilan,0,0,0
2023-01-01,ROU,Pahang,1,1,0
2023-01-01,ROU,Perak,1,1,0
2023-01-01,ROU,Perlis,4,2,2
2023-01-01,ROU,Pulau Pinang,31,22,9
2023-01-01,ROU,Sabah,19,9,10
2023-01-01,ROU,Sarawak,10,7,3
2023-01-01,ROU,Selangor,719,371,348
2023-01-01,ROU,W.P. Labuan,0,0,0
2023-01-01,RUS,Johor,370,187,183
2023-01-01,RUS,Kedah,918,490,428
2023-01-01,RUS,Kelantan,78,37,41
2023-01-01,RUS,Melaka,0,0,0
2023-01-01,RUS,Negeri Sembilan,0,0,0
2023-01-01,RUS,Pahang,0,0,0
2023-01-01,RUS,Perak,2,1,1
2023-01-01,RUS,Perlis,510,290,220
2023-01-01,RUS,Pulau Pinang,475,250,225
2023-01-01,RUS,Sabah,63,37,26
2023-01-01,RUS,Sarawak,61,23,38
2023-01-01,RUS,Selangor,14260,7333,6927
2023-01-01,RUS,W.P. Labuan,4,2,2
2023-01-01,RWA,Johor,0,0,0
2023-01-01,RWA,Kedah,0,0,0
2023-01-01,RWA,Pulau Pinang,0,0,0
2023-01-01,RWA,Selangor,10,4,6
2023-01-01,SAU,Johor,105,64,41
2023-01-01,SAU,Kedah,16,11,5
2023-01-01,SAU,Kelantan,1,1,0
2023-01-01,SAU,Melaka,0,0,0
2023-01-01,SAU,Perak,0,0,0
2023-01-01,SAU,Perlis,5,5,0
2023-01-01,SAU,Pulau Pinang,17,9,8
2023-01-01,SAU,Sabah,0,0,0
2023-01-01,SAU,Sarawak,16,11,5
2023-01-01,SAU,Selangor,2314,1339,975
2023-01-01,SAU,W.P. Labuan,1,1,0
2023-01-01,SDN,Johor,5,4,1
2023-01-01,SDN,Kedah,0,0,0
2023-01-01,SDN,Kelantan,1,0,1
2023-01-01,SDN,Perlis,0,0,0
2023-01-01,SDN,Pulau Pinang,0,0,0
2023-01-01,SDN,Sabah,0,0,0
2023-01-01,SDN,Sarawak,3,3,0
2023-01-01,SDN,Selangor,1102,622,480
2023-01-01,SDN,W.P. Labuan,0,0,0
2023-01-01,SEN,Johor,0,0,0
2023-01-01,SEN,Kedah,0,0,0
2023-01-01,SEN,Kelantan,0,0,0
2023-01-01,SEN,Perak,0,0,0
2023-01-01,SEN,Perlis,0,0,0
2023-01-01,SEN,Pulau Pinang,0,0,0
2023-01-01,SEN,Sabah,0,0,0
2023-01-01,SEN,Sarawak,0,0,0
2023-01-01,SEN,Selangor,24,17,7
2023-01-01,SGP,Johor,986919,567095,419824
2023-01-01,SGP,Kedah,3088,1644,1444
2023-01-01,SGP,Kelantan,70,50,20
2023-01-01,SGP,Melaka,16,14,2
2023-01-01,SGP,Negeri Sembilan,0,0,0
2023-01-01,SGP,Pahang,345,182,163
2023-01-01,SGP,Perak,4904,2430,2474
2023-01-01,SGP,Perlis,283,162,121
2023-01-01,SGP,Pulau Pinang,12369,6430,5939
2023-01-01,SGP,Sabah,2166,1159,1007
2023-01-01,SGP,Sarawak,3852,2138,1714
2023-01-01,SGP,Selangor,46820,23613,23207
2023-01-01,SGP,Terengganu,0,0,0
2023-01-01,SGP,W.P. Labuan,12,9,3
2023-01-01,SGS,Johor,0,0,0
2023-01-01,SGS,Sabah,0,0,0
2023-01-01,SGS,Selangor,0,0,0
2023-01-01,SHN,Sarawak,0,0,0
2023-01-01,SLB,Johor,0,0,0
2023-01-01,SLB,Perlis,0,0,0
2023-01-01,SLB,Pulau Pinang,0,0,0
2023-01-01,SLB,Sabah,0,0,0
2023-01-01,SLB,Sarawak,8,0,8
2023-01-01,SLB,Selangor,11,2,9
2023-01-01,SLB,W.P. Labuan,0,0,0
2023-01-01,SLE,Johor,3,1,2
2023-01-01,SLE,Kedah,0,0,0
2023-01-01,SLE,Perak,0,0,0
2023-01-01,SLE,Pulau Pinang,0,0,0
2023-01-01,SLE,Sabah,0,0,0
2023-01-01,SLE,Selangor,21,14,7
2023-01-01,SLV,Johor,1,1,0
2023-01-01,SLV,Kedah,0,0,0
2023-01-01,SLV,Perak,0,0,0
2023-01-01,SLV,Perlis,0,0,0
2023-01-01,SLV,Pulau Pinang,0,0,0
2023-01-01,SLV,Sabah,0,0,0
2023-01-01,SLV,Selangor,9,4,5
2023-01-01,SLV,W.P. Labuan,0,0,0
2023-01-01,SMR,Johor,0,0,0
2023-01-01,SMR,Selangor,2,2,0
2023-01-01,SOM,Johor,0,0,0
2023-01-01,SOM,Kedah,2,2,0
2023-01-01,SOM,Kelantan,0,0,0
2023-01-01,SOM,Perlis,0,0,0
2023-01-01,SOM,Sabah,0,0,0
2023-01-01,SOM,Sarawak,0,0,0
2023-01-01,SOM,Selangor,251,152,99
2023-01-01,SRB,Johor,7,3,4
2023-01-01,SRB,Kedah,3,2,1
2023-01-01,SRB,Kelantan,0,0,0
2023-01-01,SRB,Pahang,0,0,0
2023-01-01,SRB,Perak,0,0,0
2023-01-01,SRB,Perlis,0,0,0
2023-01-01,SRB,Pulau Pinang,0,0,0
2023-01-01,SRB,Sabah,0,0,0
2023-01-01,SRB,Sarawak,0,0,0
2023-01-01,SRB,Selangor,57,38,19
2023-01-01,SSD,Johor,0,0,0
2023-01-01,SSD,Kedah,0,0,0
2023-01-01,SSD,Sarawak,0,0,0
2023-01-01,SSD,Selangor,47,33,14
2023-01-01,SSD,W.P. Labuan,0,0,0
2023-01-01,STP,Selangor,3,3,0
2023-01-01,SUR,Johor,3,2,1
2023-01-01,SUR,Kedah,0,0,0
2023-01-01,SUR,Kelantan,1,1,0
2023-01-01,SUR,Perak,0,0,0
2023-01-01,SUR,Perlis,0,0,0
2023-01-01,SUR,Pulau Pinang,0,0,0
2023-01-01,SUR,Sabah,1,0,1
2023-01-01,SUR,Sarawak,0,0,0
2023-01-01,SUR,Selangor,6,4,2
2023-01-01,SVK,Johor,47,27,20
2023-01-01,SVK,Kedah,129,72,57
2023-01-01,SVK,Kelantan,2,1,1
2023-01-01,SVK,Negeri Sembilan,0,0,0
2023-01-01,SVK,Pahang,0,0,0
2023-01-01,SVK,Perak,0,0,0
2023-01-01,SVK,Perlis,8,5,3
2023-01-01,SVK,Pulau Pinang,21,16,5
2023-01-01,SVK,Sabah,11,7,4
2023-01-01,SVK,Sarawak,2,1,1
2023-01-01,SVK,Selangor,401,218,183
2023-01-01,SVK,W.P. Labuan,2,1,1
2023-01-01,SVN,Johor,21,12,9
2023-01-01,SVN,Kedah,15,8,7
2023-01-01,SVN,Kelantan,0,0,0
2023-01-01,SVN,Perak,0,0,0
2023-01-01,SVN,Perlis,0,0,0
2023-01-01,SVN,Pulau Pinang,5,3,2
2023-01-01,SVN,Sabah,1,0,1
2023-01-01,SVN,Sarawak,1,0,1
2023-01-01,SVN,Selangor,116,73,43
2023-01-01,SVN,W.P. Labuan,0,0,0
2023-01-01,SWE,Johor,272,157,115
2023-01-01,SWE,Kedah,423,206,217
2023-01-01,SWE,Kelantan,2,2,0
2023-01-01,SWE,Melaka,0,0,0
2023-01-01,SWE,Negeri Sembilan,0,0,0
2023-01-01,SWE,Pahang,0,0,0
2023-01-01,SWE,Perak,5,5,0
2023-01-01,SWE,Perlis,40,28,12
2023-01-01,SWE,Pulau Pinang,85,57,28
2023-01-01,SWE,Sabah,26,13,13
2023-01-01,SWE,Sarawak,9,5,4
2023-01-01,SWE,Selangor,1316,766,550
2023-01-01,SWE,W.P. Labuan,1,1,0
2023-01-01,SWZ,Johor,7,5,2
2023-01-01,SWZ,Kedah,0,0,0
2023-01-01,SWZ,Pulau Pinang,0,0,0
2023-01-01,SWZ,Sabah,0,0,0
2023-01-01,SWZ,Selangor,5,2,3
2023-01-01,SYC,Johor,9,5,4
2023-01-01,SYC,Kedah,0,0,0
2023-01-01,SYC,Pulau Pinang,0,0,0
2023-01-01,SYC,Sabah,0,0,0
2023-01-01,SYC,Sarawak,0,0,0
2023-01-01,SYC,Selangor,70,27,43
2023-01-01,SYR,Johor,12,7,5
2023-01-01,SYR,Kedah,1,1,0
2023-01-01,SYR,Kelantan,0,0,0
2023-01-01,SYR,Pahang,0,0,0
2023-01-01,SYR,Perlis,0,0,0
2023-01-01,SYR,Pulau Pinang,1,1,0
2023-01-01,SYR,Sabah,4,1,3
2023-01-01,SYR,Sarawak,2,2,0
2023-01-01,SYR,Selangor,493,325,168
2023-01-01,SYR,W.P. Labuan,0,0,0
2023-01-01,TCA,Perlis,0,0,0
2023-01-01,TCD,Johor,0,0,0
2023-01-01,TCD,Kedah,0,0,0
2023-01-01,TCD,Perlis,0,0,0
2023-01-01,TCD,Selangor,13,8,5
2023-01-01,TGO,Johor,1,1,0
2023-01-01,TGO,Perak,0,0,0
2023-01-01,TGO,Pulau Pinang,0,0,0
2023-01-01,TGO,Selangor,1,0,1
2023-01-01,THA,Johor,6207,1770,4437
2023-01-01,THA,Kedah,62053,36668,25385
2023-01-01,THA,Kelantan,48524,25810,22714
2023-01-01,THA,Melaka,5,3,2
2023-01-01,THA,Negeri Sembilan,0,0,0
2023-01-01,THA,Pahang,0,0,0
2023-01-01,THA,Perak,8606,4001,4605
2023-01-01,THA,Perlis,54106,33481,20625
2023-01-01,THA,Pulau Pinang,1667,658,1009
2023-01-01,THA,Sabah,133,29,104
2023-01-01,THA,Sarawak,367,126,241
2023-01-01,THA,Selangor,9090,3460,5630
2023-01-01,THA,Terengganu,0,0,0
2023-01-01,THA,W.P. Labuan,5,2,3
2023-01-01,TJK,Johor,0,0,0
2023-01-01,TJK,Kedah,0,0,0
2023-01-01,TJK,Perlis,0,0,0
2023-01-01,TJK,Pulau Pinang,1,1,0
2023-01-01,TJK,Sabah,1,1,0
2023-01-01,TJK,Selangor,99,66,33
2023-01-01,TKL,Selangor,0,0,0
2023-01-01,TKM,Johor,2,1,1
2023-01-01,TKM,Kedah,1,1,0
2023-01-01,TKM,Kelantan,0,0,0
2023-01-01,TKM,Perlis,0,0,0
2023-01-01,TKM,Pulau Pinang,0,0,0
2023-01-01,TKM,Sabah,0,0,0
2023-01-01,TKM,Sarawak,3,3,0
2023-01-01,TKM,Selangor,107,55,52
2023-01-01,TLS,Johor,4,1,3
2023-01-01,TLS,Kedah,0,0,0
2023-01-01,TLS,Perlis,0,0,0
2023-01-01,TLS,Pulau Pinang,5,3,2
2023-01-01,TLS,Sabah,4,4,0
2023-01-01,TLS,Sarawak,2,0,2
2023-01-01,TLS,Selangor,171,92,79
2023-01-01,TON,Johor,0,0,0
2023-01-01,TON,Pulau Pinang,1,1,0
2023-01-01,TON,Sarawak,0,0,0
2023-01-01,TON,Selangor,13,8,5
2023-01-01,TTO,Johor,3,0,3
2023-01-01,TTO,Kedah,0,0,0
2023-01-01,TTO,Pahang,0,0,0
2023-01-01,TTO,Pulau Pinang,0,0,0
2023-01-01,TTO,Sabah,0,0,0
2023-01-01,TTO,Sarawak,2,0,2
2023-01-01,TTO,Selangor,21,14,7
2023-01-01,TUN,Johor,17,8,9
2023-01-01,TUN,Kedah,5,3,2
2023-01-01,TUN,Kelantan,0,0,0
2023-01-01,TUN,Melaka,2,1,1
2023-01-01,TUN,Perak,0,0,0
2023-01-01,TUN,Perlis,0,0,0
2023-01-01,TUN,Pulau Pinang,3,1,2
2023-01-01,TUN,Sabah,2,1,1
2023-01-01,TUN,Sarawak,2,0,2
2023-01-01,TUN,Selangor,589,278,311
2023-01-01,TUN,W.P. Labuan,0,0,0
2023-01-01,TUR,Johor,251,167,84
2023-01-01,TUR,Kedah,56,35,21
2023-01-01,TUR,Kelantan,2,0,2
2023-01-01,TUR,Melaka,1,1,0
2023-01-01,TUR,Negeri Sembilan,0,0,0
2023-01-01,TUR,Pahang,1,0,1
2023-01-01,TUR,Perak,2,1,1
2023-01-01,TUR,Perlis,23,17,6
2023-01-01,TUR,Pulau Pinang,40,29,11
2023-01-01,TUR,Sabah,13,8,5
2023-01-01,TUR,Sarawak,24,18,6
2023-01-01,TUR,Selangor,952,648,304
2023-01-01,TUR,W.P. Labuan,0,0,0
2023-01-01,TUV,Selangor,0,0,0
2023-01-01,TWN,Johor,5464,2449,3015
2023-01-01,TWN,Kedah,169,88,81
2023-01-01,TWN,Kelantan,3,2,1
2023-01-01,TWN,Melaka,1,1,0
2023-01-01,TWN,Negeri Sembilan,0,0,0
2023-01-01,TWN,Pahang,12,6,6
2023-01-01,TWN,Perak,51,28,23
2023-01-01,TWN,Perlis,32,14,18
2023-01-01,TWN,Pulau Pinang,3376,1686,1690
2023-01-01,TWN,Sabah,1244,553,691
2023-01-01,TWN,Sarawak,483,192,291
2023-01-01,TWN,Selangor,12199,5864,6335
2023-01-01,TWN,W.P. Labuan,4,3,1
2023-01-01,TZA,Johor,15,12,3
2023-01-01,TZA,Kedah,2,2,0
2023-01-01,TZA,Perak,0,0,0
2023-01-01,TZA,Perlis,2,2,0
2023-01-01,TZA,Pulau Pinang,0,0,0
2023-01-01,TZA,Sabah,1,0,1
2023-01-01,TZA,Sarawak,1,1,0
2023-01-01,TZA,Selangor,119,51,68
2023-01-01,UGA,Johor,25,9,16
2023-01-01,UGA,Kedah,3,0,3
2023-01-01,UGA,Perak,0,0,0
2023-01-01,UGA,Perlis,1,1,0
2023-01-01,UGA,Pulau Pinang,1,0,1
2023-01-01,UGA,Sabah,0,0,0
2023-01-01,UGA,Sarawak,0,0,0
2023-01-01,UGA,Selangor,69,33,36
2023-01-01,UKR,Johor,81,57,24
2023-01-01,UKR,Kedah,70,32,38
2023-01-01,UKR,Kelantan,2,2,0
2023-01-01,UKR,Melaka,0,0,0
2023-01-01,UKR,Negeri Sembilan,0,0,0
2023-01-01,UKR,Pahang,3,2,1
2023-01-01,UKR,Perak,2,1,1
2023-01-01,UKR,Perlis,12,5,7
2023-01-01,UKR,Pulau Pinang,34,18,16
2023-01-01,UKR,Sabah,2,1,1
2023-01-01,UKR,Sarawak,2,0,2
2023-01-01,UKR,Selangor,1000,451,549
2023-01-01,UKR,W.P. Labuan,0,0,0
2023-01-01,URY,Johor,15,8,7
2023-01-01,URY,Kedah,3,2,1
2023-01-01,URY,Kelantan,2,1,1
2023-01-01,URY,Perak,0,0,0
2023-01-01,URY,Perlis,0,0,0
2023-01-01,URY,Pulau Pinang,0,0,0
2023-01-01,URY,Sabah,0,0,0
2023-01-01,URY,Sarawak,0,0,0
2023-01-01,URY,Selangor,49,23,26
2023-01-01,URY,W.P. Labuan,0,0,0
2023-01-01,USA,Johor,4101,2417,1684
2023-01-01,USA,Kedah,577,303,274
2023-01-01,USA,Kelantan,7,6,1
2023-01-01,USA,Melaka,0,0,0
2023-01-01,USA,Negeri Sembilan,0,0,0
2023-01-01,USA,Pahang,6,5,1
2023-01-01,USA,Perak,139,71,68
2023-01-01,USA,Perlis,137,84,53
2023-01-01,USA,Pulau Pinang,1739,1072,667
2023-01-01,USA,Sabah,315,174,141
2023-01-01,USA,Sarawak,251,144,107
2023-01-01,USA,Selangor,13199,7574,5625
2023-01-01,USA,Terengganu,0,0,0
2023-01-01,USA,W.P. Labuan,12,8,4
2023-01-01,UZB,Johor,93,78,15
2023-01-01,UZB,Kedah,37,22,15
2023-01-01,UZB,Kelantan,1,0,1
2023-01-01,UZB,Perak,0,0,0
2023-01-01,UZB,Perlis,2,1,1
2023-01-01,UZB,Pulau Pinang,15,3,12
2023-01-01,UZB,Sabah,6,4,2
2023-01-01,UZB,Sarawak,2,1,1
2023-01-01,UZB,Selangor,1930,1208,722
2023-01-01,VAT,Johor,0,0,0
2023-01-01,VAT,Sarawak,0,0,0
2023-01-01,VAT,Selangor,0,0,0
2023-01-01,VCT,Johor,0,0,0
2023-01-01,VCT,Kedah,0,0,0
2023-01-01,VCT,Pulau Pinang,0,0,0
2023-01-01,VCT,Sarawak,0,0,0
2023-01-01,VCT,Selangor,4,1,3
2023-01-01,VEN,Johor,19,7,12
2023-01-01,VEN,Kedah,1,0,1
2023-01-01,VEN,Kelantan,0,0,0
2023-01-01,VEN,Melaka,0,0,0
2023-01-01,VEN,Perak,0,0,0
2023-01-01,VEN,Perlis,0,0,0
2023-01-01,VEN,Pulau Pinang,3,3,0
2023-01-01,VEN,Sabah,0,0,0
2023-01-01,VEN,Sarawak,1,1,0
2023-01-01,VEN,Selangor,82,40,42
2023-01-01,VEN,W.P. Labuan,0,0,0
2023-01-01,VNM,Johor,9635,2835,6800
2023-01-01,VNM,Kedah,287,48,239
2023-01-01,VNM,Kelantan,7,3,4
2023-01-01,VNM,Melaka,0,0,0
2023-01-01,VNM,Negeri Sembilan,1,0,1
2023-01-01,VNM,Pahang,3,1,2
2023-01-01,VNM,Perak,79,3,76
2023-01-01,VNM,Perlis,178,15,163
2023-01-01,VNM,Pulau Pinang,1270,330,940
2023-01-01,VNM,Sabah,18,4,14
2023-01-01,VNM,Sarawak,158,33,125
2023-01-01,VNM,Selangor,13425,4331,9094
2023-01-01,VNM,Terengganu,0,0,0
2023-01-01,VNM,W.P. Labuan,6,4,2
2023-01-01,VUT,Johor,37,21,16
2023-01-01,VUT,Kedah,0,0,0
2023-01-01,VUT,Pulau Pinang,10,5,5
2023-01-01,VUT,Sabah,1,1,0
2023-01-01,VUT,Sarawak,0,0,0
2023-01-01,VUT,Selangor,39,34,5
2023-01-01,WSM,Johor,0,0,0
2023-01-01,WSM,Sarawak,0,0,0
2023-01-01,WSM,Selangor,0,0,0
2023-01-01,XXX,Johor,162,102,60
2023-01-01,XXX,Kedah,4,2,2
2023-01-01,XXX,Kelantan,1,0,1
2023-01-01,XXX,Melaka,0,0,0
2023-01-01,XXX,Pahang,0,0,0
2023-01-01,XXX,Perak,3,2,1
2023-01-01,XXX,Perlis,3,2,1
2023-01-01,XXX,Pulau Pinang,44,22,22
2023-01-01,XXX,Sabah,20,12,8
2023-01-01,XXX,Sarawak,38,31,7
2023-01-01,XXX,Selangor,367,219,148
2023-01-01,XXX,W.P. Labuan,0,0,0
2023-01-01,YEM,Johor,31,22,9
2023-01-01,YEM,Kedah,3,2,1
2023-01-01,YEM,Kelantan,4,4,0
2023-01-01,YEM,Melaka,5,3,2
2023-01-01,YEM,Pahang,0,0,0
2023-01-01,YEM,Perak,0,0,0
2023-01-01,YEM,Perlis,2,2,0
2023-01-01,YEM,Pulau Pinang,1,1,0
2023-01-01,YEM,Sabah,2,2,0
2023-01-01,YEM,Sarawak,0,0,0
2023-01-01,YEM,Selangor,1064,746,318
2023-01-01,YEM,W.P. Labuan,0,0,0
2023-01-01,ZAF,Johor,279,159,120
2023-01-01,ZAF,Kedah,75,41,34
2023-01-01,ZAF,Kelantan,0,0,0
2023-01-01,ZAF,Melaka,1,1,0
2023-01-01,ZAF,Pahang,2,0,2
2023-01-01,ZAF,Perak,2,2,0
2023-01-01,ZAF,Perlis,10,4,6
2023-01-01,ZAF,Pulau Pinang,42,24,18
2023-01-01,ZAF,Sabah,10,7,3
2023-01-01,ZAF,Sarawak,43,27,16
2023-01-01,ZAF,Selangor,1194,621,573
2023-01-01,ZAF,Terengganu,0,0,0
2023-01-01,ZAF,W.P. Labuan,16,7,9
2023-01-01,ZAR,Selangor,0,0,0
2023-01-01,ZMB,Johor,2,1,1
2023-01-01,ZMB,Kedah,0,0,0
2023-01-01,ZMB,Perak,0,0,0
2023-01-01,ZMB,Perlis,0,0,0
2023-01-01,ZMB,Pulau Pinang,0,0,0
2023-01-01,ZMB,Sabah,0,0,0
2023-01-01,ZMB,Sarawak,0,0,0
2023-01-01,ZMB,Selangor,67,38,29
2023-01-01,ZWE,Johor,6,4,2
2023-01-01,ZWE,Kedah,0,0,0
2023-01-01,ZWE,Kelantan,0,0,0
2023-01-01,ZWE,Perak,0,0,0
2023-01-01,ZWE,Perlis,0,0,0
2023-01-01,ZWE,Pulau Pinang,0,0,0
2023-01-01,ZWE,Sabah,0,0,0
2023-01-01,ZWE,Sarawak,0,0,0
2023-01-01,ZWE,Selangor,119,59,60
2023-02-01,ABW,Kedah,0,0,0
2023-02-01,ABW,Pulau Pinang,0,0,0
2023-02-01,AFG,Johor,0,0,0
2023-02-01,AFG,Kedah,0,0,0
2023-02-01,AFG,Perlis,0,0,0
2023-02-01,AFG,Pulau Pinang,0,0,0
2023-02-01,AFG,Sarawak,1,1,0
2023-02-01,AFG,Selangor,39,35,4
2023-02-01,AGO,Johor,0,0,0
2023-02-01,AGO,Kedah,0,0,0
2023-02-01,AGO,Sabah,0,0,0
2023-02-01,AGO,Selangor,5,4,1
2023-02-01,AIA,Selangor,0,0,0
2023-02-01,ALB,Johor,9,7,2
2023-02-01,ALB,Kedah,3,3,0
2023-02-01,ALB,Perak,0,0,0
2023-02-01,ALB,Perlis,1,0,1
2023-02-01,ALB,Pulau Pinang,1,1,0
2023-02-01,ALB,Sabah,0,0,0
2023-02-01,ALB,Sarawak,0,0,0
2023-02-01,ALB,Selangor,23,15,8
2023-02-01,AND,Johor,0,0,0
2023-02-01,AND,Kedah,0,0,0
2023-02-01,AND,Perlis,0,0,0
2023-02-01,AND,Pulau Pinang,0,0,0
2023-02-01,AND,Selangor,5,3,2
2023-02-01,ANT,Selangor,0,0,0
2023-02-01,ARE,Johor,9,6,3
2023-02-01,ARE,Kedah,0,0,0
2023-02-01,ARE,Kelantan,0,0,0
2023-02-01,ARE,Perak,0,0,0
2023-02-01,ARE,Perlis,0,0,0
2023-02-01,ARE,Pulau Pinang,2,2,0
2023-02-01,ARE,Sabah,1,1,0
2023-02-01,ARE,Sarawak,0,0,0
2023-02-01,ARE,Selangor,274,188,86
2023-02-01,ARG,Johor,70,46,24
2023-02-01,ARG,Kedah,71,34,37
2023-02-01,ARG,Kelantan,0,0,0
2023-02-01,ARG,Melaka,0,0,0
2023-02-01,ARG,Perak,0,0,0
2023-02-01,ARG,Perlis,5,3,2
2023-02-01,ARG,Pulau Pinang,4,2,2
2023-02-01,ARG,Sabah,3,2,1
2023-02-01,ARG,Sarawak,2,1,1
2023-02-01,ARG,Selangor,301,175,126
2023-02-01,ARG,W.P. Labuan,0,0,0
2023-02-01,ARM,Johor,0,0,0
2023-02-01,ARM,Kedah,1,0,1
2023-02-01,ARM,Kelantan,0,0,0
2023-02-01,ARM,Perak,0,0,0
2023-02-01,ARM,Perlis,0,0,0
2023-02-01,ARM,Pulau Pinang,4,1,3
2023-02-01,ARM,Sabah,3,1,2
2023-02-01,ARM,Sarawak,0,0,0
2023-02-01,ARM,Selangor,37,18,19
2023-02-01,ATA,Selangor,0,0,0
2023-02-01,ATG,Johor,3,2,1
2023-02-01,ATG,Kedah,0,0,0
2023-02-01,ATG,Pulau Pinang,0,0,0
2023-02-01,ATG,Sarawak,0,0,0
2023-02-01,ATG,Selangor,12,9,3
2023-02-01,AUS,Johor,4214,2536,1678
2023-02-01,AUS,Kedah,509,280,229
2023-02-01,AUS,Kelantan,4,4,0
2023-02-01,AUS,Melaka,4,4,0
2023-02-01,AUS,Negeri Sembilan,1,1,0
2023-02-01,AUS,Pahang,1,1,0
2023-02-01,AUS,Perak,218,118,100
2023-02-01,AUS,Perlis,81,54,27
2023-02-01,AUS,Pulau Pinang,1650,914,736
2023-02-01,AUS,Sabah,272,136,136
2023-02-01,AUS,Sarawak,501,282,219
2023-02-01,AUS,Selangor,15945,9512,6433
2023-02-01,AUS,Terengganu,0,0,0
2023-02-01,AUS,W.P. Labuan,13,7,6
2023-02-01,AUT,Johor,178,97,81
2023-02-01,AUT,Kedah,174,99,75
2023-02-01,AUT,Kelantan,3,3,0
2023-02-01,AUT,Melaka,1,1,0
2023-02-01,AUT,Negeri Sembilan,0,0,0
2023-02-01,AUT,Pahang,0,0,0
2023-02-01,AUT,Perak,4,2,2
2023-02-01,AUT,Perlis,28,21,7
2023-02-01,AUT,Pulau Pinang,84,43,41
2023-02-01,AUT,Sabah,15,9,6
2023-02-01,AUT,Sarawak,11,7,4
2023-02-01,AUT,Selangor,878,528,350
2023-02-01,AUT,Terengganu,0,0,0
2023-02-01,AUT,W.P. Labuan,4,4,0
2023-02-01,AZE,Johor,2,2,0
2023-02-01,AZE,Kedah,1,1,0
2023-02-01,AZE,Kelantan,0,0,0
2023-02-01,AZE,Melaka,0,0,0
2023-02-01,AZE,Perlis,0,0,0
2023-02-01,AZE,Pulau Pinang,2,2,0
2023-02-01,AZE,Sabah,1,1,0
2023-02-01,AZE,Sarawak,2,1,1
2023-02-01,AZE,Selangor,69,41,28
2023-02-01,AZE,W.P. Labuan,0,0,0
2023-02-01,BDI,Pulau Pinang,0,0,0
2023-02-01,BDI,Sarawak,0,0,0
2023-02-01,BDI,Selangor,3,2,1
2023-02-01,BEL,Johor,231,159,72
2023-02-01,BEL,Kedah,121,60,61
2023-02-01,BEL,Kelantan,1,1,0
2023-02-01,BEL,Melaka,1,1,0
2023-02-01,BEL,Negeri Sembilan,1,0,1
2023-02-01,BEL,Pahang,5,3,2
2023-02-01,BEL,Perak,7,4,3
2023-02-01,BEL,Perlis,29,14,15
2023-02-01,BEL,Pulau Pinang,50,40,10
2023-02-01,BEL,Sabah,21,10,11
2023-02-01,BEL,Sarawak,29,12,17
2023-02-01,BEL,Selangor,979,624,355
2023-02-01,BEL,W.P. Labuan,0,0,0
2023-02-01,BEN,Johor,1,1,0
2023-02-01,BEN,Kedah,0,0,0
2023-02-01,BEN,Perak,0,0,0
2023-02-01,BEN,Pulau Pinang,0,0,0
2023-02-01,BEN,Sabah,0,0,0
2023-02-01,BEN,Sarawak,1,1,0
2023-02-01,BEN,Selangor,5,4,1
2023-02-01,BFA,Perak,0,0,0
2023-02-01,BFA,Pulau Pinang,0,0,0
2023-02-01,BFA,Selangor,4,4,0
2023-02-01,BGD,Johor,2295,1920,375
2023-02-01,BGD,Kedah,37,18,19
2023-02-01,BGD,Kelantan,1,1,0
2023-02-01,BGD,Melaka,1,1,0
2023-02-01,BGD,Negeri Sembilan,0,0,0
2023-02-01,BGD,Pahang,0,0,0
2023-02-01,BGD,Perak,17,17,0
2023-02-01,BGD,Perlis,4,4,0
2023-02-01,BGD,Pulau Pinang,648,636,12
2023-02-01,BGD,Sabah,2,2,0
2023-02-01,BGD,Sarawak,28,26,2
2023-02-01,BGD,Selangor,56313,54724,1589
2023-02-01,BGD,W.P. Labuan,4,4,0
2023-02-01,BGR,Johor,44,27,17
2023-02-01,BGR,Kedah,21,11,10
2023-02-01,BGR,Kelantan,0,0,0
2023-02-01,BGR,Pahang,0,0,0
2023-02-01,BGR,Perak,1,0,1
2023-02-01,BGR,Perlis,5,4,1
2023-02-01,BGR,Pulau Pinang,14,7,7
2023-02-01,BGR,Sabah,4,1,3
2023-02-01,BGR,Sarawak,2,1,1
2023-02-01,BGR,Selangor,250,140,110
2023-02-01,BGR,W.P. Labuan,0,0,0
2023-02-01,BHR,Johor,6,3,3
2023-02-01,BHR,Kedah,2,2,0
2023-02-01,BHR,Kelantan,1,1,0
2023-02-01,BHR,Perlis,1,1,0
2023-02-01,BHR,Pulau Pinang,3,3,0
2023-02-01,BHR,Sabah,0,0,0
2023-02-01,BHR,Sarawak,0,0,0
2023-02-01,BHR,Selangor,105,56,49
2023-02-01,BHS,Johor,5,1,4
2023-02-01,BHS,Kedah,0,0,0
2023-02-01,BHS,Perak,0,0,0
2023-02-01,BHS,Sabah,0,0,0
2023-02-01,BHS,Sarawak,0,0,0
2023-02-01,BHS,Selangor,3,3,0
2023-02-01,BIH,Johor,10,7,3
2023-02-01,BIH,Kedah,0,0,0
2023-02-01,BIH,Perlis,0,0,0
2023-02-01,BIH,Pulau Pinang,3,1,2
2023-02-01,BIH,Sabah,0,0,0
2023-02-01,BIH,Sarawak,1,1,0
2023-02-01,BIH,Selangor,55,32,23
2023-02-01,BLR,Johor,6,2,4
2023-02-01,BLR,Kedah,10,4,6
2023-02-01,BLR,Kelantan,2,2,0
2023-02-01,BLR,Pahang,0,0,0
2023-02-01,BLR,Perak,0,0,0
2023-02-01,BLR,Perlis,8,4,4
2023-02-01,BLR,Pulau Pinang,11,4,7
2023-02-01,BLR,Sabah,0,0,0
2023-02-01,BLR,Sarawak,0,0,0
2023-02-01,BLR,Selangor,476,237,239
2023-02-01,BLR,W.P. Labuan,0,0,0
2023-02-01,BLZ,Johor,7,3,4
2023-02-01,BLZ,Pulau Pinang,0,0,0
2023-02-01,BLZ,Sarawak,0,0,0
2023-02-01,BLZ,Selangor,5,4,1
2023-02-01,BMU,Selangor,0,0,0
2023-02-01,BOL,Johor,1,0,1
2023-02-01,BOL,Kedah,0,0,0
2023-02-01,BOL,Melaka,0,0,0
2023-02-01,BOL,Perak,0,0,0
2023-02-01,BOL,Perlis,0,0,0
2023-02-01,BOL,Pulau Pinang,0,0,0
2023-02-01,BOL,Sabah,1,1,0
2023-02-01,BOL,Sarawak,2,0,2
2023-02-01,BOL,Selangor,12,6,6
2023-02-01,BRA,Johor,155,91,64
2023-02-01,BRA,Kedah,72,34,38
2023-02-01,BRA,Kelantan,0,0,0
2023-02-01,BRA,Melaka,0,0,0
2023-02-01,BRA,Pahang,0,0,0
2023-02-01,BRA,Perak,1,0,1
2023-02-01,BRA,Perlis,5,2,3
2023-02-01,BRA,Pulau Pinang,27,14,13
2023-02-01,BRA,Sabah,7,6,1
2023-02-01,BRA,Sarawak,5,3,2
2023-02-01,BRA,Selangor,694,401,293
2023-02-01,BRA,W.P. Labuan,2,1,1
2023-02-01,BRB,Johor,0,0,0
2023-02-01,BRB,Kedah,0,0,0
2023-02-01,BRB,Perlis,0,0,0
2023-02-01,BRB,Pulau Pinang,0,0,0
2023-02-01,BRB,Selangor,4,2,2
2023-02-01,BRN,Johor,446,224,222
2023-02-01,BRN,Kedah,23,15,8
2023-02-01,BRN,Kelantan,1,1,0
2023-02-01,BRN,Melaka,0,0,0
2023-02-01,BRN,Pahang,0,0,0
2023-02-01,BRN,Perak,7,7,0
2023-02-01,BRN,Perlis,8,2,6
2023-02-01,BRN,Pulau Pinang,11,8,3
2023-02-01,BRN,Sabah,754,313,441
2023-02-01,BRN,Sarawak,84606,46519,38087
2023-02-01,BRN,Selangor,4262,2120,2142
2023-02-01,BRN,W.P. Labuan,1362,910,452
2023-02-01,BTN,Johor,4,4,0
2023-02-01,BTN,Kedah,0,0,0
2023-02-01,BTN,Perak,0,0,0
2023-02-01,BTN,Perlis,0,0,0
2023-02-01,BTN,Pulau Pinang,3,2,1
2023-02-01,BTN,Sabah,0,0,0
2023-02-01,BTN,Sarawak,0,0,0
2023-02-01,BTN,Selangor,18,12,6
2023-02-01,BWA,Johor,0,0,0
2023-02-01,BWA,Kedah,0,0,0
2023-02-01,BWA,Perlis,0,0,0
2023-02-01,BWA,Pulau Pinang,0,0,0
2023-02-01,BWA,Sabah,0,0,0
2023-02-01,BWA,Sarawak,0,0,0
2023-02-01,BWA,Selangor,12,2,10
2023-02-01,CAF,Kedah,0,0,0
2023-02-01,CAF,Selangor,0,0,0
2023-02-01,CAN,Johor,1490,814,676
2023-02-01,CAN,Kedah,343,179,164
2023-02-01,CAN,Kelantan,2,1,1
2023-02-01,CAN,Melaka,0,0,0
2023-02-01,CAN,Negeri Sembilan,0,0,0
2023-02-01,CAN,Pahang,1,1,0
2023-02-01,CAN,Perak,43,25,18
2023-02-01,CAN,Perlis,82,50,32
2023-02-01,CAN,Pulau Pinang,646,339,307
2023-02-01,CAN,Sabah,183,99,84
2023-02-01,CAN,Sarawak,400,222,178
2023-02-01,CAN,Selangor,4360,2563,1797
2023-02-01,CAN,Terengganu,0,0,0
2023-02-01,CAN,W.P. Labuan,9,6,3
2023-02-01,CCK,Selangor,0,0,0
2023-02-01,CHE,Johor,335,198,137
2023-02-01,CHE,Kedah,218,111,107
2023-02-01,CHE,Kelantan,3,3,0
2023-02-01,CHE,Melaka,0,0,0
2023-02-01,CHE,Negeri Sembilan,0,0,0
2023-02-01,CHE,Pahang,0,0,0
2023-02-01,CHE,Perak,9,5,4
2023-02-01,CHE,Perlis,52,35,17
2023-02-01,CHE,Pulau Pinang,151,91,60
2023-02-01,CHE,Sabah,28,14,14
2023-02-01,CHE,Sarawak,43,19,24
2023-02-01,CHE,Selangor,1268,749,519
2023-02-01,CHE,W.P. Labuan,2,2,0
2023-02-01,CHL,Johor,27,9,18
2023-02-01,CHL,Kedah,22,11,11
2023-02-01,CHL,Kelantan,1,0,1
2023-02-01,CHL,Melaka,0,0,0
2023-02-01,CHL,Pahang,0,0,0
2023-02-01,CHL,Perak,0,0,0
2023-02-01,CHL,Perlis,4,2,2
2023-02-01,CHL,Pulau Pinang,5,1,4
2023-02-01,CHL,Sabah,4,2,2
2023-02-01,CHL,Sarawak,1,1,0
2023-02-01,CHL,Selangor,266,128,138
2023-02-01,CHN,Johor,19461,8292,11169
2023-02-01,CHN,Kedah,477,195,282
2023-02-01,CHN,Kelantan,2,0,2
2023-02-01,CHN,Melaka,0,0,0
2023-02-01,CHN,Pahang,1,1,0
2023-02-01,CHN,Perak,193,79,114
2023-02-01,CHN,Perlis,64,42,22
2023-02-01,CHN,Pulau Pinang,3144,1682,1462
2023-02-01,CHN,Sabah,1049,560,489
2023-02-01,CHN,Sarawak,600,315,285
2023-02-01,CHN,Selangor,39835,23650,16185
2023-02-01,CHN,Terengganu,0,0,0
2023-02-01,CHN,W.P. Labuan,66,61,5
2023-02-01,CIV,Johor,1,0,1
2023-02-01,CIV,Kedah,0,0,0
2023-02-01,CIV,Pulau Pinang,0,0,0
2023-02-01,CIV,Sabah,0,0,0
2023-02-01,CIV,Sarawak,0,0,0
2023-02-01,CIV,Selangor,26,21,5
2023-02-01,CMR,Johor,0,0,0
2023-02-01,CMR,Kedah,0,0,0
2023-02-01,CMR,Pulau Pinang,1,1,0
2023-02-01,CMR,Sabah,0,0,0
2023-02-01,CMR,Sarawak,0,0,0
2023-02-01,CMR,Selangor,15,10,5
2023-02-01,COD,Johor,3,3,0
2023-02-01,COD,Pulau Pinang,0,0,0
2023-02-01,COD,Sarawak,0,0,0
2023-02-01,COD,Selangor,3,3,0
2023-02-01,COG,Johor,0,0,0
2023-02-01,COG,Kedah,0,0,0
2023-02-01,COG,Selangor,2,2,0
2023-02-01,COK,Selangor,0,0,0
2023-02-01,COL,Johor,25,13,12
2023-02-01,COL,Kedah,0,0,0
2023-02-01,COL,Perak,0,0,0
2023-02-01,COL,Pulau Pinang,1,0,1
2023-02-01,COL,Sabah,1,1,0
2023-02-01,COL,Sarawak,0,0,0
2023-02-01,COL,Selangor,103,54,49
2023-02-01,COL,W.P. Labuan,0,0,0
2023-02-01,COM,Johor,5,3,2
2023-02-01,COM,Kedah,0,0,0
2023-02-01,COM,Selangor,17,6,11
2023-02-01,CPV,Johor,0,0,0
2023-02-01,CPV,Kedah,0,0,0
2023-02-01,CPV,Pulau Pinang,0,0,0
2023-02-01,CPV,Sabah,1,1,0
2023-02-01,CPV,Selangor,1,1,0
2023-02-01,CRI,Johor,3,2,1
2023-02-01,CRI,Kedah,1,0,1
2023-02-01,CRI,Perak,0,0,0
2023-02-01,CRI,Perlis,0,0,0
2023-02-01,CRI,Pulau Pinang,2,1,1
2023-02-01,CRI,Sabah,0,0,0
2023-02-01,CRI,Sarawak,0,0,0
2023-02-01,CRI,Selangor,44,28,16
2023-02-01,CUB,Johor,3,2,1
2023-02-01,CUB,Kedah,0,0,0
2023-02-01,CUB,Perlis,0,0,0
2023-02-01,CUB,Pulau Pinang,0,0,0
2023-02-01,CUB,Sabah,1,0,1
2023-02-01,CUB,Sarawak,0,0,0
2023-02-01,CUB,Selangor,15,7,8
2023-02-01,CYP,Johor,11,9,2
2023-02-01,CYP,Kedah,2,1,1
2023-02-01,CYP,Perak,0,0,0
2023-02-01,CYP,Perlis,0,0,0
2023-02-01,CYP,Pulau Pinang,2,1,1
2023-02-01,CYP,Sabah,0,0,0
2023-02-01,CYP,Sarawak,0,0,0
2023-02-01,CYP,Selangor,32,21,11
2023-02-01,CZE,Johor,143,74,69
2023-02-01,CZE,Kedah,170,89,81
2023-02-01,CZE,Kelantan,3,3,0
2023-02-01,CZE,Melaka,0,0,0
2023-02-01,CZE,Negeri Sembilan,0,0,0
2023-02-01,CZE,Perak,1,0,1
2023-02-01,CZE,Perlis,10,3,7
2023-02-01,CZE,Pulau Pinang,29,17,12
2023-02-01,CZE,Sabah,18,12,6
2023-02-01,CZE,Sarawak,11,7,4
2023-02-01,CZE,Selangor,629,372,257
2023-02-01,CZE,W.P. Labuan,6,3,3
2023-02-01,DEU,Johor,2361,1448,913
2023-02-01,DEU,Kedah,1167,570,597
2023-02-01,DEU,Kelantan,18,13,5
2023-02-01,DEU,Melaka,6,5,1
2023-02-01,DEU,Negeri Sembilan,0,0,0
2023-02-01,DEU,Pahang,5,4,1
2023-02-01,DEU,Perak,27,18,9
2023-02-01,DEU,Perlis,235,142,93
2023-02-01,DEU,Pulau Pinang,847,578,269
2023-02-01,DEU,Sabah,138,84,54
2023-02-01,DEU,Sarawak,245,141,104
2023-02-01,DEU,Selangor,8981,5352,3629
2023-02-01,DEU,Terengganu,0,0,0
2023-02-01,DEU,W.P. Labuan,17,12,5
2023-02-01,DJI,Johor,0,0,0
2023-02-01,DJI,Selangor,5,3,2
2023-02-01,DMA,Johor,4,4,0
2023-02-01,DMA,Kedah,0,0,0
2023-02-01,DMA,Pulau Pinang,1,1,0
2023-02-01,DMA,Sabah,0,0,0
2023-02-01,DMA,Sarawak,0,0,0
2023-02-01,DMA,Selangor,37,28,9
2023-02-01,DMA,W.P. Labuan,0,0,0
2023-02-01,DNK,Johor,321,219,102
2023-02-01,DNK,Kedah,368,178,190
2023-02-01,DNK,Kelantan,0,0,0
2023-02-01,DNK,Melaka,0,0,0
2023-02-01,DNK,Negeri Sembilan,3,3,0
2023-02-01,DNK,Pahang,0,0,0
2023-02-01,DNK,Perak,10,4,6
2023-02-01,DNK,Perlis,21,16,5
2023-02-01,DNK,Pulau Pinang,82,56,26
2023-02-01,DNK,Sabah,53,29,24
2023-02-01,DNK,Sarawak,20,11,9
2023-02-01,DNK,Selangor,1087,626,461
2023-02-01,DNK,W.P. Labuan,0,0,0
2023-02-01,DOM,Johor,4,3,1
2023-02-01,DOM,Kedah,0,0,0
2023-02-01,DOM,Perak,0,0,0
2023-02-01,DOM,Perlis,0,0,0
2023-02-01,DOM,Pulau Pinang,3,1,2
2023-02-01,DOM,Sabah,0,0,0
2023-02-01,DOM,Sarawak,0,0,0
2023-02-01,DOM,Selangor,16,7,9
2023-02-01,DZA,Johor,22,14,8
2023-02-01,DZA,Kedah,5,2,3
2023-02-01,DZA,Kelantan,1,1,0
2023-02-01,DZA,Melaka,0,0,0
2023-02-01,DZA,Perak,0,0,0
2023-02-01,DZA,Perlis,1,1,0
2023-02-01,DZA,Pulau Pinang,0,0,0
2023-02-01,DZA,Sabah,1,1,0
2023-02-01,DZA,Sarawak,5,5,0
2023-02-01,DZA,Selangor,369,256,113
2023-02-01,DZA,W.P. Labuan,0,0,0
2023-02-01,ECU,Johor,11,10,1
2023-02-01,ECU,Kedah,0,0,0
2023-02-01,ECU,Perak,0,0,0
2023-02-01,ECU,Perlis,0,0,0
2023-02-01,ECU,Pulau Pinang,1,0,1
2023-02-01,ECU,Sabah,0,0,0
2023-02-01,ECU,Sarawak,0,0,0
2023-02-01,ECU,Selangor,44,30,14
2023-02-01,EGY,Johor,181,150,31
2023-02-01,EGY,Kedah,7,3,4
2023-02-01,EGY,Kelantan,0,0,0
2023-02-01,EGY,Melaka,0,0,0
2023-02-01,EGY,Pahang,0,0,0
2023-02-01,EGY,Perak,0,0,0
2023-02-01,EGY,Perlis,2,2,0
2023-02-01,EGY,Pulau Pinang,10,8,2
2023-02-01,EGY,Sabah,6,5,1
2023-02-01,EGY,Sarawak,129,87,42
2023-02-01,EGY,Selangor,1442,996,446
2023-02-01,EGY,Terengganu,0,0,0
2023-02-01,EGY,W.P. Labuan,0,0,0
2023-02-01,ERI,Johor,1,0,1
2023-02-01,ERI,Pulau Pinang,0,0,0
2023-02-01,ERI,Sabah,0,0,0
2023-02-01,ERI,Selangor,7,4,3
2023-02-01,ESP,Johor,360,229,131
2023-02-01,ESP,Kedah,184,94,90
2023-02-01,ESP,Kelantan,5,3,2
2023-02-01,ESP,Melaka,1,1,0
2023-02-01,ESP,Negeri Sembilan,0,0,0
2023-02-01,ESP,Pahang,0,0,0
2023-02-01,ESP,Perak,6,4,2
2023-02-01,ESP,Perlis,27,16,11
2023-02-01,ESP,Pulau Pinang,97,61,36
2023-02-01,ESP,Sabah,21,12,9
2023-02-01,ESP,Sarawak,29,20,9
2023-02-01,ESP,Selangor,1469,931,538
2023-02-01,ESP,W.P. Labuan,4,2,2
2023-02-01,EST,Johor,70,41,29
2023-02-01,EST,Kedah,91,45,46
2023-02-01,EST,Kelantan,0,0,0
2023-02-01,EST,Pahang,0,0,0
2023-02-01,EST,Perak,0,0,0
2023-02-01,EST,Perlis,4,3,1
2023-02-01,EST,Pulau Pinang,34,18,16
2023-02-01,EST,Sabah,12,5,7
2023-02-01,EST,Sarawak,12,6,6
2023-02-01,EST,Selangor,308,164,144
2023-02-01,EST,W.P. Labuan,4,1,3
2023-02-01,ETH,Johor,2,2,0
2023-02-01,ETH,Kedah,0,0,0
2023-02-01,ETH,Pulau Pinang,1,1,0
2023-02-01,ETH,Sarawak,0,0,0
2023-02-01,ETH,Selangor,29,23,6
2023-02-01,FIN,Johor,184,120,64
2023-02-01,FIN,Kedah,184,91,93
2023-02-01,FIN,Kelantan,4,2,2
2023-02-01,FIN,Melaka,0,0,0
2023-02-01,FIN,Negeri Sembilan,0,0,0
2023-02-01,FIN,Pahang,0,0,0
2023-02-01,FIN,Perak,8,4,4
2023-02-01,FIN,Perlis,14,12,2
2023-02-01,FIN,Pulau Pinang,60,35,25
2023-02-01,FIN,Sabah,24,13,11
2023-02-01,FIN,Sarawak,19,12,7
2023-02-01,FIN,Selangor,660,371,289
2023-02-01,FIN,W.P. Labuan,6,5,1
2023-02-01,FJI,Johor,41,19,22
2023-02-01,FJI,Kedah,1,1,0
2023-02-01,FJI,Kelantan,0,0,0
2023-02-01,FJI,Perak,0,0,0
2023-02-01,FJI,Perlis,0,0,0
2023-02-01,FJI,Pulau Pinang,5,1,4
2023-02-01,FJI,Sabah,0,0,0
2023-02-01,FJI,Sarawak,1,0,1
2023-02-01,FJI,Selangor,57,36,21
2023-02-01,FRA,Johor,1781,1100,681
2023-02-01,FRA,Kedah,1029,546,483
2023-02-01,FRA,Kelantan,21,13,8
2023-02-01,FRA,Melaka,3,2,1
2023-02-01,FRA,Negeri Sembilan,1,1,0
2023-02-01,FRA,Pahang,4,3,1
2023-02-01,FRA,Perak,53,32,21
2023-02-01,FRA,Perlis,162,106,56
2023-02-01,FRA,Pulau Pinang,421,267,154
2023-02-01,FRA,Sabah,92,58,34
2023-02-01,FRA,Sarawak,101,71,30
2023-02-01,FRA,Selangor,6983,4205,2778
2023-02-01,FRA,Terengganu,0,0,0
2023-02-01,FRA,W.P. Labuan,4,3,1
2023-02-01,FSM,Johor,0,0,0
2023-02-01,FSM,Pulau Pinang,0,0,0
2023-02-01,FSM,Selangor,0,0,0
2023-02-01,GAB,Johor,0,0,0
2023-02-01,GAB,Pulau Pinang,0,0,0
2023-02-01,GAB,Sarawak,0,0,0
2023-02-01,GAB,Selangor,2,1,1
2023-02-01,GBR,Johor,4190,2769,1421
2023-02-01,GBR,Kedah,1502,798,704
2023-02-01,GBR,Kelantan,18,16,2
2023-02-01,GBR,Melaka,1,1,0
2023-02-01,GBR,Negeri Sembilan,1,1,0
2023-02-01,GBR,Pahang,9,6,3
2023-02-01,GBR,Perak,126,69,57
2023-02-01,GBR,Perlis,239,163,76
2023-02-01,GBR,Pulau Pinang,1713,1002,711
2023-02-01,GBR,Sabah,464,243,221
2023-02-01,GBR,Sarawak,1124,677,447
2023-02-01,GBR,Selangor,14459,8875,5584
2023-02-01,GBR,Terengganu,0,0,0
2023-02-01,GBR,W.P. Labuan,40,23,17
2023-02-01,GEO,Johor,4,1,3
2023-02-01,GEO,Kedah,3,1,2
2023-02-01,GEO,Melaka,0,0,0
2023-02-01,GEO,Perak,0,0,0
2023-02-01,GEO,Perlis,2,1,1
2023-02-01,GEO,Pulau Pinang,1,0,1
2023-02-01,GEO,Sabah,0,0,0
2023-02-01,GEO,Sarawak,0,0,0
2023-02-01,GEO,Selangor,75,59,16
2023-02-01,GHA,Johor,2,2,0
2023-02-01,GHA,Kedah,0,0,0
2023-02-01,GHA,Kelantan,1,1,0
2023-02-01,GHA,Pulau Pinang,1,1,0
2023-02-01,GHA,Sabah,1,1,0
2023-02-01,GHA,Sarawak,3,1,2
2023-02-01,GHA,Selangor,48,34,14
2023-02-01,GIB,Johor,0,0,0
2023-02-01,GIB,Sarawak,0,0,0
2023-02-01,GIN,Johor,4,1,3
2023-02-01,GIN,Kedah,0,0,0
2023-02-01,GIN,Kelantan,0,0,0
2023-02-01,GIN,Perlis,0,0,0
2023-02-01,GIN,Pulau Pinang,0,0,0
2023-02-01,GIN,Sabah,1,0,1
2023-02-01,GIN,Sarawak,0,0,0
2023-02-01,GIN,Selangor,41,33,8
2023-02-01,GLP,Selangor,0,0,0
2023-02-01,GMB,Johor,1,1,0
2023-02-01,GMB,Kedah,0,0,0
2023-02-01,GMB,Kelantan,0,0,0
2023-02-01,GMB,Pulau Pinang,0,0,0
2023-02-01,GMB,Sabah,0,0,0
2023-02-01,GMB,Sarawak,0,0,0
2023-02-01,GMB,Selangor,7,5,2
2023-02-01,GNB,Johor,0,0,0
2023-02-01,GNB,Selangor,0,0,0
2023-02-01,GNQ,Johor,0,0,0
2023-02-01,GNQ,Selangor,1,1,0
2023-02-01,GRC,Johor,50,40,10
2023-02-01,GRC,Kedah,43,26,17
2023-02-01,GRC,Kelantan,0,0,0
2023-02-01,GRC,Melaka,0,0,0
2023-02-01,GRC,Negeri Sembilan,0,0,0
2023-02-01,GRC,Pahang,0,0,0
2023-02-01,GRC,Perak,0,0,0
2023-02-01,GRC,Perlis,9,5,4
2023-02-01,GRC,Pulau Pinang,11,10,1
2023-02-01,GRC,Sabah,4,4,0
2023-02-01,GRC,Sarawak,3,2,1
2023-02-01,GRC,Selangor,277,200,77
2023-02-01,GRD,Johor,3,2,1
2023-02-01,GRD,Kedah,0,0,0
2023-02-01,GRD,Pulau Pinang,0,0,0
2023-02-01,GRD,Sabah,1,1,0
2023-02-01,GRD,Sarawak,0,0,0
2023-02-01,GRD,Selangor,6,6,0
2023-02-01,GRL,Johor,0,0,0
2023-02-01,GRL,Selangor,0,0,0
2023-02-01,GTM,Johor,0,0,0
2023-02-01,GTM,Kedah,0,0,0
2023-02-01,GTM,Pahang,0,0,0
2023-02-01,GTM,Perak,0,0,0
2023-02-01,GTM,Pulau Pinang,0,0,0
2023-02-01,GTM,Sabah,0,0,0
2023-02-01,GTM,Sarawak,0,0,0
2023-02-01,GTM,Selangor,23,10,13
2023-02-01,GTM,W.P. Labuan,0,0,0
2023-02-01,GUY,Johor,4,1,3
2023-02-01,GUY,Kedah,0,0,0
2023-02-01,GUY,Pulau Pinang,0,0,0
2023-02-01,GUY,Sarawak,0,0,0
2023-02-01,GUY,Selangor,12,7,5
2023-02-01,HKG,Johor,4,2,2
2023-02-01,HKG,Kedah,3,3,0
2023-02-01,HKG,Kelantan,0,0,0
2023-02-01,HKG,Pahang,0,0,0
2023-02-01,HKG,Perak,34,17,17
2023-02-01,HKG,Perlis,4,2,2
2023-02-01,HKG,Pulau Pinang,0,0,0
2023-02-01,HKG,Sabah,2,1,1
2023-02-01,HKG,Sarawak,0,0,0
2023-02-01,HKG,Selangor,2,1,1
2023-02-01,HKG,Terengganu,0,0,0
2023-02-01,HMD,Johor,0,0,0
2023-02-01,HND,Johor,1,1,0
2023-02-01,HND,Kedah,0,0,0
2023-02-01,HND,Perak,0,0,0
2023-02-01,HND,Pulau Pinang,1,0,1
2023-02-01,HND,Sabah,0,0,0
2023-02-01,HND,Sarawak,0,0,0
2023-02-01,HND,Selangor,29,20,9
2023-02-01,HRV,Johor,55,45,10
2023-02-01,HRV,Kedah,10,4,6
2023-02-01,HRV,Kelantan,6,6,0
2023-02-01,HRV,Melaka,0,0,0
2023-02-01,HRV,Pahang,0,0,0
2023-02-01,HRV,Perak,0,0,0
2023-02-01,HRV,Perlis,0,0,0
2023-02-01,HRV,Pulau Pinang,9,8,1
2023-02-01,HRV,Sabah,4,3,1
2023-02-01,HRV,Sarawak,3,3,0
2023-02-01,HRV,Selangor,139,86,53
2023-02-01,HTI,Johor,4,3,1
2023-02-01,HTI,Kedah,0,0,0
2023-02-01,HTI,Kelantan,1,1,0
2023-02-01,HTI,Perak,0,0,0
2023-02-01,HTI,Pulau Pinang,0,0,0
2023-02-01,HTI,Sabah,0,0,0
2023-02-01,HTI,Selangor,4,4,0
2023-02-01,HUN,Johor,93,61,32
2023-02-01,HUN,Kedah,59,32,27
2023-02-01,HUN,Kelantan,1,0,1
2023-02-01,HUN,Pahang,0,0,0
2023-02-01,HUN,Perak,0,0,0
2023-02-01,HUN,Perlis,3,0,3
2023-02-01,HUN,Pulau Pinang,33,22,11
2023-02-01,HUN,Sabah,8,6,2
2023-02-01,HUN,Sarawak,13,7,6
2023-02-01,HUN,Selangor,741,399,342
2023-02-01,HUN,W.P. Labuan,0,0,0
2023-02-01,IDN,Johor,91426,49248,42178
2023-02-01,IDN,Kedah,3939,1460,2479
2023-02-01,IDN,Kelantan,153,97,56
2023-02-01,IDN,Melaka,5198,2292,2906
2023-02-01,IDN,Negeri Sembilan,9819,6587,3232
2023-02-01,IDN,Pahang,3,1,2
2023-02-01,IDN,Perak,142,41,101
2023-02-01,IDN,Perlis,496,196,300
2023-02-01,IDN,Pulau Pinang,32124,12557,19567
2023-02-01,IDN,Sabah,4504,2149,2355
2023-02-01,IDN,Sarawak,35011,18720,16291
2023-02-01,IDN,Selangor,83391,41316,42075
2023-02-01,IDN,Terengganu,3,3,0
2023-02-01,IDN,W.P. Labuan,50,30,20
2023-02-01,IND,Johor,13413,9737,3676
2023-02-01,IND,Kedah,424,246,178
2023-02-01,IND,Kelantan,2,2,0
2023-02-01,IND,Melaka,1,1,0
2023-02-01,IND,Negeri Sembilan,0,0,0
2023-02-01,IND,Pahang,0,0,0
2023-02-01,IND,Perak,403,340,63
2023-02-01,IND,Perlis,48,35,13
2023-02-01,IND,Pulau Pinang,626,457,169
2023-02-01,IND,Sabah,174,131,43
2023-02-01,IND,Sarawak,1090,805,285
2023-02-01,IND,Selangor,36026,26746,9280
2023-02-01,IND,Terengganu,0,0,0
2023-02-01,IND,W.P. Labuan,107,85,22
2023-02-01,IOT,Pulau Pinang,0,0,0
2023-02-01,IOT,Selangor,0,0,0
2023-02-01,IRL,Johor,227,156,71
2023-02-01,IRL,Kedah,99,61,38
2023-02-01,IRL,Kelantan,3,2,1
2023-02-01,IRL,Negeri Sembilan,0,0,0
2023-02-01,IRL,Pahang,1,0,1
2023-02-01,IRL,Perak,7,4,3
2023-02-01,IRL,Perlis,26,16,10
2023-02-01,IRL,Pulau Pinang,120,71,49
2023-02-01,IRL,Sabah,17,11,6
2023-02-01,IRL,Sarawak,42,21,21
2023-02-01,IRL,Selangor,1087,654,433
2023-02-01,IRL,Terengganu,0,0,0
2023-02-01,IRL,W.P. Labuan,3,1,2
2023-02-01,IRN,Johor,83,61,22
2023-02-01,IRN,Kedah,6,3,3
2023-02-01,IRN,Kelantan,0,0,0
2023-02-01,IRN,Perak,0,0,0
2023-02-01,IRN,Perlis,15,9,6
2023-02-01,IRN,Pulau Pinang,4,2,2
2023-02-01,IRN,Sabah,3,2,1
2023-02-01,IRN,Sarawak,4,2,2
2023-02-01,IRN,Selangor,861,469,392
2023-02-01,IRN,W.P. Labuan,0,0,0
2023-02-01,IRQ,Johor,28,24,4
2023-02-01,IRQ,Kedah,0,0,0
2023-02-01,IRQ,Kelantan,0,0,0
2023-02-01,IRQ,Melaka,0,0,0
2023-02-01,IRQ,Pahang,0,0,0
2023-02-01,IRQ,Perak,0,0,0
2023-02-01,IRQ,Perlis,0,0,0
2023-02-01,IRQ,Pulau Pinang,1,1,0
2023-02-01,IRQ,Sabah,0,0,0
2023-02-01,IRQ,Sarawak,0,0,0
2023-02-01,IRQ,Selangor,793,539,254
2023-02-01,ISL,Johor,4,2,2
2023-02-01,ISL,Kedah,3,1,2
2023-02-01,ISL,Kelantan,0,0,0
2023-02-01,ISL,Perak,0,0,0
2023-02-01,ISL,Perlis,1,1,0
2023-02-01,ISL,Pulau Pinang,3,1,2
2023-02-01,ISL,Sabah,1,1,0
2023-02-01,ISL,Sarawak,0,0,0
2023-02-01,ISL,Selangor,37,17,20
2023-02-01,ISL,W.P. Labuan,0,0,0
2023-02-01,ISR,Pulau Pinang,0,0,0
2023-02-01,ITA,Johor,544,385,159
2023-02-01,ITA,Kedah,547,291,256
2023-02-01,ITA,Kelantan,8,6,2
2023-02-01,ITA,Melaka,0,0,0
2023-02-01,ITA,Negeri Sembilan,1,1,0
2023-02-01,ITA,Pahang,0,0,0
2023-02-01,ITA,Perak,9,7,2
2023-02-01,ITA,Perlis,55,44,11
2023-02-01,ITA,Pulau Pinang,126,89,37
2023-02-01,ITA,Sabah,34,22,12
2023-02-01,ITA,Sarawak,37,24,13
2023-02-01,ITA,Selangor,2576,1763,813
2023-02-01,ITA,W.P. Labuan,9,4,5
2023-02-01,JAM,Johor,0,0,0
2023-02-01,JAM,Kedah,0,0,0
2023-02-01,JAM,Perak,0,0,0
2023-02-01,JAM,Pulau Pinang,4,1,3
2023-02-01,JAM,Sabah,0,0,0
2023-02-01,JAM,Sarawak,0,0,0
2023-02-01,JAM,Selangor,11,5,6
2023-02-01,JAM,W.P. Labuan,0,0,0
2023-02-01,JOR,Johor,11,7,4
2023-02-01,JOR,Kedah,6,4,2
2023-02-01,JOR,Kelantan,0,0,0
2023-02-01,JOR,Melaka,0,0,0
2023-02-01,JOR,Perlis,1,1,0
2023-02-01,JOR,Pulau Pinang,2,1,1
2023-02-01,JOR,Sabah,2,2,0
2023-02-01,JOR,Sarawak,0,0,0
2023-02-01,JOR,Selangor,527,330,197
2023-02-01,JOR,W.P. Labuan,0,0,0
2023-02-01,JPN,Johor,5069,3560,1509
2023-02-01,JPN,Kedah,334,160,174
2023-02-01,JPN,Kelantan,7,5,2
2023-02-01,JPN,Melaka,0,0,0
2023-02-01,JPN,Negeri Sembilan,0,0,0
2023-02-01,JPN,Pahang,4,3,1
2023-02-01,JPN,Perak,85,59,26
2023-02-01,JPN,Perlis,65,54,11
2023-02-01,JPN,Pulau Pinang,1145,817,328
2023-02-01,JPN,Sabah,298,152,146
2023-02-01,JPN,Sarawak,228,133,95
2023-02-01,JPN,Selangor,16124,10292,5832
2023-02-01,JPN,W.P. Labuan,7,5,2
2023-02-01,KAZ,Johor,42,13,29
2023-02-01,KAZ,Kedah,23,11,12
2023-02-01,KAZ,Kelantan,3,1,2
2023-02-01,KAZ,Melaka,0,0,0
2023-02-01,KAZ,Perak,0,0,0
2023-02-01,KAZ,Perlis,10,6,4
2023-02-01,KAZ,Pulau Pinang,16,9,7
2023-02-01,KAZ,Sabah,4,2,2
2023-02-01,KAZ,Sarawak,8,0,8
2023-02-01,KAZ,Selangor,552,225,327
2023-02-01,KAZ,W.P. Labuan,1,0,1
2023-02-01,KEN,Johor,33,15,18
2023-02-01,KEN,Kedah,3,1,2
2023-02-01,KEN,Kelantan,0,0,0
2023-02-01,KEN,Perak,0,0,0
2023-02-01,KEN,Perlis,0,0,0
2023-02-01,KEN,Pulau Pinang,0,0,0
2023-02-01,KEN,Sabah,2,1,1
2023-02-01,KEN,Sarawak,2,0,2
2023-02-01,KEN,Selangor,208,103,105
2023-02-01,KGZ,Johor,27,14,13
2023-02-01,KGZ,Kedah,6,4,2
2023-02-01,KGZ,Kelantan,0,0,0
2023-02-01,KGZ,Perak,0,0,0
2023-02-01,KGZ,Perlis,1,0,1
2023-02-01,KGZ,Pulau Pinang,1,0,1
2023-02-01,KGZ,Sabah,2,1,1
2023-02-01,KGZ,Sarawak,0,0,0
2023-02-01,KGZ,Selangor,173,92,81
2023-02-01,KHM,Johor,1991,830,1161
2023-02-01,KHM,Kedah,168,134,34
2023-02-01,KHM,Kelantan,1314,1077,237
2023-02-01,KHM,Melaka,0,0,0
2023-02-01,KHM,Negeri Sembilan,0,0,0
2023-02-01,KHM,Pahang,0,0,0
2023-02-01,KHM,Perak,9,5,4
2023-02-01,KHM,Perlis,693,418,275
2023-02-01,KHM,Pulau Pinang,32,17,15
2023-02-01,KHM,Sabah,1,1,0
2023-02-01,KHM,Sarawak,1,0,1
2023-02-01,KHM,Selangor,3447,1715,1732
2023-02-01,KHM,W.P. Labuan,1,0,1
2023-02-01,KIR,Johor,0,0,0
2023-02-01,KIR,Sabah,0,0,0
2023-02-01,KIR,Selangor,1,0,1
2023-02-01,KNA,Johor,21,16,5
2023-02-01,KNA,Kedah,0,0,0
2023-02-01,KNA,Perlis,0,0,0
2023-02-01,KNA,Pulau Pinang,1,1,0
2023-02-01,KNA,Sabah,0,0,0
2023-02-01,KNA,Selangor,44,39,5
2023-02-01,KNA,W.P. Labuan,0,0,0
2023-02-01,KOR,Johor,12972,6643,6329
2023-02-01,KOR,Kedah,404,181,223
2023-02-01,KOR,Kelantan,1,1,0
2023-02-01,KOR,Melaka,0,0,0
2023-02-01,KOR,Negeri Sembilan,0,0,0
2023-02-01,KOR,Pahang,1,0,1
2023-02-01,KOR,Perak,50,20,30
2023-02-01,KOR,Perlis,69,42,27
2023-02-01,KOR,Pulau Pinang,520,288,232
2023-02-01,KOR,Sabah,20731,8885,11846
2023-02-01,KOR,Sarawak,246,138,108
2023-02-01,KOR,Selangor,13525,7320,6205
2023-02-01,KOR,Terengganu,0,0,0
2023-02-01,KOR,W.P. Labuan,6,4,2
2023-02-01,KWT,Johor,26,13,13
2023-02-01,KWT,Kedah,2,1,1
2023-02-01,KWT,Kelantan,1,1,0
2023-02-01,KWT,Perak,0,0,0
2023-02-01,KWT,Perlis,0,0,0
2023-02-01,KWT,Pulau Pinang,0,0,0
2023-02-01,KWT,Sabah,0,0,0
2023-02-01,KWT,Sarawak,0,0,0
2023-02-01,KWT,Selangor,369,221,148
2023-02-01,KWT,W.P. Labuan,0,0,0
2023-02-01,LAO,Johor,139,38,101
2023-02-01,LAO,Kedah,937,108,829
2023-02-01,LAO,Kelantan,803,671,132
2023-02-01,LAO,Melaka,0,0,0
2023-02-01,LAO,Perak,21,4,17
2023-02-01,LAO,Perlis,332,150,182
2023-02-01,LAO,Pulau Pinang,10,3,7
2023-02-01,LAO,Sabah,6,1,5
2023-02-01,LAO,Sarawak,6,0,6
2023-02-01,LAO,Selangor,197,85,112
2023-02-01,LAO,W.P. Labuan,0,0,0
2023-02-01,LBN,Johor,20,12,8
2023-02-01,LBN,Kedah,3,2,1
2023-02-01,LBN,Kelantan,0,0,0
2023-02-01,LBN,Pahang,0,0,0
2023-02-01,LBN,Perak,0,0,0
2023-02-01,LBN,Perlis,0,0,0
2023-02-01,LBN,Pulau Pinang,3,3,0
2023-02-01,LBN,Sabah,0,0,0
2023-02-01,LBN,Sarawak,2,2,0
2023-02-01,LBN,Selangor,217,134,83
2023-02-01,LBN,W.P. Labuan,0,0,0
2023-02-01,LBR,Johor,2,0,2
2023-02-01,LBR,Kedah,0,0,0
2023-02-01,LBR,Sabah,0,0,0
2023-02-01,LBR,Sarawak,0,0,0
2023-02-01,LBR,Selangor,5,4,1
2023-02-01,LBY,Johor,2,1,1
2023-02-01,LBY,Kedah,1,1,0
2023-02-01,LBY,Perlis,0,0,0
2023-02-01,LBY,Pulau Pinang,0,0,0
2023-02-01,LBY,Sabah,0,0,0
2023-02-01,LBY,Sarawak,12,7,5
2023-02-01,LBY,Selangor,264,169,95
2023-02-01,LCA,Johor,7,5,2
2023-02-01,LCA,Kedah,0,0,0
2023-02-01,LCA,Pulau Pinang,1,1,0
2023-02-01,LCA,Sarawak,0,0,0
2023-02-01,LCA,Selangor,3,2,1
2023-02-01,LIE,Johor,0,0,0
2023-02-01,LIE,Kedah,1,0,1
2023-02-01,LIE,Perlis,0,0,0
2023-02-01,LIE,Pulau Pinang,1,1,0
2023-02-01,LIE,Sabah,0,0,0
2023-02-01,LIE,Sarawak,0,0,0
2023-02-01,LIE,Selangor,3,0,3
2023-02-01,LKA,Johor,808,552,256
2023-02-01,LKA,Kedah,13,9,4
2023-02-01,LKA,Kelantan,0,0,0
2023-02-01,LKA,Melaka,0,0,0
2023-02-01,LKA,Pahang,0,0,0
2023-02-01,LKA,Perak,2,2,0
2023-02-01,LKA,Perlis,1,1,0
2023-02-01,LKA,Pulau Pinang,19,16,3
2023-02-01,LKA,Sabah,3,2,1
2023-02-01,LKA,Sarawak,14,10,4
2023-02-01,LKA,Selangor,3096,2011,1085
2023-02-01,LKA,W.P. Labuan,0,0,0
2023-02-01,LSO,Johor,0,0,0
2023-02-01,LSO,Kedah,0,0,0
2023-02-01,LSO,Pulau Pinang,0,0,0
2023-02-01,LSO,Sarawak,0,0,0
2023-02-01,LSO,Selangor,4,2,2
2023-02-01,LTU,Johor,99,46,53
2023-02-01,LTU,Kedah,99,48,51
2023-02-01,LTU,Kelantan,0,0,0
2023-02-01,LTU,Pahang,0,0,0
2023-02-01,LTU,Perak,6,2,4
2023-02-01,LTU,Perlis,11,7,4
2023-02-01,LTU,Pulau Pinang,22,12,10
2023-02-01,LTU,Sabah,6,3,3
2023-02-01,LTU,Sarawak,12,6,6
2023-02-01,LTU,Selangor,475,233,242
2023-02-01,LTU,W.P. Labuan,6,3,3
2023-02-01,LUX,Johor,8,6,2
2023-02-01,LUX,Kedah,0,0,0
2023-02-01,LUX,Kelantan,0,0,0
2023-02-01,LUX,Perak,0,0,0
2023-02-01,LUX,Perlis,0,0,0
2023-02-01,LUX,Pulau Pinang,4,1,3
2023-02-01,LUX,Sabah,0,0,0
2023-02-01,LUX,Sarawak,0,0,0
2023-02-01,LUX,Selangor,36,26,10
2023-02-01,LVA,Johor,54,25,29
2023-02-01,LVA,Kedah,27,10,17
2023-02-01,LVA,Kelantan,1,0,1
2023-02-01,LVA,Pahang,0,0,0
2023-02-01,LVA,Perak,0,0,0
2023-02-01,LVA,Perlis,3,1,2
2023-02-01,LVA,Pulau Pinang,6,2,4
2023-02-01,LVA,Sabah,1,0,1
2023-02-01,LVA,Sarawak,18,5,13
2023-02-01,LVA,Selangor,199,92,107
2023-02-01,LVA,W.P. Labuan,7,0,7
2023-02-01,MAC,Johor,0,0,0
2023-02-01,MAC,Pahang,0,0,0
2023-02-01,MAC,Perak,2,0,2
2023-02-01,MAC,Selangor,1,0,1
2023-02-01,MAC,W.P. Labuan,0,0,0
2023-02-01,MAR,Johor,71,51,20
2023-02-01,MAR,Kedah,7,5,2
2023-02-01,MAR,Kelantan,0,0,0
2023-02-01,MAR,Melaka,0,0,0
2023-02-01,MAR,Pahang,0,0,0
2023-02-01,MAR,Perak,0,0,0
2023-02-01,MAR,Perlis,3,3,0
2023-02-01,MAR,Pulau Pinang,15,12,3
2023-02-01,MAR,Sabah,1,1,0
2023-02-01,MAR,Sarawak,2,2,0
2023-02-01,MAR,Selangor,637,349,288
2023-02-01,MAR,W.P. Labuan,2,2,0
2023-02-01,MCO,Johor,2,2,0
2023-02-01,MCO,Kedah,2,1,1
2023-02-01,MCO,Sabah,0,0,0
2023-02-01,MCO,Selangor,4,2,2
2023-02-01,MDA,Johor,2,1,1
2023-02-01,MDA,Kedah,3,1,2
2023-02-01,MDA,Kelantan,0,0,0
2023-02-01,MDA,Negeri Sembilan,0,0,0
2023-02-01,MDA,Perlis,0,0,0
2023-02-01,MDA,Pulau Pinang,1,1,0
2023-02-01,MDA,Sabah,0,0,0
2023-02-01,MDA,Sarawak,0,0,0
2023-02-01,MDA,Selangor,42,20,22
2023-02-01,MDG,Johor,11,6,5
2023-02-01,MDG,Kedah,0,0,0
2023-02-01,MDG,Perak,0,0,0
2023-02-01,MDG,Perlis,0,0,0
2023-02-01,MDG,Pulau Pinang,1,0,1
2023-02-01,MDG,Sabah,0,0,0
2023-02-01,MDG,Sarawak,0,0,0
2023-02-01,MDG,Selangor,19,6,13
2023-02-01,MDV,Johor,121,63,58
2023-02-01,MDV,Kedah,2,1,1
2023-02-01,MDV,Kelantan,0,0,0
2023-02-01,MDV,Perak,0,0,0
2023-02-01,MDV,Perlis,0,0,0
2023-02-01,MDV,Pulau Pinang,1,1,0
2023-02-01,MDV,Sabah,1,1,0
2023-02-01,MDV,Sarawak,1,0,1
2023-02-01,MDV,Selangor,1681,914,767
2023-02-01,MEX,Johor,105,55,50
2023-02-01,MEX,Kedah,11,7,4
2023-02-01,MEX,Kelantan,0,0,0
2023-02-01,MEX,Pahang,0,0,0
2023-02-01,MEX,Perak,0,0,0
2023-02-01,MEX,Perlis,3,2,1
2023-02-01,MEX,Pulau Pinang,20,14,6
2023-02-01,MEX,Sabah,4,1,3
2023-02-01,MEX,Sarawak,1,1,0
2023-02-01,MEX,Selangor,383,205,178
2023-02-01,MEX,W.P. Labuan,0,0,0
2023-02-01,MHL,Johor,0,0,0
2023-02-01,MHL,Kedah,0,0,0
2023-02-01,MHL,Perak,0,0,0
2023-02-01,MHL,Pulau Pinang,0,0,0
2023-02-01,MHL,Sabah,0,0,0
2023-02-01,MHL,Selangor,2,2,0
2023-02-01,MKD,Johor,4,2,2
2023-02-01,MKD,Kedah,0,0,0
2023-02-01,MKD,Perak,0,0,0
2023-02-01,MKD,Pulau Pinang,0,0,0
2023-02-01,MKD,Sabah,0,0,0
2023-02-01,MKD,Sarawak,1,0,1
2023-02-01,MKD,Selangor,22,14,8
2023-02-01,MLI,Johor,3,3,0
2023-02-01,MLI,Sabah,0,0,0
2023-02-01,MLI,Selangor,3,1,2
2023-02-01,MLT,Johor,13,9,4
2023-02-01,MLT,Kedah,5,3,2
2023-02-01,MLT,Kelantan,0,0,0
2023-02-01,MLT,Perak,0,0,0
2023-02-01,MLT,Perlis,1,1,0
2023-02-01,MLT,Pulau Pinang,2,1,1
2023-02-01,MLT,Sabah,0,0,0
2023-02-01,MLT,Sarawak,0,0,0
2023-02-01,MLT,Selangor,35,23,12
2023-02-01,MLT,W.P. Labuan,0,0,0
2023-02-01,MMR,Johor,2968,923,2045
2023-02-01,MMR,Kedah,31,2,29
2023-02-01,MMR,Kelantan,1,0,1
2023-02-01,MMR,Negeri Sembilan,0,0,0
2023-02-01,MMR,Pahang,0,0,0
2023-02-01,MMR,Perak,21,9,12
2023-02-01,MMR,Perlis,3,0,3
2023-02-01,MMR,Pulau Pinang,149,79,70
2023-02-01,MMR,Sabah,8,1,7
2023-02-01,MMR,Sarawak,77,35,42
2023-02-01,MMR,Selangor,7233,5164,2069
2023-02-01,MMR,Terengganu,0,0,0
2023-02-01,MMR,W.P. Labuan,3,2,1
2023-02-01,MNE,Johor,1,1,0
2023-02-01,MNE,Kedah,0,0,0
2023-02-01,MNE,Pulau Pinang,0,0,0
2023-02-01,MNE,Sabah,1,1,0
2023-02-01,MNE,Sarawak,0,0,0
2023-02-01,MNE,Selangor,7,6,1
2023-02-01,MNG,Johor,167,73,94
2023-02-01,MNG,Kedah,12,5,7
2023-02-01,MNG,Kelantan,0,0,0
2023-02-01,MNG,Perak,0,0,0
2023-02-01,MNG,Perlis,18,13,5
2023-02-01,MNG,Pulau Pinang,6,2,4
2023-02-01,MNG,Sabah,0,0,0
2023-02-01,MNG,Sarawak,0,0,0
2023-02-01,MNG,Selangor,446,162,284
2023-02-01,MNP,Selangor,0,0,0
2023-02-01,MOZ,Johor,1,1,0
2023-02-01,MOZ,Kedah,0,0,0
2023-02-01,MOZ,Perak,0,0,0
2023-02-01,MOZ,Pulau Pinang,0,0,0
2023-02-01,MOZ,Sabah,0,0,0
2023-02-01,MOZ,Sarawak,1,1,0
2023-02-01,MOZ,Selangor,11,6,5
2023-02-01,MRT,Johor,0,0,0
2023-02-01,MRT,Kedah,0,0,0
2023-02-01,MRT,Pulau Pinang,0,0,0
2023-02-01,MRT,Sabah,0,0,0
2023-02-01,MRT,Sarawak,0,0,0
2023-02-01,MRT,Selangor,14,11,3
2023-02-01,MUS,Johor,92,55,37
2023-02-01,MUS,Kedah,4,4,0
2023-02-01,MUS,Kelantan,0,0,0
2023-02-01,MUS,Pahang,0,0,0
2023-02-01,MUS,Perak,4,2,2
2023-02-01,MUS,Perlis,2,2,0
2023-02-01,MUS,Pulau Pinang,6,4,2
2023-02-01,MUS,Sabah,5,2,3
2023-02-01,MUS,Sarawak,1,0,1
2023-02-01,MUS,Selangor,1064,522,542
2023-02-01,MWI,Johor,0,0,0
2023-02-01,MWI,Pulau Pinang,0,0,0
2023-02-01,MWI,Sabah,0,0,0
2023-02-01,MWI,Sarawak,0,0,0
2023-02-01,MWI,Selangor,17,9,8
2023-02-01,MYT,Selangor,0,0,0
2023-02-01,NAM,Johor,0,0,0
2023-02-01,NAM,Kedah,0,0,0
2023-02-01,NAM,Perak,0,0,0
2023-02-01,NAM,Perlis,0,0,0
2023-02-01,NAM,Pulau Pinang,0,0,0
2023-02-01,NAM,Sabah,0,0,0
2023-02-01,NAM,Sarawak,0,0,0
2023-02-01,NAM,Selangor,19,10,9
2023-02-01,NCL,Selangor,0,0,0
2023-02-01,NER,Johor,0,0,0
2023-02-01,NER,Sabah,0,0,0
2023-02-01,NER,Selangor,1,0,1
2023-02-01,NGA,Johor,20,19,1
2023-02-01,NGA,Kedah,0,0,0
2023-02-01,NGA,Perlis,0,0,0
2023-02-01,NGA,Pulau Pinang,1,1,0
2023-02-01,NGA,Sabah,0,0,0
2023-02-01,NGA,Sarawak,11,5,6
2023-02-01,NGA,Selangor,374,295,79
2023-02-01,NIC,Johor,1,0,1
2023-02-01,NIC,Kedah,1,0,1
2023-02-01,NIC,Pulau Pinang,0,0,0
2023-02-01,NIC,Sabah,0,0,0
2023-02-01,NIC,Selangor,7,7,0
2023-02-01,NLD,Johor,856,569,287
2023-02-01,NLD,Kedah,449,228,221
2023-02-01,NLD,Kelantan,0,0,0
2023-02-01,NLD,Melaka,4,3,1
2023-02-01,NLD,Negeri Sembilan,0,0,0
2023-02-01,NLD,Pahang,1,0,1
2023-02-01,NLD,Perak,13,7,6
2023-02-01,NLD,Perlis,67,44,23
2023-02-01,NLD,Pulau Pinang,202,123,79
2023-02-01,NLD,Sabah,87,51,36
2023-02-01,NLD,Sarawak,152,102,50
2023-02-01,NLD,Selangor,3340,2014,1326
2023-02-01,NLD,Terengganu,0,0,0
2023-02-01,NLD,W.P. Labuan,9,4,5
2023-02-01,NOR,Johor,146,88,58
2023-02-01,NOR,Kedah,119,57,62
2023-02-01,NOR,Kelantan,17,9,8
2023-02-01,NOR,Melaka,0,0,0
2023-02-01,NOR,Pahang,0,0,0
2023-02-01,NOR,Perak,2,1,1
2023-02-01,NOR,Perlis,15,7,8
2023-02-01,NOR,Pulau Pinang,33,18,15
2023-02-01,NOR,Sabah,3,1,2
2023-02-01,NOR,Sarawak,38,26,12
2023-02-01,NOR,Selangor,668,398,270
2023-02-01,NOR,W.P. Labuan,0,0,0
2023-02-01,NPL,Johor,400,295,105
2023-02-01,NPL,Kedah,2,1,1
2023-02-01,NPL,Pahang,0,0,0
2023-02-01,NPL,Perak,0,0,0
2023-02-01,NPL,Perlis,0,0,0
2023-02-01,NPL,Pulau Pinang,24,22,2
2023-02-01,NPL,Sabah,0,0,0
2023-02-01,NPL,Sarawak,173,111,62
2023-02-01,NPL,Selangor,17521,16869,652
2023-02-01,NPL,W.P. Labuan,28,25,3
2023-02-01,NRU,Johor,0,0,0
2023-02-01,NRU,Pulau Pinang,0,0,0
2023-02-01,NRU,Selangor,0,0,0
2023-02-01,NZL,Johor,562,342,220
2023-02-01,NZL,Kedah,72,46,26
2023-02-01,NZL,Kelantan,1,1,0
2023-02-01,NZL,Melaka,1,1,0
2023-02-01,NZL,Negeri Sembilan,0,0,0
2023-02-01,NZL,Pahang,0,0,0
2023-02-01,NZL,Perak,13,8,5
2023-02-01,NZL,Perlis,31,18,13
2023-02-01,NZL,Pulau Pinang,128,69,59
2023-02-01,NZL,Sabah,42,20,22
2023-02-01,NZL,Sarawak,87,42,45
2023-02-01,NZL,Selangor,1997,1209,788
2023-02-01,NZL,Terengganu,0,0,0
2023-02-01,NZL,W.P. Labuan,4,3,1
2023-02-01,OMN,Johor,19,11,8
2023-02-01,OMN,Kedah,3,2,1
2023-02-01,OMN,Kelantan,0,0,0
2023-02-01,OMN,Melaka,0,0,0
2023-02-01,OMN,Perak,0,0,0
2023-02-01,OMN,Perlis,0,0,0
2023-02-01,OMN,Pulau Pinang,6,3,3
2023-02-01,OMN,Sabah,0,0,0
2023-02-01,OMN,Sarawak,16,5,11
2023-02-01,OMN,Selangor,726,435,291
2023-02-01,PAK,Johor,687,522,165
2023-02-01,PAK,Kedah,38,28,10
2023-02-01,PAK,Kelantan,7,7,0
2023-02-01,PAK,Melaka,0,0,0
2023-02-01,PAK,Negeri Sembilan,0,0,0
2023-02-01,PAK,Pahang,0,0,0
2023-02-01,PAK,Perak,49,48,1
2023-02-01,PAK,Perlis,36,35,1
2023-02-01,PAK,Pulau Pinang,82,76,6
2023-02-01,PAK,Sabah,15,11,4
2023-02-01,PAK,Sarawak,123,95,28
2023-02-01,PAK,Selangor,12934,11788,1146
2023-02-01,PAK,W.P. Labuan,1,1,0
2023-02-01,PAN,Johor,2,1,1
2023-02-01,PAN,Kedah,0,0,0
2023-02-01,PAN,Perak,0,0,0
2023-02-01,PAN,Perlis,0,0,0
2023-02-01,PAN,Pulau Pinang,1,1,0
2023-02-01,PAN,Sabah,0,0,0
2023-02-01,PAN,Sarawak,0,0,0
2023-02-01,PAN,Selangor,44,18,26
2023-02-01,PER,Johor,51,30,21
2023-02-01,PER,Kedah,9,3,6
2023-02-01,PER,Kelantan,0,0,0
2023-02-01,PER,Pahang,0,0,0
2023-02-01,PER,Perak,0,0,0
2023-02-01,PER,Perlis,0,0,0
2023-02-01,PER,Pulau Pinang,1,0,1
2023-02-01,PER,Sabah,0,0,0
2023-02-01,PER,Sarawak,0,0,0
2023-02-01,PER,Selangor,69,38,31
2023-02-01,PER,W.P. Labuan,0,0,0
2023-02-01,PHL,Johor,15098,5021,10077
2023-02-01,PHL,Kedah,456,154,302
2023-02-01,PHL,Kelantan,27,17,10
2023-02-01,PHL,Melaka,0,0,0
2023-02-01,PHL,Negeri Sembilan,0,0,0
2023-02-01,PHL,Pahang,12,11,1
2023-02-01,PHL,Perak,92,37,55
2023-02-01,PHL,Perlis,53,14,39
2023-02-01,PHL,Pulau Pinang,417,150,267
2023-02-01,PHL,Sabah,1261,624,637
2023-02-01,PHL,Sarawak,2303,916,1387
2023-02-01,PHL,Selangor,11651,4886,6765
2023-02-01,PHL,Terengganu,0,0,0
2023-02-01,PHL,W.P. Labuan,79,22,57
2023-02-01,PLW,Johor,0,0,0
2023-02-01,PLW,Pulau Pinang,0,0,0
2023-02-01,PLW,Selangor,4,1,3
2023-02-01,PNG,Johor,7,5,2
2023-02-01,PNG,Kedah,0,0,0
2023-02-01,PNG,Kelantan,0,0,0
2023-02-01,PNG,Perak,0,0,0
2023-02-01,PNG,Pulau Pinang,4,4,0
2023-02-01,PNG,Sabah,1,0,1
2023-02-01,PNG,Sarawak,6,1,5
2023-02-01,PNG,Selangor,49,32,17
2023-02-01,POL,Johor,675,309,366
2023-02-01,POL,Kedah,327,159,168
2023-02-01,POL,Kelantan,1,1,0
2023-02-01,POL,Melaka,0,0,0
2023-02-01,POL,Negeri Sembilan,0,0,0
2023-02-01,POL,Pahang,0,0,0
2023-02-01,POL,Perak,0,0,0
2023-02-01,POL,Perlis,44,24,20
2023-02-01,POL,Pulau Pinang,69,41,28
2023-02-01,POL,Sabah,19,9,10
2023-02-01,POL,Sarawak,41,18,23
2023-02-01,POL,Selangor,1394,766,628
2023-02-01,POL,Terengganu,0,0,0
2023-02-01,POL,W.P. Labuan,3,2,1
2023-02-01,PRK,Selangor,0,0,0
2023-02-01,PRT,Johor,133,73,60
2023-02-01,PRT,Kedah,58,30,28
2023-02-01,PRT,Kelantan,0,0,0
2023-02-01,PRT,Melaka,0,0,0
2023-02-01,PRT,Pahang,0,0,0
2023-02-01,PRT,Perak,2,1,1
2023-02-01,PRT,Perlis,9,4,5
2023-02-01,PRT,Pulau Pinang,29,17,12
2023-02-01,PRT,Sabah,15,10,5
2023-02-01,PRT,Sarawak,13,6,7
2023-02-01,PRT,Selangor,542,316,226
2023-02-01,PRT,W.P. Labuan,2,1,1
2023-02-01,PRY,Johor,10,8,2
2023-02-01,PRY,Kedah,0,0,0
2023-02-01,PRY,Perak,0,0,0
2023-02-01,PRY,Perlis,0,0,0
2023-02-01,PRY,Pulau Pinang,0,0,0
2023-02-01,PRY,Sabah,0,0,0
2023-02-01,PRY,Sarawak,0,0,0
2023-02-01,PRY,Selangor,8,4,4
2023-02-01,PSE,Johor,7,7,0
2023-02-01,PSE,Kedah,1,1,0
2023-02-01,PSE,Kelantan,0,0,0
2023-02-01,PSE,Melaka,0,0,0
2023-02-01,PSE,Perak,0,0,0
2023-02-01,PSE,Perlis,0,0,0
2023-02-01,PSE,Pulau Pinang,0,0,0
2023-02-01,PSE,Sabah,0,0,0
2023-02-01,PSE,Sarawak,1,1,0
2023-02-01,PSE,Selangor,241,171,70
2023-02-01,QAT,Johor,8,7,1
2023-02-01,QAT,Kedah,0,0,0
2023-02-01,QAT,Perlis,0,0,0
2023-02-01,QAT,Pulau Pinang,0,0,0
2023-02-01,QAT,Sabah,0,0,0
2023-02-01,QAT,Sarawak,0,0,0
2023-02-01,QAT,Selangor,121,77,44
2023-02-01,REU,Johor,0,0,0
2023-02-01,REU,Sarawak,0,0,0
2023-02-01,ROU,Johor,137,77,60
2023-02-01,ROU,Kedah,92,45,47
2023-02-01,ROU,Kelantan,1,1,0
2023-02-01,ROU,Negeri Sembilan,0,0,0
2023-02-01,ROU,Pahang,1,1,0
2023-02-01,ROU,Perak,1,0,1
2023-02-01,ROU,Perlis,11,6,5
2023-02-01,ROU,Pulau Pinang,31,14,17
2023-02-01,ROU,Sabah,4,2,2
2023-02-01,ROU,Sarawak,5,5,0
2023-02-01,ROU,Selangor,558,299,259
2023-02-01,ROU,W.P. Labuan,0,0,0
2023-02-01,RUS,Johor,334,182,152
2023-02-01,RUS,Kedah,660,347,313
2023-02-01,RUS,Kelantan,99,52,47
2023-02-01,RUS,Melaka,4,2,2
2023-02-01,RUS,Negeri Sembilan,0,0,0
2023-02-01,RUS,Pahang,0,0,0
2023-02-01,RUS,Perak,10,6,4
2023-02-01,RUS,Perlis,808,451,357
2023-02-01,RUS,Pulau Pinang,281,156,125
2023-02-01,RUS,Sabah,43,18,25
2023-02-01,RUS,Sarawak,75,36,39
2023-02-01,RUS,Selangor,13648,7048,6600
2023-02-01,RUS,W.P. Labuan,14,7,7
2023-02-01,RWA,Johor,0,0,0
2023-02-01,RWA,Kedah,0,0,0
2023-02-01,RWA,Pulau Pinang,0,0,0
2023-02-01,RWA,Selangor,7,2,5
2023-02-01,SAU,Johor,106,68,38
2023-02-01,SAU,Kedah,4,3,1
2023-02-01,SAU,Kelantan,8,4,4
2023-02-01,SAU,Melaka,0,0,0
2023-02-01,SAU,Perak,0,0,0
2023-02-01,SAU,Perlis,4,4,0
2023-02-01,SAU,Pulau Pinang,7,5,2
2023-02-01,SAU,Sabah,3,3,0
2023-02-01,SAU,Sarawak,9,9,0
2023-02-01,SAU,Selangor,2178,1341,837
2023-02-01,SAU,W.P. Labuan,0,0,0
2023-02-01,SDN,Johor,5,4,1
2023-02-01,SDN,Kedah,0,0,0
2023-02-01,SDN,Kelantan,0,0,0
2023-02-01,SDN,Perlis,0,0,0
2023-02-01,SDN,Pulau Pinang,0,0,0
2023-02-01,SDN,Sabah,0,0,0
2023-02-01,SDN,Sarawak,5,4,1
2023-02-01,SDN,Selangor,927,536,391
2023-02-01,SDN,W.P. Labuan,0,0,0
2023-02-01,SEN,Johor,0,0,0
2023-02-01,SEN,Kedah,0,0,0
2023-02-01,SEN,Kelantan,0,0,0
2023-02-01,SEN,Perak,0,0,0
2023-02-01,SEN,Perlis,0,0,0
2023-02-01,SEN,Pulau Pinang,0,0,0
2023-02-01,SEN,Sabah,0,0,0
2023-02-01,SEN,Sarawak,0,0,0
2023-02-01,SEN,Selangor,30,15,15
2023-02-01,SGP,Johor,881960,518353,363607
2023-02-01,SGP,Kedah,2844,1570,1274
2023-02-01,SGP,Kelantan,43,28,15
2023-02-01,SGP,Melaka,13,6,7
2023-02-01,SGP,Negeri Sembilan,0,0,0
2023-02-01,SGP,Pahang,165,85,80
2023-02-01,SGP,Perak,4255,1968,2287
2023-02-01,SGP,Perlis,155,99,56
2023-02-01,SGP,Pulau Pinang,11326,5887,5439
2023-02-01,SGP,Sabah,1957,1089,868
2023-02-01,SGP,Sarawak,3166,1751,1415
2023-02-01,SGP,Selangor,33742,17638,16104
2023-02-01,SGP,Terengganu,0,0,0
2023-02-01,SGP,W.P. Labuan,7,6,1
2023-02-01,SGS,Johor,0,0,0
2023-02-01,SGS,Sabah,0,0,0
2023-02-01,SGS,Selangor,0,0,0
2023-02-01,SHN,Sarawak,0,0,0
2023-02-01,SLB,Johor,0,0,0
2023-02-01,SLB,Perlis,0,0,0
2023-02-01,SLB,Pulau Pinang,0,0,0
2023-02-01,SLB,Sabah,0,0,0
2023-02-01,SLB,Sarawak,2,1,1
2023-02-01,SLB,Selangor,0,0,0
2023-02-01,SLB,W.P. Labuan,0,0,0
2023-02-01,SLE,Johor,6,3,3
2023-02-01,SLE,Kedah,0,0,0
2023-02-01,SLE,Perak,0,0,0
2023-02-01,SLE,Pulau Pinang,0,0,0
2023-02-01,SLE,Sabah,0,0,0
2023-02-01,SLE,Selangor,17,9,8
2023-02-01,SLV,Johor,1,0,1
2023-02-01,SLV,Kedah,0,0,0
2023-02-01,SLV,Perak,0,0,0
2023-02-01,SLV,Perlis,0,0,0
2023-02-01,SLV,Pulau Pinang,2,1,1
2023-02-01,SLV,Sabah,0,0,0
2023-02-01,SLV,Selangor,14,8,6
2023-02-01,SLV,W.P. Labuan,0,0,0
2023-02-01,SMR,Johor,0,0,0
2023-02-01,SMR,Selangor,4,4,0
2023-02-01,SOM,Johor,0,0,0
2023-02-01,SOM,Kedah,0,0,0
2023-02-01,SOM,Kelantan,0,0,0
2023-02-01,SOM,Perlis,0,0,0
2023-02-01,SOM,Sabah,1,0,1
2023-02-01,SOM,Sarawak,0,0,0
2023-02-01,SOM,Selangor,215,133,82
2023-02-01,SRB,Johor,5,2,3
2023-02-01,SRB,Kedah,0,0,0
2023-02-01,SRB,Kelantan,0,0,0
2023-02-01,SRB,Pahang,0,0,0
2023-02-01,SRB,Perak,0,0,0
2023-02-01,SRB,Perlis,1,0,1
2023-02-01,SRB,Pulau Pinang,2,0,2
2023-02-01,SRB,Sabah,1,1,0
2023-02-01,SRB,Sarawak,1,0,1
2023-02-01,SRB,Selangor,67,38,29
2023-02-01,SSD,Johor,0,0,0
2023-02-01,SSD,Kedah,0,0,0
2023-02-01,SSD,Sarawak,0,0,0
2023-02-01,SSD,Selangor,25,15,10
2023-02-01,SSD,W.P. Labuan,0,0,0
2023-02-01,STP,Selangor,2,1,1
2023-02-01,SUR,Johor,1,0,1
2023-02-01,SUR,Kedah,0,0,0
2023-02-01,SUR,Kelantan,0,0,0
2023-02-01,SUR,Perak,0,0,0
2023-02-01,SUR,Perlis,0,0,0
2023-02-01,SUR,Pulau Pinang,0,0,0
2023-02-01,SUR,Sabah,0,0,0
2023-02-01,SUR,Sarawak,0,0,0
2023-02-01,SUR,Selangor,14,10,4
2023-02-01,SVK,Johor,44,27,17
2023-02-01,SVK,Kedah,131,61,70
2023-02-01,SVK,Kelantan,0,0,0
2023-02-01,SVK,Negeri Sembilan,0,0,0
2023-02-01,SVK,Pahang,0,0,0
2023-02-01,SVK,Perak,0,0,0
2023-02-01,SVK,Perlis,7,3,4
2023-02-01,SVK,Pulau Pinang,24,14,10
2023-02-01,SVK,Sabah,9,3,6
2023-02-01,SVK,Sarawak,4,2,2
2023-02-01,SVK,Selangor,411,229,182
2023-02-01,SVK,W.P. Labuan,3,3,0
2023-02-01,SVN,Johor,21,8,13
2023-02-01,SVN,Kedah,52,29,23
2023-02-01,SVN,Kelantan,0,0,0
2023-02-01,SVN,Perak,0,0,0
2023-02-01,SVN,Perlis,6,3,3
2023-02-01,SVN,Pulau Pinang,2,0,2
2023-02-01,SVN,Sabah,2,2,0
2023-02-01,SVN,Sarawak,1,0,1
2023-02-01,SVN,Selangor,147,76,71
2023-02-01,SVN,W.P. Labuan,8,2,6
2023-02-01,SWE,Johor,255,138,117
2023-02-01,SWE,Kedah,475,205,270
2023-02-01,SWE,Kelantan,2,1,1
2023-02-01,SWE,Melaka,1,1,0
2023-02-01,SWE,Negeri Sembilan,0,0,0
2023-02-01,SWE,Pahang,2,1,1
2023-02-01,SWE,Perak,8,7,1
2023-02-01,SWE,Perlis,21,17,4
2023-02-01,SWE,Pulau Pinang,122,77,45
2023-02-01,SWE,Sabah,45,20,25
2023-02-01,SWE,Sarawak,22,18,4
2023-02-01,SWE,Selangor,1457,838,619
2023-02-01,SWE,W.P. Labuan,2,2,0
2023-02-01,SWZ,Johor,1,0,1
2023-02-01,SWZ,Kedah,0,0,0
2023-02-01,SWZ,Pulau Pinang,0,0,0
2023-02-01,SWZ,Sabah,0,0,0
2023-02-01,SWZ,Selangor,14,4,10
2023-02-01,SYC,Johor,1,0,1
2023-02-01,SYC,Kedah,0,0,0
2023-02-01,SYC,Pulau Pinang,0,0,0
2023-02-01,SYC,Sabah,0,0,0
2023-02-01,SYC,Sarawak,1,1,0
2023-02-01,SYC,Selangor,55,15,40
2023-02-01,SYR,Johor,8,6,2
2023-02-01,SYR,Kedah,1,1,0
2023-02-01,SYR,Kelantan,0,0,0
2023-02-01,SYR,Pahang,0,0,0
2023-02-01,SYR,Perlis,0,0,0
2023-02-01,SYR,Pulau Pinang,0,0,0
2023-02-01,SYR,Sabah,1,1,0
2023-02-01,SYR,Sarawak,0,0,0
2023-02-01,SYR,Selangor,512,337,175
2023-02-01,SYR,W.P. Labuan,1,1,0
2023-02-01,TCA,Perlis,1,0,1
2023-02-01,TCD,Johor,0,0,0
2023-02-01,TCD,Kedah,0,0,0
2023-02-01,TCD,Perlis,0,0,0
2023-02-01,TCD,Selangor,10,8,2
2023-02-01,TGO,Johor,2,1,1
2023-02-01,TGO,Perak,0,0,0
2023-02-01,TGO,Pulau Pinang,0,0,0
2023-02-01,TGO,Selangor,3,2,1
2023-02-01,THA,Johor,5181,1418,3763
2023-02-01,THA,Kedah,61904,37209,24695
2023-02-01,THA,Kelantan,48527,25575,22952
2023-02-01,THA,Melaka,9,6,3
2023-02-01,THA,Negeri Sembilan,1,1,0
2023-02-01,THA,Pahang,1,0,1
2023-02-01,THA,Perak,9690,4601,5089
2023-02-01,THA,Perlis,52242,32191,20051
2023-02-01,THA,Pulau Pinang,1700,684,1016
2023-02-01,THA,Sabah,143,47,96
2023-02-01,THA,Sarawak,292,101,191
2023-02-01,THA,Selangor,9860,3971,5889
2023-02-01,THA,Terengganu,0,0,0
2023-02-01,THA,W.P. Labuan,5,2,3
2023-02-01,TJK,Johor,4,1,3
2023-02-01,TJK,Kedah,0,0,0
2023-02-01,TJK,Perlis,0,0,0
2023-02-01,TJK,Pulau Pinang,2,2,0
2023-02-01,TJK,Sabah,0,0,0
2023-02-01,TJK,Selangor,88,52,36
2023-02-01,TKL,Selangor,0,0,0
2023-02-01,TKM,Johor,3,1,2
2023-02-01,TKM,Kedah,0,0,0
2023-02-01,TKM,Kelantan,1,0,1
2023-02-01,TKM,Perlis,0,0,0
2023-02-01,TKM,Pulau Pinang,0,0,0
2023-02-01,TKM,Sabah,0,0,0
2023-02-01,TKM,Sarawak,1,1,0
2023-02-01,TKM,Selangor,49,31,18
2023-02-01,TLS,Johor,4,3,1
2023-02-01,TLS,Kedah,2,1,1
2023-02-01,TLS,Perlis,0,0,0
2023-02-01,TLS,Pulau Pinang,1,0,1
2023-02-01,TLS,Sabah,0,0,0
2023-02-01,TLS,Sarawak,4,0,4
2023-02-01,TLS,Selangor,92,41,51
2023-02-01,TON,Johor,0,0,0
2023-02-01,TON,Pulau Pinang,2,1,1
2023-02-01,TON,Sarawak,0,0,0
2023-02-01,TON,Selangor,8,6,2
2023-02-01,TTO,Johor,2,2,0
2023-02-01,TTO,Kedah,0,0,0
2023-02-01,TTO,Pahang,0,0,0
2023-02-01,TTO,Pulau Pinang,0,0,0
2023-02-01,TTO,Sabah,0,0,0
2023-02-01,TTO,Sarawak,0,0,0
2023-02-01,TTO,Selangor,15,7,8
2023-02-01,TUN,Johor,8,4,4
2023-02-01,TUN,Kedah,0,0,0
2023-02-01,TUN,Kelantan,0,0,0
2023-02-01,TUN,Melaka,0,0,0
2023-02-01,TUN,Perak,0,0,0
2023-02-01,TUN,Perlis,1,0,1
2023-02-01,TUN,Pulau Pinang,2,2,0
2023-02-01,TUN,Sabah,1,0,1
2023-02-01,TUN,Sarawak,2,2,0
2023-02-01,TUN,Selangor,275,170,105
2023-02-01,TUN,W.P. Labuan,2,0,2
2023-02-01,TUR,Johor,198,143,55
2023-02-01,TUR,Kedah,44,26,18
2023-02-01,TUR,Kelantan,2,2,0
2023-02-01,TUR,Melaka,0,0,0
2023-02-01,TUR,Negeri Sembilan,0,0,0
2023-02-01,TUR,Pahang,0,0,0
2023-02-01,TUR,Perak,1,1,0
2023-02-01,TUR,Perlis,29,26,3
2023-02-01,TUR,Pulau Pinang,47,31,16
2023-02-01,TUR,Sabah,11,7,4
2023-02-01,TUR,Sarawak,8,7,1
2023-02-01,TUR,Selangor,912,632,280
2023-02-01,TUR,W.P. Labuan,0,0,0
2023-02-01,TUV,Selangor,0,0,0
2023-02-01,TWN,Johor,4132,1820,2312
2023-02-01,TWN,Kedah,133,53,80
2023-02-01,TWN,Kelantan,0,0,0
2023-02-01,TWN,Melaka,0,0,0
2023-02-01,TWN,Negeri Sembilan,0,0,0
2023-02-01,TWN,Pahang,0,0,0
2023-02-01,TWN,Perak,63,34,29
2023-02-01,TWN,Perlis,26,10,16
2023-02-01,TWN,Pulau Pinang,2360,1261,1099
2023-02-01,TWN,Sabah,839,420,419
2023-02-01,TWN,Sarawak,401,172,229
2023-02-01,TWN,Selangor,8699,4481,4218
2023-02-01,TWN,W.P. Labuan,22,8,14
2023-02-01,TZA,Johor,21,10,11
2023-02-01,TZA,Kedah,0,0,0
2023-02-01,TZA,Perak,1,1,0
2023-02-01,TZA,Perlis,0,0,0
2023-02-01,TZA,Pulau Pinang,2,1,1
2023-02-01,TZA,Sabah,0,0,0
2023-02-01,TZA,Sarawak,5,5,0
2023-02-01,TZA,Selangor,93,50,43
2023-02-01,UGA,Johor,6,4,2
2023-02-01,UGA,Kedah,0,0,0
2023-02-01,UGA,Perak,0,0,0
2023-02-01,UGA,Perlis,1,0,1
2023-02-01,UGA,Pulau Pinang,0,0,0
2023-02-01,UGA,Sabah,0,0,0
2023-02-01,UGA,Sarawak,1,1,0
2023-02-01,UGA,Selangor,74,38,36
2023-02-01,UKR,Johor,119,69,50
2023-02-01,UKR,Kedah,49,12,37
2023-02-01,UKR,Kelantan,6,5,1
2023-02-01,UKR,Melaka,0,0,0
2023-02-01,UKR,Negeri Sembilan,0,0,0
2023-02-01,UKR,Pahang,0,0,0
2023-02-01,UKR,Perak,2,1,1
2023-02-01,UKR,Perlis,21,9,12
2023-02-01,UKR,Pulau Pinang,25,11,14
2023-02-01,UKR,Sabah,7,3,4
2023-02-01,UKR,Sarawak,1,1,0
2023-02-01,UKR,Selangor,1031,483,548
2023-02-01,UKR,W.P. Labuan,0,0,0
2023-02-01,URY,Johor,74,28,46
2023-02-01,URY,Kedah,1,1,0
2023-02-01,URY,Kelantan,0,0,0
2023-02-01,URY,Perak,0,0,0
2023-02-01,URY,Perlis,0,0,0
2023-02-01,URY,Pulau Pinang,1,0,1
2023-02-01,URY,Sabah,1,1,0
2023-02-01,URY,Sarawak,0,0,0
2023-02-01,URY,Selangor,111,53,58
2023-02-01,URY,W.P. Labuan,0,0,0
2023-02-01,USA,Johor,3786,2213,1573
2023-02-01,USA,Kedah,556,306,250
2023-02-01,USA,Kelantan,16,11,5
2023-02-01,USA,Melaka,5,2,3
2023-02-01,USA,Negeri Sembilan,0,0,0
2023-02-01,USA,Pahang,2,1,1
2023-02-01,USA,Perak,141,80,61
2023-02-01,USA,Perlis,139,90,49
2023-02-01,USA,Pulau Pinang,1796,1141,655
2023-02-01,USA,Sabah,344,177,167
2023-02-01,USA,Sarawak,282,159,123
2023-02-01,USA,Selangor,11171,6822,4349
2023-02-01,USA,Terengganu,0,0,0
2023-02-01,USA,W.P. Labuan,5,4,1
2023-02-01,UZB,Johor,92,81,11
2023-02-01,UZB,Kedah,15,7,8
2023-02-01,UZB,Kelantan,1,1,0
2023-02-01,UZB,Perak,0,0,0
2023-02-01,UZB,Perlis,6,4,2
2023-02-01,UZB,Pulau Pinang,14,2,12
2023-02-01,UZB,Sabah,1,1,0
2023-02-01,UZB,Sarawak,0,0,0
2023-02-01,UZB,Selangor,1321,768,553
2023-02-01,VAT,Johor,0,0,0
2023-02-01,VAT,Sarawak,0,0,0
2023-02-01,VAT,Selangor,1,1,0
2023-02-01,VCT,Johor,0,0,0
2023-02-01,VCT,Kedah,0,0,0
2023-02-01,VCT,Pulau Pinang,0,0,0
2023-02-01,VCT,Sarawak,0,0,0
2023-02-01,VCT,Selangor,1,1,0
2023-02-01,VEN,Johor,17,8,9
2023-02-01,VEN,Kedah,0,0,0
2023-02-01,VEN,Kelantan,0,0,0
2023-02-01,VEN,Melaka,0,0,0
2023-02-01,VEN,Perak,0,0,0
2023-02-01,VEN,Perlis,0,0,0
2023-02-01,VEN,Pulau Pinang,2,1,1
2023-02-01,VEN,Sabah,0,0,0
2023-02-01,VEN,Sarawak,5,3,2
2023-02-01,VEN,Selangor,48,24,24
2023-02-01,VEN,W.P. Labuan,0,0,0
2023-02-01,VNM,Johor,10757,3249,7508
2023-02-01,VNM,Kedah,247,29,218
2023-02-01,VNM,Kelantan,5,1,4
2023-02-01,VNM,Melaka,0,0,0
2023-02-01,VNM,Negeri Sembilan,0,0,0
2023-02-01,VNM,Pahang,0,0,0
2023-02-01,VNM,Perak,108,22,86
2023-02-01,VNM,Perlis,180,16,164
2023-02-01,VNM,Pulau Pinang,1378,432,946
2023-02-01,VNM,Sabah,19,4,15
2023-02-01,VNM,Sarawak,169,24,145
2023-02-01,VNM,Selangor,13413,4726,8687
2023-02-01,VNM,Terengganu,0,0,0
2023-02-01,VNM,W.P. Labuan,5,3,2
2023-02-01,VUT,Johor,19,13,6
2023-02-01,VUT,Kedah,0,0,0
2023-02-01,VUT,Pulau Pinang,3,3,0
2023-02-01,VUT,Sabah,1,1,0
2023-02-01,VUT,Sarawak,0,0,0
2023-02-01,VUT,Selangor,37,33,4
2023-02-01,WSM,Johor,1,1,0
2023-02-01,WSM,Sarawak,0,0,0
2023-02-01,WSM,Selangor,1,1,0
2023-02-01,XXX,Johor,144,85,59
2023-02-01,XXX,Kedah,13,7,6
2023-02-01,XXX,Kelantan,0,0,0
2023-02-01,XXX,Melaka,0,0,0
2023-02-01,XXX,Pahang,1,0,1
2023-02-01,XXX,Perak,7,4,3
2023-02-01,XXX,Perlis,1,0,1
2023-02-01,XXX,Pulau Pinang,47,24,23
2023-02-01,XXX,Sabah,14,11,3
2023-02-01,XXX,Sarawak,37,27,10
2023-02-01,XXX,Selangor,347,206,141
2023-02-01,XXX,W.P. Labuan,0,0,0
2023-02-01,YEM,Johor,22,12,10
2023-02-01,YEM,Kedah,0,0,0
2023-02-01,YEM,Kelantan,0,0,0
2023-02-01,YEM,Melaka,0,0,0
2023-02-01,YEM,Pahang,0,0,0
2023-02-01,YEM,Perak,0,0,0
2023-02-01,YEM,Perlis,1,1,0
2023-02-01,YEM,Pulau Pinang,5,5,0
2023-02-01,YEM,Sabah,0,0,0
2023-02-01,YEM,Sarawak,5,2,3
2023-02-01,YEM,Selangor,1012,743,269
2023-02-01,YEM,W.P. Labuan,0,0,0
2023-02-01,ZAF,Johor,279,176,103
2023-02-01,ZAF,Kedah,44,25,19
2023-02-01,ZAF,Kelantan,1,1,0
2023-02-01,ZAF,Melaka,0,0,0
2023-02-01,ZAF,Pahang,0,0,0
2023-02-01,ZAF,Perak,2,1,1
2023-02-01,ZAF,Perlis,10,5,5
2023-02-01,ZAF,Pulau Pinang,37,19,18
2023-02-01,ZAF,Sabah,6,1,5
2023-02-01,ZAF,Sarawak,86,40,46
2023-02-01,ZAF,Selangor,668,403,265
2023-02-01,ZAF,Terengganu,0,0,0
2023-02-01,ZAF,W.P. Labuan,1,1,0
2023-02-01,ZAR,Selangor,0,0,0
2023-02-01,ZMB,Johor,7,3,4
2023-02-01,ZMB,Kedah,0,0,0
2023-02-01,ZMB,Perak,0,0,0
2023-02-01,ZMB,Perlis,0,0,0
2023-02-01,ZMB,Pulau Pinang,0,0,0
2023-02-01,ZMB,Sabah,0,0,0
2023-02-01,ZMB,Sarawak,2,1,1
2023-02-01,ZMB,Selangor,43,26,17
2023-02-01,ZWE,Johor,8,4,4
2023-02-01,ZWE,Kedah,0,0,0
2023-02-01,ZWE,Kelantan,0,0,0
2023-02-01,ZWE,Perak,0,0,0
2023-02-01,ZWE,Perlis,1,0,1
2023-02-01,ZWE,Pulau Pinang,0,0,0
2023-02-01,ZWE,Sabah,1,0,1
2023-02-01,ZWE,Sarawak,0,0,0
2023-02-01,ZWE,Selangor,79,40,39
2023-03-01,ABW,Kedah,0,0,0
2023-03-01,ABW,Pulau Pinang,0,0,0
2023-03-01,AFG,Johor,1,1,0
2023-03-01,AFG,Kedah,0,0,0
2023-03-01,AFG,Perlis,0,0,0
2023-03-01,AFG,Pulau Pinang,0,0,0
2023-03-01,AFG,Sarawak,0,0,0
2023-03-01,AFG,Selangor,29,25,4
2023-03-01,AGO,Johor,1,1,0
2023-03-01,AGO,Kedah,2,2,0
2023-03-01,AGO,Sabah,0,0,0
2023-03-01,AGO,Selangor,19,17,2
2023-03-01,AIA,Selangor,0,0,0
2023-03-01,ALB,Johor,10,9,1
2023-03-01,ALB,Kedah,3,0,3
2023-03-01,ALB,Perak,0,0,0
2023-03-01,ALB,Perlis,0,0,0
2023-03-01,ALB,Pulau Pinang,0,0,0
2023-03-01,ALB,Sabah,1,0,1
2023-03-01,ALB,Sarawak,1,1,0
2023-03-01,ALB,Selangor,36,25,11
2023-03-01,AND,Johor,0,0,0
2023-03-01,AND,Kedah,0,0,0
2023-03-01,AND,Perlis,0,0,0
2023-03-01,AND,Pulau Pinang,0,0,0
2023-03-01,AND,Selangor,0,0,0
2023-03-01,ANT,Selangor,0,0,0
2023-03-01,ARE,Johor,15,14,1
2023-03-01,ARE,Kedah,0,0,0
2023-03-01,ARE,Kelantan,0,0,0
2023-03-01,ARE,Perak,0,0,0
2023-03-01,ARE,Perlis,0,0,0
2023-03-01,ARE,Pulau Pinang,1,1,0
2023-03-01,ARE,Sabah,0,0,0
2023-03-01,ARE,Sarawak,1,1,0
2023-03-01,ARE,Selangor,224,158,66
2023-03-01,ARG,Johor,62,39,23
2023-03-01,ARG,Kedah,69,35,34
2023-03-01,ARG,Kelantan,0,0,0
2023-03-01,ARG,Melaka,1,1,0
2023-03-01,ARG,Perak,1,1,0
2023-03-01,ARG,Perlis,16,6,10
2023-03-01,ARG,Pulau Pinang,13,7,6
2023-03-01,ARG,Sabah,1,0,1
2023-03-01,ARG,Sarawak,0,0,0
2023-03-01,ARG,Selangor,373,203,170
2023-03-01,ARG,W.P. Labuan,0,0,0
2023-03-01,ARM,Johor,3,2,1
2023-03-01,ARM,Kedah,0,0,0
2023-03-01,ARM,Kelantan,0,0,0
2023-03-01,ARM,Perak,0,0,0
2023-03-01,ARM,Perlis,0,0,0
2023-03-01,ARM,Pulau Pinang,0,0,0
2023-03-01,ARM,Sabah,0,0,0
2023-03-01,ARM,Sarawak,0,0,0
2023-03-01,ARM,Selangor,128,51,77
2023-03-01,ATA,Selangor,0,0,0
2023-03-01,ATG,Johor,8,7,1
2023-03-01,ATG,Kedah,5,2,3
2023-03-01,ATG,Pulau Pinang,0,0,0
2023-03-01,ATG,Sarawak,0,0,0
2023-03-01,ATG,Selangor,17,9,8
2023-03-01,AUS,Johor,4283,2546,1737
2023-03-01,AUS,Kedah,508,293,215
2023-03-01,AUS,Kelantan,13,10,3
2023-03-01,AUS,Melaka,1,1,0
2023-03-01,AUS,Negeri Sembilan,1,1,0
2023-03-01,AUS,Pahang,2,2,0
2023-03-01,AUS,Perak,183,101,82
2023-03-01,AUS,Perlis,74,48,26
2023-03-01,AUS,Pulau Pinang,1589,872,717
2023-03-01,AUS,Sabah,439,228,211
2023-03-01,AUS,Sarawak,639,359,280
2023-03-01,AUS,Selangor,18900,11159,7741
2023-03-01,AUS,Terengganu,0,0,0
2023-03-01,AUS,W.P. Labuan,3,2,1
2023-03-01,AUT,Johor,149,95,54
2023-03-01,AUT,Kedah,106,55,51
2023-03-01,AUT,Kelantan,4,4,0
2023-03-01,AUT,Melaka,3,2,1
2023-03-01,AUT,Negeri Sembilan,0,0,0
2023-03-01,AUT,Pahang,0,0,0
2023-03-01,AUT,Perak,1,0,1
2023-03-01,AUT,Perlis,14,10,4
2023-03-01,AUT,Pulau Pinang,91,67,24
2023-03-01,AUT,Sabah,18,11,7
2023-03-01,AUT,Sarawak,28,21,7
2023-03-01,AUT,Selangor,701,450,251
2023-03-01,AUT,Terengganu,0,0,0
2023-03-01,AUT,W.P. Labuan,0,0,0
2023-03-01,AZE,Johor,8,4,4
2023-03-01,AZE,Kedah,10,7,3
2023-03-01,AZE,Kelantan,0,0,0
2023-03-01,AZE,Melaka,0,0,0
2023-03-01,AZE,Perlis,0,0,0
2023-03-01,AZE,Pulau Pinang,2,1,1
2023-03-01,AZE,Sabah,0,0,0
2023-03-01,AZE,Sarawak,4,2,2
2023-03-01,AZE,Selangor,219,101,118
2023-03-01,AZE,W.P. Labuan,0,0,0
2023-03-01,BDI,Pulau Pinang,0,0,0
2023-03-01,BDI,Sarawak,0,0,0
2023-03-01,BDI,Selangor,4,1,3
2023-03-01,BEL,Johor,230,159,71
2023-03-01,BEL,Kedah,130,69,61
2023-03-01,BEL,Kelantan,5,3,2
2023-03-01,BEL,Melaka,0,0,0
2023-03-01,BEL,Negeri Sembilan,0,0,0
2023-03-01,BEL,Pahang,0,0,0
2023-03-01,BEL,Perak,1,1,0
2023-03-01,BEL,Perlis,24,11,13
2023-03-01,BEL,Pulau Pinang,65,40,25
2023-03-01,BEL,Sabah,10,6,4
2023-03-01,BEL,Sarawak,23,11,12
2023-03-01,BEL,Selangor,939,606,333
2023-03-01,BEL,W.P. Labuan,0,0,0
2023-03-01,BEN,Johor,2,2,0
2023-03-01,BEN,Kedah,0,0,0
2023-03-01,BEN,Perak,0,0,0
2023-03-01,BEN,Pulau Pinang,0,0,0
2023-03-01,BEN,Sabah,1,1,0
2023-03-01,BEN,Sarawak,0,0,0
2023-03-01,BEN,Selangor,8,6,2
2023-03-01,BFA,Perak,0,0,0
2023-03-01,BFA,Pulau Pinang,1,1,0
2023-03-01,BFA,Selangor,4,4,0
2023-03-01,BGD,Johor,2780,2342,438
2023-03-01,BGD,Kedah,34,22,12
2023-03-01,BGD,Kelantan,1,1,0
2023-03-01,BGD,Melaka,0,0,0
2023-03-01,BGD,Negeri Sembilan,0,0,0
2023-03-01,BGD,Pahang,1,1,0
2023-03-01,BGD,Perak,0,0,0
2023-03-01,BGD,Perlis,4,4,0
2023-03-01,BGD,Pulau Pinang,755,739,16
2023-03-01,BGD,Sabah,4,3,1
2023-03-01,BGD,Sarawak,82,77,5
2023-03-01,BGD,Selangor,59315,57741,1574
2023-03-01,BGD,W.P. Labuan,1,1,0
2023-03-01,BGR,Johor,46,22,24
2023-03-01,BGR,Kedah,24,14,10
2023-03-01,BGR,Kelantan,0,0,0
2023-03-01,BGR,Pahang,0,0,0
2023-03-01,BGR,Perak,0,0,0
2023-03-01,BGR,Perlis,2,1,1
2023-03-01,BGR,Pulau Pinang,7,5,2
2023-03-01,BGR,Sabah,5,3,2
2023-03-01,BGR,Sarawak,2,1,1
2023-03-01,BGR,Selangor,265,132,133
2023-03-01,BGR,W.P. Labuan,0,0,0
2023-03-01,BHR,Johor,1,1,0
2023-03-01,BHR,Kedah,0,0,0
2023-03-01,BHR,Kelantan,0,0,0
2023-03-01,BHR,Perlis,0,0,0
2023-03-01,BHR,Pulau Pinang,1,1,0
2023-03-01,BHR,Sabah,0,0,0
2023-03-01,BHR,Sarawak,0,0,0
2023-03-01,BHR,Selangor,72,46,26
2023-03-01,BHS,Johor,1,1,0
2023-03-01,BHS,Kedah,0,0,0
2023-03-01,BHS,Perak,0,0,0
2023-03-01,BHS,Sabah,0,0,0
2023-03-01,BHS,Sarawak,0,0,0
2023-03-01,BHS,Selangor,16,9,7
2023-03-01,BIH,Johor,9,2,7
2023-03-01,BIH,Kedah,2,1,1
2023-03-01,BIH,Perlis,0,0,0
2023-03-01,BIH,Pulau Pinang,0,0,0
2023-03-01,BIH,Sabah,2,1,1
2023-03-01,BIH,Sarawak,1,1,0
2023-03-01,BIH,Selangor,59,32,27
2023-03-01,BLR,Johor,23,4,19
2023-03-01,BLR,Kedah,23,14,9
2023-03-01,BLR,Kelantan,1,0,1
2023-03-01,BLR,Pahang,0,0,0
2023-03-01,BLR,Perak,0,0,0
2023-03-01,BLR,Perlis,3,1,2
2023-03-01,BLR,Pulau Pinang,6,2,4
2023-03-01,BLR,Sabah,6,2,4
2023-03-01,BLR,Sarawak,1,0,1
2023-03-01,BLR,Selangor,526,259,267
2023-03-01,BLR,W.P. Labuan,0,0,0
2023-03-01,BLZ,Johor,1,0,1
2023-03-01,BLZ,Pulau Pinang,0,0,0
2023-03-01,BLZ,Sarawak,0,0,0
2023-03-01,BLZ,Selangor,8,4,4
2023-03-01,BMU,Selangor,0,0,0
2023-03-01,BOL,Johor,0,0,0
2023-03-01,BOL,Kedah,0,0,0
2023-03-01,BOL,Melaka,1,1,0
2023-03-01,BOL,Perak,0,0,0
2023-03-01,BOL,Perlis,0,0,0
2023-03-01,BOL,Pulau Pinang,2,0,2
2023-03-01,BOL,Sabah,0,0,0
2023-03-01,BOL,Sarawak,1,1,0
2023-03-01,BOL,Selangor,12,9,3
2023-03-01,BRA,Johor,246,157,89
2023-03-01,BRA,Kedah,85,39,46
2023-03-01,BRA,Kelantan,2,1,1
2023-03-01,BRA,Melaka,2,2,0
2023-03-01,BRA,Pahang,1,1,0
2023-03-01,BRA,Perak,1,1,0
2023-03-01,BRA,Perlis,6,3,3
2023-03-01,BRA,Pulau Pinang,28,18,10
2023-03-01,BRA,Sabah,14,8,6
2023-03-01,BRA,Sarawak,7,6,1
2023-03-01,BRA,Selangor,778,455,323
2023-03-01,BRA,W.P. Labuan,0,0,0
2023-03-01,BRB,Johor,2,0,2
2023-03-01,BRB,Kedah,0,0,0
2023-03-01,BRB,Perlis,0,0,0
2023-03-01,BRB,Pulau Pinang,0,0,0
2023-03-01,BRB,Selangor,1,1,0
2023-03-01,BRN,Johor,366,194,172
2023-03-01,BRN,Kedah,38,28,10
2023-03-01,BRN,Kelantan,5,3,2
2023-03-01,BRN,Melaka,3,3,0
2023-03-01,BRN,Pahang,0,0,0
2023-03-01,BRN,Perak,6,4,2
2023-03-01,BRN,Perlis,20,9,11
2023-03-01,BRN,Pulau Pinang,23,11,12
2023-03-01,BRN,Sabah,623,275,348
2023-03-01,BRN,Sarawak,90248,49820,40428
2023-03-01,BRN,Selangor,4819,2330,2489
2023-03-01,BRN,W.P. Labuan,992,686,306
2023-03-01,BTN,Johor,17,11,6
2023-03-01,BTN,Kedah,0,0,0
2023-03-01,BTN,Perak,0,0,0
2023-03-01,BTN,Perlis,0,0,0
2023-03-01,BTN,Pulau Pinang,0,0,0
2023-03-01,BTN,Sabah,0,0,0
2023-03-01,BTN,Sarawak,1,1,0
2023-03-01,BTN,Selangor,48,40,8
2023-03-01,BWA,Johor,0,0,0
2023-03-01,BWA,Kedah,0,0,0
2023-03-01,BWA,Perlis,0,0,0
2023-03-01,BWA,Pulau Pinang,0,0,0
2023-03-01,BWA,Sabah,0,0,0
2023-03-01,BWA,Sarawak,0,0,0
2023-03-01,BWA,Selangor,13,8,5
2023-03-01,CAF,Kedah,0,0,0
2023-03-01,CAF,Selangor,0,0,0
2023-03-01,CAN,Johor,1589,899,690
2023-03-01,CAN,Kedah,298,168,130
2023-03-01,CAN,Kelantan,6,5,1
2023-03-01,CAN,Melaka,3,2,1
2023-03-01,CAN,Negeri Sembilan,0,0,0
2023-03-01,CAN,Pahang,0,0,0
2023-03-01,CAN,Perak,43,20,23
2023-03-01,CAN,Perlis,71,42,29
2023-03-01,CAN,Pulau Pinang,549,305,244
2023-03-01,CAN,Sabah,221,109,112
2023-03-01,CAN,Sarawak,471,260,211
2023-03-01,CAN,Selangor,4673,2709,1964
2023-03-01,CAN,Terengganu,5,5,0
2023-03-01,CAN,W.P. Labuan,3,3,0
2023-03-01,CCK,Selangor,0,0,0
2023-03-01,CHE,Johor,353,212,141
2023-03-01,CHE,Kedah,211,119,92
2023-03-01,CHE,Kelantan,2,2,0
2023-03-01,CHE,Melaka,0,0,0
2023-03-01,CHE,Negeri Sembilan,0,0,0
2023-03-01,CHE,Pahang,0,0,0
2023-03-01,CHE,Perak,9,5,4
2023-03-01,CHE,Perlis,25,16,9
2023-03-01,CHE,Pulau Pinang,156,98,58
2023-03-01,CHE,Sabah,39,18,21
2023-03-01,CHE,Sarawak,45,22,23
2023-03-01,CHE,Selangor,1305,798,507
2023-03-01,CHE,W.P. Labuan,0,0,0
2023-03-01,CHL,Johor,19,12,7
2023-03-01,CHL,Kedah,17,8,9
2023-03-01,CHL,Kelantan,1,1,0
2023-03-01,CHL,Melaka,0,0,0
2023-03-01,CHL,Pahang,0,0,0
2023-03-01,CHL,Perak,0,0,0
2023-03-01,CHL,Perlis,2,1,1
2023-03-01,CHL,Pulau Pinang,5,3,2
2023-03-01,CHL,Sabah,2,1,1
2023-03-01,CHL,Sarawak,2,1,1
2023-03-01,CHL,Selangor,199,108,91
2023-03-01,CHN,Johor,28268,11991,16277
2023-03-01,CHN,Kedah,669,307,362
2023-03-01,CHN,Kelantan,4,3,1
2023-03-01,CHN,Melaka,4,4,0
2023-03-01,CHN,Pahang,8,5,3
2023-03-01,CHN,Perak,162,63,99
2023-03-01,CHN,Perlis,112,40,72
2023-03-01,CHN,Pulau Pinang,5099,2686,2413
2023-03-01,CHN,Sabah,5054,2563,2491
2023-03-01,CHN,Sarawak,919,455,464
2023-03-01,CHN,Selangor,62452,34414,28038
2023-03-01,CHN,Terengganu,0,0,0
2023-03-01,CHN,W.P. Labuan,23,19,4
2023-03-01,CIV,Johor,1,0,1
2023-03-01,CIV,Kedah,0,0,0
2023-03-01,CIV,Pulau Pinang,0,0,0
2023-03-01,CIV,Sabah,0,0,0
2023-03-01,CIV,Sarawak,0,0,0
2023-03-01,CIV,Selangor,12,8,4
2023-03-01,CMR,Johor,1,1,0
2023-03-01,CMR,Kedah,0,0,0
2023-03-01,CMR,Pulau Pinang,0,0,0
2023-03-01,CMR,Sabah,0,0,0
2023-03-01,CMR,Sarawak,0,0,0
2023-03-01,CMR,Selangor,25,18,7
2023-03-01,COD,Johor,3,3,0
2023-03-01,COD,Pulau Pinang,0,0,0
2023-03-01,COD,Sarawak,0,0,0
2023-03-01,COD,Selangor,11,9,2
2023-03-01,COG,Johor,0,0,0
2023-03-01,COG,Kedah,0,0,0
2023-03-01,COG,Selangor,0,0,0
2023-03-01,COK,Selangor,0,0,0
2023-03-01,COL,Johor,13,7,6
2023-03-01,COL,Kedah,4,0,4
2023-03-01,COL,Perak,0,0,0
2023-03-01,COL,Pulau Pinang,3,1,2
2023-03-01,COL,Sabah,0,0,0
2023-03-01,COL,Sarawak,2,1,1
2023-03-01,COL,Selangor,143,72,71
2023-03-01,COL,W.P. Labuan,0,0,0
2023-03-01,COM,Johor,0,0,0
2023-03-01,COM,Kedah,0,0,0
2023-03-01,COM,Selangor,11,3,8
2023-03-01,CPV,Johor,2,0,2
2023-03-01,CPV,Kedah,0,0,0
2023-03-01,CPV,Pulau Pinang,0,0,0
2023-03-01,CPV,Sabah,0,0,0
2023-03-01,CPV,Selangor,1,1,0
2023-03-01,CRI,Johor,14,10,4
2023-03-01,CRI,Kedah,0,0,0
2023-03-01,CRI,Perak,0,0,0
2023-03-01,CRI,Perlis,0,0,0
2023-03-01,CRI,Pulau Pinang,3,3,0
2023-03-01,CRI,Sabah,1,1,0
2023-03-01,CRI,Sarawak,0,0,0
2023-03-01,CRI,Selangor,48,27,21
2023-03-01,CUB,Johor,2,1,1
2023-03-01,CUB,Kedah,0,0,0
2023-03-01,CUB,Perlis,0,0,0
2023-03-01,CUB,Pulau Pinang,1,1,0
2023-03-01,CUB,Sabah,0,0,0
2023-03-01,CUB,Sarawak,0,0,0
2023-03-01,CUB,Selangor,20,11,9
2023-03-01,CYP,Johor,9,4,5
2023-03-01,CYP,Kedah,0,0,0
2023-03-01,CYP,Perak,0,0,0
2023-03-01,CYP,Perlis,3,2,1
2023-03-01,CYP,Pulau Pinang,2,2,0
2023-03-01,CYP,Sabah,0,0,0
2023-03-01,CYP,Sarawak,2,1,1
2023-03-01,CYP,Selangor,75,47,28
2023-03-01,CZE,Johor,146,88,58
2023-03-01,CZE,Kedah,156,72,84
2023-03-01,CZE,Kelantan,4,2,2
2023-03-01,CZE,Melaka,0,0,0
2023-03-01,CZE,Negeri Sembilan,0,0,0
2023-03-01,CZE,Perak,0,0,0
2023-03-01,CZE,Perlis,14,11,3
2023-03-01,CZE,Pulau Pinang,51,31,20
2023-03-01,CZE,Sabah,23,12,11
2023-03-01,CZE,Sarawak,21,15,6
2023-03-01,CZE,Selangor,744,438,306
2023-03-01,CZE,W.P. Labuan,6,4,2
2023-03-01,DEU,Johor,2655,1542,1113
2023-03-01,DEU,Kedah,1183,596,587
2023-03-01,DEU,Kelantan,13,7,6
2023-03-01,DEU,Melaka,3,3,0
2023-03-01,DEU,Negeri Sembilan,1,1,0
2023-03-01,DEU,Pahang,4,3,1
2023-03-01,DEU,Perak,31,16,15
2023-03-01,DEU,Perlis,209,120,89
2023-03-01,DEU,Pulau Pinang,860,596,264
2023-03-01,DEU,Sabah,160,91,69
2023-03-01,DEU,Sarawak,272,140,132
2023-03-01,DEU,Selangor,7648,4761,2887
2023-03-01,DEU,Terengganu,0,0,0
2023-03-01,DEU,W.P. Labuan,9,4,5
2023-03-01,DJI,Johor,0,0,0
2023-03-01,DJI,Selangor,4,1,3
2023-03-01,DMA,Johor,17,13,4
2023-03-01,DMA,Kedah,1,1,0
2023-03-01,DMA,Pulau Pinang,1,1,0
2023-03-01,DMA,Sabah,1,0,1
2023-03-01,DMA,Sarawak,0,0,0
2023-03-01,DMA,Selangor,45,35,10
2023-03-01,DMA,W.P. Labuan,0,0,0
2023-03-01,DNK,Johor,238,163,75
2023-03-01,DNK,Kedah,190,80,110
2023-03-01,DNK,Kelantan,1,1,0
2023-03-01,DNK,Melaka,0,0,0
2023-03-01,DNK,Negeri Sembilan,0,0,0
2023-03-01,DNK,Pahang,0,0,0
2023-03-01,DNK,Perak,8,3,5
2023-03-01,DNK,Perlis,25,16,9
2023-03-01,DNK,Pulau Pinang,52,39,13
2023-03-01,DNK,Sabah,69,31,38
2023-03-01,DNK,Sarawak,45,22,23
2023-03-01,DNK,Selangor,1215,697,518
2023-03-01,DNK,W.P. Labuan,1,1,0
2023-03-01,DOM,Johor,0,0,0
2023-03-01,DOM,Kedah,0,0,0
2023-03-01,DOM,Perak,0,0,0
2023-03-01,DOM,Perlis,0,0,0
2023-03-01,DOM,Pulau Pinang,3,1,2
2023-03-01,DOM,Sabah,0,0,0
2023-03-01,DOM,Sarawak,0,0,0
2023-03-01,DOM,Selangor,67,40,27
2023-03-01,DZA,Johor,20,16,4
2023-03-01,DZA,Kedah,2,2,0
2023-03-01,DZA,Kelantan,0,0,0
2023-03-01,DZA,Melaka,0,0,0
2023-03-01,DZA,Perak,1,1,0
2023-03-01,DZA,Perlis,2,2,0
2023-03-01,DZA,Pulau Pinang,2,1,1
2023-03-01,DZA,Sabah,1,1,0
2023-03-01,DZA,Sarawak,0,0,0
2023-03-01,DZA,Selangor,386,281,105
2023-03-01,DZA,W.P. Labuan,0,0,0
2023-03-01,ECU,Johor,12,7,5
2023-03-01,ECU,Kedah,2,1,1
2023-03-01,ECU,Perak,0,0,0
2023-03-01,ECU,Perlis,0,0,0
2023-03-01,ECU,Pulau Pinang,0,0,0
2023-03-01,ECU,Sabah,0,0,0
2023-03-01,ECU,Sarawak,0,0,0
2023-03-01,ECU,Selangor,67,35,32
2023-03-01,EGY,Johor,250,216,34
2023-03-01,EGY,Kedah,9,6,3
2023-03-01,EGY,Kelantan,0,0,0
2023-03-01,EGY,Melaka,2,2,0
2023-03-01,EGY,Pahang,1,1,0
2023-03-01,EGY,Perak,1,1,0
2023-03-01,EGY,Perlis,2,2,0
2023-03-01,EGY,Pulau Pinang,5,4,1
2023-03-01,EGY,Sabah,0,0,0
2023-03-01,EGY,Sarawak,105,70,35
2023-03-01,EGY,Selangor,1178,907,271
2023-03-01,EGY,Terengganu,2,2,0
2023-03-01,EGY,W.P. Labuan,1,1,0
2023-03-01,ERI,Johor,2,1,1
2023-03-01,ERI,Pulau Pinang,0,0,0
2023-03-01,ERI,Sabah,0,0,0
2023-03-01,ERI,Selangor,27,17,10
2023-03-01,ESP,Johor,431,258,173
2023-03-01,ESP,Kedah,196,106,90
2023-03-01,ESP,Kelantan,4,2,2
2023-03-01,ESP,Melaka,0,0,0
2023-03-01,ESP,Negeri Sembilan,0,0,0
2023-03-01,ESP,Pahang,0,0,0
2023-03-01,ESP,Perak,1,1,0
2023-03-01,ESP,Perlis,19,9,10
2023-03-01,ESP,Pulau Pinang,94,53,41
2023-03-01,ESP,Sabah,41,25,16
2023-03-01,ESP,Sarawak,37,25,12
2023-03-01,ESP,Selangor,1955,1153,802
2023-03-01,ESP,W.P. Labuan,0,0,0
2023-03-01,EST,Johor,45,24,21
2023-03-01,EST,Kedah,88,51,37
2023-03-01,EST,Kelantan,0,0,0
2023-03-01,EST,Pahang,0,0,0
2023-03-01,EST,Perak,0,0,0
2023-03-01,EST,Perlis,4,1,3
2023-03-01,EST,Pulau Pinang,17,9,8
2023-03-01,EST,Sabah,1,0,1
2023-03-01,EST,Sarawak,5,3,2
2023-03-01,EST,Selangor,268,131,137
2023-03-01,EST,W.P. Labuan,0,0,0
2023-03-01,ETH,Johor,2,2,0
2023-03-01,ETH,Kedah,0,0,0
2023-03-01,ETH,Pulau Pinang,0,0,0
2023-03-01,ETH,Sarawak,0,0,0
2023-03-01,ETH,Selangor,20,17,3
2023-03-01,FIN,Johor,191,107,84
2023-03-01,FIN,Kedah,132,71,61
2023-03-01,FIN,Kelantan,1,1,0
2023-03-01,FIN,Melaka,0,0,0
2023-03-01,FIN,Negeri Sembilan,0,0,0
2023-03-01,FIN,Pahang,0,0,0
2023-03-01,FIN,Perak,7,4,3
2023-03-01,FIN,Perlis,12,8,4
2023-03-01,FIN,Pulau Pinang,65,38,27
2023-03-01,FIN,Sabah,29,18,11
2023-03-01,FIN,Sarawak,15,9,6
2023-03-01,FIN,Selangor,671,376,295
2023-03-01,FIN,W.P. Labuan,2,2,0
2023-03-01,FJI,Johor,42,25,17
2023-03-01,FJI,Kedah,3,1,2
2023-03-01,FJI,Kelantan,0,0,0
2023-03-01,FJI,Perak,0,0,0
2023-03-01,FJI,Perlis,0,0,0
2023-03-01,FJI,Pulau Pinang,7,5,2
2023-03-01,FJI,Sabah,3,0,3
2023-03-01,FJI,Sarawak,2,1,1
2023-03-01,FJI,Selangor,93,51,42
2023-03-01,FRA,Johor,1756,1074,682
2023-03-01,FRA,Kedah,950,500,450
2023-03-01,FRA,Kelantan,32,18,14
2023-03-01,FRA,Melaka,2,2,0
2023-03-01,FRA,Negeri Sembilan,1,1,0
2023-03-01,FRA,Pahang,10,7,3
2023-03-01,FRA,Perak,32,16,16
2023-03-01,FRA,Perlis,131,90,41
2023-03-01,FRA,Pulau Pinang,453,281,172
2023-03-01,FRA,Sabah,110,64,46
2023-03-01,FRA,Sarawak,138,80,58
2023-03-01,FRA,Selangor,7694,4574,3120
2023-03-01,FRA,Terengganu,0,0,0
2023-03-01,FRA,W.P. Labuan,2,2,0
2023-03-01,FSM,Johor,0,0,0
2023-03-01,FSM,Pulau Pinang,0,0,0
2023-03-01,FSM,Selangor,1,0,1
2023-03-01,GAB,Johor,0,0,0
2023-03-01,GAB,Pulau Pinang,0,0,0
2023-03-01,GAB,Sarawak,0,0,0
2023-03-01,GAB,Selangor,4,2,2
2023-03-01,GBR,Johor,4531,2864,1667
2023-03-01,GBR,Kedah,1489,791,698
2023-03-01,GBR,Kelantan,20,18,2
2023-03-01,GBR,Melaka,6,3,3
2023-03-01,GBR,Negeri Sembilan,1,1,0
2023-03-01,GBR,Pahang,4,4,0
2023-03-01,GBR,Perak,96,53,43
2023-03-01,GBR,Perlis,251,168,83
2023-03-01,GBR,Pulau Pinang,1604,919,685
2023-03-01,GBR,Sabah,699,375,324
2023-03-01,GBR,Sarawak,1484,876,608
2023-03-01,GBR,Selangor,16846,10148,6698
2023-03-01,GBR,Terengganu,0,0,0
2023-03-01,GBR,W.P. Labuan,21,14,7
2023-03-01,GEO,Johor,12,11,1
2023-03-01,GEO,Kedah,2,1,1
2023-03-01,GEO,Melaka,0,0,0
2023-03-01,GEO,Perak,0,0,0
2023-03-01,GEO,Perlis,5,3,2
2023-03-01,GEO,Pulau Pinang,1,1,0
2023-03-01,GEO,Sabah,0,0,0
2023-03-01,GEO,Sarawak,0,0,0
2023-03-01,GEO,Selangor,73,48,25
2023-03-01,GHA,Johor,14,14,0
2023-03-01,GHA,Kedah,0,0,0
2023-03-01,GHA,Kelantan,0,0,0
2023-03-01,GHA,Pulau Pinang,0,0,0
2023-03-01,GHA,Sabah,0,0,0
2023-03-01,GHA,Sarawak,0,0,0
2023-03-01,GHA,Selangor,66,46,20
2023-03-01,GIB,Johor,0,0,0
2023-03-01,GIB,Sarawak,0,0,0
2023-03-01,GIN,Johor,1,1,0
2023-03-01,GIN,Kedah,1,1,0
2023-03-01,GIN,Kelantan,2,2,0
2023-03-01,GIN,Perlis,0,0,0
2023-03-01,GIN,Pulau Pinang,0,0,0
2023-03-01,GIN,Sabah,0,0,0
2023-03-01,GIN,Sarawak,0,0,0
2023-03-01,GIN,Selangor,56,40,16
2023-03-01,GLP,Selangor,0,0,0
2023-03-01,GMB,Johor,1,0,1
2023-03-01,GMB,Kedah,0,0,0
2023-03-01,GMB,Kelantan,0,0,0
2023-03-01,GMB,Pulau Pinang,0,0,0
2023-03-01,GMB,Sabah,1,1,0
2023-03-01,GMB,Sarawak,0,0,0
2023-03-01,GMB,Selangor,17,11,6
2023-03-01,GNB,Johor,3,3,0
2023-03-01,GNB,Selangor,0,0,0
2023-03-01,GNQ,Johor,0,0,0
2023-03-01,GNQ,Selangor,2,2,0
2023-03-01,GRC,Johor,59,43,16
2023-03-01,GRC,Kedah,26,14,12
2023-03-01,GRC,Kelantan,1,1,0
2023-03-01,GRC,Melaka,0,0,0
2023-03-01,GRC,Negeri Sembilan,0,0,0
2023-03-01,GRC,Pahang,3,3,0
2023-03-01,GRC,Perak,1,0,1
2023-03-01,GRC,Perlis,2,2,0
2023-03-01,GRC,Pulau Pinang,14,11,3
2023-03-01,GRC,Sabah,5,3,2
2023-03-01,GRC,Sarawak,3,2,1
2023-03-01,GRC,Selangor,253,187,66
2023-03-01,GRD,Johor,4,3,1
2023-03-01,GRD,Kedah,0,0,0
2023-03-01,GRD,Pulau Pinang,0,0,0
2023-03-01,GRD,Sabah,0,0,0
2023-03-01,GRD,Sarawak,0,0,0
2023-03-01,GRD,Selangor,9,8,1
2023-03-01,GRL,Johor,0,0,0
2023-03-01,GRL,Selangor,0,0,0
2023-03-01,GTM,Johor,6,3,3
2023-03-01,GTM,Kedah,0,0,0
2023-03-01,GTM,Pahang,0,0,0
2023-03-01,GTM,Perak,0,0,0
2023-03-01,GTM,Pulau Pinang,1,1,0
2023-03-01,GTM,Sabah,0,0,0
2023-03-01,GTM,Sarawak,0,0,0
2023-03-01,GTM,Selangor,25,13,12
2023-03-01,GTM,W.P. Labuan,0,0,0
2023-03-01,GUY,Johor,1,0,1
2023-03-01,GUY,Kedah,0,0,0
2023-03-01,GUY,Pulau Pinang,0,0,0
2023-03-01,GUY,Sarawak,0,0,0
2023-03-01,GUY,Selangor,5,3,2
2023-03-01,HKG,Johor,8,3,5
2023-03-01,HKG,Kedah,0,0,0
2023-03-01,HKG,Kelantan,0,0,0
2023-03-01,HKG,Pahang,0,0,0
2023-03-01,HKG,Perak,45,16,29
2023-03-01,HKG,Perlis,3,2,1
2023-03-01,HKG,Pulau Pinang,0,0,0
2023-03-01,HKG,Sabah,102,54,48
2023-03-01,HKG,Sarawak,0,0,0
2023-03-01,HKG,Selangor,5,4,1
2023-03-01,HKG,Terengganu,0,0,0
2023-03-01,HMD,Johor,0,0,0
2023-03-01,HND,Johor,2,1,1
2023-03-01,HND,Kedah,0,0,0
2023-03-01,HND,Perak,0,0,0
2023-03-01,HND,Pulau Pinang,0,0,0
2023-03-01,HND,Sabah,2,0,2
2023-03-01,HND,Sarawak,0,0,0
2023-03-01,HND,Selangor,10,2,8
2023-03-01,HRV,Johor,57,45,12
2023-03-01,HRV,Kedah,6,5,1
2023-03-01,HRV,Kelantan,0,0,0
2023-03-01,HRV,Melaka,0,0,0
2023-03-01,HRV,Pahang,0,0,0
2023-03-01,HRV,Perak,0,0,0
2023-03-01,HRV,Perlis,1,1,0
2023-03-01,HRV,Pulau Pinang,9,4,5
2023-03-01,HRV,Sabah,1,0,1
2023-03-01,HRV,Sarawak,4,2,2
2023-03-01,HRV,Selangor,139,104,35
2023-03-01,HTI,Johor,1,1,0
2023-03-01,HTI,Kedah,0,0,0
2023-03-01,HTI,Kelantan,0,0,0
2023-03-01,HTI,Perak,0,0,0
2023-03-01,HTI,Pulau Pinang,0,0,0
2023-03-01,HTI,Sabah,0,0,0
2023-03-01,HTI,Selangor,3,2,1
2023-03-01,HUN,Johor,101,57,44
2023-03-01,HUN,Kedah,44,23,21
2023-03-01,HUN,Kelantan,0,0,0
2023-03-01,HUN,Pahang,0,0,0
2023-03-01,HUN,Perak,4,3,1
2023-03-01,HUN,Perlis,5,3,2
2023-03-01,HUN,Pulau Pinang,27,17,10
2023-03-01,HUN,Sabah,11,6,5
2023-03-01,HUN,Sarawak,19,8,11
2023-03-01,HUN,Selangor,481,274,207
2023-03-01,HUN,W.P. Labuan,0,0,0
2023-03-01,IDN,Johor,97877,52135,45742
2023-03-01,IDN,Kedah,3817,1458,2359
2023-03-01,IDN,Kelantan,141,91,50
2023-03-01,IDN,Melaka,4491,2035,2456
2023-03-01,IDN,Negeri Sembilan,8443,5513,2930
2023-03-01,IDN,Pahang,4,0,4
2023-03-01,IDN,Perak,181,61,120
2023-03-01,IDN,Perlis,440,173,267
2023-03-01,IDN,Pulau Pinang,32495,13104,19391
2023-03-01,IDN,Sabah,4963,2455,2508
2023-03-01,IDN,Sarawak,34456,18391,16065
2023-03-01,IDN,Selangor,88888,43351,45537
2023-03-01,IDN,Terengganu,3,3,0
2023-03-01,IDN,W.P. Labuan,54,39,15
2023-03-01,IND,Johor,18870,12982,5888
2023-03-01,IND,Kedah,879,496,383
2023-03-01,IND,Kelantan,3,3,0
2023-03-01,IND,Melaka,3,3,0
2023-03-01,IND,Negeri Sembilan,0,0,0
2023-03-01,IND,Pahang,3,3,0
2023-03-01,IND,Perak,516,429,87
2023-03-01,IND,Perlis,32,26,6
2023-03-01,IND,Pulau Pinang,723,523,200
2023-03-01,IND,Sabah,243,174,69
2023-03-01,IND,Sarawak,1147,924,223
2023-03-01,IND,Selangor,39734,29937,9797
2023-03-01,IND,Terengganu,0,0,0
2023-03-01,IND,W.P. Labuan,35,33,2
2023-03-01,IOT,Pulau Pinang,0,0,0
2023-03-01,IOT,Selangor,0,0,0
2023-03-01,IRL,Johor,271,185,86
2023-03-01,IRL,Kedah,97,51,46
2023-03-01,IRL,Kelantan,3,3,0
2023-03-01,IRL,Negeri Sembilan,0,0,0
2023-03-01,IRL,Pahang,0,0,0
2023-03-01,IRL,Perak,4,2,2
2023-03-01,IRL,Perlis,16,11,5
2023-03-01,IRL,Pulau Pinang,98,55,43
2023-03-01,IRL,Sabah,30,15,15
2023-03-01,IRL,Sarawak,60,27,33
2023-03-01,IRL,Selangor,1164,661,503
2023-03-01,IRL,Terengganu,0,0,0
2023-03-01,IRL,W.P. Labuan,3,1,2
2023-03-01,IRN,Johor,266,146,120
2023-03-01,IRN,Kedah,12,6,6
2023-03-01,IRN,Kelantan,0,0,0
2023-03-01,IRN,Perak,0,0,0
2023-03-01,IRN,Perlis,7,5,2
2023-03-01,IRN,Pulau Pinang,15,10,5
2023-03-01,IRN,Sabah,1,0,1
2023-03-01,IRN,Sarawak,18,11,7
2023-03-01,IRN,Selangor,2780,1416,1364
2023-03-01,IRN,W.P. Labuan,0,0,0
2023-03-01,IRQ,Johor,20,17,3
2023-03-01,IRQ,Kedah,1,1,0
2023-03-01,IRQ,Kelantan,0,0,0
2023-03-01,IRQ,Melaka,0,0,0
2023-03-01,IRQ,Pahang,0,0,0
2023-03-01,IRQ,Perak,0,0,0
2023-03-01,IRQ,Perlis,1,1,0
2023-03-01,IRQ,Pulau Pinang,0,0,0
2023-03-01,IRQ,Sabah,0,0,0
2023-03-01,IRQ,Sarawak,1,1,0
2023-03-01,IRQ,Selangor,733,540,193
2023-03-01,ISL,Johor,4,3,1
2023-03-01,ISL,Kedah,4,2,2
2023-03-01,ISL,Kelantan,0,0,0
2023-03-01,ISL,Perak,0,0,0
2023-03-01,ISL,Perlis,0,0,0
2023-03-01,ISL,Pulau Pinang,0,0,0
2023-03-01,ISL,Sabah,0,0,0
2023-03-01,ISL,Sarawak,0,0,0
2023-03-01,ISL,Selangor,48,25,23
2023-03-01,ISL,W.P. Labuan,0,0,0
2023-03-01,ISR,Pulau Pinang,0,0,0
2023-03-01,ITA,Johor,591,428,163
2023-03-01,ITA,Kedah,411,218,193
2023-03-01,ITA,Kelantan,5,5,0
2023-03-01,ITA,Melaka,0,0,0
2023-03-01,ITA,Negeri Sembilan,0,0,0
2023-03-01,ITA,Pahang,0,0,0
2023-03-01,ITA,Perak,3,2,1
2023-03-01,ITA,Perlis,42,30,12
2023-03-01,ITA,Pulau Pinang,143,109,34
2023-03-01,ITA,Sabah,34,22,12
2023-03-01,ITA,Sarawak,73,45,28
2023-03-01,ITA,Selangor,2623,1720,903
2023-03-01,ITA,W.P. Labuan,1,1,0
2023-03-01,JAM,Johor,5,0,5
2023-03-01,JAM,Kedah,1,0,1
2023-03-01,JAM,Perak,0,0,0
2023-03-01,JAM,Pulau Pinang,1,1,0
2023-03-01,JAM,Sabah,0,0,0
2023-03-01,JAM,Sarawak,0,0,0
2023-03-01,JAM,Selangor,17,7,10
2023-03-01,JAM,W.P. Labuan,0,0,0
2023-03-01,JOR,Johor,13,9,4
2023-03-01,JOR,Kedah,8,3,5
2023-03-01,JOR,Kelantan,1,1,0
2023-03-01,JOR,Melaka,0,0,0
2023-03-01,JOR,Perlis,1,1,0
2023-03-01,JOR,Pulau Pinang,5,4,1
2023-03-01,JOR,Sabah,0,0,0
2023-03-01,JOR,Sarawak,0,0,0
2023-03-01,JOR,Selangor,558,373,185
2023-03-01,JOR,W.P. Labuan,0,0,0
2023-03-01,JPN,Johor,5620,3761,1859
2023-03-01,JPN,Kedah,282,131,151
2023-03-01,JPN,Kelantan,10,7,3
2023-03-01,JPN,Melaka,3,3,0
2023-03-01,JPN,Negeri Sembilan,0,0,0
2023-03-01,JPN,Pahang,2,1,1
2023-03-01,JPN,Perak,43,24,19
2023-03-01,JPN,Perlis,122,93,29
2023-03-01,JPN,Pulau Pinang,1021,724,297
2023-03-01,JPN,Sabah,525,250,275
2023-03-01,JPN,Sarawak,230,141,89
2023-03-01,JPN,Selangor,17959,11204,6755
2023-03-01,JPN,W.P. Labuan,17,7,10
2023-03-01,KAZ,Johor,62,29,33
2023-03-01,KAZ,Kedah,19,9,10
2023-03-01,KAZ,Kelantan,4,0,4
2023-03-01,KAZ,Melaka,0,0,0
2023-03-01,KAZ,Perak,0,0,0
2023-03-01,KAZ,Perlis,3,2,1
2023-03-01,KAZ,Pulau Pinang,6,2,4
2023-03-01,KAZ,Sabah,4,0,4
2023-03-01,KAZ,Sarawak,3,1,2
2023-03-01,KAZ,Selangor,719,310,409
2023-03-01,KAZ,W.P. Labuan,0,0,0
2023-03-01,KEN,Johor,253,108,145
2023-03-01,KEN,Kedah,1,1,0
2023-03-01,KEN,Kelantan,0,0,0
2023-03-01,KEN,Perak,0,0,0
2023-03-01,KEN,Perlis,0,0,0
2023-03-01,KEN,Pulau Pinang,1,0,1
2023-03-01,KEN,Sabah,1,1,0
2023-03-01,KEN,Sarawak,6,4,2
2023-03-01,KEN,Selangor,292,171,121
2023-03-01,KGZ,Johor,17,10,7
2023-03-01,KGZ,Kedah,2,1,1
2023-03-01,KGZ,Kelantan,1,0,1
2023-03-01,KGZ,Perak,0,0,0
2023-03-01,KGZ,Perlis,0,0,0
2023-03-01,KGZ,Pulau Pinang,1,1,0
2023-03-01,KGZ,Sabah,0,0,0
2023-03-01,KGZ,Sarawak,0,0,0
2023-03-01,KGZ,Selangor,189,85,104
2023-03-01,KHM,Johor,2081,846,1235
2023-03-01,KHM,Kedah,172,108,64
2023-03-01,KHM,Kelantan,832,510,322
2023-03-01,KHM,Melaka,0,0,0
2023-03-01,KHM,Negeri Sembilan,0,0,0
2023-03-01,KHM,Pahang,0,0,0
2023-03-01,KHM,Perak,6,2,4
2023-03-01,KHM,Perlis,679,401,278
2023-03-01,KHM,Pulau Pinang,46,23,23
2023-03-01,KHM,Sabah,5,3,2
2023-03-01,KHM,Sarawak,6,2,4
2023-03-01,KHM,Selangor,3951,1790,2161
2023-03-01,KHM,W.P. Labuan,0,0,0
2023-03-01,KIR,Johor,3,3,0
2023-03-01,KIR,Sabah,0,0,0
2023-03-01,KIR,Selangor,2,2,0
2023-03-01,KNA,Johor,28,18,10
2023-03-01,KNA,Kedah,0,0,0
2023-03-01,KNA,Perlis,0,0,0
2023-03-01,KNA,Pulau Pinang,0,0,0
2023-03-01,KNA,Sabah,1,0,1
2023-03-01,KNA,Selangor,49,39,10
2023-03-01,KNA,W.P. Labuan,0,0,0
2023-03-01,KOR,Johor,8421,4565,3856
2023-03-01,KOR,Kedah,258,134,124
2023-03-01,KOR,Kelantan,2,2,0
2023-03-01,KOR,Melaka,0,0,0
2023-03-01,KOR,Negeri Sembilan,0,0,0
2023-03-01,KOR,Pahang,2,1,1
2023-03-01,KOR,Perak,18,9,9
2023-03-01,KOR,Perlis,87,58,29
2023-03-01,KOR,Pulau Pinang,426,255,171
2023-03-01,KOR,Sabah,16116,6347,9769
2023-03-01,KOR,Sarawak,246,137,109
2023-03-01,KOR,Selangor,9891,5724,4167
2023-03-01,KOR,Terengganu,0,0,0
2023-03-01,KOR,W.P. Labuan,13,11,2
2023-03-01,KWT,Johor,7,6,1
2023-03-01,KWT,Kedah,3,1,2
2023-03-01,KWT,Kelantan,2,1,1
2023-03-01,KWT,Perak,0,0,0
2023-03-01,KWT,Perlis,0,0,0
2023-03-01,KWT,Pulau Pinang,1,1,0
2023-03-01,KWT,Sabah,0,0,0
2023-03-01,KWT,Sarawak,0,0,0
2023-03-01,KWT,Selangor,213,139,74
2023-03-01,KWT,W.P. Labuan,0,0,0
2023-03-01,LAO,Johor,158,39,119
2023-03-01,LAO,Kedah,1144,122,1022
2023-03-01,LAO,Kelantan,346,170,176
2023-03-01,LAO,Melaka,0,0,0
2023-03-01,LAO,Perak,12,3,9
2023-03-01,LAO,Perlis,220,83,137
2023-03-01,LAO,Pulau Pinang,18,4,14
2023-03-01,LAO,Sabah,9,5,4
2023-03-01,LAO,Sarawak,15,6,9
2023-03-01,LAO,Selangor,216,66,150
2023-03-01,LAO,W.P. Labuan,0,0,0
2023-03-01,LBN,Johor,9,8,1
2023-03-01,LBN,Kedah,6,5,1
2023-03-01,LBN,Kelantan,0,0,0
2023-03-01,LBN,Pahang,0,0,0
2023-03-01,LBN,Perak,0,0,0
2023-03-01,LBN,Perlis,0,0,0
2023-03-01,LBN,Pulau Pinang,4,3,1
2023-03-01,LBN,Sabah,3,2,1
2023-03-01,LBN,Sarawak,1,1,0
2023-03-01,LBN,Selangor,201,134,67
2023-03-01,LBN,W.P. Labuan,0,0,0
2023-03-01,LBR,Johor,2,2,0
2023-03-01,LBR,Kedah,0,0,0
2023-03-01,LBR,Sabah,0,0,0
2023-03-01,LBR,Sarawak,0,0,0
2023-03-01,LBR,Selangor,6,5,1
2023-03-01,LBY,Johor,2,2,0
2023-03-01,LBY,Kedah,0,0,0
2023-03-01,LBY,Perlis,0,0,0
2023-03-01,LBY,Pulau Pinang,1,1,0
2023-03-01,LBY,Sabah,0,0,0
2023-03-01,LBY,Sarawak,3,3,0
2023-03-01,LBY,Selangor,228,172,56
2023-03-01,LCA,Johor,5,5,0
2023-03-01,LCA,Kedah,0,0,0
2023-03-01,LCA,Pulau Pinang,0,0,0
2023-03-01,LCA,Sarawak,0,0,0
2023-03-01,LCA,Selangor,11,9,2
2023-03-01,LIE,Johor,1,1,0
2023-03-01,LIE,Kedah,0,0,0
2023-03-01,LIE,Perlis,0,0,0
2023-03-01,LIE,Pulau Pinang,0,0,0
2023-03-01,LIE,Sabah,0,0,0
2023-03-01,LIE,Sarawak,0,0,0
2023-03-01,LIE,Selangor,3,2,1
2023-03-01,LKA,Johor,1159,775,384
2023-03-01,LKA,Kedah,43,22,21
2023-03-01,LKA,Kelantan,0,0,0
2023-03-01,LKA,Melaka,0,0,0
2023-03-01,LKA,Pahang,0,0,0
2023-03-01,LKA,Perak,0,0,0
2023-03-01,LKA,Perlis,1,1,0
2023-03-01,LKA,Pulau Pinang,26,16,10
2023-03-01,LKA,Sabah,13,8,5
2023-03-01,LKA,Sarawak,26,14,12
2023-03-01,LKA,Selangor,3231,2243,988
2023-03-01,LKA,W.P. Labuan,0,0,0
2023-03-01,LSO,Johor,1,1,0
2023-03-01,LSO,Kedah,0,0,0
2023-03-01,LSO,Pulau Pinang,0,0,0
2023-03-01,LSO,Sarawak,0,0,0
2023-03-01,LSO,Selangor,4,1,3
2023-03-01,LTU,Johor,119,46,73
2023-03-01,LTU,Kedah,39,13,26
2023-03-01,LTU,Kelantan,0,0,0
2023-03-01,LTU,Pahang,0,0,0
2023-03-01,LTU,Perak,1,0,1
2023-03-01,LTU,Perlis,7,5,2
2023-03-01,LTU,Pulau Pinang,7,2,5
2023-03-01,LTU,Sabah,6,3,3
2023-03-01,LTU,Sarawak,42,15,27
2023-03-01,LTU,Selangor,447,206,241
2023-03-01,LTU,W.P. Labuan,0,0,0
2023-03-01,LUX,Johor,6,6,0
2023-03-01,LUX,Kedah,9,5,4
2023-03-01,LUX,Kelantan,0,0,0
2023-03-01,LUX,Perak,0,0,0
2023-03-01,LUX,Perlis,1,0,1
2023-03-01,LUX,Pulau Pinang,1,0,1
2023-03-01,LUX,Sabah,0,0,0
2023-03-01,LUX,Sarawak,0,0,0
2023-03-01,LUX,Selangor,54,33,21
2023-03-01,LVA,Johor,55,23,32
2023-03-01,LVA,Kedah,18,8,10
2023-03-01,LVA,Kelantan,0,0,0
2023-03-01,LVA,Pahang,2,2,0
2023-03-01,LVA,Perak,0,0,0
2023-03-01,LVA,Perlis,4,2,2
2023-03-01,LVA,Pulau Pinang,1,1,0
2023-03-01,LVA,Sabah,9,2,7
2023-03-01,LVA,Sarawak,61,21,40
2023-03-01,LVA,Selangor,335,155,180
2023-03-01,LVA,W.P. Labuan,0,0,0
2023-03-01,MAC,Johor,0,0,0
2023-03-01,MAC,Pahang,1,0,1
2023-03-01,MAC,Perak,2,1,1
2023-03-01,MAC,Selangor,0,0,0
2023-03-01,MAC,W.P. Labuan,0,0,0
2023-03-01,MAR,Johor,68,47,21
2023-03-01,MAR,Kedah,3,2,1
2023-03-01,MAR,Kelantan,0,0,0
2023-03-01,MAR,Melaka,0,0,0
2023-03-01,MAR,Pahang,0,0,0
2023-03-01,MAR,Perak,0,0,0
2023-03-01,MAR,Perlis,3,3,0
2023-03-01,MAR,Pulau Pinang,19,16,3
2023-03-01,MAR,Sabah,5,3,2
2023-03-01,MAR,Sarawak,12,9,3
2023-03-01,MAR,Selangor,522,298,224
2023-03-01,MAR,W.P. Labuan,0,0,0
2023-03-01,MCO,Johor,0,0,0
2023-03-01,MCO,Kedah,0,0,0
2023-03-01,MCO,Sabah,0,0,0
2023-03-01,MCO,Selangor,1,1,0
2023-03-01,MDA,Johor,0,0,0
2023-03-01,MDA,Kedah,0,0,0
2023-03-01,MDA,Kelantan,0,0,0
2023-03-01,MDA,Negeri Sembilan,1,1,0
2023-03-01,MDA,Perlis,0,0,0
2023-03-01,MDA,Pulau Pinang,1,0,1
2023-03-01,MDA,Sabah,0,0,0
2023-03-01,MDA,Sarawak,0,0,0
2023-03-01,MDA,Selangor,35,21,14
2023-03-01,MDG,Johor,24,6,18
2023-03-01,MDG,Kedah,3,2,1
2023-03-01,MDG,Perak,0,0,0
2023-03-01,MDG,Perlis,0,0,0
2023-03-01,MDG,Pulau Pinang,2,1,1
2023-03-01,MDG,Sabah,0,0,0
2023-03-01,MDG,Sarawak,0,0,0
2023-03-01,MDG,Selangor,75,26,49
2023-03-01,MDV,Johor,76,52,24
2023-03-01,MDV,Kedah,1,1,0
2023-03-01,MDV,Kelantan,0,0,0
2023-03-01,MDV,Perak,1,1,0
2023-03-01,MDV,Perlis,0,0,0
2023-03-01,MDV,Pulau Pinang,5,3,2
2023-03-01,MDV,Sabah,1,1,0
2023-03-01,MDV,Sarawak,0,0,0
2023-03-01,MDV,Selangor,1804,1037,767
2023-03-01,MEX,Johor,124,58,66
2023-03-01,MEX,Kedah,19,5,14
2023-03-01,MEX,Kelantan,0,0,0
2023-03-01,MEX,Pahang,0,0,0
2023-03-01,MEX,Perak,1,1,0
2023-03-01,MEX,Perlis,4,2,2
2023-03-01,MEX,Pulau Pinang,20,16,4
2023-03-01,MEX,Sabah,6,3,3
2023-03-01,MEX,Sarawak,12,5,7
2023-03-01,MEX,Selangor,486,262,224
2023-03-01,MEX,W.P. Labuan,0,0,0
2023-03-01,MHL,Johor,0,0,0
2023-03-01,MHL,Kedah,0,0,0
2023-03-01,MHL,Perak,0,0,0
2023-03-01,MHL,Pulau Pinang,0,0,0
2023-03-01,MHL,Sabah,1,1,0
2023-03-01,MHL,Selangor,3,3,0
2023-03-01,MKD,Johor,4,1,3
2023-03-01,MKD,Kedah,0,0,0
2023-03-01,MKD,Perak,0,0,0
2023-03-01,MKD,Pulau Pinang,1,1,0
2023-03-01,MKD,Sabah,1,0,1
2023-03-01,MKD,Sarawak,1,0,1
2023-03-01,MKD,Selangor,54,31,23
2023-03-01,MLI,Johor,1,1,0
2023-03-01,MLI,Sabah,0,0,0
2023-03-01,MLI,Selangor,6,5,1
2023-03-01,MLT,Johor,6,2,4
2023-03-01,MLT,Kedah,7,6,1
2023-03-01,MLT,Kelantan,0,0,0
2023-03-01,MLT,Perak,0,0,0
2023-03-01,MLT,Perlis,2,2,0
2023-03-01,MLT,Pulau Pinang,4,1,3
2023-03-01,MLT,Sabah,0,0,0
2023-03-01,MLT,Sarawak,4,3,1
2023-03-01,MLT,Selangor,44,30,14
2023-03-01,MLT,W.P. Labuan,0,0,0
2023-03-01,MMR,Johor,4218,1186,3032
2023-03-01,MMR,Kedah,66,19,47
2023-03-01,MMR,Kelantan,1,0,1
2023-03-01,MMR,Negeri Sembilan,0,0,0
2023-03-01,MMR,Pahang,2,0,2
2023-03-01,MMR,Perak,16,3,13
2023-03-01,MMR,Perlis,5,0,5
2023-03-01,MMR,Pulau Pinang,176,104,72
2023-03-01,MMR,Sabah,17,5,12
2023-03-01,MMR,Sarawak,75,36,39
2023-03-01,MMR,Selangor,7170,5120,2050
2023-03-01,MMR,Terengganu,0,0,0
2023-03-01,MMR,W.P. Labuan,2,1,1
2023-03-01,MNE,Johor,3,3,0
2023-03-01,MNE,Kedah,0,0,0
2023-03-01,MNE,Pulau Pinang,0,0,0
2023-03-01,MNE,Sabah,0,0,0
2023-03-01,MNE,Sarawak,0,0,0
2023-03-01,MNE,Selangor,10,10,0
2023-03-01,MNG,Johor,172,66,106
2023-03-01,MNG,Kedah,4,2,2
2023-03-01,MNG,Kelantan,0,0,0
2023-03-01,MNG,Perak,0,0,0
2023-03-01,MNG,Perlis,12,5,7
2023-03-01,MNG,Pulau Pinang,8,2,6
2023-03-01,MNG,Sabah,3,0,3
2023-03-01,MNG,Sarawak,1,1,0
2023-03-01,MNG,Selangor,291,117,174
2023-03-01,MNP,Selangor,1,0,1
2023-03-01,MOZ,Johor,0,0,0
2023-03-01,MOZ,Kedah,0,0,0
2023-03-01,MOZ,Perak,0,0,0
2023-03-01,MOZ,Pulau Pinang,0,0,0
2023-03-01,MOZ,Sabah,0,0,0
2023-03-01,MOZ,Sarawak,0,0,0
2023-03-01,MOZ,Selangor,14,5,9
2023-03-01,MRT,Johor,0,0,0
2023-03-01,MRT,Kedah,1,1,0
2023-03-01,MRT,Pulau Pinang,0,0,0
2023-03-01,MRT,Sabah,0,0,0
2023-03-01,MRT,Sarawak,0,0,0
2023-03-01,MRT,Selangor,22,20,2
2023-03-01,MUS,Johor,215,106,109
2023-03-01,MUS,Kedah,5,4,1
2023-03-01,MUS,Kelantan,0,0,0
2023-03-01,MUS,Pahang,0,0,0
2023-03-01,MUS,Perak,3,2,1
2023-03-01,MUS,Perlis,1,1,0
2023-03-01,MUS,Pulau Pinang,4,3,1
2023-03-01,MUS,Sabah,2,1,1
2023-03-01,MUS,Sarawak,1,1,0
2023-03-01,MUS,Selangor,1753,915,838
2023-03-01,MWI,Johor,3,2,1
2023-03-01,MWI,Pulau Pinang,0,0,0
2023-03-01,MWI,Sabah,0,0,0
2023-03-01,MWI,Sarawak,0,0,0
2023-03-01,MWI,Selangor,21,9,12
2023-03-01,MYT,Selangor,0,0,0
2023-03-01,NAM,Johor,1,1,0
2023-03-01,NAM,Kedah,0,0,0
2023-03-01,NAM,Perak,0,0,0
2023-03-01,NAM,Perlis,0,0,0
2023-03-01,NAM,Pulau Pinang,0,0,0
2023-03-01,NAM,Sabah,0,0,0
2023-03-01,NAM,Sarawak,0,0,0
2023-03-01,NAM,Selangor,14,6,8
2023-03-01,NCL,Selangor,0,0,0
2023-03-01,NER,Johor,0,0,0
2023-03-01,NER,Sabah,0,0,0
2023-03-01,NER,Selangor,1,1,0
2023-03-01,NGA,Johor,20,18,2
2023-03-01,NGA,Kedah,2,0,2
2023-03-01,NGA,Perlis,0,0,0
2023-03-01,NGA,Pulau Pinang,3,3,0
2023-03-01,NGA,Sabah,0,0,0
2023-03-01,NGA,Sarawak,6,3,3
2023-03-01,NGA,Selangor,466,371,95
2023-03-01,NIC,Johor,0,0,0
2023-03-01,NIC,Kedah,0,0,0
2023-03-01,NIC,Pulau Pinang,0,0,0
2023-03-01,NIC,Sabah,0,0,0
2023-03-01,NIC,Selangor,2,1,1
2023-03-01,NLD,Johor,1034,683,351
2023-03-01,NLD,Kedah,496,231,265
2023-03-01,NLD,Kelantan,4,2,2
2023-03-01,NLD,Melaka,2,2,0
2023-03-01,NLD,Negeri Sembilan,0,0,0
2023-03-01,NLD,Pahang,0,0,0
2023-03-01,NLD,Perak,18,12,6
2023-03-01,NLD,Perlis,37,24,13
2023-03-01,NLD,Pulau Pinang,247,154,93
2023-03-01,NLD,Sabah,73,40,33
2023-03-01,NLD,Sarawak,163,102,61
2023-03-01,NLD,Selangor,3749,2253,1496
2023-03-01,NLD,Terengganu,0,0,0
2023-03-01,NLD,W.P. Labuan,3,2,1
2023-03-01,NOR,Johor,197,129,68
2023-03-01,NOR,Kedah,90,34,56
2023-03-01,NOR,Kelantan,2,1,1
2023-03-01,NOR,Melaka,0,0,0
2023-03-01,NOR,Pahang,0,0,0
2023-03-01,NOR,Perak,1,1,0
2023-03-01,NOR,Perlis,22,9,13
2023-03-01,NOR,Pulau Pinang,28,19,9
2023-03-01,NOR,Sabah,10,6,4
2023-03-01,NOR,Sarawak,18,13,5
2023-03-01,NOR,Selangor,773,465,308
2023-03-01,NOR,W.P. Labuan,0,0,0
2023-03-01,NPL,Johor,442,326,116
2023-03-01,NPL,Kedah,11,8,3
2023-03-01,NPL,Pahang,0,0,0
2023-03-01,NPL,Perak,0,0,0
2023-03-01,NPL,Perlis,0,0,0
2023-03-01,NPL,Pulau Pinang,30,30,0
2023-03-01,NPL,Sabah,7,6,1
2023-03-01,NPL,Sarawak,341,256,85
2023-03-01,NPL,Selangor,18301,17762,539
2023-03-01,NPL,W.P. Labuan,66,63,3
2023-03-01,NRU,Johor,0,0,0
2023-03-01,NRU,Pulau Pinang,0,0,0
2023-03-01,NRU,Selangor,0,0,0
2023-03-01,NZL,Johor,561,363,198
2023-03-01,NZL,Kedah,77,46,31
2023-03-01,NZL,Kelantan,5,2,3
2023-03-01,NZL,Melaka,0,0,0
2023-03-01,NZL,Negeri Sembilan,0,0,0
2023-03-01,NZL,Pahang,0,0,0
2023-03-01,NZL,Perak,18,8,10
2023-03-01,NZL,Perlis,20,12,8
2023-03-01,NZL,Pulau Pinang,141,77,64
2023-03-01,NZL,Sabah,55,28,27
2023-03-01,NZL,Sarawak,145,81,64
2023-03-01,NZL,Selangor,2177,1307,870
2023-03-01,NZL,Terengganu,2,2,0
2023-03-01,NZL,W.P. Labuan,4,3,1
2023-03-01,OMN,Johor,12,7,5
2023-03-01,OMN,Kedah,0,0,0
2023-03-01,OMN,Kelantan,0,0,0
2023-03-01,OMN,Melaka,0,0,0
2023-03-01,OMN,Perak,0,0,0
2023-03-01,OMN,Perlis,0,0,0
2023-03-01,OMN,Pulau Pinang,1,0,1
2023-03-01,OMN,Sabah,0,0,0
2023-03-01,OMN,Sarawak,5,2,3
2023-03-01,OMN,Selangor,458,300,158
2023-03-01,PAK,Johor,735,543,192
2023-03-01,PAK,Kedah,122,113,9
2023-03-01,PAK,Kelantan,11,11,0
2023-03-01,PAK,Melaka,0,0,0
2023-03-01,PAK,Negeri Sembilan,1,1,0
2023-03-01,PAK,Pahang,0,0,0
2023-03-01,PAK,Perak,28,26,2
2023-03-01,PAK,Perlis,34,31,3
2023-03-01,PAK,Pulau Pinang,67,63,4
2023-03-01,PAK,Sabah,14,8,6
2023-03-01,PAK,Sarawak,123,105,18
2023-03-01,PAK,Selangor,14252,13035,1217
2023-03-01,PAK,W.P. Labuan,2,2,0
2023-03-01,PAN,Johor,1,1,0
2023-03-01,PAN,Kedah,1,0,1
2023-03-01,PAN,Perak,0,0,0
2023-03-01,PAN,Perlis,1,1,0
2023-03-01,PAN,Pulau Pinang,1,1,0
2023-03-01,PAN,Sabah,0,0,0
2023-03-01,PAN,Sarawak,0,0,0
2023-03-01,PAN,Selangor,24,11,13
2023-03-01,PER,Johor,27,20,7
2023-03-01,PER,Kedah,9,4,5
2023-03-01,PER,Kelantan,0,0,0
2023-03-01,PER,Pahang,0,0,0
2023-03-01,PER,Perak,0,0,0
2023-03-01,PER,Perlis,1,1,0
2023-03-01,PER,Pulau Pinang,4,4,0
2023-03-01,PER,Sabah,3,1,2
2023-03-01,PER,Sarawak,1,0,1
2023-03-01,PER,Selangor,73,45,28
2023-03-01,PER,W.P. Labuan,0,0,0
2023-03-01,PHL,Johor,17453,5455,11998
2023-03-01,PHL,Kedah,509,164,345
2023-03-01,PHL,Kelantan,19,13,6
2023-03-01,PHL,Melaka,1,0,1
2023-03-01,PHL,Negeri Sembilan,0,0,0
2023-03-01,PHL,Pahang,10,10,0
2023-03-01,PHL,Perak,53,8,45
2023-03-01,PHL,Perlis,62,21,41
2023-03-01,PHL,Pulau Pinang,523,207,316
2023-03-01,PHL,Sabah,1589,732,857
2023-03-01,PHL,Sarawak,2289,893,1396
2023-03-01,PHL,Selangor,14815,5807,9008
2023-03-01,PHL,Terengganu,1,1,0
2023-03-01,PHL,W.P. Labuan,104,37,67
2023-03-01,PLW,Johor,0,0,0
2023-03-01,PLW,Pulau Pinang,1,1,0
2023-03-01,PLW,Selangor,0,0,0
2023-03-01,PNG,Johor,16,6,10
2023-03-01,PNG,Kedah,0,0,0
2023-03-01,PNG,Kelantan,0,0,0
2023-03-01,PNG,Perak,0,0,0
2023-03-01,PNG,Pulau Pinang,0,0,0
2023-03-01,PNG,Sabah,1,1,0
2023-03-01,PNG,Sarawak,7,5,2
2023-03-01,PNG,Selangor,81,45,36
2023-03-01,POL,Johor,513,255,258
2023-03-01,POL,Kedah,248,124,124
2023-03-01,POL,Kelantan,2,0,2
2023-03-01,POL,Melaka,0,0,0
2023-03-01,POL,Negeri Sembilan,0,0,0
2023-03-01,POL,Pahang,0,0,0
2023-03-01,POL,Perak,4,1,3
2023-03-01,POL,Perlis,31,21,10
2023-03-01,POL,Pulau Pinang,71,36,35
2023-03-01,POL,Sabah,64,39,25
2023-03-01,POL,Sarawak,56,26,30
2023-03-01,POL,Selangor,1379,734,645
2023-03-01,POL,Terengganu,0,0,0
2023-03-01,POL,W.P. Labuan,1,1,0
2023-03-01,PRK,Selangor,0,0,0
2023-03-01,PRT,Johor,144,83,61
2023-03-01,PRT,Kedah,80,38,42
2023-03-01,PRT,Kelantan,0,0,0
2023-03-01,PRT,Melaka,0,0,0
2023-03-01,PRT,Pahang,0,0,0
2023-03-01,PRT,Perak,3,2,1
2023-03-01,PRT,Perlis,12,7,5
2023-03-01,PRT,Pulau Pinang,47,21,26
2023-03-01,PRT,Sabah,12,8,4
2023-03-01,PRT,Sarawak,11,7,4
2023-03-01,PRT,Selangor,580,346,234
2023-03-01,PRT,W.P. Labuan,0,0,0
2023-03-01,PRY,Johor,3,0,3
2023-03-01,PRY,Kedah,0,0,0
2023-03-01,PRY,Perak,0,0,0
2023-03-01,PRY,Perlis,0,0,0
2023-03-01,PRY,Pulau Pinang,0,0,0
2023-03-01,PRY,Sabah,0,0,0
2023-03-01,PRY,Sarawak,0,0,0
2023-03-01,PRY,Selangor,11,5,6
2023-03-01,PSE,Johor,27,26,1
2023-03-01,PSE,Kedah,0,0,0
2023-03-01,PSE,Kelantan,0,0,0
2023-03-01,PSE,Melaka,0,0,0
2023-03-01,PSE,Perak,0,0,0
2023-03-01,PSE,Perlis,0,0,0
2023-03-01,PSE,Pulau Pinang,0,0,0
2023-03-01,PSE,Sabah,0,0,0
2023-03-01,PSE,Sarawak,0,0,0
2023-03-01,PSE,Selangor,249,204,45
2023-03-01,QAT,Johor,4,3,1
2023-03-01,QAT,Kedah,1,1,0
2023-03-01,QAT,Perlis,0,0,0
2023-03-01,QAT,Pulau Pinang,0,0,0
2023-03-01,QAT,Sabah,0,0,0
2023-03-01,QAT,Sarawak,1,1,0
2023-03-01,QAT,Selangor,89,50,39
2023-03-01,REU,Johor,0,0,0
2023-03-01,REU,Sarawak,0,0,0
2023-03-01,ROU,Johor,158,86,72
2023-03-01,ROU,Kedah,28,12,16
2023-03-01,ROU,Kelantan,0,0,0
2023-03-01,ROU,Negeri Sembilan,0,0,0
2023-03-01,ROU,Pahang,0,0,0
2023-03-01,ROU,Perak,0,0,0
2023-03-01,ROU,Perlis,8,3,5
2023-03-01,ROU,Pulau Pinang,18,9,9
2023-03-01,ROU,Sabah,29,19,10
2023-03-01,ROU,Sarawak,14,13,1
2023-03-01,ROU,Selangor,647,344,303
2023-03-01,ROU,W.P. Labuan,0,0,0
2023-03-01,RUS,Johor,434,216,218
2023-03-01,RUS,Kedah,694,355,339
2023-03-01,RUS,Kelantan,70,36,34
2023-03-01,RUS,Melaka,0,0,0
2023-03-01,RUS,Negeri Sembilan,0,0,0
2023-03-01,RUS,Pahang,1,1,0
2023-03-01,RUS,Perak,3,1,2
2023-03-01,RUS,Perlis,489,279,210
2023-03-01,RUS,Pulau Pinang,221,111,110
2023-03-01,RUS,Sabah,54,23,31
2023-03-01,RUS,Sarawak,78,39,39
2023-03-01,RUS,Selangor,14201,7235,6966
2023-03-01,RUS,W.P. Labuan,2,1,1
2023-03-01,RWA,Johor,0,0,0
2023-03-01,RWA,Kedah,0,0,0
2023-03-01,RWA,Pulau Pinang,0,0,0
2023-03-01,RWA,Selangor,9,7,2
2023-03-01,SAU,Johor,105,65,40
2023-03-01,SAU,Kedah,24,12,12
2023-03-01,SAU,Kelantan,1,1,0
2023-03-01,SAU,Melaka,0,0,0
2023-03-01,SAU,Perak,0,0,0
2023-03-01,SAU,Perlis,3,3,0
2023-03-01,SAU,Pulau Pinang,22,10,12
2023-03-01,SAU,Sabah,1,1,0
2023-03-01,SAU,Sarawak,7,7,0
2023-03-01,SAU,Selangor,2328,1291,1037
2023-03-01,SAU,W.P. Labuan,0,0,0
2023-03-01,SDN,Johor,5,5,0
2023-03-01,SDN,Kedah,4,1,3
2023-03-01,SDN,Kelantan,0,0,0
2023-03-01,SDN,Perlis,2,2,0
2023-03-01,SDN,Pulau Pinang,1,1,0
2023-03-01,SDN,Sabah,0,0,0
2023-03-01,SDN,Sarawak,11,6,5
2023-03-01,SDN,Selangor,925,567,358
2023-03-01,SDN,W.P. Labuan,0,0,0
2023-03-01,SEN,Johor,3,0,3
2023-03-01,SEN,Kedah,0,0,0
2023-03-01,SEN,Kelantan,0,0,0
2023-03-01,SEN,Perak,0,0,0
2023-03-01,SEN,Perlis,0,0,0
2023-03-01,SEN,Pulau Pinang,0,0,0
2023-03-01,SEN,Sabah,0,0,0
2023-03-01,SEN,Sarawak,0,0,0
2023-03-01,SEN,Selangor,48,37,11
2023-03-01,SGP,Johor,1059355,604758,454597
2023-03-01,SGP,Kedah,3602,1985,1617
2023-03-01,SGP,Kelantan,76,56,20
2023-03-01,SGP,Melaka,18,11,7
2023-03-01,SGP,Negeri Sembilan,0,0,0
2023-03-01,SGP,Pahang,194,96,98
2023-03-01,SGP,Perak,6743,3165,3578
2023-03-01,SGP,Perlis,239,140,99
2023-03-01,SGP,Pulau Pinang,17485,8836,8649
2023-03-01,SGP,Sabah,3829,1942,1887
2023-03-01,SGP,Sarawak,5212,2778,2434
2023-03-01,SGP,Selangor,43708,23088,20620
2023-03-01,SGP,Terengganu,2,2,0
2023-03-01,SGP,W.P. Labuan,10,10,0
2023-03-01,SGS,Johor,0,0,0
2023-03-01,SGS,Sabah,0,0,0
2023-03-01,SGS,Selangor,0,0,0
2023-03-01,SHN,Sarawak,0,0,0
2023-03-01,SLB,Johor,0,0,0
2023-03-01,SLB,Perlis,0,0,0
2023-03-01,SLB,Pulau Pinang,0,0,0
2023-03-01,SLB,Sabah,0,0,0
2023-03-01,SLB,Sarawak,4,1,3
2023-03-01,SLB,Selangor,5,2,3
2023-03-01,SLB,W.P. Labuan,0,0,0
2023-03-01,SLE,Johor,3,3,0
2023-03-01,SLE,Kedah,0,0,0
2023-03-01,SLE,Perak,0,0,0
2023-03-01,SLE,Pulau Pinang,0,0,0
2023-03-01,SLE,Sabah,0,0,0
2023-03-01,SLE,Selangor,23,17,6
2023-03-01,SLV,Johor,4,1,3
2023-03-01,SLV,Kedah,0,0,0
2023-03-01,SLV,Perak,0,0,0
2023-03-01,SLV,Perlis,1,1,0
2023-03-01,SLV,Pulau Pinang,1,1,0
2023-03-01,SLV,Sabah,2,2,0
2023-03-01,SLV,Selangor,10,6,4
2023-03-01,SLV,W.P. Labuan,0,0,0
2023-03-01,SMR,Johor,0,0,0
2023-03-01,SMR,Selangor,1,1,0
2023-03-01,SOM,Johor,0,0,0
2023-03-01,SOM,Kedah,0,0,0
2023-03-01,SOM,Kelantan,1,0,1
2023-03-01,SOM,Perlis,0,0,0
2023-03-01,SOM,Sabah,0,0,0
2023-03-01,SOM,Sarawak,0,0,0
2023-03-01,SOM,Selangor,250,163,87
2023-03-01,SRB,Johor,16,12,4
2023-03-01,SRB,Kedah,12,8,4
2023-03-01,SRB,Kelantan,0,0,0
2023-03-01,SRB,Pahang,0,0,0
2023-03-01,SRB,Perak,0,0,0
2023-03-01,SRB,Perlis,0,0,0
2023-03-01,SRB,Pulau Pinang,1,0,1
2023-03-01,SRB,Sabah,0,0,0
2023-03-01,SRB,Sarawak,1,0,1
2023-03-01,SRB,Selangor,56,35,21
2023-03-01,SSD,Johor,1,1,0
2023-03-01,SSD,Kedah,0,0,0
2023-03-01,SSD,Sarawak,2,2,0
2023-03-01,SSD,Selangor,36,18,18
2023-03-01,SSD,W.P. Labuan,0,0,0
2023-03-01,STP,Selangor,2,1,1
2023-03-01,SUR,Johor,6,2,4
2023-03-01,SUR,Kedah,0,0,0
2023-03-01,SUR,Kelantan,0,0,0
2023-03-01,SUR,Perak,0,0,0
2023-03-01,SUR,Perlis,1,1,0
2023-03-01,SUR,Pulau Pinang,1,1,0
2023-03-01,SUR,Sabah,0,0,0
2023-03-01,SUR,Sarawak,0,0,0
2023-03-01,SUR,Selangor,8,6,2
2023-03-01,SVK,Johor,65,39,26
2023-03-01,SVK,Kedah,100,57,43
2023-03-01,SVK,Kelantan,3,2,1
2023-03-01,SVK,Negeri Sembilan,0,0,0
2023-03-01,SVK,Pahang,0,0,0
2023-03-01,SVK,Perak,1,1,0
2023-03-01,SVK,Perlis,9,8,1
2023-03-01,SVK,Pulau Pinang,10,7,3
2023-03-01,SVK,Sabah,10,3,7
2023-03-01,SVK,Sarawak,6,6,0
2023-03-01,SVK,Selangor,351,188,163
2023-03-01,SVK,W.P. Labuan,10,6,4
2023-03-01,SVN,Johor,20,10,10
2023-03-01,SVN,Kedah,21,12,9
2023-03-01,SVN,Kelantan,0,0,0
2023-03-01,SVN,Perak,0,0,0
2023-03-01,SVN,Perlis,2,2,0
2023-03-01,SVN,Pulau Pinang,9,2,7
2023-03-01,SVN,Sabah,3,1,2
2023-03-01,SVN,Sarawak,0,0,0
2023-03-01,SVN,Selangor,119,64,55
2023-03-01,SVN,W.P. Labuan,0,0,0
2023-03-01,SWE,Johor,249,139,110
2023-03-01,SWE,Kedah,348,154,194
2023-03-01,SWE,Kelantan,8,5,3
2023-03-01,SWE,Melaka,0,0,0
2023-03-01,SWE,Negeri Sembilan,0,0,0
2023-03-01,SWE,Pahang,0,0,0
2023-03-01,SWE,Perak,8,7,1
2023-03-01,SWE,Perlis,30,21,9
2023-03-01,SWE,Pulau Pinang,65,47,18
2023-03-01,SWE,Sabah,39,20,19
2023-03-01,SWE,Sarawak,23,18,5
2023-03-01,SWE,Selangor,1388,833,555
2023-03-01,SWE,W.P. Labuan,1,0,1
2023-03-01,SWZ,Johor,0,0,0
2023-03-01,SWZ,Kedah,0,0,0
2023-03-01,SWZ,Pulau Pinang,0,0,0
2023-03-01,SWZ,Sabah,0,0,0
2023-03-01,SWZ,Selangor,11,2,9
2023-03-01,SYC,Johor,3,2,1
2023-03-01,SYC,Kedah,0,0,0
2023-03-01,SYC,Pulau Pinang,0,0,0
2023-03-01,SYC,Sabah,0,0,0
2023-03-01,SYC,Sarawak,0,0,0
2023-03-01,SYC,Selangor,61,23,38
2023-03-01,SYR,Johor,9,6,3
2023-03-01,SYR,Kedah,0,0,0
2023-03-01,SYR,Kelantan,0,0,0
2023-03-01,SYR,Pahang,0,0,0
2023-03-01,SYR,Perlis,1,1,0
2023-03-01,SYR,Pulau Pinang,1,1,0
2023-03-01,SYR,Sabah,0,0,0
2023-03-01,SYR,Sarawak,2,2,0
2023-03-01,SYR,Selangor,561,405,156
2023-03-01,SYR,W.P. Labuan,0,0,0
2023-03-01,TCA,Perlis,0,0,0
2023-03-01,TCD,Johor,2,2,0
2023-03-01,TCD,Kedah,2,2,0
2023-03-01,TCD,Perlis,1,1,0
2023-03-01,TCD,Selangor,27,17,10
2023-03-01,TGO,Johor,2,2,0
2023-03-01,TGO,Perak,0,0,0
2023-03-01,TGO,Pulau Pinang,0,0,0
2023-03-01,TGO,Selangor,8,8,0
2023-03-01,THA,Johor,7143,2179,4964
2023-03-01,THA,Kedah,78894,46381,32513
2023-03-01,THA,Kelantan,56877,28776,28101
2023-03-01,THA,Melaka,35,24,11
2023-03-01,THA,Negeri Sembilan,1,1,0
2023-03-01,THA,Pahang,2,1,1
2023-03-01,THA,Perak,12610,5880,6730
2023-03-01,THA,Perlis,65383,39899,25484
2023-03-01,THA,Pulau Pinang,2231,925,1306
2023-03-01,THA,Sabah,216,82,134
2023-03-01,THA,Sarawak,389,144,245
2023-03-01,THA,Selangor,13308,5196,8112
2023-03-01,THA,Terengganu,2,2,0
2023-03-01,THA,W.P. Labuan,2,2,0
2023-03-01,TJK,Johor,1,1,0
2023-03-01,TJK,Kedah,0,0,0
2023-03-01,TJK,Perlis,0,0,0
2023-03-01,TJK,Pulau Pinang,0,0,0
2023-03-01,TJK,Sabah,0,0,0
2023-03-01,TJK,Selangor,105,65,40
2023-03-01,TKL,Selangor,0,0,0
2023-03-01,TKM,Johor,0,0,0
2023-03-01,TKM,Kedah,2,1,1
2023-03-01,TKM,Kelantan,0,0,0
2023-03-01,TKM,Perlis,0,0,0
2023-03-01,TKM,Pulau Pinang,0,0,0
2023-03-01,TKM,Sabah,0,0,0
2023-03-01,TKM,Sarawak,2,2,0
2023-03-01,TKM,Selangor,109,78,31
2023-03-01,TLS,Johor,6,6,0
2023-03-01,TLS,Kedah,0,0,0
2023-03-01,TLS,Perlis,0,0,0
2023-03-01,TLS,Pulau Pinang,7,2,5
2023-03-01,TLS,Sabah,0,0,0
2023-03-01,TLS,Sarawak,0,0,0
2023-03-01,TLS,Selangor,190,113,77
2023-03-01,TON,Johor,0,0,0
2023-03-01,TON,Pulau Pinang,0,0,0
2023-03-01,TON,Sarawak,0,0,0
2023-03-01,TON,Selangor,11,4,7
2023-03-01,TTO,Johor,4,3,1
2023-03-01,TTO,Kedah,0,0,0
2023-03-01,TTO,Pahang,0,0,0
2023-03-01,TTO,Pulau Pinang,0,0,0
2023-03-01,TTO,Sabah,0,0,0
2023-03-01,TTO,Sarawak,4,3,1
2023-03-01,TTO,Selangor,25,19,6
2023-03-01,TUN,Johor,14,9,5
2023-03-01,TUN,Kedah,6,4,2
2023-03-01,TUN,Kelantan,1,1,0
2023-03-01,TUN,Melaka,0,0,0
2023-03-01,TUN,Perak,0,0,0
2023-03-01,TUN,Perlis,0,0,0
2023-03-01,TUN,Pulau Pinang,3,2,1
2023-03-01,TUN,Sabah,0,0,0
2023-03-01,TUN,Sarawak,1,1,0
2023-03-01,TUN,Selangor,339,197,142
2023-03-01,TUN,W.P. Labuan,0,0,0
2023-03-01,TUR,Johor,247,182,65
2023-03-01,TUR,Kedah,46,35,11
2023-03-01,TUR,Kelantan,6,4,2
2023-03-01,TUR,Melaka,0,0,0
2023-03-01,TUR,Negeri Sembilan,0,0,0
2023-03-01,TUR,Pahang,0,0,0
2023-03-01,TUR,Perak,1,0,1
2023-03-01,TUR,Perlis,18,16,2
2023-03-01,TUR,Pulau Pinang,47,33,14
2023-03-01,TUR,Sabah,5,3,2
2023-03-01,TUR,Sarawak,18,10,8
2023-03-01,TUR,Selangor,1300,935,365
2023-03-01,TUR,W.P. Labuan,1,1,0
2023-03-01,TUV,Selangor,0,0,0
2023-03-01,TWN,Johor,3971,1698,2273
2023-03-01,TWN,Kedah,117,65,52
2023-03-01,TWN,Kelantan,5,3,2
2023-03-01,TWN,Melaka,3,1,2
2023-03-01,TWN,Negeri Sembilan,0,0,0
2023-03-01,TWN,Pahang,1,0,1
2023-03-01,TWN,Perak,40,20,20
2023-03-01,TWN,Perlis,10,6,4
2023-03-01,TWN,Pulau Pinang,2738,1419,1319
2023-03-01,TWN,Sabah,1019,486,533
2023-03-01,TWN,Sarawak,323,138,185
2023-03-01,TWN,Selangor,10593,5326,5267
2023-03-01,TWN,W.P. Labuan,5,3,2
2023-03-01,TZA,Johor,17,7,10
2023-03-01,TZA,Kedah,0,0,0
2023-03-01,TZA,Perak,1,1,0
2023-03-01,TZA,Perlis,0,0,0
2023-03-01,TZA,Pulau Pinang,0,0,0
2023-03-01,TZA,Sabah,0,0,0
2023-03-01,TZA,Sarawak,6,6,0
2023-03-01,TZA,Selangor,106,55,51
2023-03-01,UGA,Johor,15,9,6
2023-03-01,UGA,Kedah,2,1,1
2023-03-01,UGA,Perak,0,0,0
2023-03-01,UGA,Perlis,0,0,0
2023-03-01,UGA,Pulau Pinang,1,0,1
2023-03-01,UGA,Sabah,0,0,0
2023-03-01,UGA,Sarawak,1,1,0
2023-03-01,UGA,Selangor,67,30,37
2023-03-01,UKR,Johor,114,63,51
2023-03-01,UKR,Kedah,55,29,26
2023-03-01,UKR,Kelantan,2,1,1
2023-03-01,UKR,Melaka,0,0,0
2023-03-01,UKR,Negeri Sembilan,0,0,0
2023-03-01,UKR,Pahang,3,3,0
2023-03-01,UKR,Perak,0,0,0
2023-03-01,UKR,Perlis,9,6,3
2023-03-01,UKR,Pulau Pinang,17,10,7
2023-03-01,UKR,Sabah,9,2,7
2023-03-01,UKR,Sarawak,7,7,0
2023-03-01,UKR,Selangor,1193,540,653
2023-03-01,UKR,W.P. Labuan,9,2,7
2023-03-01,URY,Johor,58,17,41
2023-03-01,URY,Kedah,2,0,2
2023-03-01,URY,Kelantan,0,0,0
2023-03-01,URY,Perak,0,0,0
2023-03-01,URY,Perlis,0,0,0
2023-03-01,URY,Pulau Pinang,0,0,0
2023-03-01,URY,Sabah,2,1,1
2023-03-01,URY,Sarawak,0,0,0
2023-03-01,URY,Selangor,131,56,75
2023-03-01,URY,W.P. Labuan,0,0,0
2023-03-01,USA,Johor,4316,2512,1804
2023-03-01,USA,Kedah,579,304,275
2023-03-01,USA,Kelantan,11,10,1
2023-03-01,USA,Melaka,8,6,2
2023-03-01,USA,Negeri Sembilan,0,0,0
2023-03-01,USA,Pahang,0,0,0
2023-03-01,USA,Perak,110,67,43
2023-03-01,USA,Perlis,142,94,48
2023-03-01,USA,Pulau Pinang,1870,1094,776
2023-03-01,USA,Sabah,565,291,274
2023-03-01,USA,Sarawak,423,233,190
2023-03-01,USA,Selangor,13532,7999,5533
2023-03-01,USA,Terengganu,0,0,0
2023-03-01,USA,W.P. Labuan,14,12,2
2023-03-01,UZB,Johor,99,79,20
2023-03-01,UZB,Kedah,9,5,4
2023-03-01,UZB,Kelantan,0,0,0
2023-03-01,UZB,Perak,1,1,0
2023-03-01,UZB,Perlis,5,4,1
2023-03-01,UZB,Pulau Pinang,12,5,7
2023-03-01,UZB,Sabah,4,4,0
2023-03-01,UZB,Sarawak,0,0,0
2023-03-01,UZB,Selangor,1356,818,538
2023-03-01,VAT,Johor,0,0,0
2023-03-01,VAT,Sarawak,0,0,0
2023-03-01,VAT,Selangor,0,0,0
2023-03-01,VCT,Johor,0,0,0
2023-03-01,VCT,Kedah,0,0,0
2023-03-01,VCT,Pulau Pinang,0,0,0
2023-03-01,VCT,Sarawak,2,2,0
2023-03-01,VCT,Selangor,2,2,0
2023-03-01,VEN,Johor,7,2,5
2023-03-01,VEN,Kedah,5,2,3
2023-03-01,VEN,Kelantan,0,0,0
2023-03-01,VEN,Melaka,0,0,0
2023-03-01,VEN,Perak,0,0,0
2023-03-01,VEN,Perlis,0,0,0
2023-03-01,VEN,Pulau Pinang,1,0,1
2023-03-01,VEN,Sabah,3,1,2
2023-03-01,VEN,Sarawak,5,5,0
2023-03-01,VEN,Selangor,73,44,29
2023-03-01,VEN,W.P. Labuan,0,0,0
2023-03-01,VNM,Johor,13546,4103,9443
2023-03-01,VNM,Kedah,296,40,256
2023-03-01,VNM,Kelantan,10,5,5
2023-03-01,VNM,Melaka,0,0,0
2023-03-01,VNM,Negeri Sembilan,0,0,0
2023-03-01,VNM,Pahang,0,0,0
2023-03-01,VNM,Perak,112,14,98
2023-03-01,VNM,Perlis,269,18,251
2023-03-01,VNM,Pulau Pinang,1423,445,978
2023-03-01,VNM,Sabah,33,8,25
2023-03-01,VNM,Sarawak,203,42,161
2023-03-01,VNM,Selangor,18317,6156,12161
2023-03-01,VNM,Terengganu,0,0,0
2023-03-01,VNM,W.P. Labuan,0,0,0
2023-03-01,VUT,Johor,41,25,16
2023-03-01,VUT,Kedah,1,1,0
2023-03-01,VUT,Pulau Pinang,6,4,2
2023-03-01,VUT,Sabah,0,0,0
2023-03-01,VUT,Sarawak,0,0,0
2023-03-01,VUT,Selangor,64,52,12
2023-03-01,WSM,Johor,0,0,0
2023-03-01,WSM,Sarawak,0,0,0
2023-03-01,WSM,Selangor,6,3,3
2023-03-01,XXX,Johor,80,48,32
2023-03-01,XXX,Kedah,10,7,3
2023-03-01,XXX,Kelantan,0,0,0
2023-03-01,XXX,Melaka,0,0,0
2023-03-01,XXX,Pahang,0,0,0
2023-03-01,XXX,Perak,4,2,2
2023-03-01,XXX,Perlis,3,3,0
2023-03-01,XXX,Pulau Pinang,47,23,24
2023-03-01,XXX,Sabah,37,22,15
2023-03-01,XXX,Sarawak,47,35,12
2023-03-01,XXX,Selangor,358,209,149
2023-03-01,XXX,W.P. Labuan,2,1,1
2023-03-01,YEM,Johor,36,26,10
2023-03-01,YEM,Kedah,11,10,1
2023-03-01,YEM,Kelantan,1,0,1
2023-03-01,YEM,Melaka,1,1,0
2023-03-01,YEM,Pahang,0,0,0
2023-03-01,YEM,Perak,0,0,0
2023-03-01,YEM,Perlis,0,0,0
2023-03-01,YEM,Pulau Pinang,2,1,1
2023-03-01,YEM,Sabah,2,2,0
2023-03-01,YEM,Sarawak,5,3,2
2023-03-01,YEM,Selangor,962,714,248
2023-03-01,YEM,W.P. Labuan,0,0,0
2023-03-01,ZAF,Johor,242,148,94
2023-03-01,ZAF,Kedah,46,29,17
2023-03-01,ZAF,Kelantan,3,3,0
2023-03-01,ZAF,Melaka,0,0,0
2023-03-01,ZAF,Pahang,0,0,0
2023-03-01,ZAF,Perak,1,1,0
2023-03-01,ZAF,Perlis,8,5,3
2023-03-01,ZAF,Pulau Pinang,31,19,12
2023-03-01,ZAF,Sabah,22,10,12
2023-03-01,ZAF,Sarawak,96,51,45
2023-03-01,ZAF,Selangor,735,436,299
2023-03-01,ZAF,Terengganu,1,1,0
2023-03-01,ZAF,W.P. Labuan,0,0,0
2023-03-01,ZAR,Selangor,0,0,0
2023-03-01,ZMB,Johor,4,3,1
2023-03-01,ZMB,Kedah,1,1,0
2023-03-01,ZMB,Perak,0,0,0
2023-03-01,ZMB,Perlis,0,0,0
2023-03-01,ZMB,Pulau Pinang,1,1,0
2023-03-01,ZMB,Sabah,0,0,0
2023-03-01,ZMB,Sarawak,2,1,1
2023-03-01,ZMB,Selangor,56,29,27
2023-03-01,ZWE,Johor,8,2,6
2023-03-01,ZWE,Kedah,4,1,3
2023-03-01,ZWE,Kelantan,0,0,0
2023-03-01,ZWE,Perak,0,0,0
2023-03-01,ZWE,Perlis,3,2,1
2023-03-01,ZWE,Pulau Pinang,1,0,1
2023-03-01,ZWE,Sabah,0,0,0
2023-03-01,ZWE,Sarawak,3,3,0
2023-03-01,ZWE,Selangor,102,44,58
2023-04-01,ABW,Kedah,0,0,0
2023-04-01,ABW,Pulau Pinang,0,0,0
2023-04-01,AFG,Johor,2,2,0
2023-04-01,AFG,Kedah,1,1,0
2023-04-01,AFG,Perlis,0,0,0
2023-04-01,AFG,Pulau Pinang,0,0,0
2023-04-01,AFG,Sarawak,1,1,0
2023-04-01,AFG,Selangor,31,23,8
2023-04-01,AGO,Johor,2,0,2
2023-04-01,AGO,Kedah,0,0,0
2023-04-01,AGO,Sabah,0,0,0
2023-04-01,AGO,Selangor,0,0,0
2023-04-01,AIA,Selangor,0,0,0
2023-04-01,ALB,Johor,14,13,1
2023-04-01,ALB,Kedah,1,1,0
2023-04-01,ALB,Perak,0,0,0
2023-04-01,ALB,Perlis,1,1,0
2023-04-01,ALB,Pulau Pinang,1,1,0
2023-04-01,ALB,Sabah,1,1,0
2023-04-01,ALB,Sarawak,0,0,0
2023-04-01,ALB,Selangor,27,18,9
2023-04-01,AND,Johor,0,0,0
2023-04-01,AND,Kedah,0,0,0
2023-04-01,AND,Perlis,0,0,0
2023-04-01,AND,Pulau Pinang,0,0,0
2023-04-01,AND,Selangor,4,2,2
2023-04-01,ANT,Selangor,0,0,0
2023-04-01,ARE,Johor,17,15,2
2023-04-01,ARE,Kedah,1,1,0
2023-04-01,ARE,Kelantan,0,0,0
2023-04-01,ARE,Perak,0,0,0
2023-04-01,ARE,Perlis,0,0,0
2023-04-01,ARE,Pulau Pinang,1,0,1
2023-04-01,ARE,Sabah,0,0,0
2023-04-01,ARE,Sarawak,0,0,0
2023-04-01,ARE,Selangor,191,110,81
2023-04-01,ARG,Johor,54,31,23
2023-04-01,ARG,Kedah,84,35,49
2023-04-01,ARG,Kelantan,1,1,0
2023-04-01,ARG,Melaka,2,1,1
2023-04-01,ARG,Perak,0,0,0
2023-04-01,ARG,Perlis,0,0,0
2023-04-01,ARG,Pulau Pinang,5,4,1
2023-04-01,ARG,Sabah,0,0,0
2023-04-01,ARG,Sarawak,2,2,0
2023-04-01,ARG,Selangor,375,196,179
2023-04-01,ARG,W.P. Labuan,0,0,0
2023-04-01,ARM,Johor,2,1,1
2023-04-01,ARM,Kedah,0,0,0
2023-04-01,ARM,Kelantan,0,0,0
2023-04-01,ARM,Perak,0,0,0
2023-04-01,ARM,Perlis,0,0,0
2023-04-01,ARM,Pulau Pinang,3,2,1
2023-04-01,ARM,Sabah,0,0,0
2023-04-01,ARM,Sarawak,0,0,0
2023-04-01,ARM,Selangor,45,31,14
2023-04-01,ATA,Selangor,0,0,0
2023-04-01,ATG,Johor,7,4,3
2023-04-01,ATG,Kedah,0,0,0
2023-04-01,ATG,Pulau Pinang,0,0,0
2023-04-01,ATG,Sarawak,1,1,0
2023-04-01,ATG,Selangor,11,9,2
2023-04-01,AUS,Johor,6016,3378,2638
2023-04-01,AUS,Kedah,816,430,386
2023-04-01,AUS,Kelantan,12,8,4
2023-04-01,AUS,Melaka,3,1,2
2023-04-01,AUS,Negeri Sembilan,0,0,0
2023-04-01,AUS,Pahang,42,26,16
2023-04-01,AUS,Perak,223,109,114
2023-04-01,AUS,Perlis,69,42,27
2023-04-01,AUS,Pulau Pinang,1989,1089,900
2023-04-01,AUS,Sabah,610,311,299
2023-04-01,AUS,Sarawak,706,399,307
2023-04-01,AUS,Selangor,22882,12855,10027
2023-04-01,AUS,Terengganu,0,0,0
2023-04-01,AUS,W.P. Labuan,15,8,7
2023-04-01,AUT,Johor,156,97,59
2023-04-01,AUT,Kedah,76,38,38
2023-04-01,AUT,Kelantan,4,2,2
2023-04-01,AUT,Melaka,0,0,0
2023-04-01,AUT,Negeri Sembilan,0,0,0
2023-04-01,AUT,Pahang,0,0,0
2023-04-01,AUT,Perak,2,2,0
2023-04-01,AUT,Perlis,11,5,6
2023-04-01,AUT,Pulau Pinang,62,40,22
2023-04-01,AUT,Sabah,13,10,3
2023-04-01,AUT,Sarawak,11,6,5
2023-04-01,AUT,Selangor,643,393,250
2023-04-01,AUT,Terengganu,0,0,0
2023-04-01,AUT,W.P. Labuan,0,0,0
2023-04-01,AZE,Johor,3,1,2
2023-04-01,AZE,Kedah,0,0,0
2023-04-01,AZE,Kelantan,1,1,0
2023-04-01,AZE,Melaka,0,0,0
2023-04-01,AZE,Perlis,0,0,0
2023-04-01,AZE,Pulau Pinang,1,0,1
2023-04-01,AZE,Sabah,0,0,0
2023-04-01,AZE,Sarawak,4,2,2
2023-04-01,AZE,Selangor,73,37,36
2023-04-01,AZE,W.P. Labuan,0,0,0
2023-04-01,BDI,Pulau Pinang,0,0,0
2023-04-01,BDI,Sarawak,0,0,0
2023-04-01,BDI,Selangor,5,3,2
2023-04-01,BEL,Johor,230,153,77
2023-04-01,BEL,Kedah,93,53,40
2023-04-01,BEL,Kelantan,3,2,1
2023-04-01,BEL,Melaka,0,0,0
2023-04-01,BEL,Negeri Sembilan,0,0,0
2023-04-01,BEL,Pahang,0,0,0
2023-04-01,BEL,Perak,1,1,0
2023-04-01,BEL,Perlis,10,6,4
2023-04-01,BEL,Pulau Pinang,48,39,9
2023-04-01,BEL,Sabah,16,11,5
2023-04-01,BEL,Sarawak,15,8,7
2023-04-01,BEL,Selangor,1025,597,428
2023-04-01,BEL,W.P. Labuan,0,0,0
2023-04-01,BEN,Johor,2,1,1
2023-04-01,BEN,Kedah,0,0,0
2023-04-01,BEN,Perak,0,0,0
2023-04-01,BEN,Pulau Pinang,0,0,0
2023-04-01,BEN,Sabah,0,0,0
2023-04-01,BEN,Sarawak,0,0,0
2023-04-01,BEN,Selangor,9,4,5
2023-04-01,BFA,Perak,0,0,0
2023-04-01,BFA,Pulau Pinang,0,0,0
2023-04-01,BFA,Selangor,1,1,0
2023-04-01,BGD,Johor,3886,3385,501
2023-04-01,BGD,Kedah,96,51,45
2023-04-01,BGD,Kelantan,0,0,0
2023-04-01,BGD,Melaka,0,0,0
2023-04-01,BGD,Negeri Sembilan,0,0,0
2023-04-01,BGD,Pahang,0,0,0
2023-04-01,BGD,Perak,3,2,1
2023-04-01,BGD,Perlis,5,5,0
2023-04-01,BGD,Pulau Pinang,260,242,18
2023-04-01,BGD,Sabah,2,1,1
2023-04-01,BGD,Sarawak,59,35,24
2023-04-01,BGD,Selangor,38998,37421,1577
2023-04-01,BGD,W.P. Labuan,2,2,0
2023-04-01,BGR,Johor,41,24,17
2023-04-01,BGR,Kedah,8,3,5
2023-04-01,BGR,Kelantan,0,0,0
2023-04-01,BGR,Pahang,0,0,0
2023-04-01,BGR,Perak,0,0,0
2023-04-01,BGR,Perlis,2,2,0
2023-04-01,BGR,Pulau Pinang,8,5,3
2023-04-01,BGR,Sabah,2,0,2
2023-04-01,BGR,Sarawak,4,2,2
2023-04-01,BGR,Selangor,269,143,126
2023-04-01,BGR,W.P. Labuan,0,0,0
2023-04-01,BHR,Johor,1,1,0
2023-04-01,BHR,Kedah,3,1,2
2023-04-01,BHR,Kelantan,0,0,0
2023-04-01,BHR,Perlis,0,0,0
2023-04-01,BHR,Pulau Pinang,1,1,0
2023-04-01,BHR,Sabah,0,0,0
2023-04-01,BHR,Sarawak,1,1,0
2023-04-01,BHR,Selangor,54,34,20
2023-04-01,BHS,Johor,0,0,0
2023-04-01,BHS,Kedah,0,0,0
2023-04-01,BHS,Perak,0,0,0
2023-04-01,BHS,Sabah,0,0,0
2023-04-01,BHS,Sarawak,0,0,0
2023-04-01,BHS,Selangor,4,2,2
2023-04-01,BIH,Johor,17,8,9
2023-04-01,BIH,Kedah,0,0,0
2023-04-01,BIH,Perlis,0,0,0
2023-04-01,BIH,Pulau Pinang,0,0,0
2023-04-01,BIH,Sabah,1,0,1
2023-04-01,BIH,Sarawak,1,1,0
2023-04-01,BIH,Selangor,40,24,16
2023-04-01,BLR,Johor,10,2,8
2023-04-01,BLR,Kedah,12,6,6
2023-04-01,BLR,Kelantan,8,5,3
2023-04-01,BLR,Pahang,0,0,0
2023-04-01,BLR,Perak,0,0,0
2023-04-01,BLR,Perlis,2,1,1
2023-04-01,BLR,Pulau Pinang,3,2,1
2023-04-01,BLR,Sabah,3,2,1
2023-04-01,BLR,Sarawak,3,1,2
2023-04-01,BLR,Selangor,539,265,274
2023-04-01,BLR,W.P. Labuan,0,0,0
2023-04-01,BLZ,Johor,2,0,2
2023-04-01,BLZ,Pulau Pinang,1,1,0
2023-04-01,BLZ,Sarawak,0,0,0
2023-04-01,BLZ,Selangor,9,6,3
2023-04-01,BMU,Selangor,0,0,0
2023-04-01,BOL,Johor,2,1,1
2023-04-01,BOL,Kedah,1,0,1
2023-04-01,BOL,Melaka,0,0,0
2023-04-01,BOL,Perak,0,0,0
2023-04-01,BOL,Perlis,0,0,0
2023-04-01,BOL,Pulau Pinang,2,1,1
2023-04-01,BOL,Sabah,0,0,0
2023-04-01,BOL,Sarawak,2,1,1
2023-04-01,BOL,Selangor,21,14,7
2023-04-01,BRA,Johor,255,139,116
2023-04-01,BRA,Kedah,88,41,47
2023-04-01,BRA,Kelantan,1,1,0
2023-04-01,BRA,Melaka,0,0,0
2023-04-01,BRA,Pahang,0,0,0
2023-04-01,BRA,Perak,14,9,5
2023-04-01,BRA,Perlis,15,7,8
2023-04-01,BRA,Pulau Pinang,31,19,12
2023-04-01,BRA,Sabah,17,8,9
2023-04-01,BRA,Sarawak,20,13,7
2023-04-01,BRA,Selangor,868,469,399
2023-04-01,BRA,W.P. Labuan,0,0,0
2023-04-01,BRB,Johor,3,1,2
2023-04-01,BRB,Kedah,0,0,0
2023-04-01,BRB,Perlis,0,0,0
2023-04-01,BRB,Pulau Pinang,0,0,0
2023-04-01,BRB,Selangor,6,4,2
2023-04-01,BRN,Johor,557,312,245
2023-04-01,BRN,Kedah,13,1,12
2023-04-01,BRN,Kelantan,12,5,7
2023-04-01,BRN,Melaka,6,3,3
2023-04-01,BRN,Pahang,0,0,0
2023-04-01,BRN,Perak,3,2,1
2023-04-01,BRN,Perlis,7,4,3
2023-04-01,BRN,Pulau Pinang,23,10,13
2023-04-01,BRN,Sabah,1135,505,630
2023-04-01,BRN,Sarawak,114421,61107,53314
2023-04-01,BRN,Selangor,5228,2439,2789
2023-04-01,BRN,W.P. Labuan,1526,872,654
2023-04-01,BTN,Johor,10,4,6
2023-04-01,BTN,Kedah,2,2,0
2023-04-01,BTN,Perak,0,0,0
2023-04-01,BTN,Perlis,0,0,0
2023-04-01,BTN,Pulau Pinang,0,0,0
2023-04-01,BTN,Sabah,1,1,0
2023-04-01,BTN,Sarawak,0,0,0
2023-04-01,BTN,Selangor,12,7,5
2023-04-01,BWA,Johor,6,3,3
2023-04-01,BWA,Kedah,0,0,0
2023-04-01,BWA,Perlis,0,0,0
2023-04-01,BWA,Pulau Pinang,0,0,0
2023-04-01,BWA,Sabah,0,0,0
2023-04-01,BWA,Sarawak,0,0,0
2023-04-01,BWA,Selangor,9,3,6
2023-04-01,CAF,Kedah,0,0,0
2023-04-01,CAF,Selangor,0,0,0
2023-04-01,CAN,Johor,1274,707,567
2023-04-01,CAN,Kedah,214,118,96
2023-04-01,CAN,Kelantan,5,4,1
2023-04-01,CAN,Melaka,0,0,0
2023-04-01,CAN,Negeri Sembilan,0,0,0
2023-04-01,CAN,Pahang,5,2,3
2023-04-01,CAN,Perak,50,27,23
2023-04-01,CAN,Perlis,47,29,18
2023-04-01,CAN,Pulau Pinang,545,296,249
2023-04-01,CAN,Sabah,207,109,98
2023-04-01,CAN,Sarawak,480,255,225
2023-04-01,CAN,Selangor,3835,2125,1710
2023-04-01,CAN,Terengganu,0,0,0
2023-04-01,CAN,W.P. Labuan,5,5,0
2023-04-01,CCK,Selangor,0,0,0
2023-04-01,CHE,Johor,420,266,154
2023-04-01,CHE,Kedah,206,106,100
2023-04-01,CHE,Kelantan,2,2,0
2023-04-01,CHE,Melaka,3,1,2
2023-04-01,CHE,Negeri Sembilan,0,0,0
2023-04-01,CHE,Pahang,8,5,3
2023-04-01,CHE,Perak,3,2,1
2023-04-01,CHE,Perlis,35,17,18
2023-04-01,CHE,Pulau Pinang,117,68,49
2023-04-01,CHE,Sabah,61,35,26
2023-04-01,CHE,Sarawak,65,30,35
2023-04-01,CHE,Selangor,1290,765,525
2023-04-01,CHE,W.P. Labuan,0,0,0
2023-04-01,CHL,Johor,21,10,11
2023-04-01,CHL,Kedah,17,8,9
2023-04-01,CHL,Kelantan,0,0,0
2023-04-01,CHL,Melaka,0,0,0
2023-04-01,CHL,Pahang,4,1,3
2023-04-01,CHL,Perak,0,0,0
2023-04-01,CHL,Perlis,3,1,2
2023-04-01,CHL,Pulau Pinang,9,5,4
2023-04-01,CHL,Sabah,5,2,3
2023-04-01,CHL,Sarawak,2,2,0
2023-04-01,CHL,Selangor,192,94,98
2023-04-01,CHN,Johor,36651,16061,20590
2023-04-01,CHN,Kedah,977,411,566
2023-04-01,CHN,Kelantan,5,1,4
2023-04-01,CHN,Melaka,0,0,0
2023-04-01,CHN,Pahang,31,13,18
2023-04-01,CHN,Perak,254,121,133
2023-04-01,CHN,Perlis,95,36,59
2023-04-01,CHN,Pulau Pinang,6448,3336,3112
2023-04-01,CHN,Sabah,8519,4159,4360
2023-04-01,CHN,Sarawak,905,435,470
2023-04-01,CHN,Selangor,70631,36720,33911
2023-04-01,CHN,Terengganu,0,0,0
2023-04-01,CHN,W.P. Labuan,67,65,2
2023-04-01,CIV,Johor,0,0,0
2023-04-01,CIV,Kedah,0,0,0
2023-04-01,CIV,Pulau Pinang,2,0,2
2023-04-01,CIV,Sabah,0,0,0
2023-04-01,CIV,Sarawak,0,0,0
2023-04-01,CIV,Selangor,10,6,4
2023-04-01,CMR,Johor,0,0,0
2023-04-01,CMR,Kedah,0,0,0
2023-04-01,CMR,Pulau Pinang,2,2,0
2023-04-01,CMR,Sabah,1,1,0
2023-04-01,CMR,Sarawak,0,0,0
2023-04-01,CMR,Selangor,16,13,3
2023-04-01,COD,Johor,2,2,0
2023-04-01,COD,Pulau Pinang,0,0,0
2023-04-01,COD,Sarawak,0,0,0
2023-04-01,COD,Selangor,6,5,1
2023-04-01,COG,Johor,0,0,0
2023-04-01,COG,Kedah,0,0,0
2023-04-01,COG,Selangor,0,0,0
2023-04-01,COK,Selangor,0,0,0
2023-04-01,COL,Johor,36,15,21
2023-04-01,COL,Kedah,4,1,3
2023-04-01,COL,Perak,0,0,0
2023-04-01,COL,Pulau Pinang,2,2,0
2023-04-01,COL,Sabah,2,1,1
2023-04-01,COL,Sarawak,5,3,2
2023-04-01,COL,Selangor,155,78,77
2023-04-01,COL,W.P. Labuan,0,0,0
2023-04-01,COM,Johor,0,0,0
2023-04-01,COM,Kedah,0,0,0
2023-04-01,COM,Selangor,6,4,2
2023-04-01,CPV,Johor,0,0,0
2023-04-01,CPV,Kedah,0,0,0
2023-04-01,CPV,Pulau Pinang,0,0,0
2023-04-01,CPV,Sabah,0,0,0
2023-04-01,CPV,Selangor,0,0,0
2023-04-01,CRI,Johor,10,7,3
2023-04-01,CRI,Kedah,0,0,0
2023-04-01,CRI,Perak,0,0,0
2023-04-01,CRI,Perlis,0,0,0
2023-04-01,CRI,Pulau Pinang,4,3,1
2023-04-01,CRI,Sabah,0,0,0
2023-04-01,CRI,Sarawak,0,0,0
2023-04-01,CRI,Selangor,82,42,40
2023-04-01,CUB,Johor,8,3,5
2023-04-01,CUB,Kedah,0,0,0
2023-04-01,CUB,Perlis,0,0,0
2023-04-01,CUB,Pulau Pinang,1,1,0
2023-04-01,CUB,Sabah,1,1,0
2023-04-01,CUB,Sarawak,0,0,0
2023-04-01,CUB,Selangor,19,13,6
2023-04-01,CYP,Johor,15,9,6
2023-04-01,CYP,Kedah,2,1,1
2023-04-01,CYP,Perak,0,0,0
2023-04-01,CYP,Perlis,0,0,0
2023-04-01,CYP,Pulau Pinang,2,2,0
2023-04-01,CYP,Sabah,0,0,0
2023-04-01,CYP,Sarawak,1,1,0
2023-04-01,CYP,Selangor,53,34,19
2023-04-01,CZE,Johor,89,55,34
2023-04-01,CZE,Kedah,60,29,31
2023-04-01,CZE,Kelantan,7,3,4
2023-04-01,CZE,Melaka,0,0,0
2023-04-01,CZE,Negeri Sembilan,0,0,0
2023-04-01,CZE,Perak,2,2,0
2023-04-01,CZE,Perlis,3,3,0
2023-04-01,CZE,Pulau Pinang,19,11,8
2023-04-01,CZE,Sabah,30,21,9
2023-04-01,CZE,Sarawak,12,5,7
2023-04-01,CZE,Selangor,546,326,220
2023-04-01,CZE,W.P. Labuan,4,2,2
2023-04-01,DEU,Johor,2235,1329,906
2023-04-01,DEU,Kedah,939,510,429
2023-04-01,DEU,Kelantan,17,11,6
2023-04-01,DEU,Melaka,2,2,0
2023-04-01,DEU,Negeri Sembilan,0,0,0
2023-04-01,DEU,Pahang,8,4,4
2023-04-01,DEU,Perak,34,23,11
2023-04-01,DEU,Perlis,108,64,44
2023-04-01,DEU,Pulau Pinang,561,363,198
2023-04-01,DEU,Sabah,185,103,82
2023-04-01,DEU,Sarawak,234,145,89
2023-04-01,DEU,Selangor,6427,3816,2611
2023-04-01,DEU,Terengganu,0,0,0
2023-04-01,DEU,W.P. Labuan,20,11,9
2023-04-01,DJI,Johor,0,0,0
2023-04-01,DJI,Selangor,5,2,3
2023-04-01,DMA,Johor,6,5,1
2023-04-01,DMA,Kedah,0,0,0
2023-04-01,DMA,Pulau Pinang,0,0,0
2023-04-01,DMA,Sabah,0,0,0
2023-04-01,DMA,Sarawak,3,2,1
2023-04-01,DMA,Selangor,19,17,2
2023-04-01,DMA,W.P. Labuan,0,0,0
2023-04-01,DNK,Johor,321,212,109
2023-04-01,DNK,Kedah,154,81,73
2023-04-01,DNK,Kelantan,1,1,0
2023-04-01,DNK,Melaka,0,0,0
2023-04-01,DNK,Negeri Sembilan,0,0,0
2023-04-01,DNK,Pahang,5,3,2
2023-04-01,DNK,Perak,1,0,1
2023-04-01,DNK,Perlis,11,4,7
2023-04-01,DNK,Pulau Pinang,49,32,17
2023-04-01,DNK,Sabah,36,18,18
2023-04-01,DNK,Sarawak,17,10,7
2023-04-01,DNK,Selangor,1026,593,433
2023-04-01,DNK,W.P. Labuan,0,0,0
2023-04-01,DOM,Johor,3,3,0
2023-04-01,DOM,Kedah,0,0,0
2023-04-01,DOM,Perak,0,0,0
2023-04-01,DOM,Perlis,0,0,0
2023-04-01,DOM,Pulau Pinang,3,0,3
2023-04-01,DOM,Sabah,3,1,2
2023-04-01,DOM,Sarawak,0,0,0
2023-04-01,DOM,Selangor,28,15,13
2023-04-01,DZA,Johor,16,15,1
2023-04-01,DZA,Kedah,1,1,0
2023-04-01,DZA,Kelantan,0,0,0
2023-04-01,DZA,Melaka,0,0,0
2023-04-01,DZA,Perak,0,0,0
2023-04-01,DZA,Perlis,1,1,0
2023-04-01,DZA,Pulau Pinang,0,0,0
2023-04-01,DZA,Sabah,0,0,0
2023-04-01,DZA,Sarawak,1,1,0
2023-04-01,DZA,Selangor,270,187,83
2023-04-01,DZA,W.P. Labuan,0,0,0
2023-04-01,ECU,Johor,16,8,8
2023-04-01,ECU,Kedah,1,0,1
2023-04-01,ECU,Perak,0,0,0
2023-04-01,ECU,Perlis,2,1,1
2023-04-01,ECU,Pulau Pinang,5,1,4
2023-04-01,ECU,Sabah,2,1,1
2023-04-01,ECU,Sarawak,0,0,0
2023-04-01,ECU,Selangor,68,39,29
2023-04-01,EGY,Johor,199,159,40
2023-04-01,EGY,Kedah,3,3,0
2023-04-01,EGY,Kelantan,1,1,0
2023-04-01,EGY,Melaka,0,0,0
2023-04-01,EGY,Pahang,1,1,0
2023-04-01,EGY,Perak,0,0,0
2023-04-01,EGY,Perlis,0,0,0
2023-04-01,EGY,Pulau Pinang,10,8,2
2023-04-01,EGY,Sabah,3,3,0
2023-04-01,EGY,Sarawak,149,106,43
2023-04-01,EGY,Selangor,1297,902,395
2023-04-01,EGY,Terengganu,0,0,0
2023-04-01,EGY,W.P. Labuan,2,1,1
2023-04-01,ERI,Johor,1,0,1
2023-04-01,ERI,Pulau Pinang,0,0,0
2023-04-01,ERI,Sabah,0,0,0
2023-04-01,ERI,Selangor,17,7,10
2023-04-01,ESP,Johor,511,312,199
2023-04-01,ESP,Kedah,209,109,100
2023-04-01,ESP,Kelantan,5,4,1
2023-04-01,ESP,Melaka,0,0,0
2023-04-01,ESP,Negeri Sembilan,0,0,0
2023-04-01,ESP,Pahang,4,2,2
2023-04-01,ESP,Perak,7,3,4
2023-04-01,ESP,Perlis,28,13,15
2023-04-01,ESP,Pulau Pinang,85,48,37
2023-04-01,ESP,Sabah,46,28,18
2023-04-01,ESP,Sarawak,41,27,14
2023-04-01,ESP,Selangor,2144,1163,981
2023-04-01,ESP,W.P. Labuan,2,1,1
2023-04-01,EST,Johor,18,12,6
2023-04-01,EST,Kedah,23,13,10
2023-04-01,EST,Kelantan,0,0,0
2023-04-01,EST,Pahang,0,0,0
2023-04-01,EST,Perak,0,0,0
2023-04-01,EST,Perlis,6,2,4
2023-04-01,EST,Pulau Pinang,6,4,2
2023-04-01,EST,Sabah,1,1,0
2023-04-01,EST,Sarawak,6,5,1
2023-04-01,EST,Selangor,156,93,63
2023-04-01,EST,W.P. Labuan,0,0,0
2023-04-01,ETH,Johor,1,1,0
2023-04-01,ETH,Kedah,0,0,0
2023-04-01,ETH,Pulau Pinang,1,0,1
2023-04-01,ETH,Sarawak,0,0,0
2023-04-01,ETH,Selangor,19,13,6
2023-04-01,FIN,Johor,145,98,47
2023-04-01,FIN,Kedah,97,49,48
2023-04-01,FIN,Kelantan,0,0,0
2023-04-01,FIN,Melaka,0,0,0
2023-04-01,FIN,Negeri Sembilan,0,0,0
2023-04-01,FIN,Pahang,0,0,0
2023-04-01,FIN,Perak,1,1,0
2023-04-01,FIN,Perlis,5,3,2
2023-04-01,FIN,Pulau Pinang,27,19,8
2023-04-01,FIN,Sabah,16,8,8
2023-04-01,FIN,Sarawak,19,9,10
2023-04-01,FIN,Selangor,503,267,236
2023-04-01,FIN,W.P. Labuan,0,0,0
2023-04-01,FJI,Johor,66,42,24
2023-04-01,FJI,Kedah,2,0,2
2023-04-01,FJI,Kelantan,0,0,0
2023-04-01,FJI,Perak,0,0,0
2023-04-01,FJI,Perlis,1,1,0
2023-04-01,FJI,Pulau Pinang,3,2,1
2023-04-01,FJI,Sabah,3,2,1
2023-04-01,FJI,Sarawak,1,0,1
2023-04-01,FJI,Selangor,101,49,52
2023-04-01,FRA,Johor,2284,1332,952
2023-04-01,FRA,Kedah,658,344,314
2023-04-01,FRA,Kelantan,26,21,5
2023-04-01,FRA,Melaka,1,0,1
2023-04-01,FRA,Negeri Sembilan,3,2,1
2023-04-01,FRA,Pahang,27,15,12
2023-04-01,FRA,Perak,30,19,11
2023-04-01,FRA,Perlis,71,50,21
2023-04-01,FRA,Pulau Pinang,439,267,172
2023-04-01,FRA,Sabah,217,125,92
2023-04-01,FRA,Sarawak,207,121,86
2023-04-01,FRA,Selangor,6536,3816,2720
2023-04-01,FRA,Terengganu,0,0,0
2023-04-01,FRA,W.P. Labuan,2,1,1
2023-04-01,FSM,Johor,0,0,0
2023-04-01,FSM,Pulau Pinang,0,0,0
2023-04-01,FSM,Selangor,0,0,0
2023-04-01,GAB,Johor,1,1,0
2023-04-01,GAB,Pulau Pinang,0,0,0
2023-04-01,GAB,Sarawak,0,0,0
2023-04-01,GAB,Selangor,3,3,0
2023-04-01,GBR,Johor,4886,2955,1931
2023-04-01,GBR,Kedah,1785,899,886
2023-04-01,GBR,Kelantan,10,8,2
2023-04-01,GBR,Melaka,1,0,1
2023-04-01,GBR,Negeri Sembilan,0,0,0
2023-04-01,GBR,Pahang,34,18,16
2023-04-01,GBR,Perak,115,64,51
2023-04-01,GBR,Perlis,187,106,81
2023-04-01,GBR,Pulau Pinang,1598,889,709
2023-04-01,GBR,Sabah,965,512,453
2023-04-01,GBR,Sarawak,1562,947,615
2023-04-01,GBR,Selangor,17137,9882,7255
2023-04-01,GBR,Terengganu,0,0,0
2023-04-01,GBR,W.P. Labuan,87,66,21
2023-04-01,GEO,Johor,6,5,1
2023-04-01,GEO,Kedah,8,5,3
2023-04-01,GEO,Melaka,0,0,0
2023-04-01,GEO,Perak,0,0,0
2023-04-01,GEO,Perlis,0,0,0
2023-04-01,GEO,Pulau Pinang,1,0,1
2023-04-01,GEO,Sabah,0,0,0
2023-04-01,GEO,Sarawak,0,0,0
2023-04-01,GEO,Selangor,51,27,24
2023-04-01,GHA,Johor,10,7,3
2023-04-01,GHA,Kedah,3,3,0
2023-04-01,GHA,Kelantan,0,0,0
2023-04-01,GHA,Pulau Pinang,0,0,0
2023-04-01,GHA,Sabah,1,0,1
2023-04-01,GHA,Sarawak,0,0,0
2023-04-01,GHA,Selangor,37,24,13
2023-04-01,GIB,Johor,0,0,0
2023-04-01,GIB,Sarawak,0,0,0
2023-04-01,GIN,Johor,0,0,0
2023-04-01,GIN,Kedah,1,1,0
2023-04-01,GIN,Kelantan,0,0,0
2023-04-01,GIN,Perlis,1,1,0
2023-04-01,GIN,Pulau Pinang,0,0,0
2023-04-01,GIN,Sabah,0,0,0
2023-04-01,GIN,Sarawak,0,0,0
2023-04-01,GIN,Selangor,31,26,5
2023-04-01,GLP,Selangor,0,0,0
2023-04-01,GMB,Johor,1,1,0
2023-04-01,GMB,Kedah,0,0,0
2023-04-01,GMB,Kelantan,0,0,0
2023-04-01,GMB,Pulau Pinang,0,0,0
2023-04-01,GMB,Sabah,0,0,0
2023-04-01,GMB,Sarawak,1,1,0
2023-04-01,GMB,Selangor,14,11,3
2023-04-01,GNB,Johor,0,0,0
2023-04-01,GNB,Selangor,1,1,0
2023-04-01,GNQ,Johor,0,0,0
2023-04-01,GNQ,Selangor,2,0,2
2023-04-01,GRC,Johor,52,41,11
2023-04-01,GRC,Kedah,17,8,9
2023-04-01,GRC,Kelantan,2,2,0
2023-04-01,GRC,Melaka,0,0,0
2023-04-01,GRC,Negeri Sembilan,0,0,0
2023-04-01,GRC,Pahang,0,0,0
2023-04-01,GRC,Perak,0,0,0
2023-04-01,GRC,Perlis,3,3,0
2023-04-01,GRC,Pulau Pinang,6,3,3
2023-04-01,GRC,Sabah,8,5,3
2023-04-01,GRC,Sarawak,16,6,10
2023-04-01,GRC,Selangor,218,146,72
2023-04-01,GRD,Johor,5,1,4
2023-04-01,GRD,Kedah,0,0,0
2023-04-01,GRD,Pulau Pinang,0,0,0
2023-04-01,GRD,Sabah,0,0,0
2023-04-01,GRD,Sarawak,0,0,0
2023-04-01,GRD,Selangor,11,10,1
2023-04-01,GRL,Johor,0,0,0
2023-04-01,GRL,Selangor,0,0,0
2023-04-01,GTM,Johor,3,2,1
2023-04-01,GTM,Kedah,0,0,0
2023-04-01,GTM,Pahang,0,0,0
2023-04-01,GTM,Perak,0,0,0
2023-04-01,GTM,Pulau Pinang,0,0,0
2023-04-01,GTM,Sabah,0,0,0
2023-04-01,GTM,Sarawak,0,0,0
2023-04-01,GTM,Selangor,72,35,37
2023-04-01,GTM,W.P. Labuan,0,0,0
2023-04-01,GUY,Johor,0,0,0
2023-04-01,GUY,Kedah,0,0,0
2023-04-01,GUY,Pulau Pinang,0,0,0
2023-04-01,GUY,Sarawak,0,0,0
2023-04-01,GUY,Selangor,3,3,0
2023-04-01,HKG,Johor,4,2,2
2023-04-01,HKG,Kedah,0,0,0
2023-04-01,HKG,Kelantan,0,0,0
2023-04-01,HKG,Pahang,8,4,4
2023-04-01,HKG,Perak,67,24,43
2023-04-01,HKG,Perlis,8,6,2
2023-04-01,HKG,Pulau Pinang,1,0,1
2023-04-01,HKG,Sabah,42,15,27
2023-04-01,HKG,Sarawak,0,0,0
2023-04-01,HKG,Selangor,6,2,4
2023-04-01,HKG,Terengganu,0,0,0
2023-04-01,HMD,Johor,0,0,0
2023-04-01,HND,Johor,2,1,1
2023-04-01,HND,Kedah,0,0,0
2023-04-01,HND,Perak,0,0,0
2023-04-01,HND,Pulau Pinang,0,0,0
2023-04-01,HND,Sabah,0,0,0
2023-04-01,HND,Sarawak,0,0,0
2023-04-01,HND,Selangor,22,11,11
2023-04-01,HRV,Johor,39,32,7
2023-04-01,HRV,Kedah,8,4,4
2023-04-01,HRV,Kelantan,0,0,0
2023-04-01,HRV,Melaka,0,0,0
2023-04-01,HRV,Pahang,0,0,0
2023-04-01,HRV,Perak,0,0,0
2023-04-01,HRV,Perlis,0,0,0
2023-04-01,HRV,Pulau Pinang,3,1,2
2023-04-01,HRV,Sabah,3,2,1
2023-04-01,HRV,Sarawak,5,5,0
2023-04-01,HRV,Selangor,138,83,55
2023-04-01,HTI,Johor,0,0,0
2023-04-01,HTI,Kedah,0,0,0
2023-04-01,HTI,Kelantan,0,0,0
2023-04-01,HTI,Perak,0,0,0
2023-04-01,HTI,Pulau Pinang,0,0,0
2023-04-01,HTI,Sabah,1,1,0
2023-04-01,HTI,Selangor,3,2,1
2023-04-01,HUN,Johor,64,31,33
2023-04-01,HUN,Kedah,26,12,14
2023-04-01,HUN,Kelantan,0,0,0
2023-04-01,HUN,Pahang,0,0,0
2023-04-01,HUN,Perak,2,2,0
2023-04-01,HUN,Perlis,6,2,4
2023-04-01,HUN,Pulau Pinang,31,20,11
2023-04-01,HUN,Sabah,12,6,6
2023-04-01,HUN,Sarawak,12,4,8
2023-04-01,HUN,Selangor,544,273,271
2023-04-01,HUN,W.P. Labuan,0,0,0
2023-04-01,IDN,Johor,85436,37705,47731
2023-04-01,IDN,Kedah,4430,1644,2786
2023-04-01,IDN,Kelantan,139,83,56
2023-04-01,IDN,Melaka,5572,2515,3057
2023-04-01,IDN,Negeri Sembilan,4328,2164,2164
2023-04-01,IDN,Pahang,51,32,19
2023-04-01,IDN,Perak,195,63,132
2023-04-01,IDN,Perlis,563,226,337
2023-04-01,IDN,Pulau Pinang,36741,14511,22230
2023-04-01,IDN,Sabah,4607,2266,2341
2023-04-01,IDN,Sarawak,42173,20538,21635
2023-04-01,IDN,Selangor,108182,50214,57968
2023-04-01,IDN,Terengganu,0,0,0
2023-04-01,IDN,W.P. Labuan,82,40,42
2023-04-01,IND,Johor,22714,15187,7527
2023-04-01,IND,Kedah,1466,761,705
2023-04-01,IND,Kelantan,5,5,0
2023-04-01,IND,Melaka,1,1,0
2023-04-01,IND,Negeri Sembilan,0,0,0
2023-04-01,IND,Pahang,12,10,2
2023-04-01,IND,Perak,525,426,99
2023-04-01,IND,Perlis,67,54,13
2023-04-01,IND,Pulau Pinang,991,645,346
2023-04-01,IND,Sabah,329,198,131
2023-04-01,IND,Sarawak,1630,1175,455
2023-04-01,IND,Selangor,45077,31100,13977
2023-04-01,IND,Terengganu,0,0,0
2023-04-01,IND,W.P. Labuan,160,117,43
2023-04-01,IOT,Pulau Pinang,0,0,0
2023-04-01,IOT,Selangor,0,0,0
2023-04-01,IRL,Johor,312,195,117
2023-04-01,IRL,Kedah,112,61,51
2023-04-01,IRL,Kelantan,0,0,0
2023-04-01,IRL,Negeri Sembilan,0,0,0
2023-04-01,IRL,Pahang,0,0,0
2023-04-01,IRL,Perak,13,6,7
2023-04-01,IRL,Perlis,10,9,1
2023-04-01,IRL,Pulau Pinang,110,63,47
2023-04-01,IRL,Sabah,41,25,16
2023-04-01,IRL,Sarawak,44,18,26
2023-04-01,IRL,Selangor,1135,648,487
2023-04-01,IRL,Terengganu,0,0,0
2023-04-01,IRL,W.P. Labuan,0,0,0
2023-04-01,IRN,Johor,251,143,108
2023-04-01,IRN,Kedah,6,4,2
2023-04-01,IRN,Kelantan,0,0,0
2023-04-01,IRN,Perak,0,0,0
2023-04-01,IRN,Perlis,5,5,0
2023-04-01,IRN,Pulau Pinang,10,4,6
2023-04-01,IRN,Sabah,2,0,2
2023-04-01,IRN,Sarawak,9,5,4
2023-04-01,IRN,Selangor,1101,599,502
2023-04-01,IRN,W.P. Labuan,0,0,0
2023-04-01,IRQ,Johor,27,23,4
2023-04-01,IRQ,Kedah,1,1,0
2023-04-01,IRQ,Kelantan,0,0,0
2023-04-01,IRQ,Melaka,0,0,0
2023-04-01,IRQ,Pahang,0,0,0
2023-04-01,IRQ,Perak,0,0,0
2023-04-01,IRQ,Perlis,0,0,0
2023-04-01,IRQ,Pulau Pinang,6,6,0
2023-04-01,IRQ,Sabah,0,0,0
2023-04-01,IRQ,Sarawak,4,2,2
2023-04-01,IRQ,Selangor,571,402,169
2023-04-01,ISL,Johor,4,3,1
2023-04-01,ISL,Kedah,0,0,0
2023-04-01,ISL,Kelantan,0,0,0
2023-04-01,ISL,Perak,2,1,1
2023-04-01,ISL,Perlis,1,1,0
2023-04-01,ISL,Pulau Pinang,4,4,0
2023-04-01,ISL,Sabah,13,7,6
2023-04-01,ISL,Sarawak,0,0,0
2023-04-01,ISL,Selangor,34,17,17
2023-04-01,ISL,W.P. Labuan,0,0,0
2023-04-01,ISR,Pulau Pinang,0,0,0
2023-04-01,ITA,Johor,577,381,196
2023-04-01,ITA,Kedah,222,136,86
2023-04-01,ITA,Kelantan,3,3,0
2023-04-01,ITA,Melaka,0,0,0
2023-04-01,ITA,Negeri Sembilan,0,0,0
2023-04-01,ITA,Pahang,0,0,0
2023-04-01,ITA,Perak,2,1,1
2023-04-01,ITA,Perlis,22,16,6
2023-04-01,ITA,Pulau Pinang,102,72,30
2023-04-01,ITA,Sabah,56,30,26
2023-04-01,ITA,Sarawak,65,41,24
2023-04-01,ITA,Selangor,2197,1400,797
2023-04-01,ITA,W.P. Labuan,5,3,2
2023-04-01,JAM,Johor,5,2,3
2023-04-01,JAM,Kedah,0,0,0
2023-04-01,JAM,Perak,0,0,0
2023-04-01,JAM,Pulau Pinang,0,0,0
2023-04-01,JAM,Sabah,0,0,0
2023-04-01,JAM,Sarawak,0,0,0
2023-04-01,JAM,Selangor,13,2,11
2023-04-01,JAM,W.P. Labuan,0,0,0
2023-04-01,JOR,Johor,17,11,6
2023-04-01,JOR,Kedah,3,1,2
2023-04-01,JOR,Kelantan,1,1,0
2023-04-01,JOR,Melaka,0,0,0
2023-04-01,JOR,Perlis,1,1,0
2023-04-01,JOR,Pulau Pinang,2,0,2
2023-04-01,JOR,Sabah,1,1,0
2023-04-01,JOR,Sarawak,5,3,2
2023-04-01,JOR,Selangor,419,272,147
2023-04-01,JOR,W.P. Labuan,0,0,0
2023-04-01,JPN,Johor,5487,3728,1759
2023-04-01,JPN,Kedah,389,212,177
2023-04-01,JPN,Kelantan,8,5,3
2023-04-01,JPN,Melaka,2,2,0
2023-04-01,JPN,Negeri Sembilan,0,0,0
2023-04-01,JPN,Pahang,8,5,3
2023-04-01,JPN,Perak,43,29,14
2023-04-01,JPN,Perlis,60,50,10
2023-04-01,JPN,Pulau Pinang,1092,711,381
2023-04-01,JPN,Sabah,559,293,266
2023-04-01,JPN,Sarawak,180,110,70
2023-04-01,JPN,Selangor,14071,8501,5570
2023-04-01,JPN,W.P. Labuan,7,5,2
2023-04-01,KAZ,Johor,48,24,24
2023-04-01,KAZ,Kedah,20,8,12
2023-04-01,KAZ,Kelantan,3,3,0
2023-04-01,KAZ,Melaka,0,0,0
2023-04-01,KAZ,Perak,0,0,0
2023-04-01,KAZ,Perlis,5,2,3
2023-04-01,KAZ,Pulau Pinang,5,1,4
2023-04-01,KAZ,Sabah,11,4,7
2023-04-01,KAZ,Sarawak,3,0,3
2023-04-01,KAZ,Selangor,558,229,329
2023-04-01,KAZ,W.P. Labuan,0,0,0
2023-04-01,KEN,Johor,55,33,22
2023-04-01,KEN,Kedah,3,1,2
2023-04-01,KEN,Kelantan,0,0,0
2023-04-01,KEN,Perak,0,0,0
2023-04-01,KEN,Perlis,0,0,0
2023-04-01,KEN,Pulau Pinang,9,6,3
2023-04-01,KEN,Sabah,1,0,1
2023-04-01,KEN,Sarawak,0,0,0
2023-04-01,KEN,Selangor,391,211,180
2023-04-01,KGZ,Johor,28,16,12
2023-04-01,KGZ,Kedah,1,0,1
2023-04-01,KGZ,Kelantan,3,3,0
2023-04-01,KGZ,Perak,1,1,0
2023-04-01,KGZ,Perlis,0,0,0
2023-04-01,KGZ,Pulau Pinang,0,0,0
2023-04-01,KGZ,Sabah,0,0,0
2023-04-01,KGZ,Sarawak,1,1,0
2023-04-01,KGZ,Selangor,136,58,78
2023-04-01,KHM,Johor,3503,1474,2029
2023-04-01,KHM,Kedah,231,173,58
2023-04-01,KHM,Kelantan,462,251,211
2023-04-01,KHM,Melaka,1,1,0
2023-04-01,KHM,Negeri Sembilan,0,0,0
2023-04-01,KHM,Pahang,1,0,1
2023-04-01,KHM,Perak,13,2,11
2023-04-01,KHM,Perlis,583,355,228
2023-04-01,KHM,Pulau Pinang,34,18,16
2023-04-01,KHM,Sabah,0,0,0
2023-04-01,KHM,Sarawak,9,0,9
2023-04-01,KHM,Selangor,5689,2517,3172
2023-04-01,KHM,W.P. Labuan,1,0,1
2023-04-01,KIR,Johor,0,0,0
2023-04-01,KIR,Sabah,0,0,0
2023-04-01,KIR,Selangor,1,1,0
2023-04-01,KNA,Johor,41,33,8
2023-04-01,KNA,Kedah,6,4,2
2023-04-01,KNA,Perlis,0,0,0
2023-04-01,KNA,Pulau Pinang,9,7,2
2023-04-01,KNA,Sabah,3,2,1
2023-04-01,KNA,Selangor,66,47,19
2023-04-01,KNA,W.P. Labuan,0,0,0
2023-04-01,KOR,Johor,8372,4679,3693
2023-04-01,KOR,Kedah,283,148,135
2023-04-01,KOR,Kelantan,3,1,2
2023-04-01,KOR,Melaka,0,0,0
2023-04-01,KOR,Negeri Sembilan,4,3,1
2023-04-01,KOR,Pahang,7,3,4
2023-04-01,KOR,Perak,24,10,14
2023-04-01,KOR,Perlis,54,39,15
2023-04-01,KOR,Pulau Pinang,479,262,217
2023-04-01,KOR,Sabah,11789,4929,6860
2023-04-01,KOR,Sarawak,229,135,94
2023-04-01,KOR,Selangor,9420,5422,3998
2023-04-01,KOR,Terengganu,0,0,0
2023-04-01,KOR,W.P. Labuan,20,11,9
2023-04-01,KWT,Johor,13,3,10
2023-04-01,KWT,Kedah,8,5,3
2023-04-01,KWT,Kelantan,0,0,0
2023-04-01,KWT,Perak,0,0,0
2023-04-01,KWT,Perlis,0,0,0
2023-04-01,KWT,Pulau Pinang,0,0,0
2023-04-01,KWT,Sabah,0,0,0
2023-04-01,KWT,Sarawak,0,0,0
2023-04-01,KWT,Selangor,322,183,139
2023-04-01,KWT,W.P. Labuan,0,0,0
2023-04-01,LAO,Johor,153,48,105
2023-04-01,LAO,Kedah,987,99,888
2023-04-01,LAO,Kelantan,187,36,151
2023-04-01,LAO,Melaka,0,0,0
2023-04-01,LAO,Perak,13,2,11
2023-04-01,LAO,Perlis,274,113,161
2023-04-01,LAO,Pulau Pinang,24,6,18
2023-04-01,LAO,Sabah,0,0,0
2023-04-01,LAO,Sarawak,21,13,8
2023-04-01,LAO,Selangor,341,120,221
2023-04-01,LAO,W.P. Labuan,0,0,0
2023-04-01,LBN,Johor,17,13,4
2023-04-01,LBN,Kedah,4,1,3
2023-04-01,LBN,Kelantan,0,0,0
2023-04-01,LBN,Pahang,0,0,0
2023-04-01,LBN,Perak,0,0,0
2023-04-01,LBN,Perlis,0,0,0
2023-04-01,LBN,Pulau Pinang,2,1,1
2023-04-01,LBN,Sabah,2,1,1
2023-04-01,LBN,Sarawak,2,2,0
2023-04-01,LBN,Selangor,235,150,85
2023-04-01,LBN,W.P. Labuan,0,0,0
2023-04-01,LBR,Johor,2,2,0
2023-04-01,LBR,Kedah,0,0,0
2023-04-01,LBR,Sabah,0,0,0
2023-04-01,LBR,Sarawak,0,0,0
2023-04-01,LBR,Selangor,5,3,2
2023-04-01,LBY,Johor,2,2,0
2023-04-01,LBY,Kedah,0,0,0
2023-04-01,LBY,Perlis,0,0,0
2023-04-01,LBY,Pulau Pinang,1,1,0
2023-04-01,LBY,Sabah,1,1,0
2023-04-01,LBY,Sarawak,9,6,3
2023-04-01,LBY,Selangor,126,100,26
2023-04-01,LCA,Johor,7,7,0
2023-04-01,LCA,Kedah,0,0,0
2023-04-01,LCA,Pulau Pinang,2,1,1
2023-04-01,LCA,Sarawak,2,1,1
2023-04-01,LCA,Selangor,11,5,6
2023-04-01,LIE,Johor,3,3,0
2023-04-01,LIE,Kedah,0,0,0
2023-04-01,LIE,Perlis,0,0,0
2023-04-01,LIE,Pulau Pinang,0,0,0
2023-04-01,LIE,Sabah,0,0,0
2023-04-01,LIE,Sarawak,0,0,0
2023-04-01,LIE,Selangor,2,0,2
2023-04-01,LKA,Johor,1406,871,535
2023-04-01,LKA,Kedah,45,23,22
2023-04-01,LKA,Kelantan,0,0,0
2023-04-01,LKA,Melaka,0,0,0
2023-04-01,LKA,Pahang,0,0,0
2023-04-01,LKA,Perak,7,3,4
2023-04-01,LKA,Perlis,4,4,0
2023-04-01,LKA,Pulau Pinang,42,21,21
2023-04-01,LKA,Sabah,4,3,1
2023-04-01,LKA,Sarawak,33,21,12
2023-04-01,LKA,Selangor,3762,2329,1433
2023-04-01,LKA,W.P. Labuan,9,8,1
2023-04-01,LSO,Johor,2,1,1
2023-04-01,LSO,Kedah,0,0,0
2023-04-01,LSO,Pulau Pinang,0,0,0
2023-04-01,LSO,Sarawak,0,0,0
2023-04-01,LSO,Selangor,5,1,4
2023-04-01,LTU,Johor,54,21,33
2023-04-01,LTU,Kedah,36,14,22
2023-04-01,LTU,Kelantan,0,0,0
2023-04-01,LTU,Pahang,0,0,0
2023-04-01,LTU,Perak,5,2,3
2023-04-01,LTU,Perlis,5,5,0
2023-04-01,LTU,Pulau Pinang,4,1,3
2023-04-01,LTU,Sabah,3,2,1
2023-04-01,LTU,Sarawak,5,3,2
2023-04-01,LTU,Selangor,361,172,189
2023-04-01,LTU,W.P. Labuan,0,0,0
2023-04-01,LUX,Johor,7,4,3
2023-04-01,LUX,Kedah,9,5,4
2023-04-01,LUX,Kelantan,0,0,0
2023-04-01,LUX,Perak,1,1,0
2023-04-01,LUX,Perlis,0,0,0
2023-04-01,LUX,Pulau Pinang,6,3,3
2023-04-01,LUX,Sabah,3,0,3
2023-04-01,LUX,Sarawak,1,0,1
2023-04-01,LUX,Selangor,41,21,20
2023-04-01,LVA,Johor,13,10,3
2023-04-01,LVA,Kedah,6,1,5
2023-04-01,LVA,Kelantan,0,0,0
2023-04-01,LVA,Pahang,0,0,0
2023-04-01,LVA,Perak,0,0,0
2023-04-01,LVA,Perlis,1,1,0
2023-04-01,LVA,Pulau Pinang,2,1,1
2023-04-01,LVA,Sabah,1,1,0
2023-04-01,LVA,Sarawak,7,3,4
2023-04-01,LVA,Selangor,194,109,85
2023-04-01,LVA,W.P. Labuan,0,0,0
2023-04-01,MAC,Johor,0,0,0
2023-04-01,MAC,Pahang,0,0,0
2023-04-01,MAC,Perak,8,5,3
2023-04-01,MAC,Selangor,0,0,0
2023-04-01,MAC,W.P. Labuan,0,0,0
2023-04-01,MAR,Johor,77,50,27
2023-04-01,MAR,Kedah,6,3,3
2023-04-01,MAR,Kelantan,1,1,0
2023-04-01,MAR,Melaka,0,0,0
2023-04-01,MAR,Pahang,0,0,0
2023-04-01,MAR,Perak,0,0,0
2023-04-01,MAR,Perlis,1,1,0
2023-04-01,MAR,Pulau Pinang,15,12,3
2023-04-01,MAR,Sabah,1,1,0
2023-04-01,MAR,Sarawak,13,11,2
2023-04-01,MAR,Selangor,428,228,200
2023-04-01,MAR,W.P. Labuan,0,0,0
2023-04-01,MCO,Johor,0,0,0
2023-04-01,MCO,Kedah,0,0,0
2023-04-01,MCO,Sabah,0,0,0
2023-04-01,MCO,Selangor,3,1,2
2023-04-01,MDA,Johor,2,2,0
2023-04-01,MDA,Kedah,4,3,1
2023-04-01,MDA,Kelantan,0,0,0
2023-04-01,MDA,Negeri Sembilan,0,0,0
2023-04-01,MDA,Perlis,0,0,0
2023-04-01,MDA,Pulau Pinang,0,0,0
2023-04-01,MDA,Sabah,1,1,0
2023-04-01,MDA,Sarawak,0,0,0
2023-04-01,MDA,Selangor,17,7,10
2023-04-01,MDG,Johor,17,8,9
2023-04-01,MDG,Kedah,4,0,4
2023-04-01,MDG,Perak,0,0,0
2023-04-01,MDG,Perlis,0,0,0
2023-04-01,MDG,Pulau Pinang,0,0,0
2023-04-01,MDG,Sabah,0,0,0
2023-04-01,MDG,Sarawak,0,0,0
2023-04-01,MDG,Selangor,56,27,29
2023-04-01,MDV,Johor,54,31,23
2023-04-01,MDV,Kedah,0,0,0
2023-04-01,MDV,Kelantan,0,0,0
2023-04-01,MDV,Perak,0,0,0
2023-04-01,MDV,Perlis,0,0,0
2023-04-01,MDV,Pulau Pinang,2,1,1
2023-04-01,MDV,Sabah,0,0,0
2023-04-01,MDV,Sarawak,1,0,1
2023-04-01,MDV,Selangor,1366,746,620
2023-04-01,MEX,Johor,166,90,76
2023-04-01,MEX,Kedah,11,1,10
2023-04-01,MEX,Kelantan,0,0,0
2023-04-01,MEX,Pahang,0,0,0
2023-04-01,MEX,Perak,0,0,0
2023-04-01,MEX,Perlis,2,2,0
2023-04-01,MEX,Pulau Pinang,34,21,13
2023-04-01,MEX,Sabah,9,4,5
2023-04-01,MEX,Sarawak,8,5,3
2023-04-01,MEX,Selangor,747,347,400
2023-04-01,MEX,W.P. Labuan,0,0,0
2023-04-01,MHL,Johor,1,1,0
2023-04-01,MHL,Kedah,0,0,0
2023-04-01,MHL,Perak,0,0,0
2023-04-01,MHL,Pulau Pinang,1,1,0
2023-04-01,MHL,Sabah,0,0,0
2023-04-01,MHL,Selangor,7,6,1
2023-04-01,MKD,Johor,2,1,1
2023-04-01,MKD,Kedah,0,0,0
2023-04-01,MKD,Perak,0,0,0
2023-04-01,MKD,Pulau Pinang,1,0,1
2023-04-01,MKD,Sabah,0,0,0
2023-04-01,MKD,Sarawak,1,0,1
2023-04-01,MKD,Selangor,48,28,20
2023-04-01,MLI,Johor,0,0,0
2023-04-01,MLI,Sabah,0,0,0
2023-04-01,MLI,Selangor,6,3,3
2023-04-01,MLT,Johor,8,5,3
2023-04-01,MLT,Kedah,0,0,0
2023-04-01,MLT,Kelantan,0,0,0
2023-04-01,MLT,Perak,0,0,0
2023-04-01,MLT,Perlis,0,0,0
2023-04-01,MLT,Pulau Pinang,10,6,4
2023-04-01,MLT,Sabah,0,0,0
2023-04-01,MLT,Sarawak,0,0,0
2023-04-01,MLT,Selangor,41,25,16
2023-04-01,MLT,W.P. Labuan,0,0,0
2023-04-01,MMR,Johor,5054,1737,3317
2023-04-01,MMR,Kedah,86,18,68
2023-04-01,MMR,Kelantan,3,1,2
2023-04-01,MMR,Negeri Sembilan,1,1,0
2023-04-01,MMR,Pahang,3,0,3
2023-04-01,MMR,Perak,17,3,14
2023-04-01,MMR,Perlis,13,3,10
2023-04-01,MMR,Pulau Pinang,208,94,114
2023-04-01,MMR,Sabah,29,6,23
2023-04-01,MMR,Sarawak,84,31,53
2023-04-01,MMR,Selangor,6295,4199,2096
2023-04-01,MMR,Terengganu,0,0,0
2023-04-01,MMR,W.P. Labuan,3,1,2
2023-04-01,MNE,Johor,1,1,0
2023-04-01,MNE,Kedah,1,0,1
2023-04-01,MNE,Pulau Pinang,0,0,0
2023-04-01,MNE,Sabah,0,0,0
2023-04-01,MNE,Sarawak,0,0,0
2023-04-01,MNE,Selangor,25,14,11
2023-04-01,MNG,Johor,106,45,61
2023-04-01,MNG,Kedah,6,3,3
2023-04-01,MNG,Kelantan,0,0,0
2023-04-01,MNG,Perak,1,0,1
2023-04-01,MNG,Perlis,4,3,1
2023-04-01,MNG,Pulau Pinang,3,2,1
2023-04-01,MNG,Sabah,3,0,3
2023-04-01,MNG,Sarawak,0,0,0
2023-04-01,MNG,Selangor,298,134,164
2023-04-01,MNP,Selangor,0,0,0
2023-04-01,MOZ,Johor,3,1,2
2023-04-01,MOZ,Kedah,0,0,0
2023-04-01,MOZ,Perak,0,0,0
2023-04-01,MOZ,Pulau Pinang,0,0,0
2023-04-01,MOZ,Sabah,0,0,0
2023-04-01,MOZ,Sarawak,0,0,0
2023-04-01,MOZ,Selangor,15,8,7
2023-04-01,MRT,Johor,0,0,0
2023-04-01,MRT,Kedah,0,0,0
2023-04-01,MRT,Pulau Pinang,0,0,0
2023-04-01,MRT,Sabah,0,0,0
2023-04-01,MRT,Sarawak,0,0,0
2023-04-01,MRT,Selangor,11,8,3
2023-04-01,MUS,Johor,196,102,94
2023-04-01,MUS,Kedah,4,1,3
2023-04-01,MUS,Kelantan,0,0,0
2023-04-01,MUS,Pahang,0,0,0
2023-04-01,MUS,Perak,3,1,2
2023-04-01,MUS,Perlis,2,2,0
2023-04-01,MUS,Pulau Pinang,10,3,7
2023-04-01,MUS,Sabah,0,0,0
2023-04-01,MUS,Sarawak,5,3,2
2023-04-01,MUS,Selangor,1744,891,853
2023-04-01,MWI,Johor,0,0,0
2023-04-01,MWI,Pulau Pinang,0,0,0
2023-04-01,MWI,Sabah,0,0,0
2023-04-01,MWI,Sarawak,0,0,0
2023-04-01,MWI,Selangor,13,7,6
2023-04-01,MYT,Selangor,0,0,0
2023-04-01,NAM,Johor,0,0,0
2023-04-01,NAM,Kedah,1,0,1
2023-04-01,NAM,Perak,0,0,0
2023-04-01,NAM,Perlis,0,0,0
2023-04-01,NAM,Pulau Pinang,1,0,1
2023-04-01,NAM,Sabah,0,0,0
2023-04-01,NAM,Sarawak,0,0,0
2023-04-01,NAM,Selangor,19,7,12
2023-04-01,NCL,Selangor,0,0,0
2023-04-01,NER,Johor,0,0,0
2023-04-01,NER,Sabah,0,0,0
2023-04-01,NER,Selangor,6,4,2
2023-04-01,NGA,Johor,28,25,3
2023-04-01,NGA,Kedah,4,0,4
2023-04-01,NGA,Perlis,1,1,0
2023-04-01,NGA,Pulau Pinang,1,1,0
2023-04-01,NGA,Sabah,1,1,0
2023-04-01,NGA,Sarawak,5,4,1
2023-04-01,NGA,Selangor,337,263,74
2023-04-01,NIC,Johor,0,0,0
2023-04-01,NIC,Kedah,0,0,0
2023-04-01,NIC,Pulau Pinang,0,0,0
2023-04-01,NIC,Sabah,0,0,0
2023-04-01,NIC,Selangor,3,2,1
2023-04-01,NLD,Johor,916,580,336
2023-04-01,NLD,Kedah,430,202,228
2023-04-01,NLD,Kelantan,14,9,5
2023-04-01,NLD,Melaka,1,0,1
2023-04-01,NLD,Negeri Sembilan,0,0,0
2023-04-01,NLD,Pahang,0,0,0
2023-04-01,NLD,Perak,17,10,7
2023-04-01,NLD,Perlis,40,23,17
2023-04-01,NLD,Pulau Pinang,279,161,118
2023-04-01,NLD,Sabah,111,62,49
2023-04-01,NLD,Sarawak,150,91,59
2023-04-01,NLD,Selangor,4113,2357,1756
2023-04-01,NLD,Terengganu,0,0,0
2023-04-01,NLD,W.P. Labuan,3,2,1
2023-04-01,NOR,Johor,158,105,53
2023-04-01,NOR,Kedah,113,54,59
2023-04-01,NOR,Kelantan,4,4,0
2023-04-01,NOR,Melaka,0,0,0
2023-04-01,NOR,Pahang,0,0,0
2023-04-01,NOR,Perak,3,2,1
2023-04-01,NOR,Perlis,10,6,4
2023-04-01,NOR,Pulau Pinang,33,24,9
2023-04-01,NOR,Sabah,25,15,10
2023-04-01,NOR,Sarawak,21,12,9
2023-04-01,NOR,Selangor,534,320,214
2023-04-01,NOR,W.P. Labuan,4,3,1
2023-04-01,NPL,Johor,792,660,132
2023-04-01,NPL,Kedah,5,4,1
2023-04-01,NPL,Pahang,0,0,0
2023-04-01,NPL,Perak,0,0,0
2023-04-01,NPL,Perlis,2,2,0
2023-04-01,NPL,Pulau Pinang,26,21,5
2023-04-01,NPL,Sabah,6,6,0
2023-04-01,NPL,Sarawak,356,242,114
2023-04-01,NPL,Selangor,13569,13021,548
2023-04-01,NPL,W.P. Labuan,62,49,13
2023-04-01,NRU,Johor,0,0,0
2023-04-01,NRU,Pulau Pinang,0,0,0
2023-04-01,NRU,Selangor,3,3,0
2023-04-01,NZL,Johor,814,484,330
2023-04-01,NZL,Kedah,137,82,55
2023-04-01,NZL,Kelantan,6,5,1
2023-04-01,NZL,Melaka,0,0,0
2023-04-01,NZL,Negeri Sembilan,0,0,0
2023-04-01,NZL,Pahang,9,5,4
2023-04-01,NZL,Perak,14,5,9
2023-04-01,NZL,Perlis,28,9,19
2023-04-01,NZL,Pulau Pinang,246,137,109
2023-04-01,NZL,Sabah,62,38,24
2023-04-01,NZL,Sarawak,154,77,77
2023-04-01,NZL,Selangor,2864,1646,1218
2023-04-01,NZL,Terengganu,0,0,0
2023-04-01,NZL,W.P. Labuan,0,0,0
2023-04-01,OMN,Johor,14,7,7
2023-04-01,OMN,Kedah,0,0,0
2023-04-01,OMN,Kelantan,0,0,0
2023-04-01,OMN,Melaka,0,0,0
2023-04-01,OMN,Perak,0,0,0
2023-04-01,OMN,Perlis,0,0,0
2023-04-01,OMN,Pulau Pinang,0,0,0
2023-04-01,OMN,Sabah,1,0,1
2023-04-01,OMN,Sarawak,7,5,2
2023-04-01,OMN,Selangor,301,197,104
2023-04-01,PAK,Johor,646,480,166
2023-04-01,PAK,Kedah,37,30,7
2023-04-01,PAK,Kelantan,10,10,0
2023-04-01,PAK,Melaka,0,0,0
2023-04-01,PAK,Negeri Sembilan,0,0,0
2023-04-01,PAK,Pahang,0,0,0
2023-04-01,PAK,Perak,27,24,3
2023-04-01,PAK,Perlis,20,19,1
2023-04-01,PAK,Pulau Pinang,219,214,5
2023-04-01,PAK,Sabah,20,15,5
2023-04-01,PAK,Sarawak,140,114,26
2023-04-01,PAK,Selangor,12969,12042,927
2023-04-01,PAK,W.P. Labuan,7,4,3
2023-04-01,PAN,Johor,11,6,5
2023-04-01,PAN,Kedah,1,0,1
2023-04-01,PAN,Perak,0,0,0
2023-04-01,PAN,Perlis,0,0,0
2023-04-01,PAN,Pulau Pinang,2,1,1
2023-04-01,PAN,Sabah,1,0,1
2023-04-01,PAN,Sarawak,0,0,0
2023-04-01,PAN,Selangor,13,3,10
2023-04-01,PER,Johor,34,18,16
2023-04-01,PER,Kedah,8,5,3
2023-04-01,PER,Kelantan,1,1,0
2023-04-01,PER,Pahang,0,0,0
2023-04-01,PER,Perak,0,0,0
2023-04-01,PER,Perlis,1,1,0
2023-04-01,PER,Pulau Pinang,3,1,2
2023-04-01,PER,Sabah,2,1,1
2023-04-01,PER,Sarawak,3,3,0
2023-04-01,PER,Selangor,106,46,60
2023-04-01,PER,W.P. Labuan,0,0,0
2023-04-01,PHL,Johor,19124,6369,12755
2023-04-01,PHL,Kedah,526,156,370
2023-04-01,PHL,Kelantan,34,16,18
2023-04-01,PHL,Melaka,1,0,1
2023-04-01,PHL,Negeri Sembilan,0,0,0
2023-04-01,PHL,Pahang,27,21,6
2023-04-01,PHL,Perak,58,18,40
2023-04-01,PHL,Perlis,72,19,53
2023-04-01,PHL,Pulau Pinang,575,202,373
2023-04-01,PHL,Sabah,1434,593,841
2023-04-01,PHL,Sarawak,2959,1134,1825
2023-04-01,PHL,Selangor,13303,5437,7866
2023-04-01,PHL,Terengganu,0,0,0
2023-04-01,PHL,W.P. Labuan,122,56,66
2023-04-01,PLW,Johor,0,0,0
2023-04-01,PLW,Pulau Pinang,0,0,0
2023-04-01,PLW,Selangor,0,0,0
2023-04-01,PNG,Johor,3,3,0
2023-04-01,PNG,Kedah,0,0,0
2023-04-01,PNG,Kelantan,0,0,0
2023-04-01,PNG,Perak,0,0,0
2023-04-01,PNG,Pulau Pinang,2,1,1
2023-04-01,PNG,Sabah,0,0,0
2023-04-01,PNG,Sarawak,5,2,3
2023-04-01,PNG,Selangor,35,22,13
2023-04-01,POL,Johor,368,217,151
2023-04-01,POL,Kedah,111,49,62
2023-04-01,POL,Kelantan,2,1,1
2023-04-01,POL,Melaka,0,0,0
2023-04-01,POL,Negeri Sembilan,0,0,0
2023-04-01,POL,Pahang,2,0,2
2023-04-01,POL,Perak,3,2,1
2023-04-01,POL,Perlis,22,13,9
2023-04-01,POL,Pulau Pinang,60,27,33
2023-04-01,POL,Sabah,36,21,15
2023-04-01,POL,Sarawak,31,9,22
2023-04-01,POL,Selangor,1017,541,476
2023-04-01,POL,Terengganu,0,0,0
2023-04-01,POL,W.P. Labuan,0,0,0
2023-04-01,PRK,Selangor,0,0,0
2023-04-01,PRT,Johor,145,71,74
2023-04-01,PRT,Kedah,116,61,55
2023-04-01,PRT,Kelantan,1,1,0
2023-04-01,PRT,Melaka,0,0,0
2023-04-01,PRT,Pahang,0,0,0
2023-04-01,PRT,Perak,0,0,0
2023-04-01,PRT,Perlis,4,1,3
2023-04-01,PRT,Pulau Pinang,31,19,12
2023-04-01,PRT,Sabah,31,12,19
2023-04-01,PRT,Sarawak,5,2,3
2023-04-01,PRT,Selangor,755,414,341
2023-04-01,PRT,W.P. Labuan,0,0,0
2023-04-01,PRY,Johor,2,1,1
2023-04-01,PRY,Kedah,1,0,1
2023-04-01,PRY,Perak,0,0,0
2023-04-01,PRY,Perlis,0,0,0
2023-04-01,PRY,Pulau Pinang,0,0,0
2023-04-01,PRY,Sabah,0,0,0
2023-04-01,PRY,Sarawak,0,0,0
2023-04-01,PRY,Selangor,11,8,3
2023-04-01,PSE,Johor,16,16,0
2023-04-01,PSE,Kedah,0,0,0
2023-04-01,PSE,Kelantan,0,0,0
2023-04-01,PSE,Melaka,1,1,0
2023-04-01,PSE,Perak,0,0,0
2023-04-01,PSE,Perlis,0,0,0
2023-04-01,PSE,Pulau Pinang,1,1,0
2023-04-01,PSE,Sabah,1,1,0
2023-04-01,PSE,Sarawak,11,8,3
2023-04-01,PSE,Selangor,178,131,47
2023-04-01,QAT,Johor,7,5,2
2023-04-01,QAT,Kedah,0,0,0
2023-04-01,QAT,Perlis,0,0,0
2023-04-01,QAT,Pulau Pinang,1,1,0
2023-04-01,QAT,Sabah,0,0,0
2023-04-01,QAT,Sarawak,0,0,0
2023-04-01,QAT,Selangor,135,90,45
2023-04-01,REU,Johor,0,0,0
2023-04-01,REU,Sarawak,0,0,0
2023-04-01,ROU,Johor,160,80,80
2023-04-01,ROU,Kedah,45,26,19
2023-04-01,ROU,Kelantan,1,1,0
2023-04-01,ROU,Negeri Sembilan,0,0,0
2023-04-01,ROU,Pahang,2,2,0
2023-04-01,ROU,Perak,0,0,0
2023-04-01,ROU,Perlis,2,1,1
2023-04-01,ROU,Pulau Pinang,2,2,0
2023-04-01,ROU,Sabah,7,4,3
2023-04-01,ROU,Sarawak,10,8,2
2023-04-01,ROU,Selangor,652,341,311
2023-04-01,ROU,W.P. Labuan,0,0,0
2023-04-01,RUS,Johor,409,206,203
2023-04-01,RUS,Kedah,580,314,266
2023-04-01,RUS,Kelantan,64,42,22
2023-04-01,RUS,Melaka,2,2,0
2023-04-01,RUS,Negeri Sembilan,0,0,0
2023-04-01,RUS,Pahang,3,2,1
2023-04-01,RUS,Perak,3,3,0
2023-04-01,RUS,Perlis,368,200,168
2023-04-01,RUS,Pulau Pinang,158,85,73
2023-04-01,RUS,Sabah,54,16,38
2023-04-01,RUS,Sarawak,87,41,46
2023-04-01,RUS,Selangor,11358,5770,5588
2023-04-01,RUS,W.P. Labuan,12,8,4
2023-04-01,RWA,Johor,1,1,0
2023-04-01,RWA,Kedah,0,0,0
2023-04-01,RWA,Pulau Pinang,0,0,0
2023-04-01,RWA,Selangor,4,2,2
2023-04-01,SAU,Johor,103,54,49
2023-04-01,SAU,Kedah,6,5,1
2023-04-01,SAU,Kelantan,0,0,0
2023-04-01,SAU,Melaka,0,0,0
2023-04-01,SAU,Perak,0,0,0
2023-04-01,SAU,Perlis,4,4,0
2023-04-01,SAU,Pulau Pinang,9,5,4
2023-04-01,SAU,Sabah,2,2,0
2023-04-01,SAU,Sarawak,12,8,4
2023-04-01,SAU,Selangor,2211,1253,958
2023-04-01,SAU,W.P. Labuan,0,0,0
2023-04-01,SDN,Johor,12,10,2
2023-04-01,SDN,Kedah,0,0,0
2023-04-01,SDN,Kelantan,0,0,0
2023-04-01,SDN,Perlis,0,0,0
2023-04-01,SDN,Pulau Pinang,1,0,1
2023-04-01,SDN,Sabah,0,0,0
2023-04-01,SDN,Sarawak,3,1,2
2023-04-01,SDN,Selangor,451,256,195
2023-04-01,SDN,W.P. Labuan,0,0,0
2023-04-01,SEN,Johor,21,17,4
2023-04-01,SEN,Kedah,0,0,0
2023-04-01,SEN,Kelantan,0,0,0
2023-04-01,SEN,Perak,0,0,0
2023-04-01,SEN,Perlis,0,0,0
2023-04-01,SEN,Pulau Pinang,1,0,1
2023-04-01,SEN,Sabah,0,0,0
2023-04-01,SEN,Sarawak,0,0,0
2023-04-01,SEN,Selangor,58,48,10
2023-04-01,SGP,Johor,979155,563701,415454
2023-04-01,SGP,Kedah,3327,1785,1542
2023-04-01,SGP,Kelantan,34,24,10
2023-04-01,SGP,Melaka,26,17,9
2023-04-01,SGP,Negeri Sembilan,0,0,0
2023-04-01,SGP,Pahang,492,246,246
2023-04-01,SGP,Perak,5172,2437,2735
2023-04-01,SGP,Perlis,157,89,68
2023-04-01,SGP,Pulau Pinang,13384,6801,6583
2023-04-01,SGP,Sabah,2423,1331,1092
2023-04-01,SGP,Sarawak,4066,2328,1738
2023-04-01,SGP,Selangor,33575,17754,15821
2023-04-01,SGP,Terengganu,1,1,0
2023-04-01,SGP,W.P. Labuan,14,14,0
2023-04-01,SGS,Johor,0,0,0
2023-04-01,SGS,Sabah,0,0,0
2023-04-01,SGS,Selangor,1,0,1
2023-04-01,SHN,Sarawak,1,1,0
2023-04-01,SLB,Johor,1,0,1
2023-04-01,SLB,Perlis,0,0,0
2023-04-01,SLB,Pulau Pinang,2,1,1
2023-04-01,SLB,Sabah,0,0,0
2023-04-01,SLB,Sarawak,5,1,4
2023-04-01,SLB,Selangor,6,2,4
2023-04-01,SLB,W.P. Labuan,0,0,0
2023-04-01,SLE,Johor,3,2,1
2023-04-01,SLE,Kedah,0,0,0
2023-04-01,SLE,Perak,0,0,0
2023-04-01,SLE,Pulau Pinang,0,0,0
2023-04-01,SLE,Sabah,0,0,0
2023-04-01,SLE,Selangor,10,10,0
2023-04-01,SLV,Johor,0,0,0
2023-04-01,SLV,Kedah,1,1,0
2023-04-01,SLV,Perak,0,0,0
2023-04-01,SLV,Perlis,0,0,0
2023-04-01,SLV,Pulau Pinang,0,0,0
2023-04-01,SLV,Sabah,0,0,0
2023-04-01,SLV,Selangor,26,16,10
2023-04-01,SLV,W.P. Labuan,0,0,0
2023-04-01,SMR,Johor,2,2,0
2023-04-01,SMR,Selangor,7,0,7
2023-04-01,SOM,Johor,0,0,0
2023-04-01,SOM,Kedah,1,1,0
2023-04-01,SOM,Kelantan,0,0,0
2023-04-01,SOM,Perlis,0,0,0
2023-04-01,SOM,Sabah,0,0,0
2023-04-01,SOM,Sarawak,0,0,0
2023-04-01,SOM,Selangor,161,98,63
2023-04-01,SRB,Johor,4,2,2
2023-04-01,SRB,Kedah,2,2,0
2023-04-01,SRB,Kelantan,0,0,0
2023-04-01,SRB,Pahang,0,0,0
2023-04-01,SRB,Perak,0,0,0
2023-04-01,SRB,Perlis,0,0,0
2023-04-01,SRB,Pulau Pinang,1,0,1
2023-04-01,SRB,Sabah,0,0,0
2023-04-01,SRB,Sarawak,0,0,0
2023-04-01,SRB,Selangor,97,47,50
2023-04-01,SSD,Johor,0,0,0
2023-04-01,SSD,Kedah,0,0,0
2023-04-01,SSD,Sarawak,0,0,0
2023-04-01,SSD,Selangor,22,12,10
2023-04-01,SSD,W.P. Labuan,0,0,0
2023-04-01,STP,Selangor,0,0,0
2023-04-01,SUR,Johor,2,0,2
2023-04-01,SUR,Kedah,1,0,1
2023-04-01,SUR,Kelantan,0,0,0
2023-04-01,SUR,Perak,0,0,0
2023-04-01,SUR,Perlis,5,5,0
2023-04-01,SUR,Pulau Pinang,0,0,0
2023-04-01,SUR,Sabah,0,0,0
2023-04-01,SUR,Sarawak,0,0,0
2023-04-01,SUR,Selangor,16,11,5
2023-04-01,SVK,Johor,35,22,13
2023-04-01,SVK,Kedah,75,39,36
2023-04-01,SVK,Kelantan,1,1,0
2023-04-01,SVK,Negeri Sembilan,0,0,0
2023-04-01,SVK,Pahang,0,0,0
2023-04-01,SVK,Perak,0,0,0
2023-04-01,SVK,Perlis,2,2,0
2023-04-01,SVK,Pulau Pinang,7,5,2
2023-04-01,SVK,Sabah,5,4,1
2023-04-01,SVK,Sarawak,2,1,1
2023-04-01,SVK,Selangor,270,156,114
2023-04-01,SVK,W.P. Labuan,4,4,0
2023-04-01,SVN,Johor,35,19,16
2023-04-01,SVN,Kedah,9,5,4
2023-04-01,SVN,Kelantan,0,0,0
2023-04-01,SVN,Perak,0,0,0
2023-04-01,SVN,Perlis,0,0,0
2023-04-01,SVN,Pulau Pinang,6,1,5
2023-04-01,SVN,Sabah,2,2,0
2023-04-01,SVN,Sarawak,1,1,0
2023-04-01,SVN,Selangor,158,86,72
2023-04-01,SVN,W.P. Labuan,0,0,0
2023-04-01,SWE,Johor,261,153,108
2023-04-01,SWE,Kedah,179,76,103
2023-04-01,SWE,Kelantan,8,6,2
2023-04-01,SWE,Melaka,0,0,0
2023-04-01,SWE,Negeri Sembilan,0,0,0
2023-04-01,SWE,Pahang,0,0,0
2023-04-01,SWE,Perak,3,3,0
2023-04-01,SWE,Perlis,11,6,5
2023-04-01,SWE,Pulau Pinang,57,33,24
2023-04-01,SWE,Sabah,50,35,15
2023-04-01,SWE,Sarawak,9,8,1
2023-04-01,SWE,Selangor,983,605,378
2023-04-01,SWE,W.P. Labuan,1,1,0
2023-04-01,SWZ,Johor,0,0,0
2023-04-01,SWZ,Kedah,0,0,0
2023-04-01,SWZ,Pulau Pinang,0,0,0
2023-04-01,SWZ,Sabah,0,0,0
2023-04-01,SWZ,Selangor,18,8,10
2023-04-01,SYC,Johor,0,0,0
2023-04-01,SYC,Kedah,0,0,0
2023-04-01,SYC,Pulau Pinang,0,0,0
2023-04-01,SYC,Sabah,0,0,0
2023-04-01,SYC,Sarawak,0,0,0
2023-04-01,SYC,Selangor,87,40,47
2023-04-01,SYR,Johor,12,9,3
2023-04-01,SYR,Kedah,1,1,0
2023-04-01,SYR,Kelantan,0,0,0
2023-04-01,SYR,Pahang,0,0,0
2023-04-01,SYR,Perlis,0,0,0
2023-04-01,SYR,Pulau Pinang,3,3,0
2023-04-01,SYR,Sabah,0,0,0
2023-04-01,SYR,Sarawak,2,2,0
2023-04-01,SYR,Selangor,486,317,169
2023-04-01,SYR,W.P. Labuan,0,0,0
2023-04-01,TCA,Perlis,0,0,0
2023-04-01,TCD,Johor,4,4,0
2023-04-01,TCD,Kedah,0,0,0
2023-04-01,TCD,Perlis,0,0,0
2023-04-01,TCD,Selangor,18,13,5
2023-04-01,TGO,Johor,4,4,0
2023-04-01,TGO,Perak,0,0,0
2023-04-01,TGO,Pulau Pinang,0,0,0
2023-04-01,TGO,Selangor,5,3,2
2023-04-01,THA,Johor,6807,2074,4733
2023-04-01,THA,Kedah,63470,35000,28470
2023-04-01,THA,Kelantan,45732,22705,23027
2023-04-01,THA,Melaka,1,0,1
2023-04-01,THA,Negeri Sembilan,3,3,0
2023-04-01,THA,Pahang,23,15,8
2023-04-01,THA,Perak,11797,5219,6578
2023-04-01,THA,Perlis,50770,29713,21057
2023-04-01,THA,Pulau Pinang,2532,1007,1525
2023-04-01,THA,Sabah,64,27,37
2023-04-01,THA,Sarawak,426,162,264
2023-04-01,THA,Selangor,13420,5257,8163
2023-04-01,THA,Terengganu,0,0,0
2023-04-01,THA,W.P. Labuan,12,9,3
2023-04-01,TJK,Johor,2,2,0
2023-04-01,TJK,Kedah,0,0,0
2023-04-01,TJK,Perlis,0,0,0
2023-04-01,TJK,Pulau Pinang,0,0,0
2023-04-01,TJK,Sabah,0,0,0
2023-04-01,TJK,Selangor,40,31,9
2023-04-01,TKL,Selangor,0,0,0
2023-04-01,TKM,Johor,2,1,1
2023-04-01,TKM,Kedah,0,0,0
2023-04-01,TKM,Kelantan,0,0,0
2023-04-01,TKM,Perlis,0,0,0
2023-04-01,TKM,Pulau Pinang,0,0,0
2023-04-01,TKM,Sabah,0,0,0
2023-04-01,TKM,Sarawak,1,1,0
2023-04-01,TKM,Selangor,48,28,20
2023-04-01,TLS,Johor,0,0,0
2023-04-01,TLS,Kedah,1,1,0
2023-04-01,TLS,Perlis,0,0,0
2023-04-01,TLS,Pulau Pinang,3,1,2
2023-04-01,TLS,Sabah,0,0,0
2023-04-01,TLS,Sarawak,1,1,0
2023-04-01,TLS,Selangor,162,80,82
2023-04-01,TON,Johor,0,0,0
2023-04-01,TON,Pulau Pinang,3,1,2
2023-04-01,TON,Sarawak,0,0,0
2023-04-01,TON,Selangor,11,6,5
2023-04-01,TTO,Johor,10,6,4
2023-04-01,TTO,Kedah,0,0,0
2023-04-01,TTO,Pahang,0,0,0
2023-04-01,TTO,Pulau Pinang,4,2,2
2023-04-01,TTO,Sabah,1,1,0
2023-04-01,TTO,Sarawak,1,1,0
2023-04-01,TTO,Selangor,25,13,12
2023-04-01,TUN,Johor,16,7,9
2023-04-01,TUN,Kedah,9,7,2
2023-04-01,TUN,Kelantan,0,0,0
2023-04-01,TUN,Melaka,0,0,0
2023-04-01,TUN,Perak,0,0,0
2023-04-01,TUN,Perlis,0,0,0
2023-04-01,TUN,Pulau Pinang,1,1,0
2023-04-01,TUN,Sabah,4,4,0
2023-04-01,TUN,Sarawak,2,1,1
2023-04-01,TUN,Selangor,199,107,92
2023-04-01,TUN,W.P. Labuan,0,0,0
2023-04-01,TUR,Johor,223,153,70
2023-04-01,TUR,Kedah,53,30,23
2023-04-01,TUR,Kelantan,4,4,0
2023-04-01,TUR,Melaka,0,0,0
2023-04-01,TUR,Negeri Sembilan,0,0,0
2023-04-01,TUR,Pahang,0,0,0
2023-04-01,TUR,Perak,0,0,0
2023-04-01,TUR,Perlis,18,16,2
2023-04-01,TUR,Pulau Pinang,30,21,9
2023-04-01,TUR,Sabah,13,8,5
2023-04-01,TUR,Sarawak,24,19,5
2023-04-01,TUR,Selangor,1143,767,376
2023-04-01,TUR,W.P. Labuan,0,0,0
2023-04-01,TUV,Selangor,0,0,0
2023-04-01,TWN,Johor,5061,2205,2856
2023-04-01,TWN,Kedah,166,74,92
2023-04-01,TWN,Kelantan,1,0,1
2023-04-01,TWN,Melaka,10,2,8
2023-04-01,TWN,Negeri Sembilan,0,0,0
2023-04-01,TWN,Pahang,3,1,2
2023-04-01,TWN,Perak,63,35,28
2023-04-01,TWN,Perlis,12,2,10
2023-04-01,TWN,Pulau Pinang,2989,1442,1547
2023-04-01,TWN,Sabah,1895,913,982
2023-04-01,TWN,Sarawak,307,138,169
2023-04-01,TWN,Selangor,12359,5939,6420
2023-04-01,TWN,W.P. Labuan,13,6,7
2023-04-01,TZA,Johor,2,1,1
2023-04-01,TZA,Kedah,0,0,0
2023-04-01,TZA,Perak,0,0,0
2023-04-01,TZA,Perlis,0,0,0
2023-04-01,TZA,Pulau Pinang,0,0,0
2023-04-01,TZA,Sabah,1,0,1
2023-04-01,TZA,Sarawak,3,3,0
2023-04-01,TZA,Selangor,101,47,54
2023-04-01,UGA,Johor,8,2,6
2023-04-01,UGA,Kedah,0,0,0
2023-04-01,UGA,Perak,0,0,0
2023-04-01,UGA,Perlis,1,0,1
2023-04-01,UGA,Pulau Pinang,0,0,0
2023-04-01,UGA,Sabah,1,1,0
2023-04-01,UGA,Sarawak,0,0,0
2023-04-01,UGA,Selangor,80,29,51
2023-04-01,UKR,Johor,85,40,45
2023-04-01,UKR,Kedah,47,17,30
2023-04-01,UKR,Kelantan,10,7,3
2023-04-01,UKR,Melaka,1,1,0
2023-04-01,UKR,Negeri Sembilan,0,0,0
2023-04-01,UKR,Pahang,1,1,0
2023-04-01,UKR,Perak,5,3,2
2023-04-01,UKR,Perlis,13,8,5
2023-04-01,UKR,Pulau Pinang,19,7,12
2023-04-01,UKR,Sabah,18,12,6
2023-04-01,UKR,Sarawak,8,7,1
2023-04-01,UKR,Selangor,1100,465,635
2023-04-01,UKR,W.P. Labuan,0,0,0
2023-04-01,URY,Johor,16,10,6
2023-04-01,URY,Kedah,1,1,0
2023-04-01,URY,Kelantan,0,0,0
2023-04-01,URY,Perak,0,0,0
2023-04-01,URY,Perlis,0,0,0
2023-04-01,URY,Pulau Pinang,0,0,0
2023-04-01,URY,Sabah,2,1,1
2023-04-01,URY,Sarawak,0,0,0
2023-04-01,URY,Selangor,186,77,109
2023-04-01,URY,W.P. Labuan,0,0,0
2023-04-01,USA,Johor,3763,2235,1528
2023-04-01,USA,Kedah,621,345,276
2023-04-01,USA,Kelantan,15,6,9
2023-04-01,USA,Melaka,1,0,1
2023-04-01,USA,Negeri Sembilan,1,1,0
2023-04-01,USA,Pahang,13,8,5
2023-04-01,USA,Perak,115,55,60
2023-04-01,USA,Perlis,113,70,43
2023-04-01,USA,Pulau Pinang,1684,1023,661
2023-04-01,USA,Sabah,671,336,335
2023-04-01,USA,Sarawak,293,168,125
2023-04-01,USA,Selangor,11293,6612,4681
2023-04-01,USA,Terengganu,0,0,0
2023-04-01,USA,W.P. Labuan,9,3,6
2023-04-01,UZB,Johor,83,73,10
2023-04-01,UZB,Kedah,14,6,8
2023-04-01,UZB,Kelantan,0,0,0
2023-04-01,UZB,Perak,0,0,0
2023-04-01,UZB,Perlis,2,1,1
2023-04-01,UZB,Pulau Pinang,9,2,7
2023-04-01,UZB,Sabah,5,4,1
2023-04-01,UZB,Sarawak,1,0,1
2023-04-01,UZB,Selangor,668,387,281
2023-04-01,VAT,Johor,0,0,0
2023-04-01,VAT,Sarawak,0,0,0
2023-04-01,VAT,Selangor,0,0,0
2023-04-01,VCT,Johor,0,0,0
2023-04-01,VCT,Kedah,0,0,0
2023-04-01,VCT,Pulau Pinang,0,0,0
2023-04-01,VCT,Sarawak,2,2,0
2023-04-01,VCT,Selangor,1,1,0
2023-04-01,VEN,Johor,5,3,2
2023-04-01,VEN,Kedah,6,2,4
2023-04-01,VEN,Kelantan,0,0,0
2023-04-01,VEN,Melaka,0,0,0
2023-04-01,VEN,Perak,0,0,0
2023-04-01,VEN,Perlis,0,0,0
2023-04-01,VEN,Pulau Pinang,1,1,0
2023-04-01,VEN,Sabah,3,2,1
2023-04-01,VEN,Sarawak,7,6,1
2023-04-01,VEN,Selangor,77,43,34
2023-04-01,VEN,W.P. Labuan,0,0,0
2023-04-01,VNM,Johor,12560,3972,8588
2023-04-01,VNM,Kedah,436,58,378
2023-04-01,VNM,Kelantan,8,1,7
2023-04-01,VNM,Melaka,1,1,0
2023-04-01,VNM,Negeri Sembilan,0,0,0
2023-04-01,VNM,Pahang,1,0,1
2023-04-01,VNM,Perak,163,10,153
2023-04-01,VNM,Perlis,244,29,215
2023-04-01,VNM,Pulau Pinang,1380,429,951
2023-04-01,VNM,Sabah,38,13,25
2023-04-01,VNM,Sarawak,210,35,175
2023-04-01,VNM,Selangor,14699,5375,9324
2023-04-01,VNM,Terengganu,0,0,0
2023-04-01,VNM,W.P. Labuan,2,1,1
2023-04-01,VUT,Johor,23,20,3
2023-04-01,VUT,Kedah,2,1,1
2023-04-01,VUT,Pulau Pinang,4,4,0
2023-04-01,VUT,Sabah,1,1,0
2023-04-01,VUT,Sarawak,0,0,0
2023-04-01,VUT,Selangor,57,46,11
2023-04-01,WSM,Johor,1,0,1
2023-04-01,WSM,Sarawak,0,0,0
2023-04-01,WSM,Selangor,3,1,2
2023-04-01,XXX,Johor,69,40,29
2023-04-01,XXX,Kedah,9,4,5
2023-04-01,XXX,Kelantan,0,0,0
2023-04-01,XXX,Melaka,0,0,0
2023-04-01,XXX,Pahang,0,0,0
2023-04-01,XXX,Perak,1,0,1
2023-04-01,XXX,Perlis,0,0,0
2023-04-01,XXX,Pulau Pinang,43,25,18
2023-04-01,XXX,Sabah,32,18,14
2023-04-01,XXX,Sarawak,50,34,16
2023-04-01,XXX,Selangor,371,229,142
2023-04-01,XXX,W.P. Labuan,0,0,0
2023-04-01,YEM,Johor,33,24,9
2023-04-01,YEM,Kedah,2,2,0
2023-04-01,YEM,Kelantan,1,1,0
2023-04-01,YEM,Melaka,0,0,0
2023-04-01,YEM,Pahang,1,1,0
2023-04-01,YEM,Perak,1,1,0
2023-04-01,YEM,Perlis,1,1,0
2023-04-01,YEM,Pulau Pinang,1,1,0
2023-04-01,YEM,Sabah,1,1,0
2023-04-01,YEM,Sarawak,2,1,1
2023-04-01,YEM,Selangor,916,621,295
2023-04-01,YEM,W.P. Labuan,0,0,0
2023-04-01,ZAF,Johor,312,183,129
2023-04-01,ZAF,Kedah,89,40,49
2023-04-01,ZAF,Kelantan,2,1,1
2023-04-01,ZAF,Melaka,0,0,0
2023-04-01,ZAF,Pahang,2,2,0
2023-04-01,ZAF,Perak,1,1,0
2023-04-01,ZAF,Perlis,8,6,2
2023-04-01,ZAF,Pulau Pinang,46,22,24
2023-04-01,ZAF,Sabah,30,16,14
2023-04-01,ZAF,Sarawak,164,82,82
2023-04-01,ZAF,Selangor,1002,491,511
2023-04-01,ZAF,Terengganu,0,0,0
2023-04-01,ZAF,W.P. Labuan,7,4,3
2023-04-01,ZAR,Selangor,0,0,0
2023-04-01,ZMB,Johor,1,1,0
2023-04-01,ZMB,Kedah,0,0,0
2023-04-01,ZMB,Perak,0,0,0
2023-04-01,ZMB,Perlis,0,0,0
2023-04-01,ZMB,Pulau Pinang,1,1,0
2023-04-01,ZMB,Sabah,0,0,0
2023-04-01,ZMB,Sarawak,2,2,0
2023-04-01,ZMB,Selangor,41,26,15
2023-04-01,ZWE,Johor,8,5,3
2023-04-01,ZWE,Kedah,1,0,1
2023-04-01,ZWE,Kelantan,0,0,0
2023-04-01,ZWE,Perak,0,0,0
2023-04-01,ZWE,Perlis,1,1,0
2023-04-01,ZWE,Pulau Pinang,1,0,1
2023-04-01,ZWE,Sabah,0,0,0
2023-04-01,ZWE,Sarawak,0,0,0
2023-04-01,ZWE,Selangor,94,40,54
2023-05-01,ABW,Kedah,0,0,0
2023-05-01,ABW,Pulau Pinang,0,0,0
2023-05-01,AFG,Johor,2,2,0
2023-05-01,AFG,Kedah,1,1,0
2023-05-01,AFG,Perlis,0,0,0
2023-05-01,AFG,Pulau Pinang,0,0,0
2023-05-01,AFG,Sarawak,0,0,0
2023-05-01,AFG,Selangor,51,35,16
2023-05-01,AGO,Johor,0,0,0
2023-05-01,AGO,Kedah,0,0,0
2023-05-01,AGO,Sabah,0,0,0
2023-05-01,AGO,Selangor,6,5,1
2023-05-01,AIA,Selangor,0,0,0
2023-05-01,ALB,Johor,17,13,4
2023-05-01,ALB,Kedah,1,0,1
2023-05-01,ALB,Perak,0,0,0
2023-05-01,ALB,Perlis,0,0,0
2023-05-01,ALB,Pulau Pinang,2,0,2
2023-05-01,ALB,Sabah,0,0,0
2023-05-01,ALB,Sarawak,0,0,0
2023-05-01,ALB,Selangor,27,21,6
2023-05-01,AND,Johor,0,0,0
2023-05-01,AND,Kedah,0,0,0
2023-05-01,AND,Perlis,0,0,0
2023-05-01,AND,Pulau Pinang,1,1,0
2023-05-01,AND,Selangor,2,1,1
2023-05-01,ANT,Selangor,0,0,0
2023-05-01,ARE,Johor,14,10,4
2023-05-01,ARE,Kedah,81,78,3
2023-05-01,ARE,Kelantan,0,0,0
2023-05-01,ARE,Perak,0,0,0
2023-05-01,ARE,Perlis,0,0,0
2023-05-01,ARE,Pulau Pinang,0,0,0
2023-05-01,ARE,Sabah,0,0,0
2023-05-01,ARE,Sarawak,2,2,0
2023-05-01,ARE,Selangor,509,363,146
2023-05-01,ARG,Johor,64,39,25
2023-05-01,ARG,Kedah,36,14,22
2023-05-01,ARG,Kelantan,0,0,0
2023-05-01,ARG,Melaka,0,0,0
2023-05-01,ARG,Perak,2,1,1
2023-05-01,ARG,Perlis,10,6,4
2023-05-01,ARG,Pulau Pinang,4,1,3
2023-05-01,ARG,Sabah,3,2,1
2023-05-01,ARG,Sarawak,3,2,1
2023-05-01,ARG,Selangor,335,181,154
2023-05-01,ARG,W.P. Labuan,0,0,0
2023-05-01,ARM,Johor,19,4,15
2023-05-01,ARM,Kedah,0,0,0
2023-05-01,ARM,Kelantan,0,0,0
2023-05-01,ARM,Perak,0,0,0
2023-05-01,ARM,Perlis,0,0,0
2023-05-01,ARM,Pulau Pinang,4,2,2
2023-05-01,ARM,Sabah,1,1,0
2023-05-01,ARM,Sarawak,0,0,0
2023-05-01,ARM,Selangor,48,28,20
2023-05-01,ATA,Selangor,0,0,0
2023-05-01,ATG,Johor,5,5,0
2023-05-01,ATG,Kedah,0,0,0
2023-05-01,ATG,Pulau Pinang,0,0,0
2023-05-01,ATG,Sarawak,0,0,0
2023-05-01,ATG,Selangor,9,7,2
2023-05-01,AUS,Johor,4250,2490,1760
2023-05-01,AUS,Kedah,459,271,188
2023-05-01,AUS,Kelantan,30,24,6
2023-05-01,AUS,Melaka,2,1,1
2023-05-01,AUS,Negeri Sembilan,1,1,0
2023-05-01,AUS,Pahang,13,10,3
2023-05-01,AUS,Perak,158,81,77
2023-05-01,AUS,Perlis,59,32,27
2023-05-01,AUS,Pulau Pinang,1621,872,749
2023-05-01,AUS,Sabah,390,204,186
2023-05-01,AUS,Sarawak,575,315,260
2023-05-01,AUS,Selangor,18192,10579,7613
2023-05-01,AUS,Terengganu,0,0,0
2023-05-01,AUS,W.P. Labuan,7,2,5
2023-05-01,AUT,Johor,138,94,44
2023-05-01,AUT,Kedah,46,28,18
2023-05-01,AUT,Kelantan,4,2,2
2023-05-01,AUT,Melaka,0,0,0
2023-05-01,AUT,Negeri Sembilan,0,0,0
2023-05-01,AUT,Pahang,1,1,0
2023-05-01,AUT,Perak,3,2,1
2023-05-01,AUT,Perlis,11,7,4
2023-05-01,AUT,Pulau Pinang,72,56,16
2023-05-01,AUT,Sabah,9,2,7
2023-05-01,AUT,Sarawak,44,24,20
2023-05-01,AUT,Selangor,742,455,287
2023-05-01,AUT,Terengganu,0,0,0
2023-05-01,AUT,W.P. Labuan,0,0,0
2023-05-01,AZE,Johor,5,1,4
2023-05-01,AZE,Kedah,2,1,1
2023-05-01,AZE,Kelantan,0,0,0
2023-05-01,AZE,Melaka,0,0,0
2023-05-01,AZE,Perlis,0,0,0
2023-05-01,AZE,Pulau Pinang,0,0,0
2023-05-01,AZE,Sabah,0,0,0
2023-05-01,AZE,Sarawak,1,0,1
2023-05-01,AZE,Selangor,119,75,44
2023-05-01,AZE,W.P. Labuan,0,0,0
2023-05-01,BDI,Pulau Pinang,0,0,0
2023-05-01,BDI,Sarawak,0,0,0
2023-05-01,BDI,Selangor,2,1,1
2023-05-01,BEL,Johor,242,133,109
2023-05-01,BEL,Kedah,84,45,39
2023-05-01,BEL,Kelantan,1,1,0
2023-05-01,BEL,Melaka,0,0,0
2023-05-01,BEL,Negeri Sembilan,0,0,0
2023-05-01,BEL,Pahang,0,0,0
2023-05-01,BEL,Perak,0,0,0
2023-05-01,BEL,Perlis,13,7,6
2023-05-01,BEL,Pulau Pinang,50,37,13
2023-05-01,BEL,Sabah,17,10,7
2023-05-01,BEL,Sarawak,25,12,13
2023-05-01,BEL,Selangor,1019,633,386
2023-05-01,BEL,W.P. Labuan,3,2,1
2023-05-01,BEN,Johor,0,0,0
2023-05-01,BEN,Kedah,0,0,0
2023-05-01,BEN,Perak,0,0,0
2023-05-01,BEN,Pulau Pinang,0,0,0
2023-05-01,BEN,Sabah,0,0,0
2023-05-01,BEN,Sarawak,0,0,0
2023-05-01,BEN,Selangor,12,9,3
2023-05-01,BFA,Perak,0,0,0
2023-05-01,BFA,Pulau Pinang,0,0,0
2023-05-01,BFA,Selangor,14,13,1
2023-05-01,BGD,Johor,2602,2243,359
2023-05-01,BGD,Kedah,37,25,12
2023-05-01,BGD,Kelantan,0,0,0
2023-05-01,BGD,Melaka,0,0,0
2023-05-01,BGD,Negeri Sembilan,0,0,0
2023-05-01,BGD,Pahang,0,0,0
2023-05-01,BGD,Perak,1,1,0
2023-05-01,BGD,Perlis,2,2,0
2023-05-01,BGD,Pulau Pinang,680,661,19
2023-05-01,BGD,Sabah,3,1,2
2023-05-01,BGD,Sarawak,50,45,5
2023-05-01,BGD,Selangor,45160,43891,1269
2023-05-01,BGD,W.P. Labuan,15,14,1
2023-05-01,BGR,Johor,50,32,18
2023-05-01,BGR,Kedah,4,2,2
2023-05-01,BGR,Kelantan,2,1,1
2023-05-01,BGR,Pahang,0,0,0
2023-05-01,BGR,Perak,0,0,0
2023-05-01,BGR,Perlis,0,0,0
2023-05-01,BGR,Pulau Pinang,6,4,2
2023-05-01,BGR,Sabah,0,0,0
2023-05-01,BGR,Sarawak,0,0,0
2023-05-01,BGR,Selangor,191,105,86
2023-05-01,BGR,W.P. Labuan,0,0,0
2023-05-01,BHR,Johor,6,3,3
2023-05-01,BHR,Kedah,0,0,0
2023-05-01,BHR,Kelantan,0,0,0
2023-05-01,BHR,Perlis,0,0,0
2023-05-01,BHR,Pulau Pinang,0,0,0
2023-05-01,BHR,Sabah,0,0,0
2023-05-01,BHR,Sarawak,0,0,0
2023-05-01,BHR,Selangor,120,68,52
2023-05-01,BHS,Johor,1,1,0
2023-05-01,BHS,Kedah,0,0,0
2023-05-01,BHS,Perak,0,0,0
2023-05-01,BHS,Sabah,0,0,0
2023-05-01,BHS,Sarawak,0,0,0
2023-05-01,BHS,Selangor,9,6,3
2023-05-01,BIH,Johor,13,9,4
2023-05-01,BIH,Kedah,0,0,0
2023-05-01,BIH,Perlis,0,0,0
2023-05-01,BIH,Pulau Pinang,2,2,0
2023-05-01,BIH,Sabah,0,0,0
2023-05-01,BIH,Sarawak,2,2,0
2023-05-01,BIH,Selangor,46,25,21
2023-05-01,BLR,Johor,10,4,6
2023-05-01,BLR,Kedah,10,6,4
2023-05-01,BLR,Kelantan,0,0,0
2023-05-01,BLR,Pahang,0,0,0
2023-05-01,BLR,Perak,0,0,0
2023-05-01,BLR,Perlis,3,3,0
2023-05-01,BLR,Pulau Pinang,3,2,1
2023-05-01,BLR,Sabah,0,0,0
2023-05-01,BLR,Sarawak,1,0,1
2023-05-01,BLR,Selangor,364,175,189
2023-05-01,BLR,W.P. Labuan,0,0,0
2023-05-01,BLZ,Johor,3,0,3
2023-05-01,BLZ,Pulau Pinang,0,0,0
2023-05-01,BLZ,Sarawak,0,0,0
2023-05-01,BLZ,Selangor,6,2,4
2023-05-01,BMU,Selangor,0,0,0
2023-05-01,BOL,Johor,1,0,1
2023-05-01,BOL,Kedah,1,1,0
2023-05-01,BOL,Melaka,0,0,0
2023-05-01,BOL,Perak,0,0,0
2023-05-01,BOL,Perlis,0,0,0
2023-05-01,BOL,Pulau Pinang,0,0,0
2023-05-01,BOL,Sabah,1,1,0
2023-05-01,BOL,Sarawak,0,0,0
2023-05-01,BOL,Selangor,38,26,12
2023-05-01,BRA,Johor,208,122,86
2023-05-01,BRA,Kedah,83,40,43
2023-05-01,BRA,Kelantan,0,0,0
2023-05-01,BRA,Melaka,0,0,0
2023-05-01,BRA,Pahang,0,0,0
2023-05-01,BRA,Perak,2,2,0
2023-05-01,BRA,Perlis,7,4,3
2023-05-01,BRA,Pulau Pinang,31,12,19
2023-05-01,BRA,Sabah,21,12,9
2023-05-01,BRA,Sarawak,7,4,3
2023-05-01,BRA,Selangor,772,463,309
2023-05-01,BRA,W.P. Labuan,0,0,0
2023-05-01,BRB,Johor,0,0,0
2023-05-01,BRB,Kedah,0,0,0
2023-05-01,BRB,Perlis,0,0,0
2023-05-01,BRB,Pulau Pinang,0,0,0
2023-05-01,BRB,Selangor,6,3,3
2023-05-01,BRN,Johor,330,185,145
2023-05-01,BRN,Kedah,22,10,12
2023-05-01,BRN,Kelantan,6,3,3
2023-05-01,BRN,Melaka,0,0,0
2023-05-01,BRN,Pahang,0,0,0
2023-05-01,BRN,Perak,4,1,3
2023-05-01,BRN,Perlis,5,2,3
2023-05-01,BRN,Pulau Pinang,11,7,4
2023-05-01,BRN,Sabah,729,303,426
2023-05-01,BRN,Sarawak,84510,47743,36767
2023-05-01,BRN,Selangor,3820,1898,1922
2023-05-01,BRN,W.P. Labuan,1202,764,438
2023-05-01,BTN,Johor,6,5,1
2023-05-01,BTN,Kedah,0,0,0
2023-05-01,BTN,Perak,0,0,0
2023-05-01,BTN,Perlis,0,0,0
2023-05-01,BTN,Pulau Pinang,1,1,0
2023-05-01,BTN,Sabah,0,0,0
2023-05-01,BTN,Sarawak,0,0,0
2023-05-01,BTN,Selangor,35,27,8
2023-05-01,BWA,Johor,0,0,0
2023-05-01,BWA,Kedah,0,0,0
2023-05-01,BWA,Perlis,0,0,0
2023-05-01,BWA,Pulau Pinang,0,0,0
2023-05-01,BWA,Sabah,0,0,0
2023-05-01,BWA,Sarawak,2,2,0
2023-05-01,BWA,Selangor,10,3,7
2023-05-01,CAF,Kedah,0,0,0
2023-05-01,CAF,Selangor,1,1,0
2023-05-01,CAN,Johor,1363,758,605
2023-05-01,CAN,Kedah,160,88,72
2023-05-01,CAN,Kelantan,11,8,3
2023-05-01,CAN,Melaka,0,0,0
2023-05-01,CAN,Negeri Sembilan,0,0,0
2023-05-01,CAN,Pahang,0,0,0
2023-05-01,CAN,Perak,31,16,15
2023-05-01,CAN,Perlis,67,30,37
2023-05-01,CAN,Pulau Pinang,416,237,179
2023-05-01,CAN,Sabah,171,79,92
2023-05-01,CAN,Sarawak,488,255,233
2023-05-01,CAN,Selangor,3929,2222,1707
2023-05-01,CAN,Terengganu,0,0,0
2023-05-01,CAN,W.P. Labuan,6,3,3
2023-05-01,CCK,Selangor,0,0,0
2023-05-01,CHE,Johor,324,194,130
2023-05-01,CHE,Kedah,150,79,71
2023-05-01,CHE,Kelantan,0,0,0
2023-05-01,CHE,Melaka,1,0,1
2023-05-01,CHE,Negeri Sembilan,0,0,0
2023-05-01,CHE,Pahang,5,2,3
2023-05-01,CHE,Perak,3,1,2
2023-05-01,CHE,Perlis,35,17,18
2023-05-01,CHE,Pulau Pinang,124,87,37
2023-05-01,CHE,Sabah,56,34,22
2023-05-01,CHE,Sarawak,43,23,20
2023-05-01,CHE,Selangor,1044,646,398
2023-05-01,CHE,W.P. Labuan,2,1,1
2023-05-01,CHL,Johor,21,11,10
2023-05-01,CHL,Kedah,14,5,9
2023-05-01,CHL,Kelantan,0,0,0
2023-05-01,CHL,Melaka,0,0,0
2023-05-01,CHL,Pahang,0,0,0
2023-05-01,CHL,Perak,0,0,0
2023-05-01,CHL,Perlis,4,2,2
2023-05-01,CHL,Pulau Pinang,4,2,2
2023-05-01,CHL,Sabah,2,1,1
2023-05-01,CHL,Sarawak,2,1,1
2023-05-01,CHL,Selangor,222,123,99
2023-05-01,CHN,Johor,36806,16137,20669
2023-05-01,CHN,Kedah,920,481,439
2023-05-01,CHN,Kelantan,11,4,7
2023-05-01,CHN,Melaka,2,1,1
2023-05-01,CHN,Pahang,45,31,14
2023-05-01,CHN,Perak,259,116,143
2023-05-01,CHN,Perlis,84,45,39
2023-05-01,CHN,Pulau Pinang,7202,4011,3191
2023-05-01,CHN,Sabah,11645,5509,6136
2023-05-01,CHN,Sarawak,785,360,425
2023-05-01,CHN,Selangor,75302,39798,35504
2023-05-01,CHN,Terengganu,0,0,0
2023-05-01,CHN,W.P. Labuan,75,64,11
2023-05-01,CIV,Johor,0,0,0
2023-05-01,CIV,Kedah,0,0,0
2023-05-01,CIV,Pulau Pinang,0,0,0
2023-05-01,CIV,Sabah,0,0,0
2023-05-01,CIV,Sarawak,0,0,0
2023-05-01,CIV,Selangor,37,28,9
2023-05-01,CMR,Johor,1,1,0
2023-05-01,CMR,Kedah,0,0,0
2023-05-01,CMR,Pulau Pinang,0,0,0
2023-05-01,CMR,Sabah,0,0,0
2023-05-01,CMR,Sarawak,0,0,0
2023-05-01,CMR,Selangor,32,21,11
2023-05-01,COD,Johor,0,0,0
2023-05-01,COD,Pulau Pinang,0,0,0
2023-05-01,COD,Sarawak,0,0,0
2023-05-01,COD,Selangor,16,12,4
2023-05-01,COG,Johor,0,0,0
2023-05-01,COG,Kedah,0,0,0
2023-05-01,COG,Selangor,0,0,0
2023-05-01,COK,Selangor,0,0,0
2023-05-01,COL,Johor,29,13,16
2023-05-01,COL,Kedah,1,0,1
2023-05-01,COL,Perak,0,0,0
2023-05-01,COL,Pulau Pinang,7,4,3
2023-05-01,COL,Sabah,3,0,3
2023-05-01,COL,Sarawak,5,2,3
2023-05-01,COL,Selangor,188,91,97
2023-05-01,COL,W.P. Labuan,0,0,0
2023-05-01,COM,Johor,0,0,0
2023-05-01,COM,Kedah,1,1,0
2023-05-01,COM,Selangor,3,3,0
2023-05-01,CPV,Johor,0,0,0
2023-05-01,CPV,Kedah,0,0,0
2023-05-01,CPV,Pulau Pinang,0,0,0
2023-05-01,CPV,Sabah,0,0,0
2023-05-01,CPV,Selangor,1,0,1
2023-05-01,CRI,Johor,3,2,1
2023-05-01,CRI,Kedah,0,0,0
2023-05-01,CRI,Perak,0,0,0
2023-05-01,CRI,Perlis,0,0,0
2023-05-01,CRI,Pulau Pinang,11,8,3
2023-05-01,CRI,Sabah,4,2,2
2023-05-01,CRI,Sarawak,0,0,0
2023-05-01,CRI,Selangor,44,24,20
2023-05-01,CUB,Johor,1,1,0
2023-05-01,CUB,Kedah,0,0,0
2023-05-01,CUB,Perlis,0,0,0
2023-05-01,CUB,Pulau Pinang,0,0,0
2023-05-01,CUB,Sabah,0,0,0
2023-05-01,CUB,Sarawak,0,0,0
2023-05-01,CUB,Selangor,31,17,14
2023-05-01,CYP,Johor,9,3,6
2023-05-01,CYP,Kedah,1,1,0
2023-05-01,CYP,Perak,0,0,0
2023-05-01,CYP,Perlis,0,0,0
2023-05-01,CYP,Pulau Pinang,1,1,0
2023-05-01,CYP,Sabah,0,0,0
2023-05-01,CYP,Sarawak,0,0,0
2023-05-01,CYP,Selangor,47,32,15
2023-05-01,CZE,Johor,58,39,19
2023-05-01,CZE,Kedah,33,18,15
2023-05-01,CZE,Kelantan,0,0,0
2023-05-01,CZE,Melaka,0,0,0
2023-05-01,CZE,Negeri Sembilan,0,0,0
2023-05-01,CZE,Perak,1,1,0
2023-05-01,CZE,Perlis,4,1,3
2023-05-01,CZE,Pulau Pinang,16,11,5
2023-05-01,CZE,Sabah,15,10,5
2023-05-01,CZE,Sarawak,17,12,5
2023-05-01,CZE,Selangor,299,189,110
2023-05-01,CZE,W.P. Labuan,2,1,1
2023-05-01,DEU,Johor,1735,1109,626
2023-05-01,DEU,Kedah,546,271,275
2023-05-01,DEU,Kelantan,16,9,7
2023-05-01,DEU,Melaka,6,6,0
2023-05-01,DEU,Negeri Sembilan,1,1,0
2023-05-01,DEU,Pahang,21,12,9
2023-05-01,DEU,Perak,41,26,15
2023-05-01,DEU,Perlis,114,70,44
2023-05-01,DEU,Pulau Pinang,655,459,196
2023-05-01,DEU,Sabah,127,68,59
2023-05-01,DEU,Sarawak,241,135,106
2023-05-01,DEU,Selangor,7816,4542,3274
2023-05-01,DEU,Terengganu,0,0,0
2023-05-01,DEU,W.P. Labuan,12,8,4
2023-05-01,DJI,Johor,1,1,0
2023-05-01,DJI,Selangor,39,21,18
2023-05-01,DMA,Johor,7,7,0
2023-05-01,DMA,Kedah,0,0,0
2023-05-01,DMA,Pulau Pinang,2,2,0
2023-05-01,DMA,Sabah,0,0,0
2023-05-01,DMA,Sarawak,0,0,0
2023-05-01,DMA,Selangor,23,21,2
2023-05-01,DMA,W.P. Labuan,0,0,0
2023-05-01,DNK,Johor,252,181,71
2023-05-01,DNK,Kedah,41,26,15
2023-05-01,DNK,Kelantan,0,0,0
2023-05-01,DNK,Melaka,1,1,0
2023-05-01,DNK,Negeri Sembilan,0,0,0
2023-05-01,DNK,Pahang,1,1,0
2023-05-01,DNK,Perak,0,0,0
2023-05-01,DNK,Perlis,6,4,2
2023-05-01,DNK,Pulau Pinang,50,36,14
2023-05-01,DNK,Sabah,30,15,15
2023-05-01,DNK,Sarawak,12,8,4
2023-05-01,DNK,Selangor,743,500,243
2023-05-01,DNK,W.P. Labuan,2,0,2
2023-05-01,DOM,Johor,2,2,0
2023-05-01,DOM,Kedah,0,0,0
2023-05-01,DOM,Perak,0,0,0
2023-05-01,DOM,Perlis,0,0,0
2023-05-01,DOM,Pulau Pinang,1,0,1
2023-05-01,DOM,Sabah,0,0,0
2023-05-01,DOM,Sarawak,0,0,0
2023-05-01,DOM,Selangor,19,12,7
2023-05-01,DZA,Johor,24,19,5
2023-05-01,DZA,Kedah,5,5,0
2023-05-01,DZA,Kelantan,0,0,0
2023-05-01,DZA,Melaka,0,0,0
2023-05-01,DZA,Perak,0,0,0
2023-05-01,DZA,Perlis,0,0,0
2023-05-01,DZA,Pulau Pinang,1,1,0
2023-05-01,DZA,Sabah,4,4,0
2023-05-01,DZA,Sarawak,5,4,1
2023-05-01,DZA,Selangor,616,403,213
2023-05-01,DZA,W.P. Labuan,1,1,0
2023-05-01,ECU,Johor,5,1,4
2023-05-01,ECU,Kedah,1,0,1
2023-05-01,ECU,Perak,0,0,0
2023-05-01,ECU,Perlis,0,0,0
2023-05-01,ECU,Pulau Pinang,1,1,0
2023-05-01,ECU,Sabah,0,0,0
2023-05-01,ECU,Sarawak,0,0,0
2023-05-01,ECU,Selangor,53,28,25
2023-05-01,EGY,Johor,201,158,43
2023-05-01,EGY,Kedah,13,9,4
2023-05-01,EGY,Kelantan,3,1,2
2023-05-01,EGY,Melaka,1,1,0
2023-05-01,EGY,Pahang,0,0,0
2023-05-01,EGY,Perak,0,0,0
2023-05-01,EGY,Perlis,2,1,1
2023-05-01,EGY,Pulau Pinang,4,3,1
2023-05-01,EGY,Sabah,6,6,0
2023-05-01,EGY,Sarawak,155,113,42
2023-05-01,EGY,Selangor,1735,1299,436
2023-05-01,EGY,Terengganu,0,0,0
2023-05-01,EGY,W.P. Labuan,1,1,0
2023-05-01,ERI,Johor,0,0,0
2023-05-01,ERI,Pulau Pinang,0,0,0
2023-05-01,ERI,Sabah,0,0,0
2023-05-01,ERI,Selangor,3,2,1
2023-05-01,ESP,Johor,393,247,146
2023-05-01,ESP,Kedah,86,51,35
2023-05-01,ESP,Kelantan,7,5,2
2023-05-01,ESP,Melaka,2,2,0
2023-05-01,ESP,Negeri Sembilan,1,1,0
2023-05-01,ESP,Pahang,0,0,0
2023-05-01,ESP,Perak,4,3,1
2023-05-01,ESP,Perlis,17,10,7
2023-05-01,ESP,Pulau Pinang,77,41,36
2023-05-01,ESP,Sabah,31,16,15
2023-05-01,ESP,Sarawak,56,40,16
2023-05-01,ESP,Selangor,1688,1027,661
2023-05-01,ESP,W.P. Labuan,2,0,2
2023-05-01,EST,Johor,37,22,15
2023-05-01,EST,Kedah,22,13,9
2023-05-01,EST,Kelantan,0,0,0
2023-05-01,EST,Pahang,0,0,0
2023-05-01,EST,Perak,0,0,0
2023-05-01,EST,Perlis,0,0,0
2023-05-01,EST,Pulau Pinang,1,1,0
2023-05-01,EST,Sabah,1,0,1
2023-05-01,EST,Sarawak,12,5,7
2023-05-01,EST,Selangor,97,51,46
2023-05-01,EST,W.P. Labuan,3,1,2
2023-05-01,ETH,Johor,13,5,8
2023-05-01,ETH,Kedah,0,0,0
2023-05-01,ETH,Pulau Pinang,0,0,0
2023-05-01,ETH,Sarawak,0,0,0
2023-05-01,ETH,Selangor,28,16,12
2023-05-01,FIN,Johor,124,72,52
2023-05-01,FIN,Kedah,34,16,18
2023-05-01,FIN,Kelantan,2,1,1
2023-05-01,FIN,Melaka,0,0,0
2023-05-01,FIN,Negeri Sembilan,0,0,0
2023-05-01,FIN,Pahang,0,0,0
2023-05-01,FIN,Perak,6,5,1
2023-05-01,FIN,Perlis,7,7,0
2023-05-01,FIN,Pulau Pinang,23,15,8
2023-05-01,FIN,Sabah,13,5,8
2023-05-01,FIN,Sarawak,11,7,4
2023-05-01,FIN,Selangor,337,214,123
2023-05-01,FIN,W.P. Labuan,1,0,1
2023-05-01,FJI,Johor,95,54,41
2023-05-01,FJI,Kedah,0,0,0
2023-05-01,FJI,Kelantan,0,0,0
2023-05-01,FJI,Perak,0,0,0
2023-05-01,FJI,Perlis,1,1,0
2023-05-01,FJI,Pulau Pinang,4,3,1
2023-05-01,FJI,Sabah,0,0,0
2023-05-01,FJI,Sarawak,3,1,2
2023-05-01,FJI,Selangor,107,65,42
2023-05-01,FRA,Johor,1777,1089,688
2023-05-01,FRA,Kedah,663,357,306
2023-05-01,FRA,Kelantan,20,11,9
2023-05-01,FRA,Melaka,4,1,3
2023-05-01,FRA,Negeri Sembilan,0,0,0
2023-05-01,FRA,Pahang,16,9,7
2023-05-01,FRA,Perak,32,18,14
2023-05-01,FRA,Perlis,97,65,32
2023-05-01,FRA,Pulau Pinang,368,230,138
2023-05-01,FRA,Sabah,122,71,51
2023-05-01,FRA,Sarawak,137,95,42
2023-05-01,FRA,Selangor,7387,4267,3120
2023-05-01,FRA,Terengganu,0,0,0
2023-05-01,FRA,W.P. Labuan,4,3,1
2023-05-01,FSM,Johor,0,0,0
2023-05-01,FSM,Pulau Pinang,0,0,0
2023-05-01,FSM,Selangor,0,0,0
2023-05-01,GAB,Johor,1,1,0
2023-05-01,GAB,Pulau Pinang,0,0,0
2023-05-01,GAB,Sarawak,0,0,0
2023-05-01,GAB,Selangor,12,7,5
2023-05-01,GBR,Johor,4306,2708,1598
2023-05-01,GBR,Kedah,1040,561,479
2023-05-01,GBR,Kelantan,7,6,1
2023-05-01,GBR,Melaka,1,1,0
2023-05-01,GBR,Negeri Sembilan,0,0,0
2023-05-01,GBR,Pahang,19,15,4
2023-05-01,GBR,Perak,82,53,29
2023-05-01,GBR,Perlis,153,99,54
2023-05-01,GBR,Pulau Pinang,1083,651,432
2023-05-01,GBR,Sabah,577,301,276
2023-05-01,GBR,Sarawak,1454,873,581
2023-05-01,GBR,Selangor,14201,8717,5484
2023-05-01,GBR,Terengganu,0,0,0
2023-05-01,GBR,W.P. Labuan,40,26,14
2023-05-01,GEO,Johor,4,4,0
2023-05-01,GEO,Kedah,2,2,0
2023-05-01,GEO,Melaka,0,0,0
2023-05-01,GEO,Perak,0,0,0
2023-05-01,GEO,Perlis,1,1,0
2023-05-01,GEO,Pulau Pinang,0,0,0
2023-05-01,GEO,Sabah,0,0,0
2023-05-01,GEO,Sarawak,0,0,0
2023-05-01,GEO,Selangor,55,30,25
2023-05-01,GHA,Johor,9,8,1
2023-05-01,GHA,Kedah,2,1,1
2023-05-01,GHA,Kelantan,0,0,0
2023-05-01,GHA,Pulau Pinang,0,0,0
2023-05-01,GHA,Sabah,0,0,0
2023-05-01,GHA,Sarawak,2,1,1
2023-05-01,GHA,Selangor,57,43,14
2023-05-01,GIB,Johor,0,0,0
2023-05-01,GIB,Sarawak,0,0,0
2023-05-01,GIN,Johor,20,15,5
2023-05-01,GIN,Kedah,0,0,0
2023-05-01,GIN,Kelantan,0,0,0
2023-05-01,GIN,Perlis,0,0,0
2023-05-01,GIN,Pulau Pinang,1,1,0
2023-05-01,GIN,Sabah,0,0,0
2023-05-01,GIN,Sarawak,1,1,0
2023-05-01,GIN,Selangor,56,45,11
2023-05-01,GLP,Selangor,0,0,0
2023-05-01,GMB,Johor,6,3,3
2023-05-01,GMB,Kedah,0,0,0
2023-05-01,GMB,Kelantan,0,0,0
2023-05-01,GMB,Pulau Pinang,0,0,0
2023-05-01,GMB,Sabah,0,0,0
2023-05-01,GMB,Sarawak,0,0,0
2023-05-01,GMB,Selangor,26,21,5
2023-05-01,GNB,Johor,0,0,0
2023-05-01,GNB,Selangor,1,1,0
2023-05-01,GNQ,Johor,0,0,0
2023-05-01,GNQ,Selangor,0,0,0
2023-05-01,GRC,Johor,67,58,9
2023-05-01,GRC,Kedah,8,7,1
2023-05-01,GRC,Kelantan,0,0,0
2023-05-01,GRC,Melaka,0,0,0
2023-05-01,GRC,Negeri Sembilan,0,0,0
2023-05-01,GRC,Pahang,1,1,0
2023-05-01,GRC,Perak,0,0,0
2023-05-01,GRC,Perlis,1,1,0
2023-05-01,GRC,Pulau Pinang,6,6,0
2023-05-01,GRC,Sabah,4,2,2
2023-05-01,GRC,Sarawak,4,3,1
2023-05-01,GRC,Selangor,155,119,36
2023-05-01,GRD,Johor,6,3,3
2023-05-01,GRD,Kedah,0,0,0
2023-05-01,GRD,Pulau Pinang,1,1,0
2023-05-01,GRD,Sabah,0,0,0
2023-05-01,GRD,Sarawak,0,0,0
2023-05-01,GRD,Selangor,6,6,0
2023-05-01,GRL,Johor,0,0,0
2023-05-01,GRL,Selangor,0,0,0
2023-05-01,GTM,Johor,6,2,4
2023-05-01,GTM,Kedah,0,0,0
2023-05-01,GTM,Pahang,0,0,0
2023-05-01,GTM,Perak,0,0,0
2023-05-01,GTM,Pulau Pinang,0,0,0
2023-05-01,GTM,Sabah,1,0,1
2023-05-01,GTM,Sarawak,0,0,0
2023-05-01,GTM,Selangor,19,11,8
2023-05-01,GTM,W.P. Labuan,0,0,0
2023-05-01,GUY,Johor,0,0,0
2023-05-01,GUY,Kedah,0,0,0
2023-05-01,GUY,Pulau Pinang,1,1,0
2023-05-01,GUY,Sarawak,0,0,0
2023-05-01,GUY,Selangor,4,1,3
2023-05-01,HKG,Johor,6,4,2
2023-05-01,HKG,Kedah,0,0,0
2023-05-01,HKG,Kelantan,0,0,0
2023-05-01,HKG,Pahang,3,1,2
2023-05-01,HKG,Perak,46,19,27
2023-05-01,HKG,Perlis,3,3,0
2023-05-01,HKG,Pulau Pinang,0,0,0
2023-05-01,HKG,Sabah,39,21,18
2023-05-01,HKG,Sarawak,0,0,0
2023-05-01,HKG,Selangor,19,7,12
2023-05-01,HKG,Terengganu,0,0,0
2023-05-01,HMD,Johor,0,0,0
2023-05-01,HND,Johor,1,1,0
2023-05-01,HND,Kedah,0,0,0
2023-05-01,HND,Perak,0,0,0
2023-05-01,HND,Pulau Pinang,0,0,0
2023-05-01,HND,Sabah,0,0,0
2023-05-01,HND,Sarawak,0,0,0
2023-05-01,HND,Selangor,7,5,2
2023-05-01,HRV,Johor,38,35,3
2023-05-01,HRV,Kedah,8,5,3
2023-05-01,HRV,Kelantan,1,1,0
2023-05-01,HRV,Melaka,0,0,0
2023-05-01,HRV,Pahang,0,0,0
2023-05-01,HRV,Perak,0,0,0
2023-05-01,HRV,Perlis,0,0,0
2023-05-01,HRV,Pulau Pinang,7,5,2
2023-05-01,HRV,Sabah,1,1,0
2023-05-01,HRV,Sarawak,4,2,2
2023-05-01,HRV,Selangor,138,99,39
2023-05-01,HTI,Johor,4,4,0
2023-05-01,HTI,Kedah,0,0,0
2023-05-01,HTI,Kelantan,0,0,0
2023-05-01,HTI,Perak,0,0,0
2023-05-01,HTI,Pulau Pinang,0,0,0
2023-05-01,HTI,Sabah,0,0,0
2023-05-01,HTI,Selangor,5,5,0
2023-05-01,HUN,Johor,59,37,22
2023-05-01,HUN,Kedah,21,12,9
2023-05-01,HUN,Kelantan,0,0,0
2023-05-01,HUN,Pahang,0,0,0
2023-05-01,HUN,Perak,0,0,0
2023-05-01,HUN,Perlis,0,0,0
2023-05-01,HUN,Pulau Pinang,12,9,3
2023-05-01,HUN,Sabah,3,2,1
2023-05-01,HUN,Sarawak,5,1,4
2023-05-01,HUN,Selangor,334,188,146
2023-05-01,HUN,W.P. Labuan,0,0,0
2023-05-01,IDN,Johor,102377,54873,47504
2023-05-01,IDN,Kedah,4628,1831,2797
2023-05-01,IDN,Kelantan,88,52,36
2023-05-01,IDN,Melaka,5199,2270,2929
2023-05-01,IDN,Negeri Sembilan,14294,10157,4137
2023-05-01,IDN,Pahang,33,22,11
2023-05-01,IDN,Perak,177,50,127
2023-05-01,IDN,Perlis,452,173,279
2023-05-01,IDN,Pulau Pinang,37752,14698,23054
2023-05-01,IDN,Sabah,6116,3204,2912
2023-05-01,IDN,Sarawak,47222,27986,19236
2023-05-01,IDN,Selangor,108569,52889,55680
2023-05-01,IDN,Terengganu,1,1,0
2023-05-01,IDN,W.P. Labuan,59,29,30
2023-05-01,IND,Johor,24610,15682,8928
2023-05-01,IND,Kedah,1429,726,703
2023-05-01,IND,Kelantan,7,6,1
2023-05-01,IND,Melaka,0,0,0
2023-05-01,IND,Negeri Sembilan,0,0,0
2023-05-01,IND,Pahang,5,4,1
2023-05-01,IND,Perak,302,234,68
2023-05-01,IND,Perlis,40,28,12
2023-05-01,IND,Pulau Pinang,1042,715,327
2023-05-01,IND,Sabah,280,192,88
2023-05-01,IND,Sarawak,1411,1096,315
2023-05-01,IND,Selangor,61760,40584,21176
2023-05-01,IND,Terengganu,0,0,0
2023-05-01,IND,W.P. Labuan,69,48,21
2023-05-01,IOT,Pulau Pinang,0,0,0
2023-05-01,IOT,Selangor,0,0,0
2023-05-01,IRL,Johor,258,157,101
2023-05-01,IRL,Kedah,73,36,37
2023-05-01,IRL,Kelantan,3,2,1
2023-05-01,IRL,Negeri Sembilan,0,0,0
2023-05-01,IRL,Pahang,1,1,0
2023-05-01,IRL,Perak,6,3,3
2023-05-01,IRL,Perlis,26,20,6
2023-05-01,IRL,Pulau Pinang,103,78,25
2023-05-01,IRL,Sabah,19,9,10
2023-05-01,IRL,Sarawak,52,31,21
2023-05-01,IRL,Selangor,999,642,357
2023-05-01,IRL,Terengganu,0,0,0
2023-05-01,IRL,W.P. Labuan,2,2,0
2023-05-01,IRN,Johor,94,60,34
2023-05-01,IRN,Kedah,22,11,11
2023-05-01,IRN,Kelantan,2,1,1
2023-05-01,IRN,Perak,0,0,0
2023-05-01,IRN,Perlis,16,8,8
2023-05-01,IRN,Pulau Pinang,9,4,5
2023-05-01,IRN,Sabah,0,0,0
2023-05-01,IRN,Sarawak,0,0,0
2023-05-01,IRN,Selangor,1050,611,439
2023-05-01,IRN,W.P. Labuan,0,0,0
2023-05-01,IRQ,Johor,22,17,5
2023-05-01,IRQ,Kedah,0,0,0
2023-05-01,IRQ,Kelantan,0,0,0
2023-05-01,IRQ,Melaka,0,0,0
2023-05-01,IRQ,Pahang,0,0,0
2023-05-01,IRQ,Perak,0,0,0
2023-05-01,IRQ,Perlis,0,0,0
2023-05-01,IRQ,Pulau Pinang,0,0,0
2023-05-01,IRQ,Sabah,0,0,0
2023-05-01,IRQ,Sarawak,2,1,1
2023-05-01,IRQ,Selangor,852,597,255
2023-05-01,ISL,Johor,4,4,0
2023-05-01,ISL,Kedah,3,3,0
2023-05-01,ISL,Kelantan,0,0,0
2023-05-01,ISL,Perak,0,0,0
2023-05-01,ISL,Perlis,0,0,0
2023-05-01,ISL,Pulau Pinang,1,1,0
2023-05-01,ISL,Sabah,1,1,0
2023-05-01,ISL,Sarawak,4,3,1
2023-05-01,ISL,Selangor,35,13,22
2023-05-01,ISL,W.P. Labuan,0,0,0
2023-05-01,ISR,Pulau Pinang,1,1,0
2023-05-01,ITA,Johor,515,383,132
2023-05-01,ITA,Kedah,122,82,40
2023-05-01,ITA,Kelantan,2,1,1
2023-05-01,ITA,Melaka,0,0,0
2023-05-01,ITA,Negeri Sembilan,0,0,0
2023-05-01,ITA,Pahang,1,1,0
2023-05-01,ITA,Perak,6,4,2
2023-05-01,ITA,Perlis,14,12,2
2023-05-01,ITA,Pulau Pinang,87,69,18
2023-05-01,ITA,Sabah,32,18,14
2023-05-01,ITA,Sarawak,63,32,31
2023-05-01,ITA,Selangor,1995,1401,594
2023-05-01,ITA,W.P. Labuan,0,0,0
2023-05-01,JAM,Johor,1,0,1
2023-05-01,JAM,Kedah,4,2,2
2023-05-01,JAM,Perak,0,0,0
2023-05-01,JAM,Pulau Pinang,2,2,0
2023-05-01,JAM,Sabah,0,0,0
2023-05-01,JAM,Sarawak,0,0,0
2023-05-01,JAM,Selangor,23,11,12
2023-05-01,JAM,W.P. Labuan,0,0,0
2023-05-01,JOR,Johor,13,8,5
2023-05-01,JOR,Kedah,9,8,1
2023-05-01,JOR,Kelantan,1,0,1
2023-05-01,JOR,Melaka,1,1,0
2023-05-01,JOR,Perlis,1,1,0
2023-05-01,JOR,Pulau Pinang,9,6,3
2023-05-01,JOR,Sabah,1,1,0
2023-05-01,JOR,Sarawak,0,0,0
2023-05-01,JOR,Selangor,690,436,254
2023-05-01,JOR,W.P. Labuan,0,0,0
2023-05-01,JPN,Johor,5169,3541,1628
2023-05-01,JPN,Kedah,312,158,154
2023-05-01,JPN,Kelantan,10,9,1
2023-05-01,JPN,Melaka,0,0,0
2023-05-01,JPN,Negeri Sembilan,0,0,0
2023-05-01,JPN,Pahang,7,7,0
2023-05-01,JPN,Perak,75,56,19
2023-05-01,JPN,Perlis,83,66,17
2023-05-01,JPN,Pulau Pinang,1283,967,316
2023-05-01,JPN,Sabah,361,189,172
2023-05-01,JPN,Sarawak,211,121,90
2023-05-01,JPN,Selangor,15311,9895,5416
2023-05-01,JPN,W.P. Labuan,10,9,1
2023-05-01,KAZ,Johor,42,22,20
2023-05-01,KAZ,Kedah,12,5,7
2023-05-01,KAZ,Kelantan,1,0,1
2023-05-01,KAZ,Melaka,0,0,0
2023-05-01,KAZ,Perak,0,0,0
2023-05-01,KAZ,Perlis,0,0,0
2023-05-01,KAZ,Pulau Pinang,5,2,3
2023-05-01,KAZ,Sabah,1,1,0
2023-05-01,KAZ,Sarawak,2,0,2
2023-05-01,KAZ,Selangor,602,217,385
2023-05-01,KAZ,W.P. Labuan,0,0,0
2023-05-01,KEN,Johor,37,16,21
2023-05-01,KEN,Kedah,4,2,2
2023-05-01,KEN,Kelantan,0,0,0
2023-05-01,KEN,Perak,0,0,0
2023-05-01,KEN,Perlis,0,0,0
2023-05-01,KEN,Pulau Pinang,1,0,1
2023-05-01,KEN,Sabah,0,0,0
2023-05-01,KEN,Sarawak,4,3,1
2023-05-01,KEN,Selangor,327,164,163
2023-05-01,KGZ,Johor,32,24,8
2023-05-01,KGZ,Kedah,1,1,0
2023-05-01,KGZ,Kelantan,0,0,0
2023-05-01,KGZ,Perak,0,0,0
2023-05-01,KGZ,Perlis,0,0,0
2023-05-01,KGZ,Pulau Pinang,1,0,1
2023-05-01,KGZ,Sabah,0,0,0
2023-05-01,KGZ,Sarawak,0,0,0
2023-05-01,KGZ,Selangor,204,102,102
2023-05-01,KHM,Johor,2888,1185,1703
2023-05-01,KHM,Kedah,253,148,105
2023-05-01,KHM,Kelantan,608,322,286
2023-05-01,KHM,Melaka,0,0,0
2023-05-01,KHM,Negeri Sembilan,0,0,0
2023-05-01,KHM,Pahang,0,0,0
2023-05-01,KHM,Perak,11,5,6
2023-05-01,KHM,Perlis,816,519,297
2023-05-01,KHM,Pulau Pinang,31,16,15
2023-05-01,KHM,Sabah,0,0,0
2023-05-01,KHM,Sarawak,16,4,12
2023-05-01,KHM,Selangor,4822,2239,2583
2023-05-01,KHM,W.P. Labuan,1,0,1
2023-05-01,KIR,Johor,1,1,0
2023-05-01,KIR,Sabah,0,0,0
2023-05-01,KIR,Selangor,0,0,0
2023-05-01,KNA,Johor,14,12,2
2023-05-01,KNA,Kedah,0,0,0
2023-05-01,KNA,Perlis,0,0,0
2023-05-01,KNA,Pulau Pinang,2,2,0
2023-05-01,KNA,Sabah,0,0,0
2023-05-01,KNA,Selangor,59,46,13
2023-05-01,KNA,W.P. Labuan,0,0,0
2023-05-01,KOR,Johor,7381,4226,3155
2023-05-01,KOR,Kedah,313,218,95
2023-05-01,KOR,Kelantan,0,0,0
2023-05-01,KOR,Melaka,1,1,0
2023-05-01,KOR,Negeri Sembilan,0,0,0
2023-05-01,KOR,Pahang,1,0,1
2023-05-01,KOR,Perak,34,15,19
2023-05-01,KOR,Perlis,62,47,15
2023-05-01,KOR,Pulau Pinang,487,303,184
2023-05-01,KOR,Sabah,14466,5891,8575
2023-05-01,KOR,Sarawak,248,145,103
2023-05-01,KOR,Selangor,10165,5951,4214
2023-05-01,KOR,Terengganu,0,0,0
2023-05-01,KOR,W.P. Labuan,15,14,1
2023-05-01,KWT,Johor,10,5,5
2023-05-01,KWT,Kedah,11,7,4
2023-05-01,KWT,Kelantan,1,1,0
2023-05-01,KWT,Perak,0,0,0
2023-05-01,KWT,Perlis,0,0,0
2023-05-01,KWT,Pulau Pinang,1,1,0
2023-05-01,KWT,Sabah,0,0,0
2023-05-01,KWT,Sarawak,1,1,0
2023-05-01,KWT,Selangor,387,243,144
2023-05-01,KWT,W.P. Labuan,0,0,0
2023-05-01,LAO,Johor,115,27,88
2023-05-01,LAO,Kedah,1312,121,1191
2023-05-01,LAO,Kelantan,227,13,214
2023-05-01,LAO,Melaka,0,0,0
2023-05-01,LAO,Perak,26,8,18
2023-05-01,LAO,Perlis,294,109,185
2023-05-01,LAO,Pulau Pinang,27,11,16
2023-05-01,LAO,Sabah,1,0,1
2023-05-01,LAO,Sarawak,11,5,6
2023-05-01,LAO,Selangor,256,91,165
2023-05-01,LAO,W.P. Labuan,0,0,0
2023-05-01,LBN,Johor,30,18,12
2023-05-01,LBN,Kedah,5,1,4
2023-05-01,LBN,Kelantan,0,0,0
2023-05-01,LBN,Pahang,0,0,0
2023-05-01,LBN,Perak,0,0,0
2023-05-01,LBN,Perlis,0,0,0
2023-05-01,LBN,Pulau Pinang,2,2,0
2023-05-01,LBN,Sabah,1,1,0
2023-05-01,LBN,Sarawak,1,1,0
2023-05-01,LBN,Selangor,226,165,61
2023-05-01,LBN,W.P. Labuan,0,0,0
2023-05-01,LBR,Johor,2,1,1
2023-05-01,LBR,Kedah,0,0,0
2023-05-01,LBR,Sabah,0,0,0
2023-05-01,LBR,Sarawak,0,0,0
2023-05-01,LBR,Selangor,5,4,1
2023-05-01,LBY,Johor,1,1,0
2023-05-01,LBY,Kedah,0,0,0
2023-05-01,LBY,Perlis,0,0,0
2023-05-01,LBY,Pulau Pinang,1,1,0
2023-05-01,LBY,Sabah,1,1,0
2023-05-01,LBY,Sarawak,2,1,1
2023-05-01,LBY,Selangor,361,224,137
2023-05-01,LCA,Johor,11,11,0
2023-05-01,LCA,Kedah,0,0,0
2023-05-01,LCA,Pulau Pinang,0,0,0
2023-05-01,LCA,Sarawak,1,1,0
2023-05-01,LCA,Selangor,7,5,2
2023-05-01,LIE,Johor,1,1,0
2023-05-01,LIE,Kedah,0,0,0
2023-05-01,LIE,Perlis,0,0,0
2023-05-01,LIE,Pulau Pinang,0,0,0
2023-05-01,LIE,Sabah,0,0,0
2023-05-01,LIE,Sarawak,0,0,0
2023-05-01,LIE,Selangor,2,1,1
2023-05-01,LKA,Johor,1089,754,335
2023-05-01,LKA,Kedah,41,25,16
2023-05-01,LKA,Kelantan,8,7,1
2023-05-01,LKA,Melaka,0,0,0
2023-05-01,LKA,Pahang,0,0,0
2023-05-01,LKA,Perak,2,2,0
2023-05-01,LKA,Perlis,1,1,0
2023-05-01,LKA,Pulau Pinang,30,24,6
2023-05-01,LKA,Sabah,11,7,4
2023-05-01,LKA,Sarawak,25,17,8
2023-05-01,LKA,Selangor,3836,2679,1157
2023-05-01,LKA,W.P. Labuan,0,0,0
2023-05-01,LSO,Johor,0,0,0
2023-05-01,LSO,Kedah,0,0,0
2023-05-01,LSO,Pulau Pinang,0,0,0
2023-05-01,LSO,Sarawak,0,0,0
2023-05-01,LSO,Selangor,2,0,2
2023-05-01,LTU,Johor,44,16,28
2023-05-01,LTU,Kedah,17,8,9
2023-05-01,LTU,Kelantan,1,1,0
2023-05-01,LTU,Pahang,0,0,0
2023-05-01,LTU,Perak,0,0,0
2023-05-01,LTU,Perlis,2,1,1
2023-05-01,LTU,Pulau Pinang,6,5,1
2023-05-01,LTU,Sabah,0,0,0
2023-05-01,LTU,Sarawak,25,11,14
2023-05-01,LTU,Selangor,207,112,95
2023-05-01,LTU,W.P. Labuan,0,0,0
2023-05-01,LUX,Johor,5,3,2
2023-05-01,LUX,Kedah,9,4,5
2023-05-01,LUX,Kelantan,0,0,0
2023-05-01,LUX,Perak,0,0,0
2023-05-01,LUX,Perlis,0,0,0
2023-05-01,LUX,Pulau Pinang,4,2,2
2023-05-01,LUX,Sabah,0,0,0
2023-05-01,LUX,Sarawak,1,1,0
2023-05-01,LUX,Selangor,38,26,12
2023-05-01,LVA,Johor,19,7,12
2023-05-01,LVA,Kedah,8,3,5
2023-05-01,LVA,Kelantan,0,0,0
2023-05-01,LVA,Pahang,0,0,0
2023-05-01,LVA,Perak,2,0,2
2023-05-01,LVA,Perlis,4,2,2
2023-05-01,LVA,Pulau Pinang,2,0,2
2023-05-01,LVA,Sabah,0,0,0
2023-05-01,LVA,Sarawak,14,7,7
2023-05-01,LVA,Selangor,79,41,38
2023-05-01,LVA,W.P. Labuan,1,0,1
2023-05-01,MAC,Johor,1,0,1
2023-05-01,MAC,Pahang,0,0,0
2023-05-01,MAC,Perak,4,2,2
2023-05-01,MAC,Selangor,3,1,2
2023-05-01,MAC,W.P. Labuan,0,0,0
2023-05-01,MAR,Johor,65,47,18
2023-05-01,MAR,Kedah,15,12,3
2023-05-01,MAR,Kelantan,0,0,0
2023-05-01,MAR,Melaka,0,0,0
2023-05-01,MAR,Pahang,0,0,0
2023-05-01,MAR,Perak,0,0,0
2023-05-01,MAR,Perlis,3,3,0
2023-05-01,MAR,Pulau Pinang,6,4,2
2023-05-01,MAR,Sabah,5,2,3
2023-05-01,MAR,Sarawak,3,3,0
2023-05-01,MAR,Selangor,807,416,391
2023-05-01,MAR,W.P. Labuan,0,0,0
2023-05-01,MCO,Johor,0,0,0
2023-05-01,MCO,Kedah,0,0,0
2023-05-01,MCO,Sabah,0,0,0
2023-05-01,MCO,Selangor,1,0,1
2023-05-01,MDA,Johor,9,4,5
2023-05-01,MDA,Kedah,2,2,0
2023-05-01,MDA,Kelantan,0,0,0
2023-05-01,MDA,Negeri Sembilan,0,0,0
2023-05-01,MDA,Perlis,1,0,1
2023-05-01,MDA,Pulau Pinang,2,1,1
2023-05-01,MDA,Sabah,0,0,0
2023-05-01,MDA,Sarawak,0,0,0
2023-05-01,MDA,Selangor,29,18,11
2023-05-01,MDG,Johor,7,1,6
2023-05-01,MDG,Kedah,2,0,2
2023-05-01,MDG,Perak,0,0,0
2023-05-01,MDG,Perlis,0,0,0
2023-05-01,MDG,Pulau Pinang,0,0,0
2023-05-01,MDG,Sabah,0,0,0
2023-05-01,MDG,Sarawak,0,0,0
2023-05-01,MDG,Selangor,55,27,28
2023-05-01,MDV,Johor,91,48,43
2023-05-01,MDV,Kedah,3,2,1
2023-05-01,MDV,Kelantan,0,0,0
2023-05-01,MDV,Perak,1,0,1
2023-05-01,MDV,Perlis,0,0,0
2023-05-01,MDV,Pulau Pinang,5,3,2
2023-05-01,MDV,Sabah,3,3,0
2023-05-01,MDV,Sarawak,5,3,2
2023-05-01,MDV,Selangor,1785,1019,766
2023-05-01,MEX,Johor,168,83,85
2023-05-01,MEX,Kedah,6,4,2
2023-05-01,MEX,Kelantan,0,0,0
2023-05-01,MEX,Pahang,0,0,0
2023-05-01,MEX,Perak,1,1,0
2023-05-01,MEX,Perlis,0,0,0
2023-05-01,MEX,Pulau Pinang,28,16,12
2023-05-01,MEX,Sabah,7,2,5
2023-05-01,MEX,Sarawak,7,4,3
2023-05-01,MEX,Selangor,569,305,264
2023-05-01,MEX,W.P. Labuan,0,0,0
2023-05-01,MHL,Johor,3,2,1
2023-05-01,MHL,Kedah,0,0,0
2023-05-01,MHL,Perak,0,0,0
2023-05-01,MHL,Pulau Pinang,0,0,0
2023-05-01,MHL,Sabah,0,0,0
2023-05-01,MHL,Selangor,2,2,0
2023-05-01,MKD,Johor,11,5,6
2023-05-01,MKD,Kedah,19,6,13
2023-05-01,MKD,Perak,0,0,0
2023-05-01,MKD,Pulau Pinang,0,0,0
2023-05-01,MKD,Sabah,0,0,0
2023-05-01,MKD,Sarawak,1,0,1
2023-05-01,MKD,Selangor,38,23,15
2023-05-01,MLI,Johor,1,1,0
2023-05-01,MLI,Sabah,0,0,0
2023-05-01,MLI,Selangor,14,9,5
2023-05-01,MLT,Johor,4,4,0
2023-05-01,MLT,Kedah,1,1,0
2023-05-01,MLT,Kelantan,0,0,0
2023-05-01,MLT,Perak,0,0,0
2023-05-01,MLT,Perlis,2,1,1
2023-05-01,MLT,Pulau Pinang,1,1,0
2023-05-01,MLT,Sabah,0,0,0
2023-05-01,MLT,Sarawak,1,1,0
2023-05-01,MLT,Selangor,33,19,14
2023-05-01,MLT,W.P. Labuan,0,0,0
2023-05-01,MMR,Johor,4099,1217,2882
2023-05-01,MMR,Kedah,75,17,58
2023-05-01,MMR,Kelantan,4,0,4
2023-05-01,MMR,Negeri Sembilan,0,0,0
2023-05-01,MMR,Pahang,6,1,5
2023-05-01,MMR,Perak,25,4,21
2023-05-01,MMR,Perlis,4,0,4
2023-05-01,MMR,Pulau Pinang,357,210,147
2023-05-01,MMR,Sabah,23,8,15
2023-05-01,MMR,Sarawak,68,27,41
2023-05-01,MMR,Selangor,8848,6404,2444
2023-05-01,MMR,Terengganu,0,0,0
2023-05-01,MMR,W.P. Labuan,2,1,1
2023-05-01,MNE,Johor,2,2,0
2023-05-01,MNE,Kedah,0,0,0
2023-05-01,MNE,Pulau Pinang,0,0,0
2023-05-01,MNE,Sabah,0,0,0
2023-05-01,MNE,Sarawak,0,0,0
2023-05-01,MNE,Selangor,11,8,3
2023-05-01,MNG,Johor,125,44,81
2023-05-01,MNG,Kedah,8,6,2
2023-05-01,MNG,Kelantan,0,0,0
2023-05-01,MNG,Perak,0,0,0
2023-05-01,MNG,Perlis,7,5,2
2023-05-01,MNG,Pulau Pinang,4,0,4
2023-05-01,MNG,Sabah,10,3,7
2023-05-01,MNG,Sarawak,1,0,1
2023-05-01,MNG,Selangor,256,90,166
2023-05-01,MNP,Selangor,0,0,0
2023-05-01,MOZ,Johor,0,0,0
2023-05-01,MOZ,Kedah,0,0,0
2023-05-01,MOZ,Perak,0,0,0
2023-05-01,MOZ,Pulau Pinang,0,0,0
2023-05-01,MOZ,Sabah,0,0,0
2023-05-01,MOZ,Sarawak,0,0,0
2023-05-01,MOZ,Selangor,71,34,37
2023-05-01,MRT,Johor,2,2,0
2023-05-01,MRT,Kedah,0,0,0
2023-05-01,MRT,Pulau Pinang,0,0,0
2023-05-01,MRT,Sabah,0,0,0
2023-05-01,MRT,Sarawak,4,4,0
2023-05-01,MRT,Selangor,8,7,1
2023-05-01,MUS,Johor,142,76,66
2023-05-01,MUS,Kedah,5,4,1
2023-05-01,MUS,Kelantan,0,0,0
2023-05-01,MUS,Pahang,0,0,0
2023-05-01,MUS,Perak,0,0,0
2023-05-01,MUS,Perlis,0,0,0
2023-05-01,MUS,Pulau Pinang,7,6,1
2023-05-01,MUS,Sabah,1,1,0
2023-05-01,MUS,Sarawak,2,1,1
2023-05-01,MUS,Selangor,1332,749,583
2023-05-01,MWI,Johor,0,0,0
2023-05-01,MWI,Pulau Pinang,0,0,0
2023-05-01,MWI,Sabah,0,0,0
2023-05-01,MWI,Sarawak,2,0,2
2023-05-01,MWI,Selangor,16,11,5
2023-05-01,MYT,Selangor,0,0,0
2023-05-01,NAM,Johor,4,3,1
2023-05-01,NAM,Kedah,0,0,0
2023-05-01,NAM,Perak,0,0,0
2023-05-01,NAM,Perlis,0,0,0
2023-05-01,NAM,Pulau Pinang,0,0,0
2023-05-01,NAM,Sabah,0,0,0
2023-05-01,NAM,Sarawak,0,0,0
2023-05-01,NAM,Selangor,20,3,17
2023-05-01,NCL,Selangor,0,0,0
2023-05-01,NER,Johor,1,1,0
2023-05-01,NER,Sabah,0,0,0
2023-05-01,NER,Selangor,5,4,1
2023-05-01,NGA,Johor,35,32,3
2023-05-01,NGA,Kedah,2,1,1
2023-05-01,NGA,Perlis,0,0,0
2023-05-01,NGA,Pulau Pinang,3,3,0
2023-05-01,NGA,Sabah,0,0,0
2023-05-01,NGA,Sarawak,3,2,1
2023-05-01,NGA,Selangor,517,399,118
2023-05-01,NIC,Johor,0,0,0
2023-05-01,NIC,Kedah,0,0,0
2023-05-01,NIC,Pulau Pinang,0,0,0
2023-05-01,NIC,Sabah,0,0,0
2023-05-01,NIC,Selangor,3,1,2
2023-05-01,NLD,Johor,937,622,315
2023-05-01,NLD,Kedah,381,180,201
2023-05-01,NLD,Kelantan,3,2,1
2023-05-01,NLD,Melaka,0,0,0
2023-05-01,NLD,Negeri Sembilan,0,0,0
2023-05-01,NLD,Pahang,0,0,0
2023-05-01,NLD,Perak,13,6,7
2023-05-01,NLD,Perlis,28,17,11
2023-05-01,NLD,Pulau Pinang,264,176,88
2023-05-01,NLD,Sabah,102,51,51
2023-05-01,NLD,Sarawak,189,123,66
2023-05-01,NLD,Selangor,3927,2286,1641
2023-05-01,NLD,Terengganu,0,0,0
2023-05-01,NLD,W.P. Labuan,0,0,0
2023-05-01,NOR,Johor,110,74,36
2023-05-01,NOR,Kedah,31,16,15
2023-05-01,NOR,Kelantan,0,0,0
2023-05-01,NOR,Melaka,0,0,0
2023-05-01,NOR,Pahang,0,0,0
2023-05-01,NOR,Perak,1,1,0
2023-05-01,NOR,Perlis,6,2,4
2023-05-01,NOR,Pulau Pinang,17,10,7
2023-05-01,NOR,Sabah,6,4,2
2023-05-01,NOR,Sarawak,9,9,0
2023-05-01,NOR,Selangor,466,310,156
2023-05-01,NOR,W.P. Labuan,0,0,0
2023-05-01,NPL,Johor,471,334,137
2023-05-01,NPL,Kedah,10,5,5
2023-05-01,NPL,Pahang,0,0,0
2023-05-01,NPL,Perak,1,1,0
2023-05-01,NPL,Perlis,0,0,0
2023-05-01,NPL,Pulau Pinang,31,23,8
2023-05-01,NPL,Sabah,4,3,1
2023-05-01,NPL,Sarawak,255,170,85
2023-05-01,NPL,Selangor,15437,14805,632
2023-05-01,NPL,W.P. Labuan,54,50,4
2023-05-01,NRU,Johor,1,0,1
2023-05-01,NRU,Pulau Pinang,0,0,0
2023-05-01,NRU,Selangor,2,2,0
2023-05-01,NZL,Johor,659,411,248
2023-05-01,NZL,Kedah,75,43,32
2023-05-01,NZL,Kelantan,0,0,0
2023-05-01,NZL,Melaka,1,1,0
2023-05-01,NZL,Negeri Sembilan,0,0,0
2023-05-01,NZL,Pahang,3,2,1
2023-05-01,NZL,Perak,20,12,8
2023-05-01,NZL,Perlis,7,5,2
2023-05-01,NZL,Pulau Pinang,199,122,77
2023-05-01,NZL,Sabah,90,46,44
2023-05-01,NZL,Sarawak,140,70,70
2023-05-01,NZL,Selangor,2377,1435,942
2023-05-01,NZL,Terengganu,0,0,0
2023-05-01,NZL,W.P. Labuan,1,1,0
2023-05-01,OMN,Johor,25,20,5
2023-05-01,OMN,Kedah,6,3,3
2023-05-01,OMN,Kelantan,0,0,0
2023-05-01,OMN,Melaka,0,0,0
2023-05-01,OMN,Perak,3,2,1
2023-05-01,OMN,Perlis,7,5,2
2023-05-01,OMN,Pulau Pinang,1,1,0
2023-05-01,OMN,Sabah,1,1,0
2023-05-01,OMN,Sarawak,15,8,7
2023-05-01,OMN,Selangor,801,494,307
2023-05-01,PAK,Johor,810,629,181
2023-05-01,PAK,Kedah,76,52,24
2023-05-01,PAK,Kelantan,4,4,0
2023-05-01,PAK,Melaka,0,0,0
2023-05-01,PAK,Negeri Sembilan,1,1,0
2023-05-01,PAK,Pahang,0,0,0
2023-05-01,PAK,Perak,18,18,0
2023-05-01,PAK,Perlis,25,22,3
2023-05-01,PAK,Pulau Pinang,133,119,14
2023-05-01,PAK,Sabah,13,12,1
2023-05-01,PAK,Sarawak,142,126,16
2023-05-01,PAK,Selangor,13691,12546,1145
2023-05-01,PAK,W.P. Labuan,0,0,0
2023-05-01,PAN,Johor,2,1,1
2023-05-01,PAN,Kedah,0,0,0
2023-05-01,PAN,Perak,2,2,0
2023-05-01,PAN,Perlis,0,0,0
2023-05-01,PAN,Pulau Pinang,0,0,0
2023-05-01,PAN,Sabah,0,0,0
2023-05-01,PAN,Sarawak,0,0,0
2023-05-01,PAN,Selangor,14,8,6
2023-05-01,PER,Johor,20,16,4
2023-05-01,PER,Kedah,5,2,3
2023-05-01,PER,Kelantan,0,0,0
2023-05-01,PER,Pahang,0,0,0
2023-05-01,PER,Perak,0,0,0
2023-05-01,PER,Perlis,0,0,0
2023-05-01,PER,Pulau Pinang,2,0,2
2023-05-01,PER,Sabah,1,0,1
2023-05-01,PER,Sarawak,0,0,0
2023-05-01,PER,Selangor,140,63,77
2023-05-01,PER,W.P. Labuan,0,0,0
2023-05-01,PHL,Johor,18515,5944,12571
2023-05-01,PHL,Kedah,581,161,420
2023-05-01,PHL,Kelantan,41,19,22
2023-05-01,PHL,Melaka,0,0,0
2023-05-01,PHL,Negeri Sembilan,0,0,0
2023-05-01,PHL,Pahang,36,27,9
2023-05-01,PHL,Perak,67,17,50
2023-05-01,PHL,Perlis,84,30,54
2023-05-01,PHL,Pulau Pinang,583,275,308
2023-05-01,PHL,Sabah,1086,460,626
2023-05-01,PHL,Sarawak,2556,999,1557
2023-05-01,PHL,Selangor,15100,6180,8920
2023-05-01,PHL,Terengganu,0,0,0
2023-05-01,PHL,W.P. Labuan,96,23,73
2023-05-01,PLW,Johor,0,0,0
2023-05-01,PLW,Pulau Pinang,0,0,0
2023-05-01,PLW,Selangor,0,0,0
2023-05-01,PNG,Johor,12,7,5
2023-05-01,PNG,Kedah,2,1,1
2023-05-01,PNG,Kelantan,0,0,0
2023-05-01,PNG,Perak,0,0,0
2023-05-01,PNG,Pulau Pinang,3,1,2
2023-05-01,PNG,Sabah,0,0,0
2023-05-01,PNG,Sarawak,3,1,2
2023-05-01,PNG,Selangor,48,30,18
2023-05-01,POL,Johor,247,146,101
2023-05-01,POL,Kedah,57,33,24
2023-05-01,POL,Kelantan,3,1,2
2023-05-01,POL,Melaka,0,0,0
2023-05-01,POL,Negeri Sembilan,0,0,0
2023-05-01,POL,Pahang,1,1,0
2023-05-01,POL,Perak,4,2,2
2023-05-01,POL,Perlis,16,10,6
2023-05-01,POL,Pulau Pinang,47,25,22
2023-05-01,POL,Sabah,34,17,17
2023-05-01,POL,Sarawak,55,23,32
2023-05-01,POL,Selangor,950,537,413
2023-05-01,POL,Terengganu,0,0,0
2023-05-01,POL,W.P. Labuan,3,2,1
2023-05-01,PRK,Selangor,0,0,0
2023-05-01,PRT,Johor,131,85,46
2023-05-01,PRT,Kedah,36,16,20
2023-05-01,PRT,Kelantan,1,0,1
2023-05-01,PRT,Melaka,0,0,0
2023-05-01,PRT,Pahang,0,0,0
2023-05-01,PRT,Perak,0,0,0
2023-05-01,PRT,Perlis,6,5,1
2023-05-01,PRT,Pulau Pinang,39,20,19
2023-05-01,PRT,Sabah,9,8,1
2023-05-01,PRT,Sarawak,23,11,12
2023-05-01,PRT,Selangor,667,393,274
2023-05-01,PRT,W.P. Labuan,2,1,1
2023-05-01,PRY,Johor,2,0,2
2023-05-01,PRY,Kedah,0,0,0
2023-05-01,PRY,Perak,0,0,0
2023-05-01,PRY,Perlis,0,0,0
2023-05-01,PRY,Pulau Pinang,0,0,0
2023-05-01,PRY,Sabah,0,0,0
2023-05-01,PRY,Sarawak,0,0,0
2023-05-01,PRY,Selangor,14,7,7
2023-05-01,PSE,Johor,24,24,0
2023-05-01,PSE,Kedah,1,1,0
2023-05-01,PSE,Kelantan,0,0,0
2023-05-01,PSE,Melaka,1,1,0
2023-05-01,PSE,Perak,0,0,0
2023-05-01,PSE,Perlis,0,0,0
2023-05-01,PSE,Pulau Pinang,2,2,0
2023-05-01,PSE,Sabah,1,1,0
2023-05-01,PSE,Sarawak,2,1,1
2023-05-01,PSE,Selangor,265,205,60
2023-05-01,QAT,Johor,12,6,6
2023-05-01,QAT,Kedah,2,1,1
2023-05-01,QAT,Perlis,0,0,0
2023-05-01,QAT,Pulau Pinang,0,0,0
2023-05-01,QAT,Sabah,0,0,0
2023-05-01,QAT,Sarawak,1,1,0
2023-05-01,QAT,Selangor,108,75,33
2023-05-01,REU,Johor,0,0,0
2023-05-01,REU,Sarawak,0,0,0
2023-05-01,ROU,Johor,102,65,37
2023-05-01,ROU,Kedah,12,5,7
2023-05-01,ROU,Kelantan,0,0,0
2023-05-01,ROU,Negeri Sembilan,0,0,0
2023-05-01,ROU,Pahang,1,1,0
2023-05-01,ROU,Perak,1,1,0
2023-05-01,ROU,Perlis,6,3,3
2023-05-01,ROU,Pulau Pinang,26,15,11
2023-05-01,ROU,Sabah,2,1,1
2023-05-01,ROU,Sarawak,11,9,2
2023-05-01,ROU,Selangor,419,219,200
2023-05-01,ROU,W.P. Labuan,0,0,0
2023-05-01,RUS,Johor,418,209,209
2023-05-01,RUS,Kedah,692,410,282
2023-05-01,RUS,Kelantan,72,43,29
2023-05-01,RUS,Melaka,1,1,0
2023-05-01,RUS,Negeri Sembilan,0,0,0
2023-05-01,RUS,Pahang,7,6,1
2023-05-01,RUS,Perak,7,4,3
2023-05-01,RUS,Perlis,300,168,132
2023-05-01,RUS,Pulau Pinang,160,78,82
2023-05-01,RUS,Sabah,47,28,19
2023-05-01,RUS,Sarawak,77,41,36
2023-05-01,RUS,Selangor,8734,4583,4151
2023-05-01,RUS,W.P. Labuan,6,4,2
2023-05-01,RWA,Johor,0,0,0
2023-05-01,RWA,Kedah,0,0,0
2023-05-01,RWA,Pulau Pinang,0,0,0
2023-05-01,RWA,Selangor,10,6,4
2023-05-01,SAU,Johor,109,66,43
2023-05-01,SAU,Kedah,12,6,6
2023-05-01,SAU,Kelantan,11,5,6
2023-05-01,SAU,Melaka,0,0,0
2023-05-01,SAU,Perak,3,1,2
2023-05-01,SAU,Perlis,7,2,5
2023-05-01,SAU,Pulau Pinang,35,19,16
2023-05-01,SAU,Sabah,0,0,0
2023-05-01,SAU,Sarawak,9,6,3
2023-05-01,SAU,Selangor,3381,2041,1340
2023-05-01,SAU,W.P. Labuan,0,0,0
2023-05-01,SDN,Johor,9,6,3
2023-05-01,SDN,Kedah,0,0,0
2023-05-01,SDN,Kelantan,0,0,0
2023-05-01,SDN,Perlis,0,0,0
2023-05-01,SDN,Pulau Pinang,0,0,0
2023-05-01,SDN,Sabah,0,0,0
2023-05-01,SDN,Sarawak,2,2,0
2023-05-01,SDN,Selangor,434,273,161
2023-05-01,SDN,W.P. Labuan,0,0,0
2023-05-01,SEN,Johor,21,20,1
2023-05-01,SEN,Kedah,1,0,1
2023-05-01,SEN,Kelantan,0,0,0
2023-05-01,SEN,Perak,0,0,0
2023-05-01,SEN,Perlis,0,0,0
2023-05-01,SEN,Pulau Pinang,2,1,1
2023-05-01,SEN,Sabah,0,0,0
2023-05-01,SEN,Sarawak,1,0,1
2023-05-01,SEN,Selangor,69,49,20
2023-05-01,SGP,Johor,1035130,606272,428858
2023-05-01,SGP,Kedah,4658,2620,2038
2023-05-01,SGP,Kelantan,52,39,13
2023-05-01,SGP,Melaka,18,11,7
2023-05-01,SGP,Negeri Sembilan,4,2,2
2023-05-01,SGP,Pahang,521,268,253
2023-05-01,SGP,Perak,5790,2691,3099
2023-05-01,SGP,Perlis,182,95,87
2023-05-01,SGP,Pulau Pinang,16984,8733,8251
2023-05-01,SGP,Sabah,3478,1843,1635
2023-05-01,SGP,Sarawak,4415,2542,1873
2023-05-01,SGP,Selangor,48167,24682,23485
2023-05-01,SGP,Terengganu,0,0,0
2023-05-01,SGP,W.P. Labuan,13,13,0
2023-05-01,SGS,Johor,0,0,0
2023-05-01,SGS,Sabah,0,0,0
2023-05-01,SGS,Selangor,0,0,0
2023-05-01,SHN,Sarawak,0,0,0
2023-05-01,SLB,Johor,0,0,0
2023-05-01,SLB,Perlis,0,0,0
2023-05-01,SLB,Pulau Pinang,0,0,0
2023-05-01,SLB,Sabah,1,0,1
2023-05-01,SLB,Sarawak,3,1,2
2023-05-01,SLB,Selangor,15,3,12
2023-05-01,SLB,W.P. Labuan,0,0,0
2023-05-01,SLE,Johor,1,1,0
2023-05-01,SLE,Kedah,0,0,0
2023-05-01,SLE,Perak,0,0,0
2023-05-01,SLE,Pulau Pinang,0,0,0
2023-05-01,SLE,Sabah,0,0,0
2023-05-01,SLE,Selangor,11,8,3
2023-05-01,SLV,Johor,5,3,2
2023-05-01,SLV,Kedah,7,5,2
2023-05-01,SLV,Perak,0,0,0
2023-05-01,SLV,Perlis,0,0,0
2023-05-01,SLV,Pulau Pinang,0,0,0
2023-05-01,SLV,Sabah,0,0,0
2023-05-01,SLV,Selangor,18,10,8
2023-05-01,SLV,W.P. Labuan,0,0,0
2023-05-01,SMR,Johor,0,0,0
2023-05-01,SMR,Selangor,3,2,1
2023-05-01,SOM,Johor,0,0,0
2023-05-01,SOM,Kedah,0,0,0
2023-05-01,SOM,Kelantan,0,0,0
2023-05-01,SOM,Perlis,0,0,0
2023-05-01,SOM,Sabah,0,0,0
2023-05-01,SOM,Sarawak,0,0,0
2023-05-01,SOM,Selangor,227,137,90
2023-05-01,SRB,Johor,4,1,3
2023-05-01,SRB,Kedah,0,0,0
2023-05-01,SRB,Kelantan,0,0,0
2023-05-01,SRB,Pahang,0,0,0
2023-05-01,SRB,Perak,0,0,0
2023-05-01,SRB,Perlis,0,0,0
2023-05-01,SRB,Pulau Pinang,5,3,2
2023-05-01,SRB,Sabah,1,0,1
2023-05-01,SRB,Sarawak,1,1,0
2023-05-01,SRB,Selangor,37,23,14
2023-05-01,SSD,Johor,0,0,0
2023-05-01,SSD,Kedah,0,0,0
2023-05-01,SSD,Sarawak,1,1,0
2023-05-01,SSD,Selangor,21,14,7
2023-05-01,SSD,W.P. Labuan,0,0,0
2023-05-01,STP,Selangor,4,4,0
2023-05-01,SUR,Johor,10,2,8
2023-05-01,SUR,Kedah,0,0,0
2023-05-01,SUR,Kelantan,0,0,0
2023-05-01,SUR,Perak,0,0,0
2023-05-01,SUR,Perlis,0,0,0
2023-05-01,SUR,Pulau Pinang,0,0,0
2023-05-01,SUR,Sabah,0,0,0
2023-05-01,SUR,Sarawak,0,0,0
2023-05-01,SUR,Selangor,27,17,10
2023-05-01,SVK,Johor,36,20,16
2023-05-01,SVK,Kedah,37,15,22
2023-05-01,SVK,Kelantan,0,0,0
2023-05-01,SVK,Negeri Sembilan,0,0,0
2023-05-01,SVK,Pahang,0,0,0
2023-05-01,SVK,Perak,2,2,0
2023-05-01,SVK,Perlis,1,0,1
2023-05-01,SVK,Pulau Pinang,17,12,5
2023-05-01,SVK,Sabah,3,2,1
2023-05-01,SVK,Sarawak,1,1,0
2023-05-01,SVK,Selangor,263,162,101
2023-05-01,SVK,W.P. Labuan,1,1,0
2023-05-01,SVN,Johor,16,10,6
2023-05-01,SVN,Kedah,20,9,11
2023-05-01,SVN,Kelantan,0,0,0
2023-05-01,SVN,Perak,0,0,0
2023-05-01,SVN,Perlis,0,0,0
2023-05-01,SVN,Pulau Pinang,3,1,2
2023-05-01,SVN,Sabah,0,0,0
2023-05-01,SVN,Sarawak,0,0,0
2023-05-01,SVN,Selangor,57,41,16
2023-05-01,SVN,W.P. Labuan,0,0,0
2023-05-01,SWE,Johor,224,144,80
2023-05-01,SWE,Kedah,45,24,21
2023-05-01,SWE,Kelantan,11,5,6
2023-05-01,SWE,Melaka,0,0,0
2023-05-01,SWE,Negeri Sembilan,0,0,0
2023-05-01,SWE,Pahang,0,0,0
2023-05-01,SWE,Perak,5,5,0
2023-05-01,SWE,Perlis,17,13,4
2023-05-01,SWE,Pulau Pinang,57,35,22
2023-05-01,SWE,Sabah,12,4,8
2023-05-01,SWE,Sarawak,26,15,11
2023-05-01,SWE,Selangor,653,413,240
2023-05-01,SWE,W.P. Labuan,2,2,0
2023-05-01,SWZ,Johor,0,0,0
2023-05-01,SWZ,Kedah,0,0,0
2023-05-01,SWZ,Pulau Pinang,0,0,0
2023-05-01,SWZ,Sabah,0,0,0
2023-05-01,SWZ,Selangor,5,1,4
2023-05-01,SYC,Johor,5,0,5
2023-05-01,SYC,Kedah,1,1,0
2023-05-01,SYC,Pulau Pinang,0,0,0
2023-05-01,SYC,Sabah,1,1,0
2023-05-01,SYC,Sarawak,1,1,0
2023-05-01,SYC,Selangor,52,20,32
2023-05-01,SYR,Johor,18,9,9
2023-05-01,SYR,Kedah,2,2,0
2023-05-01,SYR,Kelantan,0,0,0
2023-05-01,SYR,Pahang,8,8,0
2023-05-01,SYR,Perlis,1,1,0
2023-05-01,SYR,Pulau Pinang,3,3,0
2023-05-01,SYR,Sabah,1,1,0
2023-05-01,SYR,Sarawak,4,3,1
2023-05-01,SYR,Selangor,585,420,165
2023-05-01,SYR,W.P. Labuan,0,0,0
2023-05-01,TCA,Perlis,0,0,0
2023-05-01,TCD,Johor,2,2,0
2023-05-01,TCD,Kedah,0,0,0
2023-05-01,TCD,Perlis,0,0,0
2023-05-01,TCD,Selangor,25,23,2
2023-05-01,TGO,Johor,0,0,0
2023-05-01,TGO,Perak,0,0,0
2023-05-01,TGO,Pulau Pinang,1,0,1
2023-05-01,TGO,Selangor,5,5,0
2023-05-01,THA,Johor,6574,1844,4730
2023-05-01,THA,Kedah,69698,39266,30432
2023-05-01,THA,Kelantan,50984,26984,24000
2023-05-01,THA,Melaka,1,1,0
2023-05-01,THA,Negeri Sembilan,0,0,0
2023-05-01,THA,Pahang,30,21,9
2023-05-01,THA,Perak,12545,5962,6583
2023-05-01,THA,Perlis,59332,35965,23367
2023-05-01,THA,Pulau Pinang,2280,979,1301
2023-05-01,THA,Sabah,30,11,19
2023-05-01,THA,Sarawak,449,180,269
2023-05-01,THA,Selangor,13273,5122,8151
2023-05-01,THA,Terengganu,0,0,0
2023-05-01,THA,W.P. Labuan,2,1,1
2023-05-01,TJK,Johor,4,1,3
2023-05-01,TJK,Kedah,2,1,1
2023-05-01,TJK,Perlis,0,0,0
2023-05-01,TJK,Pulau Pinang,0,0,0
2023-05-01,TJK,Sabah,3,3,0
2023-05-01,TJK,Selangor,85,62,23
2023-05-01,TKL,Selangor,0,0,0
2023-05-01,TKM,Johor,0,0,0
2023-05-01,TKM,Kedah,0,0,0
2023-05-01,TKM,Kelantan,0,0,0
2023-05-01,TKM,Perlis,0,0,0
2023-05-01,TKM,Pulau Pinang,0,0,0
2023-05-01,TKM,Sabah,0,0,0
2023-05-01,TKM,Sarawak,1,1,0
2023-05-01,TKM,Selangor,101,62,39
2023-05-01,TLS,Johor,10,2,8
2023-05-01,TLS,Kedah,0,0,0
2023-05-01,TLS,Perlis,0,0,0
2023-05-01,TLS,Pulau Pinang,3,3,0
2023-05-01,TLS,Sabah,0,0,0
2023-05-01,TLS,Sarawak,4,2,2
2023-05-01,TLS,Selangor,199,116,83
2023-05-01,TON,Johor,0,0,0
2023-05-01,TON,Pulau Pinang,1,0,1
2023-05-01,TON,Sarawak,0,0,0
2023-05-01,TON,Selangor,7,3,4
2023-05-01,TTO,Johor,6,4,2
2023-05-01,TTO,Kedah,3,1,2
2023-05-01,TTO,Pahang,0,0,0
2023-05-01,TTO,Pulau Pinang,1,1,0
2023-05-01,TTO,Sabah,1,0,1
2023-05-01,TTO,Sarawak,4,2,2
2023-05-01,TTO,Selangor,41,23,18
2023-05-01,TUN,Johor,15,10,5
2023-05-01,TUN,Kedah,2,2,0
2023-05-01,TUN,Kelantan,1,1,0
2023-05-01,TUN,Melaka,0,0,0
2023-05-01,TUN,Perak,0,0,0
2023-05-01,TUN,Perlis,3,2,1
2023-05-01,TUN,Pulau Pinang,4,4,0
2023-05-01,TUN,Sabah,3,1,2
2023-05-01,TUN,Sarawak,0,0,0
2023-05-01,TUN,Selangor,651,344,307
2023-05-01,TUN,W.P. Labuan,0,0,0
2023-05-01,TUR,Johor,258,187,71
2023-05-01,TUR,Kedah,55,44,11
2023-05-01,TUR,Kelantan,4,4,0
2023-05-01,TUR,Melaka,3,3,0
2023-05-01,TUR,Negeri Sembilan,0,0,0
2023-05-01,TUR,Pahang,0,0,0
2023-05-01,TUR,Perak,4,3,1
2023-05-01,TUR,Perlis,28,22,6
2023-05-01,TUR,Pulau Pinang,24,18,6
2023-05-01,TUR,Sabah,6,4,2
2023-05-01,TUR,Sarawak,23,14,9
2023-05-01,TUR,Selangor,1290,930,360
2023-05-01,TUR,W.P. Labuan,0,0,0
2023-05-01,TUV,Selangor,1,1,0
2023-05-01,TWN,Johor,4729,2017,2712
2023-05-01,TWN,Kedah,145,70,75
2023-05-01,TWN,Kelantan,1,0,1
2023-05-01,TWN,Melaka,8,5,3
2023-05-01,TWN,Negeri Sembilan,0,0,0
2023-05-01,TWN,Pahang,0,0,0
2023-05-01,TWN,Perak,55,26,29
2023-05-01,TWN,Perlis,24,6,18
2023-05-01,TWN,Pulau Pinang,3940,2040,1900
2023-05-01,TWN,Sabah,1221,606,615
2023-05-01,TWN,Sarawak,293,150,143
2023-05-01,TWN,Selangor,13399,6554,6845
2023-05-01,TWN,W.P. Labuan,8,6,2
2023-05-01,TZA,Johor,17,14,3
2023-05-01,TZA,Kedah,5,2,3
2023-05-01,TZA,Perak,0,0,0
2023-05-01,TZA,Perlis,0,0,0
2023-05-01,TZA,Pulau Pinang,0,0,0
2023-05-01,TZA,Sabah,0,0,0
2023-05-01,TZA,Sarawak,3,3,0
2023-05-01,TZA,Selangor,137,63,74
2023-05-01,UGA,Johor,7,2,5
2023-05-01,UGA,Kedah,1,0,1
2023-05-01,UGA,Perak,0,0,0
2023-05-01,UGA,Perlis,1,0,1
2023-05-01,UGA,Pulau Pinang,3,1,2
2023-05-01,UGA,Sabah,0,0,0
2023-05-01,UGA,Sarawak,1,0,1
2023-05-01,UGA,Selangor,111,64,47
2023-05-01,UKR,Johor,75,43,32
2023-05-01,UKR,Kedah,28,10,18
2023-05-01,UKR,Kelantan,0,0,0
2023-05-01,UKR,Melaka,0,0,0
2023-05-01,UKR,Negeri Sembilan,0,0,0
2023-05-01,UKR,Pahang,3,3,0
2023-05-01,UKR,Perak,0,0,0
2023-05-01,UKR,Perlis,8,4,4
2023-05-01,UKR,Pulau Pinang,31,17,14
2023-05-01,UKR,Sabah,5,3,2
2023-05-01,UKR,Sarawak,1,0,1
2023-05-01,UKR,Selangor,934,433,501
2023-05-01,UKR,W.P. Labuan,0,0,0
2023-05-01,URY,Johor,24,12,12
2023-05-01,URY,Kedah,0,0,0
2023-05-01,URY,Kelantan,0,0,0
2023-05-01,URY,Perak,0,0,0
2023-05-01,URY,Perlis,0,0,0
2023-05-01,URY,Pulau Pinang,1,1,0
2023-05-01,URY,Sabah,0,0,0
2023-05-01,URY,Sarawak,0,0,0
2023-05-01,URY,Selangor,265,136,129
2023-05-01,URY,W.P. Labuan,0,0,0
2023-05-01,USA,Johor,4050,2362,1688
2023-05-01,USA,Kedah,576,332,244
2023-05-01,USA,Kelantan,13,8,5
2023-05-01,USA,Melaka,1,0,1
2023-05-01,USA,Negeri Sembilan,1,0,1
2023-05-01,USA,Pahang,12,7,5
2023-05-01,USA,Perak,118,71,47
2023-05-01,USA,Perlis,91,54,37
2023-05-01,USA,Pulau Pinang,1815,1163,652
2023-05-01,USA,Sabah,357,187,170
2023-05-01,USA,Sarawak,352,200,152
2023-05-01,USA,Selangor,12392,7406,4986
2023-05-01,USA,Terengganu,0,0,0
2023-05-01,USA,W.P. Labuan,10,7,3
2023-05-01,UZB,Johor,111,99,12
2023-05-01,UZB,Kedah,11,9,2
2023-05-01,UZB,Kelantan,0,0,0
2023-05-01,UZB,Perak,0,0,0
2023-05-01,UZB,Perlis,1,1,0
2023-05-01,UZB,Pulau Pinang,10,2,8
2023-05-01,UZB,Sabah,9,7,2
2023-05-01,UZB,Sarawak,0,0,0
2023-05-01,UZB,Selangor,817,492,325
2023-05-01,VAT,Johor,0,0,0
2023-05-01,VAT,Sarawak,0,0,0
2023-05-01,VAT,Selangor,1,1,0
2023-05-01,VCT,Johor,1,1,0
2023-05-01,VCT,Kedah,0,0,0
2023-05-01,VCT,Pulau Pinang,0,0,0
2023-05-01,VCT,Sarawak,0,0,0
2023-05-01,VCT,Selangor,4,4,0
2023-05-01,VEN,Johor,16,11,5
2023-05-01,VEN,Kedah,2,0,2
2023-05-01,VEN,Kelantan,0,0,0
2023-05-01,VEN,Melaka,0,0,0
2023-05-01,VEN,Perak,0,0,0
2023-05-01,VEN,Perlis,0,0,0
2023-05-01,VEN,Pulau Pinang,2,2,0
2023-05-01,VEN,Sabah,5,3,2
2023-05-01,VEN,Sarawak,6,5,1
2023-05-01,VEN,Selangor,85,49,36
2023-05-01,VEN,W.P. Labuan,2,2,0
2023-05-01,VNM,Johor,18818,5840,12978
2023-05-01,VNM,Kedah,321,67,254
2023-05-01,VNM,Kelantan,13,1,12
2023-05-01,VNM,Melaka,0,0,0
2023-05-01,VNM,Negeri Sembilan,0,0,0
2023-05-01,VNM,Pahang,3,3,0
2023-05-01,VNM,Perak,141,12,129
2023-05-01,VNM,Perlis,233,24,209
2023-05-01,VNM,Pulau Pinang,1554,465,1089
2023-05-01,VNM,Sabah,22,5,17
2023-05-01,VNM,Sarawak,256,50,206
2023-05-01,VNM,Selangor,17961,6159,11802
2023-05-01,VNM,Terengganu,0,0,0
2023-05-01,VNM,W.P. Labuan,1,1,0
2023-05-01,VUT,Johor,33,28,5
2023-05-01,VUT,Kedah,0,0,0
2023-05-01,VUT,Pulau Pinang,6,5,1
2023-05-01,VUT,Sabah,0,0,0
2023-05-01,VUT,Sarawak,0,0,0
2023-05-01,VUT,Selangor,60,52,8
2023-05-01,WSM,Johor,0,0,0
2023-05-01,WSM,Sarawak,1,0,1
2023-05-01,WSM,Selangor,1,0,1
2023-05-01,XXX,Johor,52,34,18
2023-05-01,XXX,Kedah,8,4,4
2023-05-01,XXX,Kelantan,1,1,0
2023-05-01,XXX,Melaka,0,0,0
2023-05-01,XXX,Pahang,0,0,0
2023-05-01,XXX,Perak,2,1,1
2023-05-01,XXX,Perlis,2,1,1
2023-05-01,XXX,Pulau Pinang,51,26,25
2023-05-01,XXX,Sabah,29,16,13
2023-05-01,XXX,Sarawak,34,24,10
2023-05-01,XXX,Selangor,434,256,178
2023-05-01,XXX,W.P. Labuan,2,1,1
2023-05-01,YEM,Johor,23,17,6
2023-05-01,YEM,Kedah,0,0,0
2023-05-01,YEM,Kelantan,0,0,0
2023-05-01,YEM,Melaka,0,0,0
2023-05-01,YEM,Pahang,0,0,0
2023-05-01,YEM,Perak,0,0,0
2023-05-01,YEM,Perlis,0,0,0
2023-05-01,YEM,Pulau Pinang,3,3,0
2023-05-01,YEM,Sabah,0,0,0
2023-05-01,YEM,Sarawak,4,1,3
2023-05-01,YEM,Selangor,1201,833,368
2023-05-01,YEM,W.P. Labuan,0,0,0
2023-05-01,ZAF,Johor,216,143,73
2023-05-01,ZAF,Kedah,33,21,12
2023-05-01,ZAF,Kelantan,3,2,1
2023-05-01,ZAF,Melaka,0,0,0
2023-05-01,ZAF,Pahang,0,0,0
2023-05-01,ZAF,Perak,1,0,1
2023-05-01,ZAF,Perlis,12,9,3
2023-05-01,ZAF,Pulau Pinang,35,21,14
2023-05-01,ZAF,Sabah,17,11,6
2023-05-01,ZAF,Sarawak,81,44,37
2023-05-01,ZAF,Selangor,768,443,325
2023-05-01,ZAF,Terengganu,0,0,0
2023-05-01,ZAF,W.P. Labuan,1,1,0
2023-05-01,ZAR,Selangor,0,0,0
2023-05-01,ZMB,Johor,2,2,0
2023-05-01,ZMB,Kedah,0,0,0
2023-05-01,ZMB,Perak,0,0,0
2023-05-01,ZMB,Perlis,0,0,0
2023-05-01,ZMB,Pulau Pinang,0,0,0
2023-05-01,ZMB,Sabah,0,0,0
2023-05-01,ZMB,Sarawak,1,1,0
2023-05-01,ZMB,Selangor,46,19,27
2023-05-01,ZWE,Johor,17,10,7
2023-05-01,ZWE,Kedah,2,1,1
2023-05-01,ZWE,Kelantan,0,0,0
2023-05-01,ZWE,Perak,0,0,0
2023-05-01,ZWE,Perlis,1,1,0
2023-05-01,ZWE,Pulau Pinang,0,0,0
2023-05-01,ZWE,Sabah,0,0,0
2023-05-01,ZWE,Sarawak,0,0,0
2023-05-01,ZWE,Selangor,88,48,40
2023-06-01,ABW,Kedah,0,0,0
2023-06-01,ABW,Pulau Pinang,0,0,0
2023-06-01,AFG,Johor,1,1,0
2023-06-01,AFG,Kedah,0,0,0
2023-06-01,AFG,Perlis,0,0,0
2023-06-01,AFG,Pulau Pinang,0,0,0
2023-06-01,AFG,Sarawak,0,0,0
2023-06-01,AFG,Selangor,43,33,10
2023-06-01,AGO,Johor,0,0,0
2023-06-01,AGO,Kedah,0,0,0
2023-06-01,AGO,Sabah,0,0,0
2023-06-01,AGO,Selangor,12,8,4
2023-06-01,AIA,Selangor,0,0,0
2023-06-01,ALB,Johor,10,10,0
2023-06-01,ALB,Kedah,0,0,0
2023-06-01,ALB,Perak,0,0,0
2023-06-01,ALB,Perlis,0,0,0
2023-06-01,ALB,Pulau Pinang,0,0,0
2023-06-01,ALB,Sabah,0,0,0
2023-06-01,ALB,Sarawak,0,0,0
2023-06-01,ALB,Selangor,16,10,6
2023-06-01,AND,Johor,0,0,0
2023-06-01,AND,Kedah,0,0,0
2023-06-01,AND,Perlis,0,0,0
2023-06-01,AND,Pulau Pinang,0,0,0
2023-06-01,AND,Selangor,1,1,0
2023-06-01,ANT,Selangor,0,0,0
2023-06-01,ARE,Johor,23,16,7
2023-06-01,ARE,Kedah,1,0,1
2023-06-01,ARE,Kelantan,2,2,0
2023-06-01,ARE,Perak,0,0,0
2023-06-01,ARE,Perlis,4,4,0
2023-06-01,ARE,Pulau Pinang,4,4,0
2023-06-01,ARE,Sabah,0,0,0
2023-06-01,ARE,Sarawak,0,0,0
2023-06-01,ARE,Selangor,732,395,337
2023-06-01,ARG,Johor,76,40,36
2023-06-01,ARG,Kedah,4,4,0
2023-06-01,ARG,Kelantan,0,0,0
2023-06-01,ARG,Melaka,0,0,0
2023-06-01,ARG,Perak,1,1,0
2023-06-01,ARG,Perlis,3,2,1
2023-06-01,ARG,Pulau Pinang,11,7,4
2023-06-01,ARG,Sabah,1,1,0
2023-06-01,ARG,Sarawak,1,1,0
2023-06-01,ARG,Selangor,216,124,92
2023-06-01,ARG,W.P. Labuan,0,0,0
2023-06-01,ARM,Johor,9,5,4
2023-06-01,ARM,Kedah,0,0,0
2023-06-01,ARM,Kelantan,0,0,0
2023-06-01,ARM,Perak,0,0,0
2023-06-01,ARM,Perlis,0,0,0
2023-06-01,ARM,Pulau Pinang,2,0,2
2023-06-01,ARM,Sabah,0,0,0
2023-06-01,ARM,Sarawak,0,0,0
2023-06-01,ARM,Selangor,101,32,69
2023-06-01,ATA,Selangor,0,0,0
2023-06-01,ATG,Johor,3,3,0
2023-06-01,ATG,Kedah,0,0,0
2023-06-01,ATG,Pulau Pinang,0,0,0
2023-06-01,ATG,Sarawak,0,0,0
2023-06-01,ATG,Selangor,15,11,4
2023-06-01,AUS,Johor,4705,2736,1969
2023-06-01,AUS,Kedah,593,310,283
2023-06-01,AUS,Kelantan,11,5,6
2023-06-01,AUS,Melaka,0,0,0
2023-06-01,AUS,Negeri Sembilan,0,0,0
2023-06-01,AUS,Pahang,32,16,16
2023-06-01,AUS,Perak,182,98,84
2023-06-01,AUS,Perlis,97,60,37
2023-06-01,AUS,Pulau Pinang,1961,1027,934
2023-06-01,AUS,Sabah,294,153,141
2023-06-01,AUS,Sarawak,523,305,218
2023-06-01,AUS,Selangor,17718,10048,7670
2023-06-01,AUS,Terengganu,0,0,0
2023-06-01,AUS,W.P. Labuan,21,17,4
2023-06-01,AUT,Johor,101,62,39
2023-06-01,AUT,Kedah,17,9,8
2023-06-01,AUT,Kelantan,3,3,0
2023-06-01,AUT,Melaka,1,1,0
2023-06-01,AUT,Negeri Sembilan,0,0,0
2023-06-01,AUT,Pahang,0,0,0
2023-06-01,AUT,Perak,1,1,0
2023-06-01,AUT,Perlis,5,4,1
2023-06-01,AUT,Pulau Pinang,60,48,12
2023-06-01,AUT,Sabah,9,6,3
2023-06-01,AUT,Sarawak,13,10,3
2023-06-01,AUT,Selangor,403,269,134
2023-06-01,AUT,Terengganu,0,0,0
2023-06-01,AUT,W.P. Labuan,0,0,0
2023-06-01,AZE,Johor,5,3,2
2023-06-01,AZE,Kedah,3,2,1
2023-06-01,AZE,Kelantan,0,0,0
2023-06-01,AZE,Melaka,0,0,0
2023-06-01,AZE,Perlis,0,0,0
2023-06-01,AZE,Pulau Pinang,0,0,0
2023-06-01,AZE,Sabah,0,0,0
2023-06-01,AZE,Sarawak,0,0,0
2023-06-01,AZE,Selangor,80,54,26
2023-06-01,AZE,W.P. Labuan,10,10,0
2023-06-01,BDI,Pulau Pinang,0,0,0
2023-06-01,BDI,Sarawak,0,0,0
2023-06-01,BDI,Selangor,8,3,5
2023-06-01,BEL,Johor,209,132,77
2023-06-01,BEL,Kedah,29,13,16
2023-06-01,BEL,Kelantan,3,2,1
2023-06-01,BEL,Melaka,0,0,0
2023-06-01,BEL,Negeri Sembilan,0,0,0
2023-06-01,BEL,Pahang,2,2,0
2023-06-01,BEL,Perak,3,1,2
2023-06-01,BEL,Perlis,23,16,7
2023-06-01,BEL,Pulau Pinang,35,28,7
2023-06-01,BEL,Sabah,25,20,5
2023-06-01,BEL,Sarawak,27,16,11
2023-06-01,BEL,Selangor,826,490,336
2023-06-01,BEL,W.P. Labuan,0,0,0
2023-06-01,BEN,Johor,0,0,0
2023-06-01,BEN,Kedah,0,0,0
2023-06-01,BEN,Perak,1,1,0
2023-06-01,BEN,Pulau Pinang,0,0,0
2023-06-01,BEN,Sabah,0,0,0
2023-06-01,BEN,Sarawak,0,0,0
2023-06-01,BEN,Selangor,9,7,2
2023-06-01,BFA,Perak,0,0,0
2023-06-01,BFA,Pulau Pinang,0,0,0
2023-06-01,BFA,Selangor,1,1,0
2023-06-01,BGD,Johor,3887,3327,560
2023-06-01,BGD,Kedah,110,65,45
2023-06-01,BGD,Kelantan,3,3,0
2023-06-01,BGD,Melaka,0,0,0
2023-06-01,BGD,Negeri Sembilan,0,0,0
2023-06-01,BGD,Pahang,0,0,0
2023-06-01,BGD,Perak,4,2,2
2023-06-01,BGD,Perlis,3,3,0
2023-06-01,BGD,Pulau Pinang,308,288,20
2023-06-01,BGD,Sabah,6,3,3
2023-06-01,BGD,Sarawak,18,16,2
2023-06-01,BGD,Selangor,47417,46058,1359
2023-06-01,BGD,W.P. Labuan,12,12,0
2023-06-01,BGR,Johor,25,14,11
2023-06-01,BGR,Kedah,5,3,2
2023-06-01,BGR,Kelantan,0,0,0
2023-06-01,BGR,Pahang,0,0,0
2023-06-01,BGR,Perak,1,0,1
2023-06-01,BGR,Perlis,2,0,2
2023-06-01,BGR,Pulau Pinang,3,3,0
2023-06-01,BGR,Sabah,1,0,1
2023-06-01,BGR,Sarawak,3,3,0
2023-06-01,BGR,Selangor,112,58,54
2023-06-01,BGR,W.P. Labuan,1,0,1
2023-06-01,BHR,Johor,14,8,6
2023-06-01,BHR,Kedah,4,2,2
2023-06-01,BHR,Kelantan,0,0,0
2023-06-01,BHR,Perlis,1,1,0
2023-06-01,BHR,Pulau Pinang,1,1,0
2023-06-01,BHR,Sabah,0,0,0
2023-06-01,BHR,Sarawak,1,0,1
2023-06-01,BHR,Selangor,254,138,116
2023-06-01,BHS,Johor,0,0,0
2023-06-01,BHS,Kedah,0,0,0
2023-06-01,BHS,Perak,0,0,0
2023-06-01,BHS,Sabah,0,0,0
2023-06-01,BHS,Sarawak,0,0,0
2023-06-01,BHS,Selangor,9,5,4
2023-06-01,BIH,Johor,5,3,2
2023-06-01,BIH,Kedah,0,0,0
2023-06-01,BIH,Perlis,0,0,0
2023-06-01,BIH,Pulau Pinang,1,1,0
2023-06-01,BIH,Sabah,1,1,0
2023-06-01,BIH,Sarawak,1,1,0
2023-06-01,BIH,Selangor,32,21,11
2023-06-01,BLR,Johor,26,9,17
2023-06-01,BLR,Kedah,7,3,4
2023-06-01,BLR,Kelantan,1,0,1
2023-06-01,BLR,Pahang,0,0,0
2023-06-01,BLR,Perak,0,0,0
2023-06-01,BLR,Perlis,1,1,0
2023-06-01,BLR,Pulau Pinang,9,5,4
2023-06-01,BLR,Sabah,2,1,1
2023-06-01,BLR,Sarawak,0,0,0
2023-06-01,BLR,Selangor,184,71,113
2023-06-01,BLR,W.P. Labuan,0,0,0
2023-06-01,BLZ,Johor,1,1,0
2023-06-01,BLZ,Pulau Pinang,0,0,0
2023-06-01,BLZ,Sarawak,0,0,0
2023-06-01,BLZ,Selangor,1,1,0
2023-06-01,BMU,Selangor,0,0,0
2023-06-01,BOL,Johor,3,2,1
2023-06-01,BOL,Kedah,1,0,1
2023-06-01,BOL,Melaka,0,0,0
2023-06-01,BOL,Perak,0,0,0
2023-06-01,BOL,Perlis,0,0,0
2023-06-01,BOL,Pulau Pinang,1,0,1
2023-06-01,BOL,Sabah,0,0,0
2023-06-01,BOL,Sarawak,0,0,0
2023-06-01,BOL,Selangor,4,1,3
2023-06-01,BRA,Johor,237,136,101
2023-06-01,BRA,Kedah,21,8,13
2023-06-01,BRA,Kelantan,2,2,0
2023-06-01,BRA,Melaka,0,0,0
2023-06-01,BRA,Pahang,0,0,0
2023-06-01,BRA,Perak,3,2,1
2023-06-01,BRA,Perlis,1,1,0
2023-06-01,BRA,Pulau Pinang,16,11,5
2023-06-01,BRA,Sabah,5,1,4
2023-06-01,BRA,Sarawak,10,7,3
2023-06-01,BRA,Selangor,520,291,229
2023-06-01,BRA,W.P. Labuan,0,0,0
2023-06-01,BRB,Johor,6,2,4
2023-06-01,BRB,Kedah,0,0,0
2023-06-01,BRB,Perlis,0,0,0
2023-06-01,BRB,Pulau Pinang,0,0,0
2023-06-01,BRB,Selangor,9,5,4
2023-06-01,BRN,Johor,377,205,172
2023-06-01,BRN,Kedah,5,5,0
2023-06-01,BRN,Kelantan,10,7,3
2023-06-01,BRN,Melaka,0,0,0
2023-06-01,BRN,Pahang,0,0,0
2023-06-01,BRN,Perak,3,2,1
2023-06-01,BRN,Perlis,46,24,22
2023-06-01,BRN,Pulau Pinang,11,5,6
2023-06-01,BRN,Sabah,793,310,483
2023-06-01,BRN,Sarawak,71268,39748,31520
2023-06-01,BRN,Selangor,2820,1454,1366
2023-06-01,BRN,W.P. Labuan,1035,686,349
2023-06-01,BTN,Johor,12,7,5
2023-06-01,BTN,Kedah,0,0,0
2023-06-01,BTN,Perak,0,0,0
2023-06-01,BTN,Perlis,0,0,0
2023-06-01,BTN,Pulau Pinang,6,6,0
2023-06-01,BTN,Sabah,0,0,0
2023-06-01,BTN,Sarawak,0,0,0
2023-06-01,BTN,Selangor,17,9,8
2023-06-01,BWA,Johor,3,2,1
2023-06-01,BWA,Kedah,0,0,0
2023-06-01,BWA,Perlis,0,0,0
2023-06-01,BWA,Pulau Pinang,0,0,0
2023-06-01,BWA,Sabah,0,0,0
2023-06-01,BWA,Sarawak,0,0,0
2023-06-01,BWA,Selangor,14,10,4
2023-06-01,CAF,Kedah,0,0,0
2023-06-01,CAF,Selangor,0,0,0
2023-06-01,CAN,Johor,1140,633,507
2023-06-01,CAN,Kedah,112,57,55
2023-06-01,CAN,Kelantan,1,1,0
2023-06-01,CAN,Melaka,2,1,1
2023-06-01,CAN,Negeri Sembilan,0,0,0
2023-06-01,CAN,Pahang,1,1,0
2023-06-01,CAN,Perak,38,24,14
2023-06-01,CAN,Perlis,35,19,16
2023-06-01,CAN,Pulau Pinang,409,201,208
2023-06-01,CAN,Sabah,67,36,31
2023-06-01,CAN,Sarawak,253,132,121
2023-06-01,CAN,Selangor,2375,1410,965
2023-06-01,CAN,Terengganu,0,0,0
2023-06-01,CAN,W.P. Labuan,1,1,0
2023-06-01,CCK,Selangor,0,0,0
2023-06-01,CHE,Johor,346,195,151
2023-06-01,CHE,Kedah,80,43,37
2023-06-01,CHE,Kelantan,2,2,0
2023-06-01,CHE,Melaka,2,1,1
2023-06-01,CHE,Negeri Sembilan,0,0,0
2023-06-01,CHE,Pahang,9,6,3
2023-06-01,CHE,Perak,5,4,1
2023-06-01,CHE,Perlis,15,7,8
2023-06-01,CHE,Pulau Pinang,76,47,29
2023-06-01,CHE,Sabah,19,10,9
2023-06-01,CHE,Sarawak,34,19,15
2023-06-01,CHE,Selangor,723,456,267
2023-06-01,CHE,W.P. Labuan,0,0,0
2023-06-01,CHL,Johor,18,11,7
2023-06-01,CHL,Kedah,6,3,3
2023-06-01,CHL,Kelantan,0,0,0
2023-06-01,CHL,Melaka,0,0,0
2023-06-01,CHL,Pahang,0,0,0
2023-06-01,CHL,Perak,0,0,0
2023-06-01,CHL,Perlis,7,5,2
2023-06-01,CHL,Pulau Pinang,12,6,6
2023-06-01,CHL,Sabah,1,1,0
2023-06-01,CHL,Sarawak,1,1,0
2023-06-01,CHL,Selangor,145,78,67
2023-06-01,CHN,Johor,41635,17973,23662
2023-06-01,CHN,Kedah,895,387,508
2023-06-01,CHN,Kelantan,3,1,2
2023-06-01,CHN,Melaka,2,1,1
2023-06-01,CHN,Pahang,21,6,15
2023-06-01,CHN,Perak,248,116,132
2023-06-01,CHN,Perlis,93,38,55
2023-06-01,CHN,Pulau Pinang,8331,4361,3970
2023-06-01,CHN,Sabah,5479,2637,2842
2023-06-01,CHN,Sarawak,741,349,392
2023-06-01,CHN,Selangor,52309,27061,25248
2023-06-01,CHN,Terengganu,0,0,0
2023-06-01,CHN,W.P. Labuan,58,48,10
2023-06-01,CIV,Johor,2,0,2
2023-06-01,CIV,Kedah,0,0,0
2023-06-01,CIV,Pulau Pinang,0,0,0
2023-06-01,CIV,Sabah,0,0,0
2023-06-01,CIV,Sarawak,0,0,0
2023-06-01,CIV,Selangor,15,13,2
2023-06-01,CMR,Johor,3,3,0
2023-06-01,CMR,Kedah,0,0,0
2023-06-01,CMR,Pulau Pinang,0,0,0
2023-06-01,CMR,Sabah,0,0,0
2023-06-01,CMR,Sarawak,0,0,0
2023-06-01,CMR,Selangor,19,15,4
2023-06-01,COD,Johor,2,2,0
2023-06-01,COD,Pulau Pinang,0,0,0
2023-06-01,COD,Sarawak,0,0,0
2023-06-01,COD,Selangor,15,12,3
2023-06-01,COG,Johor,0,0,0
2023-06-01,COG,Kedah,0,0,0
2023-06-01,COG,Selangor,1,0,1
2023-06-01,COK,Selangor,0,0,0
2023-06-01,COL,Johor,27,13,14
2023-06-01,COL,Kedah,0,0,0
2023-06-01,COL,Perak,0,0,0
2023-06-01,COL,Pulau Pinang,5,3,2
2023-06-01,COL,Sabah,1,0,1
2023-06-01,COL,Sarawak,0,0,0
2023-06-01,COL,Selangor,152,69,83
2023-06-01,COL,W.P. Labuan,0,0,0
2023-06-01,COM,Johor,2,0,2
2023-06-01,COM,Kedah,0,0,0
2023-06-01,COM,Selangor,34,24,10
2023-06-01,CPV,Johor,0,0,0
2023-06-01,CPV,Kedah,0,0,0
2023-06-01,CPV,Pulau Pinang,0,0,0
2023-06-01,CPV,Sabah,0,0,0
2023-06-01,CPV,Selangor,2,2,0
2023-06-01,CRI,Johor,9,6,3
2023-06-01,CRI,Kedah,1,0,1
2023-06-01,CRI,Perak,0,0,0
2023-06-01,CRI,Perlis,0,0,0
2023-06-01,CRI,Pulau Pinang,2,2,0
2023-06-01,CRI,Sabah,3,2,1
2023-06-01,CRI,Sarawak,0,0,0
2023-06-01,CRI,Selangor,30,13,17
2023-06-01,CUB,Johor,3,2,1
2023-06-01,CUB,Kedah,0,0,0
2023-06-01,CUB,Perlis,0,0,0
2023-06-01,CUB,Pulau Pinang,1,0,1
2023-06-01,CUB,Sabah,0,0,0
2023-06-01,CUB,Sarawak,0,0,0
2023-06-01,CUB,Selangor,21,12,9
2023-06-01,CYP,Johor,7,7,0
2023-06-01,CYP,Kedah,0,0,0
2023-06-01,CYP,Perak,0,0,0
2023-06-01,CYP,Perlis,0,0,0
2023-06-01,CYP,Pulau Pinang,2,1,1
2023-06-01,CYP,Sabah,0,0,0
2023-06-01,CYP,Sarawak,0,0,0
2023-06-01,CYP,Selangor,67,51,16
2023-06-01,CZE,Johor,105,73,32
2023-06-01,CZE,Kedah,19,11,8
2023-06-01,CZE,Kelantan,0,0,0
2023-06-01,CZE,Melaka,0,0,0
2023-06-01,CZE,Negeri Sembilan,0,0,0
2023-06-01,CZE,Perak,0,0,0
2023-06-01,CZE,Perlis,2,2,0
2023-06-01,CZE,Pulau Pinang,5,3,2
2023-06-01,CZE,Sabah,7,3,4
2023-06-01,CZE,Sarawak,13,9,4
2023-06-01,CZE,Selangor,251,150,101
2023-06-01,CZE,W.P. Labuan,1,1,0
2023-06-01,DEU,Johor,1893,1163,730
2023-06-01,DEU,Kedah,313,161,152
2023-06-01,DEU,Kelantan,13,10,3
2023-06-01,DEU,Melaka,10,5,5
2023-06-01,DEU,Negeri Sembilan,0,0,0
2023-06-01,DEU,Pahang,15,7,8
2023-06-01,DEU,Perak,32,19,13
2023-06-01,DEU,Perlis,80,49,31
2023-06-01,DEU,Pulau Pinang,510,383,127
2023-06-01,DEU,Sabah,134,83,51
2023-06-01,DEU,Sarawak,200,111,89
2023-06-01,DEU,Selangor,4102,2595,1507
2023-06-01,DEU,Terengganu,0,0,0
2023-06-01,DEU,W.P. Labuan,5,4,1
2023-06-01,DJI,Johor,0,0,0
2023-06-01,DJI,Selangor,8,7,1
2023-06-01,DMA,Johor,9,9,0
2023-06-01,DMA,Kedah,0,0,0
2023-06-01,DMA,Pulau Pinang,0,0,0
2023-06-01,DMA,Sabah,0,0,0
2023-06-01,DMA,Sarawak,2,1,1
2023-06-01,DMA,Selangor,37,30,7
2023-06-01,DMA,W.P. Labuan,0,0,0
2023-06-01,DNK,Johor,231,169,62
2023-06-01,DNK,Kedah,16,11,5
2023-06-01,DNK,Kelantan,6,5,1
2023-06-01,DNK,Melaka,0,0,0
2023-06-01,DNK,Negeri Sembilan,0,0,0
2023-06-01,DNK,Pahang,0,0,0
2023-06-01,DNK,Perak,8,5,3
2023-06-01,DNK,Perlis,10,5,5
2023-06-01,DNK,Pulau Pinang,50,37,13
2023-06-01,DNK,Sabah,24,16,8
2023-06-01,DNK,Sarawak,7,6,1
2023-06-01,DNK,Selangor,673,389,284
2023-06-01,DNK,W.P. Labuan,0,0,0
2023-06-01,DOM,Johor,2,0,2
2023-06-01,DOM,Kedah,1,0,1
2023-06-01,DOM,Perak,0,0,0
2023-06-01,DOM,Perlis,0,0,0
2023-06-01,DOM,Pulau Pinang,0,0,0
2023-06-01,DOM,Sabah,0,0,0
2023-06-01,DOM,Sarawak,0,0,0
2023-06-01,DOM,Selangor,18,13,5
2023-06-01,DZA,Johor,18,16,2
2023-06-01,DZA,Kedah,3,3,0
2023-06-01,DZA,Kelantan,0,0,0
2023-06-01,DZA,Melaka,0,0,0
2023-06-01,DZA,Perak,1,1,0
2023-06-01,DZA,Perlis,0,0,0
2023-06-01,DZA,Pulau Pinang,5,3,2
2023-06-01,DZA,Sabah,1,0,1
2023-06-01,DZA,Sarawak,8,7,1
2023-06-01,DZA,Selangor,467,305,162
2023-06-01,DZA,W.P. Labuan,0,0,0
2023-06-01,ECU,Johor,16,5,11
2023-06-01,ECU,Kedah,0,0,0
2023-06-01,ECU,Perak,0,0,0
2023-06-01,ECU,Perlis,0,0,0
2023-06-01,ECU,Pulau Pinang,2,0,2
2023-06-01,ECU,Sabah,0,0,0
2023-06-01,ECU,Sarawak,0,0,0
2023-06-01,ECU,Selangor,46,17,29
2023-06-01,EGY,Johor,228,176,52
2023-06-01,EGY,Kedah,8,7,1
2023-06-01,EGY,Kelantan,1,1,0
2023-06-01,EGY,Melaka,0,0,0
2023-06-01,EGY,Pahang,0,0,0
2023-06-01,EGY,Perak,3,2,1
2023-06-01,EGY,Perlis,6,3,3
2023-06-01,EGY,Pulau Pinang,12,11,1
2023-06-01,EGY,Sabah,5,5,0
2023-06-01,EGY,Sarawak,105,74,31
2023-06-01,EGY,Selangor,1495,1012,483
2023-06-01,EGY,Terengganu,0,0,0
2023-06-01,EGY,W.P. Labuan,1,1,0
2023-06-01,ERI,Johor,1,1,0
2023-06-01,ERI,Pulau Pinang,0,0,0
2023-06-01,ERI,Sabah,0,0,0
2023-06-01,ERI,Selangor,24,13,11
2023-06-01,ESP,Johor,476,316,160
2023-06-01,ESP,Kedah,59,28,31
2023-06-01,ESP,Kelantan,3,3,0
2023-06-01,ESP,Melaka,0,0,0
2023-06-01,ESP,Negeri Sembilan,0,0,0
2023-06-01,ESP,Pahang,0,0,0
2023-06-01,ESP,Perak,2,0,2
2023-06-01,ESP,Perlis,18,15,3
2023-06-01,ESP,Pulau Pinang,83,55,28
2023-06-01,ESP,Sabah,29,14,15
2023-06-01,ESP,Sarawak,42,26,16
2023-06-01,ESP,Selangor,1499,856,643
2023-06-01,ESP,W.P. Labuan,2,0,2
2023-06-01,EST,Johor,25,16,9
2023-06-01,EST,Kedah,2,0,2
2023-06-01,EST,Kelantan,0,0,0
2023-06-01,EST,Pahang,0,0,0
2023-06-01,EST,Perak,0,0,0
2023-06-01,EST,Perlis,1,0,1
2023-06-01,EST,Pulau Pinang,4,4,0
2023-06-01,EST,Sabah,0,0,0
2023-06-01,EST,Sarawak,2,1,1
2023-06-01,EST,Selangor,60,29,31
2023-06-01,EST,W.P. Labuan,1,0,1
2023-06-01,ETH,Johor,1,0,1
2023-06-01,ETH,Kedah,0,0,0
2023-06-01,ETH,Pulau Pinang,0,0,0
2023-06-01,ETH,Sarawak,0,0,0
2023-06-01,ETH,Selangor,38,24,14
2023-06-01,FIN,Johor,148,83,65
2023-06-01,FIN,Kedah,19,10,9
2023-06-01,FIN,Kelantan,1,1,0
2023-06-01,FIN,Melaka,0,0,0
2023-06-01,FIN,Negeri Sembilan,0,0,0
2023-06-01,FIN,Pahang,0,0,0
2023-06-01,FIN,Perak,7,3,4
2023-06-01,FIN,Perlis,7,6,1
2023-06-01,FIN,Pulau Pinang,19,15,4
2023-06-01,FIN,Sabah,9,3,6
2023-06-01,FIN,Sarawak,9,5,4
2023-06-01,FIN,Selangor,266,159,107
2023-06-01,FIN,W.P. Labuan,0,0,0
2023-06-01,FJI,Johor,71,27,44
2023-06-01,FJI,Kedah,0,0,0
2023-06-01,FJI,Kelantan,0,0,0
2023-06-01,FJI,Perak,0,0,0
2023-06-01,FJI,Perlis,0,0,0
2023-06-01,FJI,Pulau Pinang,4,1,3
2023-06-01,FJI,Sabah,0,0,0
2023-06-01,FJI,Sarawak,1,0,1
2023-06-01,FJI,Selangor,109,57,52
2023-06-01,FRA,Johor,1998,1171,827
2023-06-01,FRA,Kedah,295,173,122
2023-06-01,FRA,Kelantan,21,13,8
2023-06-01,FRA,Melaka,3,2,1
2023-06-01,FRA,Negeri Sembilan,0,0,0
2023-06-01,FRA,Pahang,20,13,7
2023-06-01,FRA,Perak,32,21,11
2023-06-01,FRA,Perlis,82,47,35
2023-06-01,FRA,Pulau Pinang,363,230,133
2023-06-01,FRA,Sabah,105,67,38
2023-06-01,FRA,Sarawak,126,78,48
2023-06-01,FRA,Selangor,5098,3025,2073
2023-06-01,FRA,Terengganu,0,0,0
2023-06-01,FRA,W.P. Labuan,0,0,0
2023-06-01,FSM,Johor,0,0,0
2023-06-01,FSM,Pulau Pinang,0,0,0
2023-06-01,FSM,Selangor,2,1,1
2023-06-01,GAB,Johor,2,0,2
2023-06-01,GAB,Pulau Pinang,0,0,0
2023-06-01,GAB,Sarawak,0,0,0
2023-06-01,GAB,Selangor,7,3,4
2023-06-01,GBR,Johor,4561,2911,1650
2023-06-01,GBR,Kedah,671,367,304
2023-06-01,GBR,Kelantan,16,10,6
2023-06-01,GBR,Melaka,1,1,0
2023-06-01,GBR,Negeri Sembilan,0,0,0
2023-06-01,GBR,Pahang,14,10,4
2023-06-01,GBR,Perak,87,59,28
2023-06-01,GBR,Perlis,191,106,85
2023-06-01,GBR,Pulau Pinang,1122,711,411
2023-06-01,GBR,Sabah,391,231,160
2023-06-01,GBR,Sarawak,961,583,378
2023-06-01,GBR,Selangor,11393,6950,4443
2023-06-01,GBR,Terengganu,0,0,0
2023-06-01,GBR,W.P. Labuan,30,22,8
2023-06-01,GEO,Johor,9,5,4
2023-06-01,GEO,Kedah,2,1,1
2023-06-01,GEO,Melaka,0,0,0
2023-06-01,GEO,Perak,0,0,0
2023-06-01,GEO,Perlis,1,1,0
2023-06-01,GEO,Pulau Pinang,0,0,0
2023-06-01,GEO,Sabah,1,1,0
2023-06-01,GEO,Sarawak,0,0,0
2023-06-01,GEO,Selangor,42,24,18
2023-06-01,GHA,Johor,5,4,1
2023-06-01,GHA,Kedah,0,0,0
2023-06-01,GHA,Kelantan,0,0,0
2023-06-01,GHA,Pulau Pinang,2,1,1
2023-06-01,GHA,Sabah,2,1,1
2023-06-01,GHA,Sarawak,0,0,0
2023-06-01,GHA,Selangor,49,40,9
2023-06-01,GIB,Johor,0,0,0
2023-06-01,GIB,Sarawak,0,0,0
2023-06-01,GIN,Johor,1,1,0
2023-06-01,GIN,Kedah,0,0,0
2023-06-01,GIN,Kelantan,0,0,0
2023-06-01,GIN,Perlis,0,0,0
2023-06-01,GIN,Pulau Pinang,0,0,0
2023-06-01,GIN,Sabah,0,0,0
2023-06-01,GIN,Sarawak,0,0,0
2023-06-01,GIN,Selangor,41,26,15
2023-06-01,GLP,Selangor,0,0,0
2023-06-01,GMB,Johor,1,1,0
2023-06-01,GMB,Kedah,0,0,0
2023-06-01,GMB,Kelantan,0,0,0
2023-06-01,GMB,Pulau Pinang,0,0,0
2023-06-01,GMB,Sabah,0,0,0
2023-06-01,GMB,Sarawak,0,0,0
2023-06-01,GMB,Selangor,25,18,7
2023-06-01,GNB,Johor,1,1,0
2023-06-01,GNB,Selangor,0,0,0
2023-06-01,GNQ,Johor,0,0,0
2023-06-01,GNQ,Selangor,1,1,0
2023-06-01,GRC,Johor,50,40,10
2023-06-01,GRC,Kedah,3,2,1
2023-06-01,GRC,Kelantan,0,0,0
2023-06-01,GRC,Melaka,0,0,0
2023-06-01,GRC,Negeri Sembilan,0,0,0
2023-06-01,GRC,Pahang,0,0,0
2023-06-01,GRC,Perak,0,0,0
2023-06-01,GRC,Perlis,2,2,0
2023-06-01,GRC,Pulau Pinang,4,3,1
2023-06-01,GRC,Sabah,12,7,5
2023-06-01,GRC,Sarawak,0,0,0
2023-06-01,GRC,Selangor,134,106,28
2023-06-01,GRD,Johor,5,1,4
2023-06-01,GRD,Kedah,3,0,3
2023-06-01,GRD,Pulau Pinang,0,0,0
2023-06-01,GRD,Sabah,0,0,0
2023-06-01,GRD,Sarawak,0,0,0
2023-06-01,GRD,Selangor,6,4,2
2023-06-01,GRL,Johor,0,0,0
2023-06-01,GRL,Selangor,0,0,0
2023-06-01,GTM,Johor,3,0,3
2023-06-01,GTM,Kedah,0,0,0
2023-06-01,GTM,Pahang,0,0,0
2023-06-01,GTM,Perak,0,0,0
2023-06-01,GTM,Pulau Pinang,1,1,0
2023-06-01,GTM,Sabah,0,0,0
2023-06-01,GTM,Sarawak,1,0,1
2023-06-01,GTM,Selangor,12,9,3
2023-06-01,GTM,W.P. Labuan,1,0,1
2023-06-01,GUY,Johor,0,0,0
2023-06-01,GUY,Kedah,0,0,0
2023-06-01,GUY,Pulau Pinang,1,0,1
2023-06-01,GUY,Sarawak,0,0,0
2023-06-01,GUY,Selangor,3,2,1
2023-06-01,HKG,Johor,2,2,0
2023-06-01,HKG,Kedah,0,0,0
2023-06-01,HKG,Kelantan,0,0,0
2023-06-01,HKG,Pahang,0,0,0
2023-06-01,HKG,Perak,51,12,39
2023-06-01,HKG,Perlis,0,0,0
2023-06-01,HKG,Pulau Pinang,0,0,0
2023-06-01,HKG,Sabah,11,8,3
2023-06-01,HKG,Sarawak,0,0,0
2023-06-01,HKG,Selangor,7,1,6
2023-06-01,HKG,Terengganu,0,0,0
2023-06-01,HMD,Johor,0,0,0
2023-06-01,HND,Johor,5,3,2
2023-06-01,HND,Kedah,1,1,0
2023-06-01,HND,Perak,0,0,0
2023-06-01,HND,Pulau Pinang,1,0,1
2023-06-01,HND,Sabah,0,0,0
2023-06-01,HND,Sarawak,0,0,0
2023-06-01,HND,Selangor,10,7,3
2023-06-01,HRV,Johor,29,23,6
2023-06-01,HRV,Kedah,2,1,1
2023-06-01,HRV,Kelantan,0,0,0
2023-06-01,HRV,Melaka,0,0,0
2023-06-01,HRV,Pahang,0,0,0
2023-06-01,HRV,Perak,0,0,0
2023-06-01,HRV,Perlis,0,0,0
2023-06-01,HRV,Pulau Pinang,2,2,0
2023-06-01,HRV,Sabah,0,0,0
2023-06-01,HRV,Sarawak,2,1,1
2023-06-01,HRV,Selangor,85,58,27
2023-06-01,HTI,Johor,0,0,0
2023-06-01,HTI,Kedah,0,0,0
2023-06-01,HTI,Kelantan,0,0,0
2023-06-01,HTI,Perak,0,0,0
2023-06-01,HTI,Pulau Pinang,0,0,0
2023-06-01,HTI,Sabah,0,0,0
2023-06-01,HTI,Selangor,2,2,0
2023-06-01,HUN,Johor,60,36,24
2023-06-01,HUN,Kedah,13,7,6
2023-06-01,HUN,Kelantan,0,0,0
2023-06-01,HUN,Pahang,0,0,0
2023-06-01,HUN,Perak,3,1,2
2023-06-01,HUN,Perlis,5,2,3
2023-06-01,HUN,Pulau Pinang,18,14,4
2023-06-01,HUN,Sabah,7,6,1
2023-06-01,HUN,Sarawak,6,5,1
2023-06-01,HUN,Selangor,254,148,106
2023-06-01,HUN,W.P. Labuan,0,0,0
2023-06-01,IDN,Johor,101577,46878,54699
2023-06-01,IDN,Kedah,5320,1974,3346
2023-06-01,IDN,Kelantan,109,59,50
2023-06-01,IDN,Melaka,5091,2392,2699
2023-06-01,IDN,Negeri Sembilan,5032,3302,1730
2023-06-01,IDN,Pahang,28,18,10
2023-06-01,IDN,Perak,250,59,191
2023-06-01,IDN,Perlis,595,220,375
2023-06-01,IDN,Pulau Pinang,42475,17224,25251
2023-06-01,IDN,Sabah,4907,2323,2584
2023-06-01,IDN,Sarawak,34662,17072,17590
2023-06-01,IDN,Selangor,75546,35482,40064
2023-06-01,IDN,Terengganu,0,0,0
2023-06-01,IDN,W.P. Labuan,55,32,23
2023-06-01,IND,Johor,28743,18283,10460
2023-06-01,IND,Kedah,1697,881,816
2023-06-01,IND,Kelantan,5,4,1
2023-06-01,IND,Melaka,0,0,0
2023-06-01,IND,Negeri Sembilan,0,0,0
2023-06-01,IND,Pahang,5,5,0
2023-06-01,IND,Perak,441,330,111
2023-06-01,IND,Perlis,28,20,8
2023-06-01,IND,Pulau Pinang,946,625,321
2023-06-01,IND,Sabah,195,112,83
2023-06-01,IND,Sarawak,1028,795,233
2023-06-01,IND,Selangor,36628,24600,12028
2023-06-01,IND,Terengganu,0,0,0
2023-06-01,IND,W.P. Labuan,55,42,13
2023-06-01,IOT,Pulau Pinang,0,0,0
2023-06-01,IOT,Selangor,0,0,0
2023-06-01,IRL,Johor,259,160,99
2023-06-01,IRL,Kedah,65,33,32
2023-06-01,IRL,Kelantan,0,0,0
2023-06-01,IRL,Negeri Sembilan,0,0,0
2023-06-01,IRL,Pahang,3,1,2
2023-06-01,IRL,Perak,8,4,4
2023-06-01,IRL,Perlis,14,8,6
2023-06-01,IRL,Pulau Pinang,106,62,44
2023-06-01,IRL,Sabah,22,15,7
2023-06-01,IRL,Sarawak,49,24,25
2023-06-01,IRL,Selangor,1087,645,442
2023-06-01,IRL,Terengganu,0,0,0
2023-06-01,IRL,W.P. Labuan,0,0,0
2023-06-01,IRN,Johor,182,103,79
2023-06-01,IRN,Kedah,7,5,2
2023-06-01,IRN,Kelantan,0,0,0
2023-06-01,IRN,Perak,0,0,0
2023-06-01,IRN,Perlis,0,0,0
2023-06-01,IRN,Pulau Pinang,3,2,1
2023-06-01,IRN,Sabah,0,0,0
2023-06-01,IRN,Sarawak,8,6,2
2023-06-01,IRN,Selangor,1119,593,526
2023-06-01,IRN,W.P. Labuan,0,0,0
2023-06-01,IRQ,Johor,28,20,8
2023-06-01,IRQ,Kedah,0,0,0
2023-06-01,IRQ,Kelantan,0,0,0
2023-06-01,IRQ,Melaka,0,0,0
2023-06-01,IRQ,Pahang,0,0,0
2023-06-01,IRQ,Perak,0,0,0
2023-06-01,IRQ,Perlis,0,0,0
2023-06-01,IRQ,Pulau Pinang,1,0,1
2023-06-01,IRQ,Sabah,0,0,0
2023-06-01,IRQ,Sarawak,0,0,0
2023-06-01,IRQ,Selangor,1349,838,511
2023-06-01,ISL,Johor,1,0,1
2023-06-01,ISL,Kedah,7,3,4
2023-06-01,ISL,Kelantan,0,0,0
2023-06-01,ISL,Perak,0,0,0
2023-06-01,ISL,Perlis,0,0,0
2023-06-01,ISL,Pulau Pinang,0,0,0
2023-06-01,ISL,Sabah,0,0,0
2023-06-01,ISL,Sarawak,0,0,0
2023-06-01,ISL,Selangor,22,12,10
2023-06-01,ISL,W.P. Labuan,0,0,0
2023-06-01,ISR,Pulau Pinang,0,0,0
2023-06-01,ITA,Johor,502,338,164
2023-06-01,ITA,Kedah,46,29,17
2023-06-01,ITA,Kelantan,2,1,1
2023-06-01,ITA,Melaka,0,0,0
2023-06-01,ITA,Negeri Sembilan,0,0,0
2023-06-01,ITA,Pahang,2,1,1
2023-06-01,ITA,Perak,4,1,3
2023-06-01,ITA,Perlis,19,10,9
2023-06-01,ITA,Pulau Pinang,104,75,29
2023-06-01,ITA,Sabah,16,11,5
2023-06-01,ITA,Sarawak,52,36,16
2023-06-01,ITA,Selangor,1743,1178,565
2023-06-01,ITA,W.P. Labuan,1,1,0
2023-06-01,JAM,Johor,2,1,1
2023-06-01,JAM,Kedah,1,1,0
2023-06-01,JAM,Perak,0,0,0
2023-06-01,JAM,Pulau Pinang,1,0,1
2023-06-01,JAM,Sabah,0,0,0
2023-06-01,JAM,Sarawak,0,0,0
2023-06-01,JAM,Selangor,25,13,12
2023-06-01,JAM,W.P. Labuan,2,1,1
2023-06-01,JOR,Johor,14,8,6
2023-06-01,JOR,Kedah,2,1,1
2023-06-01,JOR,Kelantan,0,0,0
2023-06-01,JOR,Melaka,0,0,0
2023-06-01,JOR,Perlis,1,1,0
2023-06-01,JOR,Pulau Pinang,9,6,3
2023-06-01,JOR,Sabah,6,2,4
2023-06-01,JOR,Sarawak,1,1,0
2023-06-01,JOR,Selangor,1022,621,401
2023-06-01,JOR,W.P. Labuan,0,0,0
2023-06-01,JPN,Johor,5269,3665,1604
2023-06-01,JPN,Kedah,130,75,55
2023-06-01,JPN,Kelantan,7,6,1
2023-06-01,JPN,Melaka,1,1,0
2023-06-01,JPN,Negeri Sembilan,0,0,0
2023-06-01,JPN,Pahang,4,2,2
2023-06-01,JPN,Perak,49,27,22
2023-06-01,JPN,Perlis,51,38,13
2023-06-01,JPN,Pulau Pinang,1071,771,300
2023-06-01,JPN,Sabah,151,75,76
2023-06-01,JPN,Sarawak,155,95,60
2023-06-01,JPN,Selangor,10682,7221,3461
2023-06-01,JPN,W.P. Labuan,15,8,7
2023-06-01,KAZ,Johor,50,26,24
2023-06-01,KAZ,Kedah,3,2,1
2023-06-01,KAZ,Kelantan,1,0,1
2023-06-01,KAZ,Melaka,0,0,0
2023-06-01,KAZ,Perak,0,0,0
2023-06-01,KAZ,Perlis,3,2,1
2023-06-01,KAZ,Pulau Pinang,16,6,10
2023-06-01,KAZ,Sabah,2,1,1
2023-06-01,KAZ,Sarawak,1,0,1
2023-06-01,KAZ,Selangor,556,231,325
2023-06-01,KAZ,W.P. Labuan,0,0,0
2023-06-01,KEN,Johor,55,28,27
2023-06-01,KEN,Kedah,1,1,0
2023-06-01,KEN,Kelantan,0,0,0
2023-06-01,KEN,Perak,0,0,0
2023-06-01,KEN,Perlis,0,0,0
2023-06-01,KEN,Pulau Pinang,3,0,3
2023-06-01,KEN,Sabah,5,2,3
2023-06-01,KEN,Sarawak,0,0,0
2023-06-01,KEN,Selangor,282,139,143
2023-06-01,KGZ,Johor,14,7,7
2023-06-01,KGZ,Kedah,0,0,0
2023-06-01,KGZ,Kelantan,0,0,0
2023-06-01,KGZ,Perak,0,0,0
2023-06-01,KGZ,Perlis,0,0,0
2023-06-01,KGZ,Pulau Pinang,1,0,1
2023-06-01,KGZ,Sabah,1,0,1
2023-06-01,KGZ,Sarawak,1,0,1
2023-06-01,KGZ,Selangor,181,88,93
2023-06-01,KHM,Johor,1950,851,1099
2023-06-01,KHM,Kedah,104,66,38
2023-06-01,KHM,Kelantan,429,236,193
2023-06-01,KHM,Melaka,0,0,0
2023-06-01,KHM,Negeri Sembilan,0,0,0
2023-06-01,KHM,Pahang,0,0,0
2023-06-01,KHM,Perak,8,0,8
2023-06-01,KHM,Perlis,556,352,204
2023-06-01,KHM,Pulau Pinang,28,11,17
2023-06-01,KHM,Sabah,3,2,1
2023-06-01,KHM,Sarawak,3,1,2
2023-06-01,KHM,Selangor,1880,890,990
2023-06-01,KHM,W.P. Labuan,0,0,0
2023-06-01,KIR,Johor,0,0,0
2023-06-01,KIR,Sabah,0,0,0
2023-06-01,KIR,Selangor,0,0,0
2023-06-01,KNA,Johor,20,13,7
2023-06-01,KNA,Kedah,0,0,0
2023-06-01,KNA,Perlis,0,0,0
2023-06-01,KNA,Pulau Pinang,1,1,0
2023-06-01,KNA,Sabah,2,2,0
2023-06-01,KNA,Selangor,62,41,21
2023-06-01,KNA,W.P. Labuan,1,1,0
2023-06-01,KOR,Johor,8116,4651,3465
2023-06-01,KOR,Kedah,105,70,35
2023-06-01,KOR,Kelantan,3,0,3
2023-06-01,KOR,Melaka,5,4,1
2023-06-01,KOR,Negeri Sembilan,0,0,0
2023-06-01,KOR,Pahang,1,0,1
2023-06-01,KOR,Perak,18,12,6
2023-06-01,KOR,Perlis,57,48,9
2023-06-01,KOR,Pulau Pinang,461,256,205
2023-06-01,KOR,Sabah,6271,2702,3569
2023-06-01,KOR,Sarawak,174,104,70
2023-06-01,KOR,Selangor,7908,4574,3334
2023-06-01,KOR,Terengganu,0,0,0
2023-06-01,KOR,W.P. Labuan,3,2,1
2023-06-01,KWT,Johor,88,41,47
2023-06-01,KWT,Kedah,24,13,11
2023-06-01,KWT,Kelantan,0,0,0
2023-06-01,KWT,Perak,0,0,0
2023-06-01,KWT,Perlis,0,0,0
2023-06-01,KWT,Pulau Pinang,22,12,10
2023-06-01,KWT,Sabah,0,0,0
2023-06-01,KWT,Sarawak,2,2,0
2023-06-01,KWT,Selangor,1312,652,660
2023-06-01,KWT,W.P. Labuan,0,0,0
2023-06-01,LAO,Johor,130,36,94
2023-06-01,LAO,Kedah,605,42,563
2023-06-01,LAO,Kelantan,250,57,193
2023-06-01,LAO,Melaka,0,0,0
2023-06-01,LAO,Perak,28,3,25
2023-06-01,LAO,Perlis,439,130,309
2023-06-01,LAO,Pulau Pinang,8,2,6
2023-06-01,LAO,Sabah,0,0,0
2023-06-01,LAO,Sarawak,12,6,6
2023-06-01,LAO,Selangor,138,47,91
2023-06-01,LAO,W.P. Labuan,0,0,0
2023-06-01,LBN,Johor,13,9,4
2023-06-01,LBN,Kedah,0,0,0
2023-06-01,LBN,Kelantan,0,0,0
2023-06-01,LBN,Pahang,0,0,0
2023-06-01,LBN,Perak,0,0,0
2023-06-01,LBN,Perlis,0,0,0
2023-06-01,LBN,Pulau Pinang,2,2,0
2023-06-01,LBN,Sabah,0,0,0
2023-06-01,LBN,Sarawak,3,3,0
2023-06-01,LBN,Selangor,233,149,84
2023-06-01,LBN,W.P. Labuan,0,0,0
2023-06-01,LBR,Johor,1,1,0
2023-06-01,LBR,Kedah,0,0,0
2023-06-01,LBR,Sabah,0,0,0
2023-06-01,LBR,Sarawak,0,0,0
2023-06-01,LBR,Selangor,7,5,2
2023-06-01,LBY,Johor,11,10,1
2023-06-01,LBY,Kedah,0,0,0
2023-06-01,LBY,Perlis,0,0,0
2023-06-01,LBY,Pulau Pinang,0,0,0
2023-06-01,LBY,Sabah,2,2,0
2023-06-01,LBY,Sarawak,0,0,0
2023-06-01,LBY,Selangor,253,167,86
2023-06-01,LCA,Johor,7,7,0
2023-06-01,LCA,Kedah,0,0,0
2023-06-01,LCA,Pulau Pinang,2,1,1
2023-06-01,LCA,Sarawak,0,0,0
2023-06-01,LCA,Selangor,4,3,1
2023-06-01,LIE,Johor,1,1,0
2023-06-01,LIE,Kedah,0,0,0
2023-06-01,LIE,Perlis,1,1,0
2023-06-01,LIE,Pulau Pinang,0,0,0
2023-06-01,LIE,Sabah,0,0,0
2023-06-01,LIE,Sarawak,0,0,0
2023-06-01,LIE,Selangor,4,1,3
2023-06-01,LKA,Johor,1365,883,482
2023-06-01,LKA,Kedah,42,23,19
2023-06-01,LKA,Kelantan,0,0,0
2023-06-01,LKA,Melaka,0,0,0
2023-06-01,LKA,Pahang,0,0,0
2023-06-01,LKA,Perak,4,1,3
2023-06-01,LKA,Perlis,1,1,0
2023-06-01,LKA,Pulau Pinang,58,44,14
2023-06-01,LKA,Sabah,10,9,1
2023-06-01,LKA,Sarawak,12,9,3
2023-06-01,LKA,Selangor,3254,2182,1072
2023-06-01,LKA,W.P. Labuan,1,1,0
2023-06-01,LSO,Johor,0,0,0
2023-06-01,LSO,Kedah,0,0,0
2023-06-01,LSO,Pulau Pinang,0,0,0
2023-06-01,LSO,Sarawak,0,0,0
2023-06-01,LSO,Selangor,0,0,0
2023-06-01,LTU,Johor,34,16,18
2023-06-01,LTU,Kedah,5,3,2
2023-06-01,LTU,Kelantan,1,1,0
2023-06-01,LTU,Pahang,1,1,0
2023-06-01,LTU,Perak,0,0,0
2023-06-01,LTU,Perlis,5,5,0
2023-06-01,LTU,Pulau Pinang,6,5,1
2023-06-01,LTU,Sabah,2,0,2
2023-06-01,LTU,Sarawak,3,2,1
2023-06-01,LTU,Selangor,109,65,44
2023-06-01,LTU,W.P. Labuan,0,0,0
2023-06-01,LUX,Johor,10,6,4
2023-06-01,LUX,Kedah,4,3,1
2023-06-01,LUX,Kelantan,0,0,0
2023-06-01,LUX,Perak,0,0,0
2023-06-01,LUX,Perlis,0,0,0
2023-06-01,LUX,Pulau Pinang,4,3,1
2023-06-01,LUX,Sabah,0,0,0
2023-06-01,LUX,Sarawak,0,0,0
2023-06-01,LUX,Selangor,24,16,8
2023-06-01,LVA,Johor,7,7,0
2023-06-01,LVA,Kedah,2,1,1
2023-06-01,LVA,Kelantan,1,0,1
2023-06-01,LVA,Pahang,0,0,0
2023-06-01,LVA,Perak,0,0,0
2023-06-01,LVA,Perlis,3,3,0
2023-06-01,LVA,Pulau Pinang,2,0,2
2023-06-01,LVA,Sabah,0,0,0
2023-06-01,LVA,Sarawak,2,1,1
2023-06-01,LVA,Selangor,56,32,24
2023-06-01,LVA,W.P. Labuan,0,0,0
2023-06-01,MAC,Johor,0,0,0
2023-06-01,MAC,Pahang,0,0,0
2023-06-01,MAC,Perak,2,1,1
2023-06-01,MAC,Selangor,2,1,1
2023-06-01,MAC,W.P. Labuan,0,0,0
2023-06-01,MAR,Johor,65,43,22
2023-06-01,MAR,Kedah,4,4,0
2023-06-01,MAR,Kelantan,0,0,0
2023-06-01,MAR,Melaka,0,0,0
2023-06-01,MAR,Pahang,4,2,2
2023-06-01,MAR,Perak,1,1,0
2023-06-01,MAR,Perlis,3,3,0
2023-06-01,MAR,Pulau Pinang,4,4,0
2023-06-01,MAR,Sabah,1,1,0
2023-06-01,MAR,Sarawak,4,3,1
2023-06-01,MAR,Selangor,566,269,297
2023-06-01,MAR,W.P. Labuan,0,0,0
2023-06-01,MCO,Johor,0,0,0
2023-06-01,MCO,Kedah,0,0,0
2023-06-01,MCO,Sabah,0,0,0
2023-06-01,MCO,Selangor,1,0,1
2023-06-01,MDA,Johor,6,3,3
2023-06-01,MDA,Kedah,5,3,2
2023-06-01,MDA,Kelantan,0,0,0
2023-06-01,MDA,Negeri Sembilan,0,0,0
2023-06-01,MDA,Perlis,0,0,0
2023-06-01,MDA,Pulau Pinang,0,0,0
2023-06-01,MDA,Sabah,0,0,0
2023-06-01,MDA,Sarawak,0,0,0
2023-06-01,MDA,Selangor,22,11,11
2023-06-01,MDG,Johor,9,4,5
2023-06-01,MDG,Kedah,3,2,1
2023-06-01,MDG,Perak,0,0,0
2023-06-01,MDG,Perlis,0,0,0
2023-06-01,MDG,Pulau Pinang,0,0,0
2023-06-01,MDG,Sabah,1,0,1
2023-06-01,MDG,Sarawak,0,0,0
2023-06-01,MDG,Selangor,57,33,24
2023-06-01,MDV,Johor,172,77,95
2023-06-01,MDV,Kedah,7,4,3
2023-06-01,MDV,Kelantan,2,1,1
2023-06-01,MDV,Perak,0,0,0
2023-06-01,MDV,Perlis,0,0,0
2023-06-01,MDV,Pulau Pinang,14,9,5
2023-06-01,MDV,Sabah,0,0,0
2023-06-01,MDV,Sarawak,5,2,3
2023-06-01,MDV,Selangor,2334,1194,1140
2023-06-01,MEX,Johor,150,62,88
2023-06-01,MEX,Kedah,14,5,9
2023-06-01,MEX,Kelantan,0,0,0
2023-06-01,MEX,Pahang,0,0,0
2023-06-01,MEX,Perak,4,2,2
2023-06-01,MEX,Perlis,6,3,3
2023-06-01,MEX,Pulau Pinang,18,14,4
2023-06-01,MEX,Sabah,9,4,5
2023-06-01,MEX,Sarawak,6,3,3
2023-06-01,MEX,Selangor,298,173,125
2023-06-01,MEX,W.P. Labuan,0,0,0
2023-06-01,MHL,Johor,0,0,0
2023-06-01,MHL,Kedah,0,0,0
2023-06-01,MHL,Perak,0,0,0
2023-06-01,MHL,Pulau Pinang,0,0,0
2023-06-01,MHL,Sabah,0,0,0
2023-06-01,MHL,Selangor,0,0,0
2023-06-01,MKD,Johor,3,2,1
2023-06-01,MKD,Kedah,0,0,0
2023-06-01,MKD,Perak,0,0,0
2023-06-01,MKD,Pulau Pinang,0,0,0
2023-06-01,MKD,Sabah,0,0,0
2023-06-01,MKD,Sarawak,0,0,0
2023-06-01,MKD,Selangor,25,16,9
2023-06-01,MLI,Johor,4,4,0
2023-06-01,MLI,Sabah,0,0,0
2023-06-01,MLI,Selangor,9,5,4
2023-06-01,MLT,Johor,7,5,2
2023-06-01,MLT,Kedah,0,0,0
2023-06-01,MLT,Kelantan,0,0,0
2023-06-01,MLT,Perak,0,0,0
2023-06-01,MLT,Perlis,0,0,0
2023-06-01,MLT,Pulau Pinang,1,1,0
2023-06-01,MLT,Sabah,0,0,0
2023-06-01,MLT,Sarawak,0,0,0
2023-06-01,MLT,Selangor,29,20,9
2023-06-01,MLT,W.P. Labuan,0,0,0
2023-06-01,MMR,Johor,6439,1876,4563
2023-06-01,MMR,Kedah,85,19,66
2023-06-01,MMR,Kelantan,5,4,1
2023-06-01,MMR,Negeri Sembilan,0,0,0
2023-06-01,MMR,Pahang,7,3,4
2023-06-01,MMR,Perak,35,7,28
2023-06-01,MMR,Perlis,5,0,5
2023-06-01,MMR,Pulau Pinang,287,109,178
2023-06-01,MMR,Sabah,22,10,12
2023-06-01,MMR,Sarawak,77,37,40
2023-06-01,MMR,Selangor,5749,4225,1524
2023-06-01,MMR,Terengganu,1,1,0
2023-06-01,MMR,W.P. Labuan,0,0,0
2023-06-01,MNE,Johor,7,7,0
2023-06-01,MNE,Kedah,0,0,0
2023-06-01,MNE,Pulau Pinang,0,0,0
2023-06-01,MNE,Sabah,0,0,0
2023-06-01,MNE,Sarawak,0,0,0
2023-06-01,MNE,Selangor,7,5,2
2023-06-01,MNG,Johor,161,63,98
2023-06-01,MNG,Kedah,0,0,0
2023-06-01,MNG,Kelantan,5,1,4
2023-06-01,MNG,Perak,1,1,0
2023-06-01,MNG,Perlis,1,0,1
2023-06-01,MNG,Pulau Pinang,21,11,10
2023-06-01,MNG,Sabah,3,0,3
2023-06-01,MNG,Sarawak,0,0,0
2023-06-01,MNG,Selangor,170,74,96
2023-06-01,MNP,Selangor,0,0,0
2023-06-01,MOZ,Johor,0,0,0
2023-06-01,MOZ,Kedah,0,0,0
2023-06-01,MOZ,Perak,0,0,0
2023-06-01,MOZ,Pulau Pinang,0,0,0
2023-06-01,MOZ,Sabah,0,0,0
2023-06-01,MOZ,Sarawak,0,0,0
2023-06-01,MOZ,Selangor,17,8,9
2023-06-01,MRT,Johor,5,5,0
2023-06-01,MRT,Kedah,0,0,0
2023-06-01,MRT,Pulau Pinang,0,0,0
2023-06-01,MRT,Sabah,0,0,0
2023-06-01,MRT,Sarawak,2,2,0
2023-06-01,MRT,Selangor,4,4,0
2023-06-01,MUS,Johor,184,94,90
2023-06-01,MUS,Kedah,4,2,2
2023-06-01,MUS,Kelantan,0,0,0
2023-06-01,MUS,Pahang,0,0,0
2023-06-01,MUS,Perak,0,0,0
2023-06-01,MUS,Perlis,0,0,0
2023-06-01,MUS,Pulau Pinang,4,2,2
2023-06-01,MUS,Sabah,2,0,2
2023-06-01,MUS,Sarawak,0,0,0
2023-06-01,MUS,Selangor,891,458,433
2023-06-01,MWI,Johor,0,0,0
2023-06-01,MWI,Pulau Pinang,0,0,0
2023-06-01,MWI,Sabah,0,0,0
2023-06-01,MWI,Sarawak,0,0,0
2023-06-01,MWI,Selangor,12,7,5
2023-06-01,MYT,Selangor,0,0,0
2023-06-01,NAM,Johor,0,0,0
2023-06-01,NAM,Kedah,1,0,1
2023-06-01,NAM,Perak,0,0,0
2023-06-01,NAM,Perlis,0,0,0
2023-06-01,NAM,Pulau Pinang,0,0,0
2023-06-01,NAM,Sabah,0,0,0
2023-06-01,NAM,Sarawak,0,0,0
2023-06-01,NAM,Selangor,37,22,15
2023-06-01,NCL,Selangor,0,0,0
2023-06-01,NER,Johor,0,0,0
2023-06-01,NER,Sabah,0,0,0
2023-06-01,NER,Selangor,3,2,1
2023-06-01,NGA,Johor,47,44,3
2023-06-01,NGA,Kedah,1,0,1
2023-06-01,NGA,Perlis,0,0,0
2023-06-01,NGA,Pulau Pinang,0,0,0
2023-06-01,NGA,Sabah,0,0,0
2023-06-01,NGA,Sarawak,2,2,0
2023-06-01,NGA,Selangor,334,257,77
2023-06-01,NIC,Johor,1,1,0
2023-06-01,NIC,Kedah,3,1,2
2023-06-01,NIC,Pulau Pinang,0,0,0
2023-06-01,NIC,Sabah,0,0,0
2023-06-01,NIC,Selangor,3,3,0
2023-06-01,NLD,Johor,854,561,293
2023-06-01,NLD,Kedah,158,86,72
2023-06-01,NLD,Kelantan,1,1,0
2023-06-01,NLD,Melaka,1,1,0
2023-06-01,NLD,Negeri Sembilan,0,0,0
2023-06-01,NLD,Pahang,5,2,3
2023-06-01,NLD,Perak,16,9,7
2023-06-01,NLD,Perlis,48,29,19
2023-06-01,NLD,Pulau Pinang,203,123,80
2023-06-01,NLD,Sabah,71,38,33
2023-06-01,NLD,Sarawak,116,76,40
2023-06-01,NLD,Selangor,2705,1661,1044
2023-06-01,NLD,Terengganu,0,0,0
2023-06-01,NLD,W.P. Labuan,4,2,2
2023-06-01,NOR,Johor,180,111,69
2023-06-01,NOR,Kedah,13,9,4
2023-06-01,NOR,Kelantan,1,1,0
2023-06-01,NOR,Melaka,0,0,0
2023-06-01,NOR,Pahang,0,0,0
2023-06-01,NOR,Perak,0,0,0
2023-06-01,NOR,Perlis,11,6,5
2023-06-01,NOR,Pulau Pinang,24,13,11
2023-06-01,NOR,Sabah,8,6,2
2023-06-01,NOR,Sarawak,23,13,10
2023-06-01,NOR,Selangor,517,313,204
2023-06-01,NOR,W.P. Labuan,1,1,0
2023-06-01,NPL,Johor,702,508,194
2023-06-01,NPL,Kedah,28,25,3
2023-06-01,NPL,Pahang,0,0,0
2023-06-01,NPL,Perak,0,0,0
2023-06-01,NPL,Perlis,0,0,0
2023-06-01,NPL,Pulau Pinang,17,13,4
2023-06-01,NPL,Sabah,3,3,0
2023-06-01,NPL,Sarawak,195,142,53
2023-06-01,NPL,Selangor,12311,11693,618
2023-06-01,NPL,W.P. Labuan,103,101,2
2023-06-01,NRU,Johor,0,0,0
2023-06-01,NRU,Pulau Pinang,0,0,0
2023-06-01,NRU,Selangor,0,0,0
2023-06-01,NZL,Johor,818,492,326
2023-06-01,NZL,Kedah,81,40,41
2023-06-01,NZL,Kelantan,2,2,0
2023-06-01,NZL,Melaka,0,0,0
2023-06-01,NZL,Negeri Sembilan,0,0,0
2023-06-01,NZL,Pahang,6,2,4
2023-06-01,NZL,Perak,28,12,16
2023-06-01,NZL,Perlis,31,18,13
2023-06-01,NZL,Pulau Pinang,219,132,87
2023-06-01,NZL,Sabah,39,23,16
2023-06-01,NZL,Sarawak,113,66,47
2023-06-01,NZL,Selangor,2198,1285,913
2023-06-01,NZL,Terengganu,0,0,0
2023-06-01,NZL,W.P. Labuan,6,3,3
2023-06-01,OMN,Johor,80,39,41
2023-06-01,OMN,Kedah,9,3,6
2023-06-01,OMN,Kelantan,0,0,0
2023-06-01,OMN,Melaka,0,0,0
2023-06-01,OMN,Perak,0,0,0
2023-06-01,OMN,Perlis,0,0,0
2023-06-01,OMN,Pulau Pinang,9,6,3
2023-06-01,OMN,Sabah,0,0,0
2023-06-01,OMN,Sarawak,5,2,3
2023-06-01,OMN,Selangor,1296,700,596
2023-06-01,PAK,Johor,1163,805,358
2023-06-01,PAK,Kedah,144,108,36
2023-06-01,PAK,Kelantan,7,7,0
2023-06-01,PAK,Melaka,0,0,0
2023-06-01,PAK,Negeri Sembilan,0,0,0
2023-06-01,PAK,Pahang,0,0,0
2023-06-01,PAK,Perak,15,11,4
2023-06-01,PAK,Perlis,23,23,0
2023-06-01,PAK,Pulau Pinang,90,77,13
2023-06-01,PAK,Sabah,13,13,0
2023-06-01,PAK,Sarawak,156,135,21
2023-06-01,PAK,Selangor,10745,9160,1585
2023-06-01,PAK,W.P. Labuan,1,1,0
2023-06-01,PAN,Johor,0,0,0
2023-06-01,PAN,Kedah,0,0,0
2023-06-01,PAN,Perak,0,0,0
2023-06-01,PAN,Perlis,0,0,0
2023-06-01,PAN,Pulau Pinang,1,0,1
2023-06-01,PAN,Sabah,0,0,0
2023-06-01,PAN,Sarawak,0,0,0
2023-06-01,PAN,Selangor,6,4,2
2023-06-01,PER,Johor,19,12,7
2023-06-01,PER,Kedah,4,3,1
2023-06-01,PER,Kelantan,0,0,0
2023-06-01,PER,Pahang,1,1,0
2023-06-01,PER,Perak,0,0,0
2023-06-01,PER,Perlis,2,0,2
2023-06-01,PER,Pulau Pinang,5,3,2
2023-06-01,PER,Sabah,2,0,2
2023-06-01,PER,Sarawak,1,1,0
2023-06-01,PER,Selangor,90,43,47
2023-06-01,PER,W.P. Labuan,0,0,0
2023-06-01,PHL,Johor,24673,7915,16758
2023-06-01,PHL,Kedah,510,158,352
2023-06-01,PHL,Kelantan,45,25,20
2023-06-01,PHL,Melaka,1,0,1
2023-06-01,PHL,Negeri Sembilan,0,0,0
2023-06-01,PHL,Pahang,24,20,4
2023-06-01,PHL,Perak,93,38,55
2023-06-01,PHL,Perlis,78,18,60
2023-06-01,PHL,Pulau Pinang,625,208,417
2023-06-01,PHL,Sabah,748,331,417
2023-06-01,PHL,Sarawak,1987,725,1262
2023-06-01,PHL,Selangor,7912,3472,4440
2023-06-01,PHL,Terengganu,0,0,0
2023-06-01,PHL,W.P. Labuan,117,23,94
2023-06-01,PLW,Johor,3,3,0
2023-06-01,PLW,Pulau Pinang,1,1,0
2023-06-01,PLW,Selangor,2,1,1
2023-06-01,PNG,Johor,28,17,11
2023-06-01,PNG,Kedah,0,0,0
2023-06-01,PNG,Kelantan,0,0,0
2023-06-01,PNG,Perak,0,0,0
2023-06-01,PNG,Pulau Pinang,0,0,0
2023-06-01,PNG,Sabah,1,1,0
2023-06-01,PNG,Sarawak,11,8,3
2023-06-01,PNG,Selangor,95,68,27
2023-06-01,POL,Johor,252,141,111
2023-06-01,POL,Kedah,39,19,20
2023-06-01,POL,Kelantan,2,2,0
2023-06-01,POL,Melaka,0,0,0
2023-06-01,POL,Negeri Sembilan,0,0,0
2023-06-01,POL,Pahang,7,4,3
2023-06-01,POL,Perak,4,3,1
2023-06-01,POL,Perlis,13,7,6
2023-06-01,POL,Pulau Pinang,34,20,14
2023-06-01,POL,Sabah,14,6,8
2023-06-01,POL,Sarawak,80,40,40
2023-06-01,POL,Selangor,661,359,302
2023-06-01,POL,Terengganu,0,0,0
2023-06-01,POL,W.P. Labuan,0,0,0
2023-06-01,PRK,Selangor,0,0,0
2023-06-01,PRT,Johor,138,76,62
2023-06-01,PRT,Kedah,20,7,13
2023-06-01,PRT,Kelantan,1,1,0
2023-06-01,PRT,Melaka,0,0,0
2023-06-01,PRT,Pahang,0,0,0
2023-06-01,PRT,Perak,1,1,0
2023-06-01,PRT,Perlis,14,9,5
2023-06-01,PRT,Pulau Pinang,44,26,18
2023-06-01,PRT,Sabah,14,8,6
2023-06-01,PRT,Sarawak,7,5,2
2023-06-01,PRT,Selangor,400,250,150
2023-06-01,PRT,W.P. Labuan,0,0,0
2023-06-01,PRY,Johor,2,0,2
2023-06-01,PRY,Kedah,0,0,0
2023-06-01,PRY,Perak,0,0,0
2023-06-01,PRY,Perlis,0,0,0
2023-06-01,PRY,Pulau Pinang,0,0,0
2023-06-01,PRY,Sabah,0,0,0
2023-06-01,PRY,Sarawak,0,0,0
2023-06-01,PRY,Selangor,9,5,4
2023-06-01,PSE,Johor,24,20,4
2023-06-01,PSE,Kedah,0,0,0
2023-06-01,PSE,Kelantan,3,3,0
2023-06-01,PSE,Melaka,1,1,0
2023-06-01,PSE,Perak,0,0,0
2023-06-01,PSE,Perlis,0,0,0
2023-06-01,PSE,Pulau Pinang,0,0,0
2023-06-01,PSE,Sabah,0,0,0
2023-06-01,PSE,Sarawak,5,5,0
2023-06-01,PSE,Selangor,409,261,148
2023-06-01,QAT,Johor,29,17,12
2023-06-01,QAT,Kedah,0,0,0
2023-06-01,QAT,Perlis,0,0,0
2023-06-01,QAT,Pulau Pinang,9,7,2
2023-06-01,QAT,Sabah,0,0,0
2023-06-01,QAT,Sarawak,0,0,0
2023-06-01,QAT,Selangor,304,171,133
2023-06-01,REU,Johor,0,0,0
2023-06-01,REU,Sarawak,1,1,0
2023-06-01,ROU,Johor,93,58,35
2023-06-01,ROU,Kedah,10,2,8
2023-06-01,ROU,Kelantan,0,0,0
2023-06-01,ROU,Negeri Sembilan,0,0,0
2023-06-01,ROU,Pahang,0,0,0
2023-06-01,ROU,Perak,1,0,1
2023-06-01,ROU,Perlis,4,3,1
2023-06-01,ROU,Pulau Pinang,14,5,9
2023-06-01,ROU,Sabah,4,1,3
2023-06-01,ROU,Sarawak,5,4,1
2023-06-01,ROU,Selangor,336,188,148
2023-06-01,ROU,W.P. Labuan,0,0,0
2023-06-01,RUS,Johor,445,219,226
2023-06-01,RUS,Kedah,313,158,155
2023-06-01,RUS,Kelantan,50,31,19
2023-06-01,RUS,Melaka,0,0,0
2023-06-01,RUS,Negeri Sembilan,0,0,0
2023-06-01,RUS,Pahang,0,0,0
2023-06-01,RUS,Perak,3,3,0
2023-06-01,RUS,Perlis,334,204,130
2023-06-01,RUS,Pulau Pinang,132,75,57
2023-06-01,RUS,Sabah,20,9,11
2023-06-01,RUS,Sarawak,39,20,19
2023-06-01,RUS,Selangor,4266,2221,2045
2023-06-01,RUS,W.P. Labuan,2,1,1
2023-06-01,RWA,Johor,0,0,0
2023-06-01,RWA,Kedah,0,0,0
2023-06-01,RWA,Pulau Pinang,0,0,0
2023-06-01,RWA,Selangor,30,23,7
2023-06-01,SAU,Johor,281,175,106
2023-06-01,SAU,Kedah,43,21,22
2023-06-01,SAU,Kelantan,2,1,1
2023-06-01,SAU,Melaka,0,0,0
2023-06-01,SAU,Perak,0,0,0
2023-06-01,SAU,Perlis,5,3,2
2023-06-01,SAU,Pulau Pinang,78,41,37
2023-06-01,SAU,Sabah,2,1,1
2023-06-01,SAU,Sarawak,8,8,0
2023-06-01,SAU,Selangor,5466,2954,2512
2023-06-01,SAU,W.P. Labuan,0,0,0
2023-06-01,SDN,Johor,6,6,0
2023-06-01,SDN,Kedah,0,0,0
2023-06-01,SDN,Kelantan,0,0,0
2023-06-01,SDN,Perlis,0,0,0
2023-06-01,SDN,Pulau Pinang,0,0,0
2023-06-01,SDN,Sabah,0,0,0
2023-06-01,SDN,Sarawak,10,4,6
2023-06-01,SDN,Selangor,851,476,375
2023-06-01,SDN,W.P. Labuan,0,0,0
2023-06-01,SEN,Johor,3,3,0
2023-06-01,SEN,Kedah,1,1,0
2023-06-01,SEN,Kelantan,0,0,0
2023-06-01,SEN,Perak,0,0,0
2023-06-01,SEN,Perlis,0,0,0
2023-06-01,SEN,Pulau Pinang,0,0,0
2023-06-01,SEN,Sabah,0,0,0
2023-06-01,SEN,Sarawak,0,0,0
2023-06-01,SEN,Selangor,43,34,9
2023-06-01,SGP,Johor,1224502,684070,540432
2023-06-01,SGP,Kedah,9489,4711,4778
2023-06-01,SGP,Kelantan,175,114,61
2023-06-01,SGP,Melaka,24,18,6
2023-06-01,SGP,Negeri Sembilan,1,1,0
2023-06-01,SGP,Pahang,721,355,366
2023-06-01,SGP,Perak,7970,3718,4252
2023-06-01,SGP,Perlis,519,265,254
2023-06-01,SGP,Pulau Pinang,29639,14323,15316
2023-06-01,SGP,Sabah,4139,2095,2044
2023-06-01,SGP,Sarawak,5720,3085,2635
2023-06-01,SGP,Selangor,35275,17545,17730
2023-06-01,SGP,Terengganu,0,0,0
2023-06-01,SGP,W.P. Labuan,9,4,5
2023-06-01,SGS,Johor,0,0,0
2023-06-01,SGS,Sabah,0,0,0
2023-06-01,SGS,Selangor,0,0,0
2023-06-01,SHN,Sarawak,0,0,0
2023-06-01,SLB,Johor,29,29,0
2023-06-01,SLB,Perlis,0,0,0
2023-06-01,SLB,Pulau Pinang,0,0,0
2023-06-01,SLB,Sabah,0,0,0
2023-06-01,SLB,Sarawak,2,1,1
2023-06-01,SLB,Selangor,1,1,0
2023-06-01,SLB,W.P. Labuan,0,0,0
2023-06-01,SLE,Johor,0,0,0
2023-06-01,SLE,Kedah,0,0,0
2023-06-01,SLE,Perak,0,0,0
2023-06-01,SLE,Pulau Pinang,0,0,0
2023-06-01,SLE,Sabah,0,0,0
2023-06-01,SLE,Selangor,9,4,5
2023-06-01,SLV,Johor,4,3,1
2023-06-01,SLV,Kedah,0,0,0
2023-06-01,SLV,Perak,0,0,0
2023-06-01,SLV,Perlis,0,0,0
2023-06-01,SLV,Pulau Pinang,0,0,0
2023-06-01,SLV,Sabah,1,1,0
2023-06-01,SLV,Selangor,15,10,5
2023-06-01,SLV,W.P. Labuan,0,0,0
2023-06-01,SMR,Johor,0,0,0
2023-06-01,SMR,Selangor,1,1,0
2023-06-01,SOM,Johor,0,0,0
2023-06-01,SOM,Kedah,0,0,0
2023-06-01,SOM,Kelantan,0,0,0
2023-06-01,SOM,Perlis,1,0,1
2023-06-01,SOM,Sabah,0,0,0
2023-06-01,SOM,Sarawak,0,0,0
2023-06-01,SOM,Selangor,170,100,70
2023-06-01,SRB,Johor,12,5,7
2023-06-01,SRB,Kedah,3,3,0
2023-06-01,SRB,Kelantan,0,0,0
2023-06-01,SRB,Pahang,0,0,0
2023-06-01,SRB,Perak,0,0,0
2023-06-01,SRB,Perlis,0,0,0
2023-06-01,SRB,Pulau Pinang,6,3,3
2023-06-01,SRB,Sabah,0,0,0
2023-06-01,SRB,Sarawak,0,0,0
2023-06-01,SRB,Selangor,31,17,14
2023-06-01,SSD,Johor,0,0,0
2023-06-01,SSD,Kedah,0,0,0
2023-06-01,SSD,Sarawak,0,0,0
2023-06-01,SSD,Selangor,14,9,5
2023-06-01,SSD,W.P. Labuan,0,0,0
2023-06-01,STP,Selangor,0,0,0
2023-06-01,SUR,Johor,4,2,2
2023-06-01,SUR,Kedah,0,0,0
2023-06-01,SUR,Kelantan,0,0,0
2023-06-01,SUR,Perak,0,0,0
2023-06-01,SUR,Perlis,0,0,0
2023-06-01,SUR,Pulau Pinang,3,3,0
2023-06-01,SUR,Sabah,0,0,0
2023-06-01,SUR,Sarawak,0,0,0
2023-06-01,SUR,Selangor,17,11,6
2023-06-01,SVK,Johor,30,17,13
2023-06-01,SVK,Kedah,18,11,7
2023-06-01,SVK,Kelantan,0,0,0
2023-06-01,SVK,Negeri Sembilan,0,0,0
2023-06-01,SVK,Pahang,0,0,0
2023-06-01,SVK,Perak,2,0,2
2023-06-01,SVK,Perlis,0,0,0
2023-06-01,SVK,Pulau Pinang,8,6,2
2023-06-01,SVK,Sabah,1,1,0
2023-06-01,SVK,Sarawak,5,3,2
2023-06-01,SVK,Selangor,119,67,52
2023-06-01,SVK,W.P. Labuan,0,0,0
2023-06-01,SVN,Johor,12,4,8
2023-06-01,SVN,Kedah,4,2,2
2023-06-01,SVN,Kelantan,0,0,0
2023-06-01,SVN,Perak,0,0,0
2023-06-01,SVN,Perlis,4,2,2
2023-06-01,SVN,Pulau Pinang,4,2,2
2023-06-01,SVN,Sabah,1,0,1
2023-06-01,SVN,Sarawak,1,0,1
2023-06-01,SVN,Selangor,70,47,23
2023-06-01,SVN,W.P. Labuan,0,0,0
2023-06-01,SWE,Johor,250,152,98
2023-06-01,SWE,Kedah,25,11,14
2023-06-01,SWE,Kelantan,4,3,1
2023-06-01,SWE,Melaka,0,0,0
2023-06-01,SWE,Negeri Sembilan,0,0,0
2023-06-01,SWE,Pahang,1,1,0
2023-06-01,SWE,Perak,4,2,2
2023-06-01,SWE,Perlis,13,10,3
2023-06-01,SWE,Pulau Pinang,63,44,19
2023-06-01,SWE,Sabah,11,6,5
2023-06-01,SWE,Sarawak,15,12,3
2023-06-01,SWE,Selangor,728,457,271
2023-06-01,SWE,W.P. Labuan,0,0,0
2023-06-01,SWZ,Johor,0,0,0
2023-06-01,SWZ,Kedah,0,0,0
2023-06-01,SWZ,Pulau Pinang,0,0,0
2023-06-01,SWZ,Sabah,0,0,0
2023-06-01,SWZ,Selangor,17,7,10
2023-06-01,SYC,Johor,3,1,2
2023-06-01,SYC,Kedah,0,0,0
2023-06-01,SYC,Pulau Pinang,0,0,0
2023-06-01,SYC,Sabah,0,0,0
2023-06-01,SYC,Sarawak,1,1,0
2023-06-01,SYC,Selangor,48,16,32
2023-06-01,SYR,Johor,12,7,5
2023-06-01,SYR,Kedah,0,0,0
2023-06-01,SYR,Kelantan,0,0,0
2023-06-01,SYR,Pahang,0,0,0
2023-06-01,SYR,Perlis,0,0,0
2023-06-01,SYR,Pulau Pinang,1,1,0
2023-06-01,SYR,Sabah,0,0,0
2023-06-01,SYR,Sarawak,1,1,0
2023-06-01,SYR,Selangor,670,383,287
2023-06-01,SYR,W.P. Labuan,1,1,0
2023-06-01,TCA,Perlis,0,0,0
2023-06-01,TCD,Johor,0,0,0
2023-06-01,TCD,Kedah,0,0,0
2023-06-01,TCD,Perlis,0,0,0
2023-06-01,TCD,Selangor,26,18,8
2023-06-01,TGO,Johor,0,0,0
2023-06-01,TGO,Perak,1,1,0
2023-06-01,TGO,Pulau Pinang,1,1,0
2023-06-01,TGO,Selangor,2,2,0
2023-06-01,THA,Johor,5129,1309,3820
2023-06-01,THA,Kedah,53478,30729,22749
2023-06-01,THA,Kelantan,35495,18643,16852
2023-06-01,THA,Melaka,57,24,33
2023-06-01,THA,Negeri Sembilan,1,0,1
2023-06-01,THA,Pahang,25,20,5
2023-06-01,THA,Perak,8447,3837,4610
2023-06-01,THA,Perlis,42362,24786,17576
2023-06-01,THA,Pulau Pinang,2023,841,1182
2023-06-01,THA,Sabah,16,7,9
2023-06-01,THA,Sarawak,326,103,223
2023-06-01,THA,Selangor,6857,2750,4107
2023-06-01,THA,Terengganu,0,0,0
2023-06-01,THA,W.P. Labuan,3,1,2
2023-06-01,TJK,Johor,4,3,1
2023-06-01,TJK,Kedah,0,0,0
2023-06-01,TJK,Perlis,0,0,0
2023-06-01,TJK,Pulau Pinang,1,0,1
2023-06-01,TJK,Sabah,1,0,1
2023-06-01,TJK,Selangor,83,60,23
2023-06-01,TKL,Selangor,0,0,0
2023-06-01,TKM,Johor,4,2,2
2023-06-01,TKM,Kedah,1,1,0
2023-06-01,TKM,Kelantan,0,0,0
2023-06-01,TKM,Perlis,0,0,0
2023-06-01,TKM,Pulau Pinang,1,1,0
2023-06-01,TKM,Sabah,0,0,0
2023-06-01,TKM,Sarawak,0,0,0
2023-06-01,TKM,Selangor,92,60,32
2023-06-01,TLS,Johor,2,0,2
2023-06-01,TLS,Kedah,0,0,0
2023-06-01,TLS,Perlis,0,0,0
2023-06-01,TLS,Pulau Pinang,6,2,4
2023-06-01,TLS,Sabah,2,0,2
2023-06-01,TLS,Sarawak,4,1,3
2023-06-01,TLS,Selangor,138,90,48
2023-06-01,TON,Johor,0,0,0
2023-06-01,TON,Pulau Pinang,3,1,2
2023-06-01,TON,Sarawak,0,0,0
2023-06-01,TON,Selangor,3,1,2
2023-06-01,TTO,Johor,3,2,1
2023-06-01,TTO,Kedah,0,0,0
2023-06-01,TTO,Pahang,0,0,0
2023-06-01,TTO,Pulau Pinang,1,1,0
2023-06-01,TTO,Sabah,0,0,0
2023-06-01,TTO,Sarawak,0,0,0
2023-06-01,TTO,Selangor,29,18,11
2023-06-01,TUN,Johor,13,7,6
2023-06-01,TUN,Kedah,1,0,1
2023-06-01,TUN,Kelantan,0,0,0
2023-06-01,TUN,Melaka,0,0,0
2023-06-01,TUN,Perak,0,0,0
2023-06-01,TUN,Perlis,0,0,0
2023-06-01,TUN,Pulau Pinang,2,1,1
2023-06-01,TUN,Sabah,1,0,1
2023-06-01,TUN,Sarawak,1,0,1
2023-06-01,TUN,Selangor,344,170,174
2023-06-01,TUN,W.P. Labuan,0,0,0
2023-06-01,TUR,Johor,323,230,93
2023-06-01,TUR,Kedah,32,24,8
2023-06-01,TUR,Kelantan,1,1,0
2023-06-01,TUR,Melaka,0,0,0
2023-06-01,TUR,Negeri Sembilan,0,0,0
2023-06-01,TUR,Pahang,2,2,0
2023-06-01,TUR,Perak,2,1,1
2023-06-01,TUR,Perlis,20,15,5
2023-06-01,TUR,Pulau Pinang,27,21,6
2023-06-01,TUR,Sabah,6,3,3
2023-06-01,TUR,Sarawak,22,14,8
2023-06-01,TUR,Selangor,1164,797,367
2023-06-01,TUR,W.P. Labuan,0,0,0
2023-06-01,TUV,Selangor,0,0,0
2023-06-01,TWN,Johor,6594,2943,3651
2023-06-01,TWN,Kedah,190,108,82
2023-06-01,TWN,Kelantan,0,0,0
2023-06-01,TWN,Melaka,6,2,4
2023-06-01,TWN,Negeri Sembilan,0,0,0
2023-06-01,TWN,Pahang,8,2,6
2023-06-01,TWN,Perak,65,39,26
2023-06-01,TWN,Perlis,24,10,14
2023-06-01,TWN,Pulau Pinang,5861,2718,3143
2023-06-01,TWN,Sabah,967,477,490
2023-06-01,TWN,Sarawak,265,142,123
2023-06-01,TWN,Selangor,13914,6292,7622
2023-06-01,TWN,W.P. Labuan,6,3,3
2023-06-01,TZA,Johor,19,11,8
2023-06-01,TZA,Kedah,1,1,0
2023-06-01,TZA,Perak,0,0,0
2023-06-01,TZA,Perlis,0,0,0
2023-06-01,TZA,Pulau Pinang,0,0,0
2023-06-01,TZA,Sabah,0,0,0
2023-06-01,TZA,Sarawak,6,5,1
2023-06-01,TZA,Selangor,135,68,67
2023-06-01,UGA,Johor,15,5,10
2023-06-01,UGA,Kedah,2,1,1
2023-06-01,UGA,Perak,0,0,0
2023-06-01,UGA,Perlis,0,0,0
2023-06-01,UGA,Pulau Pinang,3,3,0
2023-06-01,UGA,Sabah,0,0,0
2023-06-01,UGA,Sarawak,0,0,0
2023-06-01,UGA,Selangor,107,53,54
2023-06-01,UKR,Johor,132,84,48
2023-06-01,UKR,Kedah,15,4,11
2023-06-01,UKR,Kelantan,4,3,1
2023-06-01,UKR,Melaka,4,4,0
2023-06-01,UKR,Negeri Sembilan,0,0,0
2023-06-01,UKR,Pahang,3,3,0
2023-06-01,UKR,Perak,0,0,0
2023-06-01,UKR,Perlis,6,4,2
2023-06-01,UKR,Pulau Pinang,17,10,7
2023-06-01,UKR,Sabah,3,1,2
2023-06-01,UKR,Sarawak,4,3,1
2023-06-01,UKR,Selangor,525,276,249
2023-06-01,UKR,W.P. Labuan,0,0,0
2023-06-01,URY,Johor,7,3,4
2023-06-01,URY,Kedah,1,1,0
2023-06-01,URY,Kelantan,0,0,0
2023-06-01,URY,Perak,0,0,0
2023-06-01,URY,Perlis,0,0,0
2023-06-01,URY,Pulau Pinang,0,0,0
2023-06-01,URY,Sabah,0,0,0
2023-06-01,URY,Sarawak,1,0,1
2023-06-01,URY,Selangor,37,19,18
2023-06-01,URY,W.P. Labuan,0,0,0
2023-06-01,USA,Johor,4955,2834,2121
2023-06-01,USA,Kedah,457,258,199
2023-06-01,USA,Kelantan,18,12,6
2023-06-01,USA,Melaka,2,2,0
2023-06-01,USA,Negeri Sembilan,0,0,0
2023-06-01,USA,Pahang,21,14,7
2023-06-01,USA,Perak,192,105,87
2023-06-01,USA,Perlis,139,90,49
2023-06-01,USA,Pulau Pinang,2245,1318,927
2023-06-01,USA,Sabah,252,149,103
2023-06-01,USA,Sarawak,302,181,121
2023-06-01,USA,Selangor,11853,6854,4999
2023-06-01,USA,Terengganu,0,0,0
2023-06-01,USA,W.P. Labuan,4,3,1
2023-06-01,UZB,Johor,107,81,26
2023-06-01,UZB,Kedah,5,4,1
2023-06-01,UZB,Kelantan,0,0,0
2023-06-01,UZB,Perak,0,0,0
2023-06-01,UZB,Perlis,2,2,0
2023-06-01,UZB,Pulau Pinang,18,7,11
2023-06-01,UZB,Sabah,3,2,1
2023-06-01,UZB,Sarawak,0,0,0
2023-06-01,UZB,Selangor,823,478,345
2023-06-01,VAT,Johor,0,0,0
2023-06-01,VAT,Sarawak,0,0,0
2023-06-01,VAT,Selangor,0,0,0
2023-06-01,VCT,Johor,3,1,2
2023-06-01,VCT,Kedah,1,1,0
2023-06-01,VCT,Pulau Pinang,1,0,1
2023-06-01,VCT,Sarawak,0,0,0
2023-06-01,VCT,Selangor,9,2,7
2023-06-01,VEN,Johor,12,10,2
2023-06-01,VEN,Kedah,0,0,0
2023-06-01,VEN,Kelantan,0,0,0
2023-06-01,VEN,Melaka,0,0,0
2023-06-01,VEN,Perak,0,0,0
2023-06-01,VEN,Perlis,0,0,0
2023-06-01,VEN,Pulau Pinang,5,3,2
2023-06-01,VEN,Sabah,5,2,3
2023-06-01,VEN,Sarawak,1,1,0
2023-06-01,VEN,Selangor,62,35,27
2023-06-01,VEN,W.P. Labuan,0,0,0
2023-06-01,VNM,Johor,19318,6651,12667
2023-06-01,VNM,Kedah,316,63,253
2023-06-01,VNM,Kelantan,22,10,12
2023-06-01,VNM,Melaka,0,0,0
2023-06-01,VNM,Negeri Sembilan,0,0,0
2023-06-01,VNM,Pahang,2,1,1
2023-06-01,VNM,Perak,152,16,136
2023-06-01,VNM,Perlis,278,38,240
2023-06-01,VNM,Pulau Pinang,1904,541,1363
2023-06-01,VNM,Sabah,31,10,21
2023-06-01,VNM,Sarawak,207,47,160
2023-06-01,VNM,Selangor,12279,4633,7646
2023-06-01,VNM,Terengganu,2,2,0
2023-06-01,VNM,W.P. Labuan,4,1,3
2023-06-01,VUT,Johor,46,31,15
2023-06-01,VUT,Kedah,0,0,0
2023-06-01,VUT,Pulau Pinang,1,1,0
2023-06-01,VUT,Sabah,0,0,0
2023-06-01,VUT,Sarawak,0,0,0
2023-06-01,VUT,Selangor,40,37,3
2023-06-01,WSM,Johor,0,0,0
2023-06-01,WSM,Sarawak,0,0,0
2023-06-01,WSM,Selangor,4,3,1
2023-06-01,XXX,Johor,87,51,36
2023-06-01,XXX,Kedah,4,1,3
2023-06-01,XXX,Kelantan,1,0,1
2023-06-01,XXX,Melaka,0,0,0
2023-06-01,XXX,Pahang,0,0,0
2023-06-01,XXX,Perak,2,0,2
2023-06-01,XXX,Perlis,3,3,0
2023-06-01,XXX,Pulau Pinang,62,42,20
2023-06-01,XXX,Sabah,15,7,8
2023-06-01,XXX,Sarawak,31,22,9
2023-06-01,XXX,Selangor,309,180,129
2023-06-01,XXX,W.P. Labuan,0,0,0
2023-06-01,YEM,Johor,43,32,11
2023-06-01,YEM,Kedah,2,2,0
2023-06-01,YEM,Kelantan,0,0,0
2023-06-01,YEM,Melaka,4,2,2
2023-06-01,YEM,Pahang,1,1,0
2023-06-01,YEM,Perak,1,1,0
2023-06-01,YEM,Perlis,0,0,0
2023-06-01,YEM,Pulau Pinang,4,4,0
2023-06-01,YEM,Sabah,0,0,0
2023-06-01,YEM,Sarawak,3,1,2
2023-06-01,YEM,Selangor,1533,924,609
2023-06-01,YEM,W.P. Labuan,0,0,0
2023-06-01,ZAF,Johor,270,167,103
2023-06-01,ZAF,Kedah,26,14,12
2023-06-01,ZAF,Kelantan,7,5,2
2023-06-01,ZAF,Melaka,0,0,0
2023-06-01,ZAF,Pahang,2,1,1
2023-06-01,ZAF,Perak,3,2,1
2023-06-01,ZAF,Perlis,28,19,9
2023-06-01,ZAF,Pulau Pinang,54,34,20
2023-06-01,ZAF,Sabah,27,12,15
2023-06-01,ZAF,Sarawak,69,29,40
2023-06-01,ZAF,Selangor,765,428,337
2023-06-01,ZAF,Terengganu,0,0,0
2023-06-01,ZAF,W.P. Labuan,14,7,7
2023-06-01,ZAR,Selangor,0,0,0
2023-06-01,ZMB,Johor,9,1,8
2023-06-01,ZMB,Kedah,0,0,0
2023-06-01,ZMB,Perak,0,0,0
2023-06-01,ZMB,Perlis,0,0,0
2023-06-01,ZMB,Pulau Pinang,0,0,0
2023-06-01,ZMB,Sabah,0,0,0
2023-06-01,ZMB,Sarawak,0,0,0
2023-06-01,ZMB,Selangor,78,42,36
2023-06-01,ZWE,Johor,2,1,1
2023-06-01,ZWE,Kedah,1,1,0
2023-06-01,ZWE,Kelantan,0,0,0
2023-06-01,ZWE,Perak,0,0,0
2023-06-01,ZWE,Perlis,0,0,0
2023-06-01,ZWE,Pulau Pinang,2,1,1
2023-06-01,ZWE,Sabah,0,0,0
2023-06-01,ZWE,Sarawak,0,0,0
2023-06-01,ZWE,Selangor,151,71,80
2023-07-01,ABW,Kedah,0,0,0
2023-07-01,ABW,Pulau Pinang,0,0,0
2023-07-01,AFG,Johor,0,0,0
2023-07-01,AFG,Kedah,0,0,0
2023-07-01,AFG,Perlis,3,3,0
2023-07-01,AFG,Pulau Pinang,0,0,0
2023-07-01,AFG,Sarawak,0,0,0
2023-07-01,AFG,Selangor,68,39,29
2023-07-01,AGO,Johor,0,0,0
2023-07-01,AGO,Kedah,0,0,0
2023-07-01,AGO,Sabah,0,0,0
2023-07-01,AGO,Selangor,8,8,0
2023-07-01,AIA,Selangor,0,0,0
2023-07-01,ALB,Johor,20,16,4
2023-07-01,ALB,Kedah,0,0,0
2023-07-01,ALB,Perak,0,0,0
2023-07-01,ALB,Perlis,0,0,0
2023-07-01,ALB,Pulau Pinang,1,1,0
2023-07-01,ALB,Sabah,0,0,0
2023-07-01,ALB,Sarawak,1,1,0
2023-07-01,ALB,Selangor,25,12,13
2023-07-01,AND,Johor,0,0,0
2023-07-01,AND,Kedah,0,0,0
2023-07-01,AND,Perlis,0,0,0
2023-07-01,AND,Pulau Pinang,0,0,0
2023-07-01,AND,Selangor,7,3,4
2023-07-01,ANT,Selangor,0,0,0
2023-07-01,ARE,Johor,106,58,48
2023-07-01,ARE,Kedah,27,13,14
2023-07-01,ARE,Kelantan,0,0,0
2023-07-01,ARE,Perak,0,0,0
2023-07-01,ARE,Perlis,3,1,2
2023-07-01,ARE,Pulau Pinang,9,3,6
2023-07-01,ARE,Sabah,0,0,0
2023-07-01,ARE,Sarawak,0,0,0
2023-07-01,ARE,Selangor,2070,1023,1047
2023-07-01,ARG,Johor,105,64,41
2023-07-01,ARG,Kedah,11,5,6
2023-07-01,ARG,Kelantan,0,0,0
2023-07-01,ARG,Melaka,0,0,0
2023-07-01,ARG,Perak,0,0,0
2023-07-01,ARG,Perlis,4,2,2
2023-07-01,ARG,Pulau Pinang,13,9,4
2023-07-01,ARG,Sabah,1,0,1
2023-07-01,ARG,Sarawak,1,1,0
2023-07-01,ARG,Selangor,368,185,183
2023-07-01,ARG,W.P. Labuan,0,0,0
2023-07-01,ARM,Johor,4,1,3
2023-07-01,ARM,Kedah,0,0,0
2023-07-01,ARM,Kelantan,0,0,0
2023-07-01,ARM,Perak,0,0,0
2023-07-01,ARM,Perlis,0,0,0
2023-07-01,ARM,Pulau Pinang,0,0,0
2023-07-01,ARM,Sabah,0,0,0
2023-07-01,ARM,Sarawak,1,1,0
2023-07-01,ARM,Selangor,130,50,80
2023-07-01,ATA,Selangor,0,0,0
2023-07-01,ATG,Johor,8,8,0
2023-07-01,ATG,Kedah,0,0,0
2023-07-01,ATG,Pulau Pinang,2,0,2
2023-07-01,ATG,Sarawak,0,0,0
2023-07-01,ATG,Selangor,23,19,4
2023-07-01,AUS,Johor,5848,3444,2404
2023-07-01,AUS,Kedah,629,340,289
2023-07-01,AUS,Kelantan,9,5,4
2023-07-01,AUS,Melaka,5,3,2
2023-07-01,AUS,Negeri Sembilan,1,1,0
2023-07-01,AUS,Pahang,18,7,11
2023-07-01,AUS,Perak,263,135,128
2023-07-01,AUS,Perlis,113,67,46
2023-07-01,AUS,Pulau Pinang,2182,1120,1062
2023-07-01,AUS,Sabah,305,174,131
2023-07-01,AUS,Sarawak,563,321,242
2023-07-01,AUS,Selangor,29346,16481,12865
2023-07-01,AUS,Terengganu,0,0,0
2023-07-01,AUS,W.P. Labuan,9,6,3
2023-07-01,AUT,Johor,228,158,70
2023-07-01,AUT,Kedah,47,24,23
2023-07-01,AUT,Kelantan,3,2,1
2023-07-01,AUT,Melaka,0,0,0
2023-07-01,AUT,Negeri Sembilan,0,0,0
2023-07-01,AUT,Pahang,0,0,0
2023-07-01,AUT,Perak,1,1,0
2023-07-01,AUT,Perlis,14,9,5
2023-07-01,AUT,Pulau Pinang,84,52,32
2023-07-01,AUT,Sabah,10,6,4
2023-07-01,AUT,Sarawak,17,9,8
2023-07-01,AUT,Selangor,987,532,455
2023-07-01,AUT,Terengganu,0,0,0
2023-07-01,AUT,W.P. Labuan,0,0,0
2023-07-01,AZE,Johor,3,2,1
2023-07-01,AZE,Kedah,2,1,1
2023-07-01,AZE,Kelantan,0,0,0
2023-07-01,AZE,Melaka,0,0,0
2023-07-01,AZE,Perlis,0,0,0
2023-07-01,AZE,Pulau Pinang,1,0,1
2023-07-01,AZE,Sabah,0,0,0
2023-07-01,AZE,Sarawak,1,1,0
2023-07-01,AZE,Selangor,159,88,71
2023-07-01,AZE,W.P. Labuan,0,0,0
2023-07-01,BDI,Pulau Pinang,0,0,0
2023-07-01,BDI,Sarawak,0,0,0
2023-07-01,BDI,Selangor,3,2,1
2023-07-01,BEL,Johor,465,263,202
2023-07-01,BEL,Kedah,105,53,52
2023-07-01,BEL,Kelantan,1,1,0
2023-07-01,BEL,Melaka,0,0,0
2023-07-01,BEL,Negeri Sembilan,0,0,0
2023-07-01,BEL,Pahang,1,1,0
2023-07-01,BEL,Perak,2,1,1
2023-07-01,BEL,Perlis,10,10,0
2023-07-01,BEL,Pulau Pinang,81,49,32
2023-07-01,BEL,Sabah,29,16,13
2023-07-01,BEL,Sarawak,49,29,20
2023-07-01,BEL,Selangor,2618,1401,1217
2023-07-01,BEL,W.P. Labuan,4,1,3
2023-07-01,BEN,Johor,0,0,0
2023-07-01,BEN,Kedah,5,1,4
2023-07-01,BEN,Perak,0,0,0
2023-07-01,BEN,Pulau Pinang,0,0,0
2023-07-01,BEN,Sabah,0,0,0
2023-07-01,BEN,Sarawak,0,0,0
2023-07-01,BEN,Selangor,18,15,3
2023-07-01,BFA,Perak,0,0,0
2023-07-01,BFA,Pulau Pinang,0,0,0
2023-07-01,BFA,Selangor,7,7,0
2023-07-01,BGD,Johor,3183,2587,596
2023-07-01,BGD,Kedah,214,123,91
2023-07-01,BGD,Kelantan,3,3,0
2023-07-01,BGD,Melaka,0,0,0
2023-07-01,BGD,Negeri Sembilan,0,0,0
2023-07-01,BGD,Pahang,2,2,0
2023-07-01,BGD,Perak,6,4,2
2023-07-01,BGD,Perlis,2,2,0
2023-07-01,BGD,Pulau Pinang,603,541,62
2023-07-01,BGD,Sabah,3,3,0
2023-07-01,BGD,Sarawak,23,21,2
2023-07-01,BGD,Selangor,57489,54806,2683
2023-07-01,BGD,W.P. Labuan,9,8,1
2023-07-01,BGR,Johor,22,5,17
2023-07-01,BGR,Kedah,0,0,0
2023-07-01,BGR,Kelantan,1,0,1
2023-07-01,BGR,Pahang,0,0,0
2023-07-01,BGR,Perak,0,0,0
2023-07-01,BGR,Perlis,0,0,0
2023-07-01,BGR,Pulau Pinang,11,7,4
2023-07-01,BGR,Sabah,3,2,1
2023-07-01,BGR,Sarawak,2,2,0
2023-07-01,BGR,Selangor,138,79,59
2023-07-01,BGR,W.P. Labuan,0,0,0
2023-07-01,BHR,Johor,57,22,35
2023-07-01,BHR,Kedah,1,1,0
2023-07-01,BHR,Kelantan,0,0,0
2023-07-01,BHR,Perlis,2,2,0
2023-07-01,BHR,Pulau Pinang,2,1,1
2023-07-01,BHR,Sabah,0,0,0
2023-07-01,BHR,Sarawak,0,0,0
2023-07-01,BHR,Selangor,514,254,260
2023-07-01,BHS,Johor,0,0,0
2023-07-01,BHS,Kedah,0,0,0
2023-07-01,BHS,Perak,0,0,0
2023-07-01,BHS,Sabah,0,0,0
2023-07-01,BHS,Sarawak,0,0,0
2023-07-01,BHS,Selangor,7,5,2
2023-07-01,BIH,Johor,16,6,10
2023-07-01,BIH,Kedah,0,0,0
2023-07-01,BIH,Perlis,2,2,0
2023-07-01,BIH,Pulau Pinang,0,0,0
2023-07-01,BIH,Sabah,0,0,0
2023-07-01,BIH,Sarawak,0,0,0
2023-07-01,BIH,Selangor,42,22,20
2023-07-01,BLR,Johor,6,2,4
2023-07-01,BLR,Kedah,16,5,11
2023-07-01,BLR,Kelantan,2,1,1
2023-07-01,BLR,Pahang,0,0,0
2023-07-01,BLR,Perak,1,0,1
2023-07-01,BLR,Perlis,1,1,0
2023-07-01,BLR,Pulau Pinang,5,3,2
2023-07-01,BLR,Sabah,1,0,1
2023-07-01,BLR,Sarawak,1,1,0
2023-07-01,BLR,Selangor,308,150,158
2023-07-01,BLR,W.P. Labuan,0,0,0
2023-07-01,BLZ,Johor,4,2,2
2023-07-01,BLZ,Pulau Pinang,0,0,0
2023-07-01,BLZ,Sarawak,0,0,0
2023-07-01,BLZ,Selangor,14,9,5
2023-07-01,BMU,Selangor,0,0,0
2023-07-01,BOL,Johor,10,8,2
2023-07-01,BOL,Kedah,0,0,0
2023-07-01,BOL,Melaka,0,0,0
2023-07-01,BOL,Perak,0,0,0
2023-07-01,BOL,Perlis,0,0,0
2023-07-01,BOL,Pulau Pinang,0,0,0
2023-07-01,BOL,Sabah,1,0,1
2023-07-01,BOL,Sarawak,0,0,0
2023-07-01,BOL,Selangor,40,22,18
2023-07-01,BRA,Johor,207,113,94
2023-07-01,BRA,Kedah,19,7,12
2023-07-01,BRA,Kelantan,1,1,0
2023-07-01,BRA,Melaka,1,0,1
2023-07-01,BRA,Pahang,0,0,0
2023-07-01,BRA,Perak,6,3,3
2023-07-01,BRA,Perlis,9,5,4
2023-07-01,BRA,Pulau Pinang,28,18,10
2023-07-01,BRA,Sabah,3,2,1
2023-07-01,BRA,Sarawak,13,7,6
2023-07-01,BRA,Selangor,980,541,439
2023-07-01,BRA,W.P. Labuan,1,1,0
2023-07-01,BRB,Johor,2,2,0
2023-07-01,BRB,Kedah,0,0,0
2023-07-01,BRB,Perlis,0,0,0
2023-07-01,BRB,Pulau Pinang,2,0,2
2023-07-01,BRB,Selangor,3,1,2
2023-07-01,BRN,Johor,436,234,202
2023-07-01,BRN,Kedah,34,18,16
2023-07-01,BRN,Kelantan,23,11,12
2023-07-01,BRN,Melaka,0,0,0
2023-07-01,BRN,Pahang,0,0,0
2023-07-01,BRN,Perak,3,2,1
2023-07-01,BRN,Perlis,18,3,15
2023-07-01,BRN,Pulau Pinang,22,11,11
2023-07-01,BRN,Sabah,435,177,258
2023-07-01,BRN,Sarawak,78969,43184,35785
2023-07-01,BRN,Selangor,4956,2422,2534
2023-07-01,BRN,W.P. Labuan,817,622,195
2023-07-01,BTN,Johor,7,7,0
2023-07-01,BTN,Kedah,0,0,0
2023-07-01,BTN,Perak,0,0,0
2023-07-01,BTN,Perlis,0,0,0
2023-07-01,BTN,Pulau Pinang,4,3,1
2023-07-01,BTN,Sabah,0,0,0
2023-07-01,BTN,Sarawak,0,0,0
2023-07-01,BTN,Selangor,63,48,15
2023-07-01,BWA,Johor,2,2,0
2023-07-01,BWA,Kedah,0,0,0
2023-07-01,BWA,Perlis,0,0,0
2023-07-01,BWA,Pulau Pinang,0,0,0
2023-07-01,BWA,Sabah,0,0,0
2023-07-01,BWA,Sarawak,0,0,0
2023-07-01,BWA,Selangor,6,1,5
2023-07-01,CAF,Kedah,0,0,0
2023-07-01,CAF,Selangor,0,0,0
2023-07-01,CAN,Johor,1496,842,654
2023-07-01,CAN,Kedah,136,75,61
2023-07-01,CAN,Kelantan,6,3,3
2023-07-01,CAN,Melaka,1,1,0
2023-07-01,CAN,Negeri Sembilan,0,0,0
2023-07-01,CAN,Pahang,1,1,0
2023-07-01,CAN,Perak,39,21,18
2023-07-01,CAN,Perlis,34,20,14
2023-07-01,CAN,Pulau Pinang,515,283,232
2023-07-01,CAN,Sabah,83,41,42
2023-07-01,CAN,Sarawak,243,124,119
2023-07-01,CAN,Selangor,4568,2583,1985
2023-07-01,CAN,Terengganu,0,0,0
2023-07-01,CAN,W.P. Labuan,16,12,4
2023-07-01,CCK,Selangor,0,0,0
2023-07-01,CHE,Johor,717,397,320
2023-07-01,CHE,Kedah,86,46,40
2023-07-01,CHE,Kelantan,6,3,3
2023-07-01,CHE,Melaka,0,0,0
2023-07-01,CHE,Negeri Sembilan,0,0,0
2023-07-01,CHE,Pahang,1,0,1
2023-07-01,CHE,Perak,13,10,3
2023-07-01,CHE,Perlis,45,26,19
2023-07-01,CHE,Pulau Pinang,157,93,64
2023-07-01,CHE,Sabah,44,21,23
2023-07-01,CHE,Sarawak,52,27,25
2023-07-01,CHE,Selangor,2693,1445,1248
2023-07-01,CHE,W.P. Labuan,2,1,1
2023-07-01,CHL,Johor,33,24,9
2023-07-01,CHL,Kedah,14,9,5
2023-07-01,CHL,Kelantan,1,1,0
2023-07-01,CHL,Melaka,0,0,0
2023-07-01,CHL,Pahang,0,0,0
2023-07-01,CHL,Perak,1,1,0
2023-07-01,CHL,Perlis,7,6,1
2023-07-01,CHL,Pulau Pinang,8,5,3
2023-07-01,CHL,Sabah,0,0,0
2023-07-01,CHL,Sarawak,1,1,0
2023-07-01,CHL,Selangor,203,97,106
2023-07-01,CHN,Johor,51990,22144,29846
2023-07-01,CHN,Kedah,1955,792,1163
2023-07-01,CHN,Kelantan,5,2,3
2023-07-01,CHN,Melaka,3,2,1
2023-07-01,CHN,Pahang,41,18,23
2023-07-01,CHN,Perak,275,122,153
2023-07-01,CHN,Perlis,146,73,73
2023-07-01,CHN,Pulau Pinang,10737,5492,5245
2023-07-01,CHN,Sabah,11535,5247,6288
2023-07-01,CHN,Sarawak,871,413,458
2023-07-01,CHN,Selangor,134932,63626,71306
2023-07-01,CHN,Terengganu,0,0,0
2023-07-01,CHN,W.P. Labuan,56,48,8
2023-07-01,CIV,Johor,0,0,0
2023-07-01,CIV,Kedah,0,0,0
2023-07-01,CIV,Pulau Pinang,0,0,0
2023-07-01,CIV,Sabah,0,0,0
2023-07-01,CIV,Sarawak,0,0,0
2023-07-01,CIV,Selangor,15,11,4
2023-07-01,CMR,Johor,3,3,0
2023-07-01,CMR,Kedah,0,0,0
2023-07-01,CMR,Pulau Pinang,1,0,1
2023-07-01,CMR,Sabah,1,1,0
2023-07-01,CMR,Sarawak,0,0,0
2023-07-01,CMR,Selangor,21,12,9
2023-07-01,COD,Johor,3,3,0
2023-07-01,COD,Pulau Pinang,0,0,0
2023-07-01,COD,Sarawak,0,0,0
2023-07-01,COD,Selangor,12,8,4
2023-07-01,COG,Johor,0,0,0
2023-07-01,COG,Kedah,0,0,0
2023-07-01,COG,Selangor,8,6,2
2023-07-01,COK,Selangor,1,1,0
2023-07-01,COL,Johor,34,20,14
2023-07-01,COL,Kedah,2,2,0
2023-07-01,COL,Perak,0,0,0
2023-07-01,COL,Pulau Pinang,0,0,0
2023-07-01,COL,Sabah,1,0,1
2023-07-01,COL,Sarawak,0,0,0
2023-07-01,COL,Selangor,214,105,109
2023-07-01,COL,W.P. Labuan,0,0,0
2023-07-01,COM,Johor,3,0,3
2023-07-01,COM,Kedah,0,0,0
2023-07-01,COM,Selangor,36,17,19
2023-07-01,CPV,Johor,0,0,0
2023-07-01,CPV,Kedah,0,0,0
2023-07-01,CPV,Pulau Pinang,0,0,0
2023-07-01,CPV,Sabah,0,0,0
2023-07-01,CPV,Selangor,3,2,1
2023-07-01,CRI,Johor,32,15,17
2023-07-01,CRI,Kedah,1,1,0
2023-07-01,CRI,Perak,0,0,0
2023-07-01,CRI,Perlis,0,0,0
2023-07-01,CRI,Pulau Pinang,5,4,1
2023-07-01,CRI,Sabah,0,0,0
2023-07-01,CRI,Sarawak,0,0,0
2023-07-01,CRI,Selangor,56,34,22
2023-07-01,CUB,Johor,4,4,0
2023-07-01,CUB,Kedah,1,0,1
2023-07-01,CUB,Perlis,0,0,0
2023-07-01,CUB,Pulau Pinang,1,1,0
2023-07-01,CUB,Sabah,0,0,0
2023-07-01,CUB,Sarawak,0,0,0
2023-07-01,CUB,Selangor,33,21,12
2023-07-01,CYP,Johor,12,7,5
2023-07-01,CYP,Kedah,0,0,0
2023-07-01,CYP,Perak,0,0,0
2023-07-01,CYP,Perlis,0,0,0
2023-07-01,CYP,Pulau Pinang,2,2,0
2023-07-01,CYP,Sabah,1,0,1
2023-07-01,CYP,Sarawak,0,0,0
2023-07-01,CYP,Selangor,124,73,51
2023-07-01,CZE,Johor,150,81,69
2023-07-01,CZE,Kedah,67,30,37
2023-07-01,CZE,Kelantan,2,0,2
2023-07-01,CZE,Melaka,0,0,0
2023-07-01,CZE,Negeri Sembilan,0,0,0
2023-07-01,CZE,Perak,1,1,0
2023-07-01,CZE,Perlis,6,4,2
2023-07-01,CZE,Pulau Pinang,16,6,10
2023-07-01,CZE,Sabah,8,3,5
2023-07-01,CZE,Sarawak,19,5,14
2023-07-01,CZE,Selangor,654,372,282
2023-07-01,CZE,W.P. Labuan,4,2,2
2023-07-01,DEU,Johor,2379,1419,960
2023-07-01,DEU,Kedah,357,195,162
2023-07-01,DEU,Kelantan,15,10,5
2023-07-01,DEU,Melaka,2,2,0
2023-07-01,DEU,Negeri Sembilan,1,0,1
2023-07-01,DEU,Pahang,4,3,1
2023-07-01,DEU,Perak,42,31,11
2023-07-01,DEU,Perlis,137,81,56
2023-07-01,DEU,Pulau Pinang,763,515,248
2023-07-01,DEU,Sabah,102,64,38
2023-07-01,DEU,Sarawak,202,117,85
2023-07-01,DEU,Selangor,7898,4700,3198
2023-07-01,DEU,Terengganu,0,0,0
2023-07-01,DEU,W.P. Labuan,9,8,1
2023-07-01,DJI,Johor,0,0,0
2023-07-01,DJI,Selangor,2,2,0
2023-07-01,DMA,Johor,5,5,0
2023-07-01,DMA,Kedah,0,0,0
2023-07-01,DMA,Pulau Pinang,0,0,0
2023-07-01,DMA,Sabah,0,0,0
2023-07-01,DMA,Sarawak,0,0,0
2023-07-01,DMA,Selangor,61,42,19
2023-07-01,DMA,W.P. Labuan,0,0,0
2023-07-01,DNK,Johor,312,207,105
2023-07-01,DNK,Kedah,54,32,22
2023-07-01,DNK,Kelantan,0,0,0
2023-07-01,DNK,Melaka,0,0,0
2023-07-01,DNK,Negeri Sembilan,0,0,0
2023-07-01,DNK,Pahang,0,0,0
2023-07-01,DNK,Perak,4,2,2
2023-07-01,DNK,Perlis,14,11,3
2023-07-01,DNK,Pulau Pinang,64,36,28
2023-07-01,DNK,Sabah,26,12,14
2023-07-01,DNK,Sarawak,44,22,22
2023-07-01,DNK,Selangor,1844,1007,837
2023-07-01,DNK,W.P. Labuan,0,0,0
2023-07-01,DOM,Johor,1,0,1
2023-07-01,DOM,Kedah,0,0,0
2023-07-01,DOM,Perak,0,0,0
2023-07-01,DOM,Perlis,0,0,0
2023-07-01,DOM,Pulau Pinang,1,1,0
2023-07-01,DOM,Sabah,0,0,0
2023-07-01,DOM,Sarawak,0,0,0
2023-07-01,DOM,Selangor,16,8,8
2023-07-01,DZA,Johor,26,21,5
2023-07-01,DZA,Kedah,3,3,0
2023-07-01,DZA,Kelantan,0,0,0
2023-07-01,DZA,Melaka,0,0,0
2023-07-01,DZA,Perak,0,0,0
2023-07-01,DZA,Perlis,4,1,3
2023-07-01,DZA,Pulau Pinang,5,3,2
2023-07-01,DZA,Sabah,0,0,0
2023-07-01,DZA,Sarawak,0,0,0
2023-07-01,DZA,Selangor,1134,613,521
2023-07-01,DZA,W.P. Labuan,0,0,0
2023-07-01,ECU,Johor,11,10,1
2023-07-01,ECU,Kedah,3,1,2
2023-07-01,ECU,Perak,0,0,0
2023-07-01,ECU,Perlis,0,0,0
2023-07-01,ECU,Pulau Pinang,1,0,1
2023-07-01,ECU,Sabah,1,1,0
2023-07-01,ECU,Sarawak,0,0,0
2023-07-01,ECU,Selangor,72,35,37
2023-07-01,EGY,Johor,247,190,57
2023-07-01,EGY,Kedah,5,4,1
2023-07-01,EGY,Kelantan,1,1,0
2023-07-01,EGY,Melaka,2,2,0
2023-07-01,EGY,Pahang,0,0,0
2023-07-01,EGY,Perak,0,0,0
2023-07-01,EGY,Perlis,0,0,0
2023-07-01,EGY,Pulau Pinang,7,7,0
2023-07-01,EGY,Sabah,2,2,0
2023-07-01,EGY,Sarawak,92,64,28
2023-07-01,EGY,Selangor,1964,1188,776
2023-07-01,EGY,Terengganu,0,0,0
2023-07-01,EGY,W.P. Labuan,0,0,0
2023-07-01,ERI,Johor,1,0,1
2023-07-01,ERI,Pulau Pinang,0,0,0
2023-07-01,ERI,Sabah,0,0,0
2023-07-01,ERI,Selangor,12,11,1
2023-07-01,ESP,Johor,627,360,267
2023-07-01,ESP,Kedah,116,58,58
2023-07-01,ESP,Kelantan,14,6,8
2023-07-01,ESP,Melaka,0,0,0
2023-07-01,ESP,Negeri Sembilan,0,0,0
2023-07-01,ESP,Pahang,0,0,0
2023-07-01,ESP,Perak,17,7,10
2023-07-01,ESP,Perlis,18,11,7
2023-07-01,ESP,Pulau Pinang,200,103,97
2023-07-01,ESP,Sabah,47,32,15
2023-07-01,ESP,Sarawak,92,54,38
2023-07-01,ESP,Selangor,5115,2558,2557
2023-07-01,ESP,W.P. Labuan,6,4,2
2023-07-01,EST,Johor,19,8,11
2023-07-01,EST,Kedah,9,5,4
2023-07-01,EST,Kelantan,0,0,0
2023-07-01,EST,Pahang,0,0,0
2023-07-01,EST,Perak,0,0,0
2023-07-01,EST,Perlis,0,0,0
2023-07-01,EST,Pulau Pinang,7,4,3
2023-07-01,EST,Sabah,1,0,1
2023-07-01,EST,Sarawak,0,0,0
2023-07-01,EST,Selangor,90,48,42
2023-07-01,EST,W.P. Labuan,0,0,0
2023-07-01,ETH,Johor,0,0,0
2023-07-01,ETH,Kedah,0,0,0
2023-07-01,ETH,Pulau Pinang,0,0,0
2023-07-01,ETH,Sarawak,1,1,0
2023-07-01,ETH,Selangor,53,24,29
2023-07-01,FIN,Johor,112,66,46
2023-07-01,FIN,Kedah,20,10,10
2023-07-01,FIN,Kelantan,2,1,1
2023-07-01,FIN,Melaka,0,0,0
2023-07-01,FIN,Negeri Sembilan,0,0,0
2023-07-01,FIN,Pahang,0,0,0
2023-07-01,FIN,Perak,0,0,0
2023-07-01,FIN,Perlis,21,13,8
2023-07-01,FIN,Pulau Pinang,33,19,14
2023-07-01,FIN,Sabah,9,3,6
2023-07-01,FIN,Sarawak,4,1,3
2023-07-01,FIN,Selangor,399,226,173
2023-07-01,FIN,W.P. Labuan,2,1,1
2023-07-01,FJI,Johor,64,33,31
2023-07-01,FJI,Kedah,1,1,0
2023-07-01,FJI,Kelantan,0,0,0
2023-07-01,FJI,Perak,0,0,0
2023-07-01,FJI,Perlis,0,0,0
2023-07-01,FJI,Pulau Pinang,4,0,4
2023-07-01,FJI,Sabah,1,1,0
2023-07-01,FJI,Sarawak,4,4,0
2023-07-01,FJI,Selangor,141,78,63
2023-07-01,FRA,Johor,3199,1804,1395
2023-07-01,FRA,Kedah,382,217,165
2023-07-01,FRA,Kelantan,32,17,15
2023-07-01,FRA,Melaka,7,6,1
2023-07-01,FRA,Negeri Sembilan,1,1,0
2023-07-01,FRA,Pahang,10,6,4
2023-07-01,FRA,Perak,46,32,14
2023-07-01,FRA,Perlis,79,45,34
2023-07-01,FRA,Pulau Pinang,482,284,198
2023-07-01,FRA,Sabah,107,72,35
2023-07-01,FRA,Sarawak,170,105,65
2023-07-01,FRA,Selangor,14425,7767,6658
2023-07-01,FRA,Terengganu,0,0,0
2023-07-01,FRA,W.P. Labuan,5,3,2
2023-07-01,FSM,Johor,0,0,0
2023-07-01,FSM,Pulau Pinang,0,0,0
2023-07-01,FSM,Selangor,0,0,0
2023-07-01,GAB,Johor,2,2,0
2023-07-01,GAB,Pulau Pinang,0,0,0
2023-07-01,GAB,Sarawak,1,0,1
2023-07-01,GAB,Selangor,5,4,1
2023-07-01,GBR,Johor,5000,3130,1870
2023-07-01,GBR,Kedah,948,540,408
2023-07-01,GBR,Kelantan,15,14,1
2023-07-01,GBR,Melaka,4,2,2
2023-07-01,GBR,Negeri Sembilan,1,1,0
2023-07-01,GBR,Pahang,10,8,2
2023-07-01,GBR,Perak,137,72,65
2023-07-01,GBR,Perlis,193,116,77
2023-07-01,GBR,Pulau Pinang,1796,998,798
2023-07-01,GBR,Sabah,464,248,216
2023-07-01,GBR,Sarawak,1048,621,427
2023-07-01,GBR,Selangor,23629,13369,10260
2023-07-01,GBR,Terengganu,0,0,0
2023-07-01,GBR,W.P. Labuan,25,17,8
2023-07-01,GEO,Johor,11,11,0
2023-07-01,GEO,Kedah,0,0,0
2023-07-01,GEO,Melaka,0,0,0
2023-07-01,GEO,Perak,0,0,0
2023-07-01,GEO,Perlis,1,0,1
2023-07-01,GEO,Pulau Pinang,1,0,1
2023-07-01,GEO,Sabah,0,0,0
2023-07-01,GEO,Sarawak,0,0,0
2023-07-01,GEO,Selangor,43,28,15
2023-07-01,GHA,Johor,10,9,1
2023-07-01,GHA,Kedah,1,1,0
2023-07-01,GHA,Kelantan,0,0,0
2023-07-01,GHA,Pulau Pinang,0,0,0
2023-07-01,GHA,Sabah,0,0,0
2023-07-01,GHA,Sarawak,0,0,0
2023-07-01,GHA,Selangor,58,44,14
2023-07-01,GIB,Johor,0,0,0
2023-07-01,GIB,Sarawak,0,0,0
2023-07-01,GIN,Johor,7,7,0
2023-07-01,GIN,Kedah,1,1,0
2023-07-01,GIN,Kelantan,0,0,0
2023-07-01,GIN,Perlis,0,0,0
2023-07-01,GIN,Pulau Pinang,0,0,0
2023-07-01,GIN,Sabah,0,0,0
2023-07-01,GIN,Sarawak,0,0,0
2023-07-01,GIN,Selangor,53,36,17
2023-07-01,GLP,Selangor,0,0,0
2023-07-01,GMB,Johor,10,9,1
2023-07-01,GMB,Kedah,0,0,0
2023-07-01,GMB,Kelantan,0,0,0
2023-07-01,GMB,Pulau Pinang,0,0,0
2023-07-01,GMB,Sabah,0,0,0
2023-07-01,GMB,Sarawak,0,0,0
2023-07-01,GMB,Selangor,28,26,2
2023-07-01,GNB,Johor,0,0,0
2023-07-01,GNB,Selangor,0,0,0
2023-07-01,GNQ,Johor,0,0,0
2023-07-01,GNQ,Selangor,3,0,3
2023-07-01,GRC,Johor,42,31,11
2023-07-01,GRC,Kedah,3,2,1
2023-07-01,GRC,Kelantan,0,0,0
2023-07-01,GRC,Melaka,0,0,0
2023-07-01,GRC,Negeri Sembilan,0,0,0
2023-07-01,GRC,Pahang,0,0,0
2023-07-01,GRC,Perak,1,1,0
2023-07-01,GRC,Perlis,3,1,2
2023-07-01,GRC,Pulau Pinang,8,3,5
2023-07-01,GRC,Sabah,1,1,0
2023-07-01,GRC,Sarawak,6,4,2
2023-07-01,GRC,Selangor,190,135,55
2023-07-01,GRD,Johor,12,5,7
2023-07-01,GRD,Kedah,1,1,0
2023-07-01,GRD,Pulau Pinang,1,0,1
2023-07-01,GRD,Sabah,0,0,0
2023-07-01,GRD,Sarawak,0,0,0
2023-07-01,GRD,Selangor,12,9,3
2023-07-01,GRL,Johor,1,1,0
2023-07-01,GRL,Selangor,0,0,0
2023-07-01,GTM,Johor,5,5,0
2023-07-01,GTM,Kedah,0,0,0
2023-07-01,GTM,Pahang,0,0,0
2023-07-01,GTM,Perak,0,0,0
2023-07-01,GTM,Pulau Pinang,0,0,0
2023-07-01,GTM,Sabah,0,0,0
2023-07-01,GTM,Sarawak,0,0,0
2023-07-01,GTM,Selangor,19,15,4
2023-07-01,GTM,W.P. Labuan,0,0,0
2023-07-01,GUY,Johor,0,0,0
2023-07-01,GUY,Kedah,0,0,0
2023-07-01,GUY,Pulau Pinang,0,0,0
2023-07-01,GUY,Sarawak,1,0,1
2023-07-01,GUY,Selangor,4,1,3
2023-07-01,HKG,Johor,4,4,0
2023-07-01,HKG,Kedah,0,0,0
2023-07-01,HKG,Kelantan,1,1,0
2023-07-01,HKG,Pahang,3,2,1
2023-07-01,HKG,Perak,91,49,42
2023-07-01,HKG,Perlis,1,0,1
2023-07-01,HKG,Pulau Pinang,0,0,0
2023-07-01,HKG,Sabah,0,0,0
2023-07-01,HKG,Sarawak,0,0,0
2023-07-01,HKG,Selangor,7,6,1
2023-07-01,HKG,Terengganu,0,0,0
2023-07-01,HMD,Johor,0,0,0
2023-07-01,HND,Johor,9,7,2
2023-07-01,HND,Kedah,0,0,0
2023-07-01,HND,Perak,0,0,0
2023-07-01,HND,Pulau Pinang,0,0,0
2023-07-01,HND,Sabah,0,0,0
2023-07-01,HND,Sarawak,0,0,0
2023-07-01,HND,Selangor,15,14,1
2023-07-01,HRV,Johor,25,16,9
2023-07-01,HRV,Kedah,1,1,0
2023-07-01,HRV,Kelantan,0,0,0
2023-07-01,HRV,Melaka,0,0,0
2023-07-01,HRV,Pahang,0,0,0
2023-07-01,HRV,Perak,0,0,0
2023-07-01,HRV,Perlis,0,0,0
2023-07-01,HRV,Pulau Pinang,1,0,1
2023-07-01,HRV,Sabah,1,1,0
2023-07-01,HRV,Sarawak,2,2,0
2023-07-01,HRV,Selangor,150,105,45
2023-07-01,HTI,Johor,0,0,0
2023-07-01,HTI,Kedah,0,0,0
2023-07-01,HTI,Kelantan,0,0,0
2023-07-01,HTI,Perak,0,0,0
2023-07-01,HTI,Pulau Pinang,0,0,0
2023-07-01,HTI,Sabah,0,0,0
2023-07-01,HTI,Selangor,9,4,5
2023-07-01,HUN,Johor,104,59,45
2023-07-01,HUN,Kedah,14,6,8
2023-07-01,HUN,Kelantan,0,0,0
2023-07-01,HUN,Pahang,0,0,0
2023-07-01,HUN,Perak,0,0,0
2023-07-01,HUN,Perlis,7,4,3
2023-07-01,HUN,Pulau Pinang,10,6,4
2023-07-01,HUN,Sabah,3,2,1
2023-07-01,HUN,Sarawak,18,5,13
2023-07-01,HUN,Selangor,465,253,212
2023-07-01,HUN,W.P. Labuan,0,0,0
2023-07-01,IDN,Johor,110963,52035,58928
2023-07-01,IDN,Kedah,7844,2720,5124
2023-07-01,IDN,Kelantan,206,100,106
2023-07-01,IDN,Melaka,5206,2314,2892
2023-07-01,IDN,Negeri Sembilan,6484,4492,1992
2023-07-01,IDN,Pahang,18,13,5
2023-07-01,IDN,Perak,323,170,153
2023-07-01,IDN,Perlis,681,266,415
2023-07-01,IDN,Pulau Pinang,40973,16180,24793
2023-07-01,IDN,Sabah,4863,2329,2534
2023-07-01,IDN,Sarawak,36328,18358,17970
2023-07-01,IDN,Selangor,130764,61675,69089
2023-07-01,IDN,Terengganu,1,1,0
2023-07-01,IDN,W.P. Labuan,106,42,64
2023-07-01,IND,Johor,22725,15889,6836
2023-07-01,IND,Kedah,1141,637,504
2023-07-01,IND,Kelantan,6,6,0
2023-07-01,IND,Melaka,3,2,1
2023-07-01,IND,Negeri Sembilan,0,0,0
2023-07-01,IND,Pahang,9,8,1
2023-07-01,IND,Perak,269,181,88
2023-07-01,IND,Perlis,35,30,5
2023-07-01,IND,Pulau Pinang,1108,776,332
2023-07-01,IND,Sabah,151,108,43
2023-07-01,IND,Sarawak,1048,846,202
2023-07-01,IND,Selangor,52105,37815,14290
2023-07-01,IND,Terengganu,0,0,0
2023-07-01,IND,W.P. Labuan,81,62,19
2023-07-01,IOT,Pulau Pinang,0,0,0
2023-07-01,IOT,Selangor,0,0,0
2023-07-01,IRL,Johor,315,180,135
2023-07-01,IRL,Kedah,80,50,30
2023-07-01,IRL,Kelantan,0,0,0
2023-07-01,IRL,Negeri Sembilan,1,0,1
2023-07-01,IRL,Pahang,0,0,0
2023-07-01,IRL,Perak,19,13,6
2023-07-01,IRL,Perlis,17,11,6
2023-07-01,IRL,Pulau Pinang,137,79,58
2023-07-01,IRL,Sabah,16,8,8
2023-07-01,IRL,Sarawak,26,11,15
2023-07-01,IRL,Selangor,1791,975,816
2023-07-01,IRL,Terengganu,0,0,0
2023-07-01,IRL,W.P. Labuan,1,1,0
2023-07-01,IRN,Johor,177,100,77
2023-07-01,IRN,Kedah,12,7,5
2023-07-01,IRN,Kelantan,0,0,0
2023-07-01,IRN,Perak,0,0,0
2023-07-01,IRN,Perlis,9,6,3
2023-07-01,IRN,Pulau Pinang,8,4,4
2023-07-01,IRN,Sabah,2,1,1
2023-07-01,IRN,Sarawak,3,2,1
2023-07-01,IRN,Selangor,1488,823,665
2023-07-01,IRN,W.P. Labuan,0,0,0
2023-07-01,IRQ,Johor,47,30,17
2023-07-01,IRQ,Kedah,2,2,0
2023-07-01,IRQ,Kelantan,1,1,0
2023-07-01,IRQ,Melaka,0,0,0
2023-07-01,IRQ,Pahang,0,0,0
2023-07-01,IRQ,Perak,0,0,0
2023-07-01,IRQ,Perlis,0,0,0
2023-07-01,IRQ,Pulau Pinang,3,2,1
2023-07-01,IRQ,Sabah,0,0,0
2023-07-01,IRQ,Sarawak,0,0,0
2023-07-01,IRQ,Selangor,1191,711,480
2023-07-01,ISL,Johor,12,4,8
2023-07-01,ISL,Kedah,2,1,1
2023-07-01,ISL,Kelantan,0,0,0
2023-07-01,ISL,Perak,4,2,2
2023-07-01,ISL,Perlis,0,0,0
2023-07-01,ISL,Pulau Pinang,0,0,0
2023-07-01,ISL,Sabah,0,0,0
2023-07-01,ISL,Sarawak,0,0,0
2023-07-01,ISL,Selangor,41,24,17
2023-07-01,ISL,W.P. Labuan,0,0,0
2023-07-01,ISR,Pulau Pinang,0,0,0
2023-07-01,ITA,Johor,763,468,295
2023-07-01,ITA,Kedah,57,38,19
2023-07-01,ITA,Kelantan,3,2,1
2023-07-01,ITA,Melaka,1,1,0
2023-07-01,ITA,Negeri Sembilan,0,0,0
2023-07-01,ITA,Pahang,1,1,0
2023-07-01,ITA,Perak,8,3,5
2023-07-01,ITA,Perlis,25,14,11
2023-07-01,ITA,Pulau Pinang,165,120,45
2023-07-01,ITA,Sabah,41,24,17
2023-07-01,ITA,Sarawak,111,62,49
2023-07-01,ITA,Selangor,4711,2671,2040
2023-07-01,ITA,W.P. Labuan,1,1,0
2023-07-01,JAM,Johor,4,1,3
2023-07-01,JAM,Kedah,0,0,0
2023-07-01,JAM,Perak,0,0,0
2023-07-01,JAM,Pulau Pinang,2,1,1
2023-07-01,JAM,Sabah,0,0,0
2023-07-01,JAM,Sarawak,0,0,0
2023-07-01,JAM,Selangor,27,9,18
2023-07-01,JAM,W.P. Labuan,0,0,0
2023-07-01,JOR,Johor,40,26,14
2023-07-01,JOR,Kedah,6,3,3
2023-07-01,JOR,Kelantan,0,0,0
2023-07-01,JOR,Melaka,0,0,0
2023-07-01,JOR,Perlis,0,0,0
2023-07-01,JOR,Pulau Pinang,18,11,7
2023-07-01,JOR,Sabah,1,1,0
2023-07-01,JOR,Sarawak,0,0,0
2023-07-01,JOR,Selangor,1371,749,622
2023-07-01,JOR,W.P. Labuan,0,0,0
2023-07-01,JPN,Johor,6456,4146,2310
2023-07-01,JPN,Kedah,209,100,109
2023-07-01,JPN,Kelantan,16,10,6
2023-07-01,JPN,Melaka,1,1,0
2023-07-01,JPN,Negeri Sembilan,0,0,0
2023-07-01,JPN,Pahang,1,0,1
2023-07-01,JPN,Perak,79,57,22
2023-07-01,JPN,Perlis,70,54,16
2023-07-01,JPN,Pulau Pinang,1541,1051,490
2023-07-01,JPN,Sabah,121,76,45
2023-07-01,JPN,Sarawak,191,137,54
2023-07-01,JPN,Selangor,21617,12766,8851
2023-07-01,JPN,W.P. Labuan,10,6,4
2023-07-01,KAZ,Johor,87,45,42
2023-07-01,KAZ,Kedah,18,5,13
2023-07-01,KAZ,Kelantan,1,1,0
2023-07-01,KAZ,Melaka,0,0,0
2023-07-01,KAZ,Perak,1,1,0
2023-07-01,KAZ,Perlis,3,0,3
2023-07-01,KAZ,Pulau Pinang,7,5,2
2023-07-01,KAZ,Sabah,5,2,3
2023-07-01,KAZ,Sarawak,7,0,7
2023-07-01,KAZ,Selangor,966,417,549
2023-07-01,KAZ,W.P. Labuan,0,0,0
2023-07-01,KEN,Johor,79,41,38
2023-07-01,KEN,Kedah,8,3,5
2023-07-01,KEN,Kelantan,0,0,0
2023-07-01,KEN,Perak,0,0,0
2023-07-01,KEN,Perlis,1,0,1
2023-07-01,KEN,Pulau Pinang,2,1,1
2023-07-01,KEN,Sabah,0,0,0
2023-07-01,KEN,Sarawak,0,0,0
2023-07-01,KEN,Selangor,395,203,192
2023-07-01,KGZ,Johor,30,18,12
2023-07-01,KGZ,Kedah,3,2,1
2023-07-01,KGZ,Kelantan,0,0,0
2023-07-01,KGZ,Perak,0,0,0
2023-07-01,KGZ,Perlis,1,0,1
2023-07-01,KGZ,Pulau Pinang,11,6,5
2023-07-01,KGZ,Sabah,0,0,0
2023-07-01,KGZ,Sarawak,0,0,0
2023-07-01,KGZ,Selangor,222,98,124
2023-07-01,KHM,Johor,2372,1067,1305
2023-07-01,KHM,Kedah,106,63,43
2023-07-01,KHM,Kelantan,565,314,251
2023-07-01,KHM,Melaka,0,0,0
2023-07-01,KHM,Negeri Sembilan,0,0,0
2023-07-01,KHM,Pahang,0,0,0
2023-07-01,KHM,Perak,11,2,9
2023-07-01,KHM,Perlis,858,529,329
2023-07-01,KHM,Pulau Pinang,51,23,28
2023-07-01,KHM,Sabah,0,0,0
2023-07-01,KHM,Sarawak,11,4,7
2023-07-01,KHM,Selangor,4326,2043,2283
2023-07-01,KHM,W.P. Labuan,0,0,0
2023-07-01,KIR,Johor,0,0,0
2023-07-01,KIR,Sabah,0,0,0
2023-07-01,KIR,Selangor,2,1,1
2023-07-01,KNA,Johor,24,14,10
2023-07-01,KNA,Kedah,0,0,0
2023-07-01,KNA,Perlis,0,0,0
2023-07-01,KNA,Pulau Pinang,0,0,0
2023-07-01,KNA,Sabah,2,0,2
2023-07-01,KNA,Selangor,98,68,30
2023-07-01,KNA,W.P. Labuan,0,0,0
2023-07-01,KOR,Johor,15171,7790,7381
2023-07-01,KOR,Kedah,183,101,82
2023-07-01,KOR,Kelantan,1,0,1
2023-07-01,KOR,Melaka,3,2,1
2023-07-01,KOR,Negeri Sembilan,0,0,0
2023-07-01,KOR,Pahang,2,0,2
2023-07-01,KOR,Perak,16,10,6
2023-07-01,KOR,Perlis,60,41,19
2023-07-01,KOR,Pulau Pinang,741,393,348
2023-07-01,KOR,Sabah,7839,3327,4512
2023-07-01,KOR,Sarawak,229,125,104
2023-07-01,KOR,Selangor,21820,10908,10912
2023-07-01,KOR,Terengganu,0,0,0
2023-07-01,KOR,W.P. Labuan,3,2,1
2023-07-01,KWT,Johor,104,64,40
2023-07-01,KWT,Kedah,30,9,21
2023-07-01,KWT,Kelantan,0,0,0
2023-07-01,KWT,Perak,1,0,1
2023-07-01,KWT,Perlis,2,1,1
2023-07-01,KWT,Pulau Pinang,10,3,7
2023-07-01,KWT,Sabah,2,1,1
2023-07-01,KWT,Sarawak,0,0,0
2023-07-01,KWT,Selangor,2585,1351,1234
2023-07-01,KWT,W.P. Labuan,1,1,0
2023-07-01,LAO,Johor,206,66,140
2023-07-01,LAO,Kedah,292,24,268
2023-07-01,LAO,Kelantan,144,59,85
2023-07-01,LAO,Melaka,0,0,0
2023-07-01,LAO,Perak,35,2,33
2023-07-01,LAO,Perlis,535,115,420
2023-07-01,LAO,Pulau Pinang,22,5,17
2023-07-01,LAO,Sabah,2,0,2
2023-07-01,LAO,Sarawak,8,5,3
2023-07-01,LAO,Selangor,309,106,203
2023-07-01,LAO,W.P. Labuan,0,0,0
2023-07-01,LBN,Johor,12,6,6
2023-07-01,LBN,Kedah,1,0,1
2023-07-01,LBN,Kelantan,0,0,0
2023-07-01,LBN,Pahang,0,0,0
2023-07-01,LBN,Perak,0,0,0
2023-07-01,LBN,Perlis,0,0,0
2023-07-01,LBN,Pulau Pinang,3,2,1
2023-07-01,LBN,Sabah,0,0,0
2023-07-01,LBN,Sarawak,1,1,0
2023-07-01,LBN,Selangor,299,177,122
2023-07-01,LBN,W.P. Labuan,0,0,0
2023-07-01,LBR,Johor,0,0,0
2023-07-01,LBR,Kedah,0,0,0
2023-07-01,LBR,Sabah,0,0,0
2023-07-01,LBR,Sarawak,0,0,0
2023-07-01,LBR,Selangor,4,2,2
2023-07-01,LBY,Johor,1,1,0
2023-07-01,LBY,Kedah,0,0,0
2023-07-01,LBY,Perlis,0,0,0
2023-07-01,LBY,Pulau Pinang,0,0,0
2023-07-01,LBY,Sabah,1,1,0
2023-07-01,LBY,Sarawak,3,2,1
2023-07-01,LBY,Selangor,333,242,91
2023-07-01,LCA,Johor,6,4,2
2023-07-01,LCA,Kedah,0,0,0
2023-07-01,LCA,Pulau Pinang,0,0,0
2023-07-01,LCA,Sarawak,1,1,0
2023-07-01,LCA,Selangor,11,8,3
2023-07-01,LIE,Johor,1,1,0
2023-07-01,LIE,Kedah,0,0,0
2023-07-01,LIE,Perlis,1,1,0
2023-07-01,LIE,Pulau Pinang,0,0,0
2023-07-01,LIE,Sabah,0,0,0
2023-07-01,LIE,Sarawak,1,1,0
2023-07-01,LIE,Selangor,17,8,9
2023-07-01,LKA,Johor,1119,743,376
2023-07-01,LKA,Kedah,43,20,23
2023-07-01,LKA,Kelantan,0,0,0
2023-07-01,LKA,Melaka,0,0,0
2023-07-01,LKA,Pahang,0,0,0
2023-07-01,LKA,Perak,0,0,0
2023-07-01,LKA,Perlis,0,0,0
2023-07-01,LKA,Pulau Pinang,37,21,16
2023-07-01,LKA,Sabah,3,1,2
2023-07-01,LKA,Sarawak,27,19,8
2023-07-01,LKA,Selangor,4693,3011,1682
2023-07-01,LKA,W.P. Labuan,0,0,0
2023-07-01,LSO,Johor,1,1,0
2023-07-01,LSO,Kedah,0,0,0
2023-07-01,LSO,Pulau Pinang,0,0,0
2023-07-01,LSO,Sarawak,0,0,0
2023-07-01,LSO,Selangor,8,3,5
2023-07-01,LTU,Johor,35,14,21
2023-07-01,LTU,Kedah,8,2,6
2023-07-01,LTU,Kelantan,1,0,1
2023-07-01,LTU,Pahang,0,0,0
2023-07-01,LTU,Perak,0,0,0
2023-07-01,LTU,Perlis,3,3,0
2023-07-01,LTU,Pulau Pinang,3,2,1
2023-07-01,LTU,Sabah,7,4,3
2023-07-01,LTU,Sarawak,1,1,0
2023-07-01,LTU,Selangor,238,113,125
2023-07-01,LTU,W.P. Labuan,0,0,0
2023-07-01,LUX,Johor,10,4,6
2023-07-01,LUX,Kedah,3,1,2
2023-07-01,LUX,Kelantan,0,0,0
2023-07-01,LUX,Perak,0,0,0
2023-07-01,LUX,Perlis,0,0,0
2023-07-01,LUX,Pulau Pinang,3,1,2
2023-07-01,LUX,Sabah,4,2,2
2023-07-01,LUX,Sarawak,2,2,0
2023-07-01,LUX,Selangor,60,36,24
2023-07-01,LVA,Johor,12,7,5
2023-07-01,LVA,Kedah,3,1,2
2023-07-01,LVA,Kelantan,0,0,0
2023-07-01,LVA,Pahang,0,0,0
2023-07-01,LVA,Perak,1,1,0
2023-07-01,LVA,Perlis,0,0,0
2023-07-01,LVA,Pulau Pinang,0,0,0
2023-07-01,LVA,Sabah,1,0,1
2023-07-01,LVA,Sarawak,1,0,1
2023-07-01,LVA,Selangor,108,67,41
2023-07-01,LVA,W.P. Labuan,0,0,0
2023-07-01,MAC,Johor,0,0,0
2023-07-01,MAC,Pahang,0,0,0
2023-07-01,MAC,Perak,4,3,1
2023-07-01,MAC,Selangor,0,0,0
2023-07-01,MAC,W.P. Labuan,0,0,0
2023-07-01,MAR,Johor,75,43,32
2023-07-01,MAR,Kedah,8,4,4
2023-07-01,MAR,Kelantan,2,1,1
2023-07-01,MAR,Melaka,0,0,0
2023-07-01,MAR,Pahang,0,0,0
2023-07-01,MAR,Perak,1,1,0
2023-07-01,MAR,Perlis,3,2,1
2023-07-01,MAR,Pulau Pinang,18,9,9
2023-07-01,MAR,Sabah,2,2,0
2023-07-01,MAR,Sarawak,8,6,2
2023-07-01,MAR,Selangor,1180,590,590
2023-07-01,MAR,W.P. Labuan,0,0,0
2023-07-01,MCO,Johor,0,0,0
2023-07-01,MCO,Kedah,0,0,0
2023-07-01,MCO,Sabah,0,0,0
2023-07-01,MCO,Selangor,3,0,3
2023-07-01,MDA,Johor,3,2,1
2023-07-01,MDA,Kedah,0,0,0
2023-07-01,MDA,Kelantan,0,0,0
2023-07-01,MDA,Negeri Sembilan,0,0,0
2023-07-01,MDA,Perlis,1,1,0
2023-07-01,MDA,Pulau Pinang,1,1,0
2023-07-01,MDA,Sabah,0,0,0
2023-07-01,MDA,Sarawak,1,0,1
2023-07-01,MDA,Selangor,27,17,10
2023-07-01,MDG,Johor,14,6,8
2023-07-01,MDG,Kedah,0,0,0
2023-07-01,MDG,Perak,0,0,0
2023-07-01,MDG,Perlis,0,0,0
2023-07-01,MDG,Pulau Pinang,1,0,1
2023-07-01,MDG,Sabah,2,0,2
2023-07-01,MDG,Sarawak,0,0,0
2023-07-01,MDG,Selangor,105,47,58
2023-07-01,MDV,Johor,714,355,359
2023-07-01,MDV,Kedah,6,4,2
2023-07-01,MDV,Kelantan,2,2,0
2023-07-01,MDV,Perak,1,1,0
2023-07-01,MDV,Perlis,2,2,0
2023-07-01,MDV,Pulau Pinang,4,2,2
2023-07-01,MDV,Sabah,6,3,3
2023-07-01,MDV,Sarawak,4,2,2
2023-07-01,MDV,Selangor,5552,2707,2845
2023-07-01,MEX,Johor,222,101,121
2023-07-01,MEX,Kedah,5,3,2
2023-07-01,MEX,Kelantan,0,0,0
2023-07-01,MEX,Pahang,3,2,1
2023-07-01,MEX,Perak,1,0,1
2023-07-01,MEX,Perlis,0,0,0
2023-07-01,MEX,Pulau Pinang,49,20,29
2023-07-01,MEX,Sabah,1,1,0
2023-07-01,MEX,Sarawak,8,4,4
2023-07-01,MEX,Selangor,862,451,411
2023-07-01,MEX,W.P. Labuan,0,0,0
2023-07-01,MHL,Johor,1,1,0
2023-07-01,MHL,Kedah,0,0,0
2023-07-01,MHL,Perak,0,0,0
2023-07-01,MHL,Pulau Pinang,0,0,0
2023-07-01,MHL,Sabah,0,0,0
2023-07-01,MHL,Selangor,3,3,0
2023-07-01,MKD,Johor,5,3,2
2023-07-01,MKD,Kedah,2,1,1
2023-07-01,MKD,Perak,0,0,0
2023-07-01,MKD,Pulau Pinang,0,0,0
2023-07-01,MKD,Sabah,0,0,0
2023-07-01,MKD,Sarawak,1,0,1
2023-07-01,MKD,Selangor,27,11,16
2023-07-01,MLI,Johor,5,5,0
2023-07-01,MLI,Sabah,0,0,0
2023-07-01,MLI,Selangor,15,11,4
2023-07-01,MLT,Johor,7,4,3
2023-07-01,MLT,Kedah,0,0,0
2023-07-01,MLT,Kelantan,0,0,0
2023-07-01,MLT,Perak,0,0,0
2023-07-01,MLT,Perlis,0,0,0
2023-07-01,MLT,Pulau Pinang,3,2,1
2023-07-01,MLT,Sabah,0,0,0
2023-07-01,MLT,Sarawak,0,0,0
2023-07-01,MLT,Selangor,66,36,30
2023-07-01,MLT,W.P. Labuan,0,0,0
2023-07-01,MMR,Johor,5534,1782,3752
2023-07-01,MMR,Kedah,60,10,50
2023-07-01,MMR,Kelantan,2,0,2
2023-07-01,MMR,Negeri Sembilan,0,0,0
2023-07-01,MMR,Pahang,2,0,2
2023-07-01,MMR,Perak,22,4,18
2023-07-01,MMR,Perlis,4,0,4
2023-07-01,MMR,Pulau Pinang,350,177,173
2023-07-01,MMR,Sabah,8,2,6
2023-07-01,MMR,Sarawak,93,44,49
2023-07-01,MMR,Selangor,7517,5327,2190
2023-07-01,MMR,Terengganu,0,0,0
2023-07-01,MMR,W.P. Labuan,1,0,1
2023-07-01,MNE,Johor,2,1,1
2023-07-01,MNE,Kedah,0,0,0
2023-07-01,MNE,Pulau Pinang,0,0,0
2023-07-01,MNE,Sabah,0,0,0
2023-07-01,MNE,Sarawak,0,0,0
2023-07-01,MNE,Selangor,12,12,0
2023-07-01,MNG,Johor,143,49,94
2023-07-01,MNG,Kedah,1,0,1
2023-07-01,MNG,Kelantan,2,1,1
2023-07-01,MNG,Perak,2,0,2
2023-07-01,MNG,Perlis,0,0,0
2023-07-01,MNG,Pulau Pinang,11,4,7
2023-07-01,MNG,Sabah,10,5,5
2023-07-01,MNG,Sarawak,0,0,0
2023-07-01,MNG,Selangor,361,150,211
2023-07-01,MNP,Selangor,0,0,0
2023-07-01,MOZ,Johor,0,0,0
2023-07-01,MOZ,Kedah,0,0,0
2023-07-01,MOZ,Perak,0,0,0
2023-07-01,MOZ,Pulau Pinang,0,0,0
2023-07-01,MOZ,Sabah,0,0,0
2023-07-01,MOZ,Sarawak,0,0,0
2023-07-01,MOZ,Selangor,25,12,13
2023-07-01,MRT,Johor,4,4,0
2023-07-01,MRT,Kedah,0,0,0
2023-07-01,MRT,Pulau Pinang,0,0,0
2023-07-01,MRT,Sabah,0,0,0
2023-07-01,MRT,Sarawak,0,0,0
2023-07-01,MRT,Selangor,18,13,5
2023-07-01,MUS,Johor,152,85,67
2023-07-01,MUS,Kedah,6,2,4
2023-07-01,MUS,Kelantan,0,0,0
2023-07-01,MUS,Pahang,0,0,0
2023-07-01,MUS,Perak,1,0,1
2023-07-01,MUS,Perlis,4,2,2
2023-07-01,MUS,Pulau Pinang,6,5,1
2023-07-01,MUS,Sabah,0,0,0
2023-07-01,MUS,Sarawak,0,0,0
2023-07-01,MUS,Selangor,1358,696,662
2023-07-01,MWI,Johor,3,3,0
2023-07-01,MWI,Pulau Pinang,0,0,0
2023-07-01,MWI,Sabah,0,0,0
2023-07-01,MWI,Sarawak,1,0,1
2023-07-01,MWI,Selangor,11,4,7
2023-07-01,MYT,Selangor,0,0,0
2023-07-01,NAM,Johor,20,14,6
2023-07-01,NAM,Kedah,0,0,0
2023-07-01,NAM,Perak,0,0,0
2023-07-01,NAM,Perlis,0,0,0
2023-07-01,NAM,Pulau Pinang,1,1,0
2023-07-01,NAM,Sabah,0,0,0
2023-07-01,NAM,Sarawak,0,0,0
2023-07-01,NAM,Selangor,19,9,10
2023-07-01,NCL,Selangor,0,0,0
2023-07-01,NER,Johor,0,0,0
2023-07-01,NER,Sabah,0,0,0
2023-07-01,NER,Selangor,4,2,2
2023-07-01,NGA,Johor,34,32,2
2023-07-01,NGA,Kedah,1,1,0
2023-07-01,NGA,Perlis,0,0,0
2023-07-01,NGA,Pulau Pinang,3,2,1
2023-07-01,NGA,Sabah,1,1,0
2023-07-01,NGA,Sarawak,11,8,3
2023-07-01,NGA,Selangor,313,238,75
2023-07-01,NIC,Johor,2,0,2
2023-07-01,NIC,Kedah,0,0,0
2023-07-01,NIC,Pulau Pinang,1,0,1
2023-07-01,NIC,Sabah,1,1,0
2023-07-01,NIC,Selangor,6,3,3
2023-07-01,NLD,Johor,1759,1022,737
2023-07-01,NLD,Kedah,339,174,165
2023-07-01,NLD,Kelantan,10,5,5
2023-07-01,NLD,Melaka,0,0,0
2023-07-01,NLD,Negeri Sembilan,1,0,1
2023-07-01,NLD,Pahang,1,1,0
2023-07-01,NLD,Perak,15,8,7
2023-07-01,NLD,Perlis,58,35,23
2023-07-01,NLD,Pulau Pinang,325,174,151
2023-07-01,NLD,Sabah,66,30,36
2023-07-01,NLD,Sarawak,182,104,78
2023-07-01,NLD,Selangor,9860,5216,4644
2023-07-01,NLD,Terengganu,0,0,0
2023-07-01,NLD,W.P. Labuan,3,2,1
2023-07-01,NOR,Johor,302,157,145
2023-07-01,NOR,Kedah,81,38,43
2023-07-01,NOR,Kelantan,0,0,0
2023-07-01,NOR,Melaka,0,0,0
2023-07-01,NOR,Pahang,0,0,0
2023-07-01,NOR,Perak,3,2,1
2023-07-01,NOR,Perlis,16,9,7
2023-07-01,NOR,Pulau Pinang,59,35,24
2023-07-01,NOR,Sabah,7,5,2
2023-07-01,NOR,Sarawak,26,19,7
2023-07-01,NOR,Selangor,1162,619,543
2023-07-01,NOR,W.P. Labuan,0,0,0
2023-07-01,NPL,Johor,529,374,155
2023-07-01,NPL,Kedah,23,8,15
2023-07-01,NPL,Pahang,0,0,0
2023-07-01,NPL,Perak,1,1,0
2023-07-01,NPL,Perlis,4,3,1
2023-07-01,NPL,Pulau Pinang,17,13,4
2023-07-01,NPL,Sabah,5,4,1
2023-07-01,NPL,Sarawak,232,159,73
2023-07-01,NPL,Selangor,12190,11633,557
2023-07-01,NPL,W.P. Labuan,24,23,1
2023-07-01,NRU,Johor,2,0,2
2023-07-01,NRU,Pulau Pinang,0,0,0
2023-07-01,NRU,Selangor,0,0,0
2023-07-01,NZL,Johor,941,551,390
2023-07-01,NZL,Kedah,116,63,53
2023-07-01,NZL,Kelantan,8,5,3
2023-07-01,NZL,Melaka,0,0,0
2023-07-01,NZL,Negeri Sembilan,2,1,1
2023-07-01,NZL,Pahang,5,2,3
2023-07-01,NZL,Perak,39,20,19
2023-07-01,NZL,Perlis,16,8,8
2023-07-01,NZL,Pulau Pinang,340,180,160
2023-07-01,NZL,Sabah,68,36,32
2023-07-01,NZL,Sarawak,163,98,65
2023-07-01,NZL,Selangor,3921,2208,1713
2023-07-01,NZL,Terengganu,0,0,0
2023-07-01,NZL,W.P. Labuan,2,1,1
2023-07-01,OMN,Johor,245,101,144
2023-07-01,OMN,Kedah,24,15,9
2023-07-01,OMN,Kelantan,5,5,0
2023-07-01,OMN,Melaka,1,1,0
2023-07-01,OMN,Perak,3,2,1
2023-07-01,OMN,Perlis,5,5,0
2023-07-01,OMN,Pulau Pinang,107,57,50
2023-07-01,OMN,Sabah,0,0,0
2023-07-01,OMN,Sarawak,6,3,3
2023-07-01,OMN,Selangor,4665,2428,2237
2023-07-01,PAK,Johor,1236,847,389
2023-07-01,PAK,Kedah,230,114,116
2023-07-01,PAK,Kelantan,11,11,0
2023-07-01,PAK,Melaka,1,1,0
2023-07-01,PAK,Negeri Sembilan,0,0,0
2023-07-01,PAK,Pahang,1,1,0
2023-07-01,PAK,Perak,21,20,1
2023-07-01,PAK,Perlis,19,18,1
2023-07-01,PAK,Pulau Pinang,78,67,11
2023-07-01,PAK,Sabah,9,7,2
2023-07-01,PAK,Sarawak,127,102,25
2023-07-01,PAK,Selangor,10693,8441,2252
2023-07-01,PAK,W.P. Labuan,1,1,0
2023-07-01,PAN,Johor,4,1,3
2023-07-01,PAN,Kedah,0,0,0
2023-07-01,PAN,Perak,0,0,0
2023-07-01,PAN,Perlis,0,0,0
2023-07-01,PAN,Pulau Pinang,3,3,0
2023-07-01,PAN,Sabah,2,0,2
2023-07-01,PAN,Sarawak,0,0,0
2023-07-01,PAN,Selangor,46,23,23
2023-07-01,PER,Johor,34,16,18
2023-07-01,PER,Kedah,9,4,5
2023-07-01,PER,Kelantan,0,0,0
2023-07-01,PER,Pahang,0,0,0
2023-07-01,PER,Perak,0,0,0
2023-07-01,PER,Perlis,4,3,1
2023-07-01,PER,Pulau Pinang,5,4,1
2023-07-01,PER,Sabah,0,0,0
2023-07-01,PER,Sarawak,0,0,0
2023-07-01,PER,Selangor,144,79,65
2023-07-01,PER,W.P. Labuan,0,0,0
2023-07-01,PHL,Johor,26964,9160,17804
2023-07-01,PHL,Kedah,492,157,335
2023-07-01,PHL,Kelantan,21,13,8
2023-07-01,PHL,Melaka,4,2,2
2023-07-01,PHL,Negeri Sembilan,3,3,0
2023-07-01,PHL,Pahang,23,19,4
2023-07-01,PHL,Perak,69,17,52
2023-07-01,PHL,Perlis,192,50,142
2023-07-01,PHL,Pulau Pinang,716,285,431
2023-07-01,PHL,Sabah,1015,471,544
2023-07-01,PHL,Sarawak,2283,847,1436
2023-07-01,PHL,Selangor,21286,8208,13078
2023-07-01,PHL,Terengganu,0,0,0
2023-07-01,PHL,W.P. Labuan,104,30,74
2023-07-01,PLW,Johor,0,0,0
2023-07-01,PLW,Pulau Pinang,0,0,0
2023-07-01,PLW,Selangor,3,1,2
2023-07-01,PNG,Johor,26,18,8
2023-07-01,PNG,Kedah,1,0,1
2023-07-01,PNG,Kelantan,0,0,0
2023-07-01,PNG,Perak,1,1,0
2023-07-01,PNG,Pulau Pinang,1,0,1
2023-07-01,PNG,Sabah,0,0,0
2023-07-01,PNG,Sarawak,4,2,2
2023-07-01,PNG,Selangor,68,44,24
2023-07-01,POL,Johor,478,251,227
2023-07-01,POL,Kedah,46,19,27
2023-07-01,POL,Kelantan,1,1,0
2023-07-01,POL,Melaka,0,0,0
2023-07-01,POL,Negeri Sembilan,0,0,0
2023-07-01,POL,Pahang,4,4,0
2023-07-01,POL,Perak,6,3,3
2023-07-01,POL,Perlis,13,7,6
2023-07-01,POL,Pulau Pinang,60,30,30
2023-07-01,POL,Sabah,35,16,19
2023-07-01,POL,Sarawak,70,38,32
2023-07-01,POL,Selangor,1349,700,649
2023-07-01,POL,Terengganu,0,0,0
2023-07-01,POL,W.P. Labuan,0,0,0
2023-07-01,PRK,Selangor,0,0,0
2023-07-01,PRT,Johor,222,131,91
2023-07-01,PRT,Kedah,19,7,12
2023-07-01,PRT,Kelantan,0,0,0
2023-07-01,PRT,Melaka,0,0,0
2023-07-01,PRT,Pahang,1,0,1
2023-07-01,PRT,Perak,2,1,1
2023-07-01,PRT,Perlis,6,3,3
2023-07-01,PRT,Pulau Pinang,34,21,13
2023-07-01,PRT,Sabah,15,11,4
2023-07-01,PRT,Sarawak,9,5,4
2023-07-01,PRT,Selangor,724,420,304
2023-07-01,PRT,W.P. Labuan,0,0,0
2023-07-01,PRY,Johor,4,3,1
2023-07-01,PRY,Kedah,0,0,0
2023-07-01,PRY,Perak,0,0,0
2023-07-01,PRY,Perlis,0,0,0
2023-07-01,PRY,Pulau Pinang,1,0,1
2023-07-01,PRY,Sabah,0,0,0
2023-07-01,PRY,Sarawak,0,0,0
2023-07-01,PRY,Selangor,12,5,7
2023-07-01,PSE,Johor,28,25,3
2023-07-01,PSE,Kedah,1,1,0
2023-07-01,PSE,Kelantan,0,0,0
2023-07-01,PSE,Melaka,0,0,0
2023-07-01,PSE,Perak,0,0,0
2023-07-01,PSE,Perlis,0,0,0
2023-07-01,PSE,Pulau Pinang,1,1,0
2023-07-01,PSE,Sabah,0,0,0
2023-07-01,PSE,Sarawak,0,0,0
2023-07-01,PSE,Selangor,478,290,188
2023-07-01,QAT,Johor,74,42,32
2023-07-01,QAT,Kedah,8,5,3
2023-07-01,QAT,Perlis,0,0,0
2023-07-01,QAT,Pulau Pinang,13,2,11
2023-07-01,QAT,Sabah,0,0,0
2023-07-01,QAT,Sarawak,0,0,0
2023-07-01,QAT,Selangor,747,386,361
2023-07-01,REU,Johor,0,0,0
2023-07-01,REU,Sarawak,0,0,0
2023-07-01,ROU,Johor,132,71,61
2023-07-01,ROU,Kedah,8,4,4
2023-07-01,ROU,Kelantan,1,0,1
2023-07-01,ROU,Negeri Sembilan,0,0,0
2023-07-01,ROU,Pahang,0,0,0
2023-07-01,ROU,Perak,0,0,0
2023-07-01,ROU,Perlis,0,0,0
2023-07-01,ROU,Pulau Pinang,20,9,11
2023-07-01,ROU,Sabah,2,1,1
2023-07-01,ROU,Sarawak,6,5,1
2023-07-01,ROU,Selangor,570,268,302
2023-07-01,ROU,W.P. Labuan,0,0,0
2023-07-01,RUS,Johor,511,251,260
2023-07-01,RUS,Kedah,352,189,163
2023-07-01,RUS,Kelantan,31,21,10
2023-07-01,RUS,Melaka,0,0,0
2023-07-01,RUS,Negeri Sembilan,0,0,0
2023-07-01,RUS,Pahang,5,2,3
2023-07-01,RUS,Perak,8,3,5
2023-07-01,RUS,Perlis,330,203,127
2023-07-01,RUS,Pulau Pinang,124,67,57
2023-07-01,RUS,Sabah,27,14,13
2023-07-01,RUS,Sarawak,46,20,26
2023-07-01,RUS,Selangor,7902,3979,3923
2023-07-01,RUS,W.P. Labuan,9,4,5
2023-07-01,RWA,Johor,3,1,2
2023-07-01,RWA,Kedah,0,0,0
2023-07-01,RWA,Pulau Pinang,2,2,0
2023-07-01,RWA,Selangor,11,6,5
2023-07-01,SAU,Johor,706,373,333
2023-07-01,SAU,Kedah,241,126,115
2023-07-01,SAU,Kelantan,28,14,14
2023-07-01,SAU,Melaka,0,0,0
2023-07-01,SAU,Perak,6,5,1
2023-07-01,SAU,Perlis,24,12,12
2023-07-01,SAU,Pulau Pinang,209,109,100
2023-07-01,SAU,Sabah,2,1,1
2023-07-01,SAU,Sarawak,19,13,6
2023-07-01,SAU,Selangor,10164,5390,4774
2023-07-01,SAU,W.P. Labuan,0,0,0
2023-07-01,SDN,Johor,11,6,5
2023-07-01,SDN,Kedah,0,0,0
2023-07-01,SDN,Kelantan,0,0,0
2023-07-01,SDN,Perlis,0,0,0
2023-07-01,SDN,Pulau Pinang,0,0,0
2023-07-01,SDN,Sabah,0,0,0
2023-07-01,SDN,Sarawak,1,1,0
2023-07-01,SDN,Selangor,1226,651,575
2023-07-01,SDN,W.P. Labuan,0,0,0
2023-07-01,SEN,Johor,7,5,2
2023-07-01,SEN,Kedah,1,0,1
2023-07-01,SEN,Kelantan,0,0,0
2023-07-01,SEN,Perak,0,0,0
2023-07-01,SEN,Perlis,0,0,0
2023-07-01,SEN,Pulau Pinang,0,0,0
2023-07-01,SEN,Sabah,1,1,0
2023-07-01,SEN,Sarawak,0,0,0
2023-07-01,SEN,Selangor,56,37,19
2023-07-01,SGP,Johor,1217340,694189,523151
2023-07-01,SGP,Kedah,4811,2470,2341
2023-07-01,SGP,Kelantan,117,72,45
2023-07-01,SGP,Melaka,6,5,1
2023-07-01,SGP,Negeri Sembilan,2,0,2
2023-07-01,SGP,Pahang,508,264,244
2023-07-01,SGP,Perak,6463,2854,3609
2023-07-01,SGP,Perlis,196,102,94
2023-07-01,SGP,Pulau Pinang,19079,9039,10040
2023-07-01,SGP,Sabah,1773,922,851
2023-07-01,SGP,Sarawak,3348,1882,1466
2023-07-01,SGP,Selangor,41414,21825,19589
2023-07-01,SGP,Terengganu,0,0,0
2023-07-01,SGP,W.P. Labuan,10,9,1
2023-07-01,SGS,Johor,0,0,0
2023-07-01,SGS,Sabah,0,0,0
2023-07-01,SGS,Selangor,0,0,0
2023-07-01,SHN,Sarawak,0,0,0
2023-07-01,SLB,Johor,0,0,0
2023-07-01,SLB,Perlis,0,0,0
2023-07-01,SLB,Pulau Pinang,0,0,0
2023-07-01,SLB,Sabah,0,0,0
2023-07-01,SLB,Sarawak,0,0,0
2023-07-01,SLB,Selangor,6,3,3
2023-07-01,SLB,W.P. Labuan,1,0,1
2023-07-01,SLE,Johor,2,2,0
2023-07-01,SLE,Kedah,0,0,0
2023-07-01,SLE,Perak,0,0,0
2023-07-01,SLE,Pulau Pinang,0,0,0
2023-07-01,SLE,Sabah,0,0,0
2023-07-01,SLE,Selangor,31,13,18
2023-07-01,SLV,Johor,1,0,1
2023-07-01,SLV,Kedah,0,0,0
2023-07-01,SLV,Perak,0,0,0
2023-07-01,SLV,Perlis,0,0,0
2023-07-01,SLV,Pulau Pinang,5,3,2
2023-07-01,SLV,Sabah,0,0,0
2023-07-01,SLV,Selangor,16,8,8
2023-07-01,SLV,W.P. Labuan,0,0,0
2023-07-01,SMR,Johor,2,1,1
2023-07-01,SMR,Selangor,2,2,0
2023-07-01,SOM,Johor,0,0,0
2023-07-01,SOM,Kedah,0,0,0
2023-07-01,SOM,Kelantan,0,0,0
2023-07-01,SOM,Perlis,0,0,0
2023-07-01,SOM,Sabah,0,0,0
2023-07-01,SOM,Sarawak,0,0,0
2023-07-01,SOM,Selangor,181,108,73
2023-07-01,SRB,Johor,9,3,6
2023-07-01,SRB,Kedah,0,0,0
2023-07-01,SRB,Kelantan,0,0,0
2023-07-01,SRB,Pahang,0,0,0
2023-07-01,SRB,Perak,0,0,0
2023-07-01,SRB,Perlis,0,0,0
2023-07-01,SRB,Pulau Pinang,1,1,0
2023-07-01,SRB,Sabah,0,0,0
2023-07-01,SRB,Sarawak,0,0,0
2023-07-01,SRB,Selangor,75,43,32
2023-07-01,SSD,Johor,0,0,0
2023-07-01,SSD,Kedah,0,0,0
2023-07-01,SSD,Sarawak,2,2,0
2023-07-01,SSD,Selangor,26,13,13
2023-07-01,SSD,W.P. Labuan,0,0,0
2023-07-01,STP,Selangor,1,1,0
2023-07-01,SUR,Johor,4,2,2
2023-07-01,SUR,Kedah,0,0,0
2023-07-01,SUR,Kelantan,0,0,0
2023-07-01,SUR,Perak,1,1,0
2023-07-01,SUR,Perlis,0,0,0
2023-07-01,SUR,Pulau Pinang,1,1,0
2023-07-01,SUR,Sabah,1,0,1
2023-07-01,SUR,Sarawak,0,0,0
2023-07-01,SUR,Selangor,21,16,5
2023-07-01,SVK,Johor,50,25,25
2023-07-01,SVK,Kedah,55,29,26
2023-07-01,SVK,Kelantan,2,2,0
2023-07-01,SVK,Negeri Sembilan,1,1,0
2023-07-01,SVK,Pahang,0,0,0
2023-07-01,SVK,Perak,0,0,0
2023-07-01,SVK,Perlis,1,1,0
2023-07-01,SVK,Pulau Pinang,13,10,3
2023-07-01,SVK,Sabah,0,0,0
2023-07-01,SVK,Sarawak,3,1,2
2023-07-01,SVK,Selangor,323,168,155
2023-07-01,SVK,W.P. Labuan,9,4,5
2023-07-01,SVN,Johor,25,13,12
2023-07-01,SVN,Kedah,10,4,6
2023-07-01,SVN,Kelantan,0,0,0
2023-07-01,SVN,Perak,1,1,0
2023-07-01,SVN,Perlis,0,0,0
2023-07-01,SVN,Pulau Pinang,1,0,1
2023-07-01,SVN,Sabah,12,7,5
2023-07-01,SVN,Sarawak,1,1,0
2023-07-01,SVN,Selangor,193,95,98
2023-07-01,SVN,W.P. Labuan,0,0,0
2023-07-01,SWE,Johor,270,154,116
2023-07-01,SWE,Kedah,42,26,16
2023-07-01,SWE,Kelantan,29,22,7
2023-07-01,SWE,Melaka,0,0,0
2023-07-01,SWE,Negeri Sembilan,0,0,0
2023-07-01,SWE,Pahang,0,0,0
2023-07-01,SWE,Perak,11,7,4
2023-07-01,SWE,Perlis,7,1,6
2023-07-01,SWE,Pulau Pinang,57,36,21
2023-07-01,SWE,Sabah,8,4,4
2023-07-01,SWE,Sarawak,19,11,8
2023-07-01,SWE,Selangor,1048,639,409
2023-07-01,SWE,W.P. Labuan,1,1,0
2023-07-01,SWZ,Johor,6,0,6
2023-07-01,SWZ,Kedah,0,0,0
2023-07-01,SWZ,Pulau Pinang,0,0,0
2023-07-01,SWZ,Sabah,0,0,0
2023-07-01,SWZ,Selangor,26,14,12
2023-07-01,SYC,Johor,10,4,6
2023-07-01,SYC,Kedah,0,0,0
2023-07-01,SYC,Pulau Pinang,1,1,0
2023-07-01,SYC,Sabah,0,0,0
2023-07-01,SYC,Sarawak,0,0,0
2023-07-01,SYC,Selangor,43,15,28
2023-07-01,SYR,Johor,7,5,2
2023-07-01,SYR,Kedah,2,2,0
2023-07-01,SYR,Kelantan,0,0,0
2023-07-01,SYR,Pahang,0,0,0
2023-07-01,SYR,Perlis,1,1,0
2023-07-01,SYR,Pulau Pinang,2,2,0
2023-07-01,SYR,Sabah,0,0,0
2023-07-01,SYR,Sarawak,1,1,0
2023-07-01,SYR,Selangor,821,482,339
2023-07-01,SYR,W.P. Labuan,0,0,0
2023-07-01,TCA,Perlis,0,0,0
2023-07-01,TCD,Johor,14,12,2
2023-07-01,TCD,Kedah,0,0,0
2023-07-01,TCD,Perlis,0,0,0
2023-07-01,TCD,Selangor,20,13,7
2023-07-01,TGO,Johor,0,0,0
2023-07-01,TGO,Perak,0,0,0
2023-07-01,TGO,Pulau Pinang,0,0,0
2023-07-01,TGO,Selangor,12,8,4
2023-07-01,THA,Johor,6728,1755,4973
2023-07-01,THA,Kedah,62029,36453,25576
2023-07-01,THA,Kelantan,48622,26002,22620
2023-07-01,THA,Melaka,1,1,0
2023-07-01,THA,Negeri Sembilan,1,1,0
2023-07-01,THA,Pahang,16,13,3
2023-07-01,THA,Perak,12551,5742,6809
2023-07-01,THA,Perlis,60902,36177,24725
2023-07-01,THA,Pulau Pinang,2341,933,1408
2023-07-01,THA,Sabah,35,22,13
2023-07-01,THA,Sarawak,358,145,213
2023-07-01,THA,Selangor,17209,6989,10220
2023-07-01,THA,Terengganu,0,0,0
2023-07-01,THA,W.P. Labuan,3,0,3
2023-07-01,TJK,Johor,7,5,2
2023-07-01,TJK,Kedah,1,0,1
2023-07-01,TJK,Perlis,2,2,0
2023-07-01,TJK,Pulau Pinang,0,0,0
2023-07-01,TJK,Sabah,1,1,0
2023-07-01,TJK,Selangor,128,86,42
2023-07-01,TKL,Selangor,0,0,0
2023-07-01,TKM,Johor,1,1,0
2023-07-01,TKM,Kedah,2,2,0
2023-07-01,TKM,Kelantan,0,0,0
2023-07-01,TKM,Perlis,0,0,0
2023-07-01,TKM,Pulau Pinang,0,0,0
2023-07-01,TKM,Sabah,2,0,2
2023-07-01,TKM,Sarawak,2,2,0
2023-07-01,TKM,Selangor,142,83,59
2023-07-01,TLS,Johor,9,3,6
2023-07-01,TLS,Kedah,3,1,2
2023-07-01,TLS,Perlis,1,1,0
2023-07-01,TLS,Pulau Pinang,7,1,6
2023-07-01,TLS,Sabah,0,0,0
2023-07-01,TLS,Sarawak,3,1,2
2023-07-01,TLS,Selangor,255,154,101
2023-07-01,TON,Johor,0,0,0
2023-07-01,TON,Pulau Pinang,1,0,1
2023-07-01,TON,Sarawak,0,0,0
2023-07-01,TON,Selangor,9,7,2
2023-07-01,TTO,Johor,9,5,4
2023-07-01,TTO,Kedah,0,0,0
2023-07-01,TTO,Pahang,2,1,1
2023-07-01,TTO,Pulau Pinang,3,1,2
2023-07-01,TTO,Sabah,1,0,1
2023-07-01,TTO,Sarawak,5,3,2
2023-07-01,TTO,Selangor,56,28,28
2023-07-01,TUN,Johor,12,9,3
2023-07-01,TUN,Kedah,5,4,1
2023-07-01,TUN,Kelantan,0,0,0
2023-07-01,TUN,Melaka,0,0,0
2023-07-01,TUN,Perak,0,0,0
2023-07-01,TUN,Perlis,0,0,0
2023-07-01,TUN,Pulau Pinang,7,3,4
2023-07-01,TUN,Sabah,0,0,0
2023-07-01,TUN,Sarawak,0,0,0
2023-07-01,TUN,Selangor,1070,511,559
2023-07-01,TUN,W.P. Labuan,0,0,0
2023-07-01,TUR,Johor,312,210,102
2023-07-01,TUR,Kedah,51,31,20
2023-07-01,TUR,Kelantan,6,5,1
2023-07-01,TUR,Melaka,1,1,0
2023-07-01,TUR,Negeri Sembilan,0,0,0
2023-07-01,TUR,Pahang,1,1,0
2023-07-01,TUR,Perak,2,2,0
2023-07-01,TUR,Perlis,19,16,3
2023-07-01,TUR,Pulau Pinang,47,33,14
2023-07-01,TUR,Sabah,4,3,1
2023-07-01,TUR,Sarawak,21,19,2
2023-07-01,TUR,Selangor,1401,914,487
2023-07-01,TUR,W.P. Labuan,0,0,0
2023-07-01,TUV,Selangor,0,0,0
2023-07-01,TWN,Johor,9966,4342,5624
2023-07-01,TWN,Kedah,253,124,129
2023-07-01,TWN,Kelantan,0,0,0
2023-07-01,TWN,Melaka,4,2,2
2023-07-01,TWN,Negeri Sembilan,0,0,0
2023-07-01,TWN,Pahang,5,4,1
2023-07-01,TWN,Perak,98,52,46
2023-07-01,TWN,Perlis,19,7,12
2023-07-01,TWN,Pulau Pinang,4955,2365,2590
2023-07-01,TWN,Sabah,1614,781,833
2023-07-01,TWN,Sarawak,343,147,196
2023-07-01,TWN,Selangor,21828,10362,11466
2023-07-01,TWN,W.P. Labuan,8,4,4
2023-07-01,TZA,Johor,40,24,16
2023-07-01,TZA,Kedah,2,1,1
2023-07-01,TZA,Perak,0,0,0
2023-07-01,TZA,Perlis,0,0,0
2023-07-01,TZA,Pulau Pinang,0,0,0
2023-07-01,TZA,Sabah,0,0,0
2023-07-01,TZA,Sarawak,4,4,0
2023-07-01,TZA,Selangor,209,103,106
2023-07-01,UGA,Johor,12,5,7
2023-07-01,UGA,Kedah,3,1,2
2023-07-01,UGA,Perak,0,0,0
2023-07-01,UGA,Perlis,0,0,0
2023-07-01,UGA,Pulau Pinang,2,1,1
2023-07-01,UGA,Sabah,0,0,0
2023-07-01,UGA,Sarawak,0,0,0
2023-07-01,UGA,Selangor,134,70,64
2023-07-01,UKR,Johor,121,73,48
2023-07-01,UKR,Kedah,15,7,8
2023-07-01,UKR,Kelantan,2,1,1
2023-07-01,UKR,Melaka,0,0,0
2023-07-01,UKR,Negeri Sembilan,0,0,0
2023-07-01,UKR,Pahang,2,2,0
2023-07-01,UKR,Perak,0,0,0
2023-07-01,UKR,Perlis,1,0,1
2023-07-01,UKR,Pulau Pinang,29,16,13
2023-07-01,UKR,Sabah,4,2,2
2023-07-01,UKR,Sarawak,1,0,1
2023-07-01,UKR,Selangor,841,438,403
2023-07-01,UKR,W.P. Labuan,0,0,0
2023-07-01,URY,Johor,4,0,4
2023-07-01,URY,Kedah,1,1,0
2023-07-01,URY,Kelantan,0,0,0
2023-07-01,URY,Perak,0,0,0
2023-07-01,URY,Perlis,0,0,0
2023-07-01,URY,Pulau Pinang,2,0,2
2023-07-01,URY,Sabah,0,0,0
2023-07-01,URY,Sarawak,4,1,3
2023-07-01,URY,Selangor,34,20,14
2023-07-01,URY,W.P. Labuan,4,2,2
2023-07-01,USA,Johor,5734,3183,2551
2023-07-01,USA,Kedah,511,269,242
2023-07-01,USA,Kelantan,12,7,5
2023-07-01,USA,Melaka,1,1,0
2023-07-01,USA,Negeri Sembilan,0,0,0
2023-07-01,USA,Pahang,11,8,3
2023-07-01,USA,Perak,195,90,105
2023-07-01,USA,Perlis,145,91,54
2023-07-01,USA,Pulau Pinang,2791,1564,1227
2023-07-01,USA,Sabah,243,132,111
2023-07-01,USA,Sarawak,304,176,128
2023-07-01,USA,Selangor,18311,10343,7968
2023-07-01,USA,Terengganu,0,0,0
2023-07-01,USA,W.P. Labuan,5,1,4
2023-07-01,UZB,Johor,101,79,22
2023-07-01,UZB,Kedah,9,5,4
2023-07-01,UZB,Kelantan,1,1,0
2023-07-01,UZB,Perak,0,0,0
2023-07-01,UZB,Perlis,1,1,0
2023-07-01,UZB,Pulau Pinang,8,2,6
2023-07-01,UZB,Sabah,5,5,0
2023-07-01,UZB,Sarawak,4,2,2
2023-07-01,UZB,Selangor,1554,915,639
2023-07-01,VAT,Johor,0,0,0
2023-07-01,VAT,Sarawak,0,0,0
2023-07-01,VAT,Selangor,0,0,0
2023-07-01,VCT,Johor,1,0,1
2023-07-01,VCT,Kedah,0,0,0
2023-07-01,VCT,Pulau Pinang,0,0,0
2023-07-01,VCT,Sarawak,0,0,0
2023-07-01,VCT,Selangor,4,0,4
2023-07-01,VEN,Johor,20,9,11
2023-07-01,VEN,Kedah,3,1,2
2023-07-01,VEN,Kelantan,0,0,0
2023-07-01,VEN,Melaka,0,0,0
2023-07-01,VEN,Perak,0,0,0
2023-07-01,VEN,Perlis,0,0,0
2023-07-01,VEN,Pulau Pinang,1,1,0
2023-07-01,VEN,Sabah,2,1,1
2023-07-01,VEN,Sarawak,1,1,0
2023-07-01,VEN,Selangor,108,58,50
2023-07-01,VEN,W.P. Labuan,0,0,0
2023-07-01,VNM,Johor,25253,9424,15829
2023-07-01,VNM,Kedah,318,67,251
2023-07-01,VNM,Kelantan,13,5,8
2023-07-01,VNM,Melaka,3,0,3
2023-07-01,VNM,Negeri Sembilan,0,0,0
2023-07-01,VNM,Pahang,1,0,1
2023-07-01,VNM,Perak,199,13,186
2023-07-01,VNM,Perlis,233,23,210
2023-07-01,VNM,Pulau Pinang,1975,632,1343
2023-07-01,VNM,Sabah,15,6,9
2023-07-01,VNM,Sarawak,197,45,152
2023-07-01,VNM,Selangor,21579,8159,13420
2023-07-01,VNM,Terengganu,0,0,0
2023-07-01,VNM,W.P. Labuan,6,2,4
2023-07-01,VUT,Johor,38,30,8
2023-07-01,VUT,Kedah,0,0,0
2023-07-01,VUT,Pulau Pinang,4,3,1
2023-07-01,VUT,Sabah,0,0,0
2023-07-01,VUT,Sarawak,1,0,1
2023-07-01,VUT,Selangor,59,46,13
2023-07-01,WSM,Johor,3,3,0
2023-07-01,WSM,Sarawak,0,0,0
2023-07-01,WSM,Selangor,6,0,6
2023-07-01,XXX,Johor,72,42,30
2023-07-01,XXX,Kedah,5,2,3
2023-07-01,XXX,Kelantan,1,0,1
2023-07-01,XXX,Melaka,0,0,0
2023-07-01,XXX,Pahang,0,0,0
2023-07-01,XXX,Perak,1,0,1
2023-07-01,XXX,Perlis,0,0,0
2023-07-01,XXX,Pulau Pinang,50,25,25
2023-07-01,XXX,Sabah,26,11,15
2023-07-01,XXX,Sarawak,24,15,9
2023-07-01,XXX,Selangor,402,225,177
2023-07-01,XXX,W.P. Labuan,0,0,0
2023-07-01,YEM,Johor,37,22,15
2023-07-01,YEM,Kedah,2,1,1
2023-07-01,YEM,Kelantan,1,1,0
2023-07-01,YEM,Melaka,0,0,0
2023-07-01,YEM,Pahang,0,0,0
2023-07-01,YEM,Perak,0,0,0
2023-07-01,YEM,Perlis,2,2,0
2023-07-01,YEM,Pulau Pinang,1,1,0
2023-07-01,YEM,Sabah,0,0,0
2023-07-01,YEM,Sarawak,2,0,2
2023-07-01,YEM,Selangor,1570,991,579
2023-07-01,YEM,W.P. Labuan,0,0,0
2023-07-01,ZAF,Johor,317,172,145
2023-07-01,ZAF,Kedah,36,19,17
2023-07-01,ZAF,Kelantan,0,0,0
2023-07-01,ZAF,Melaka,0,0,0
2023-07-01,ZAF,Pahang,3,2,1
2023-07-01,ZAF,Perak,2,2,0
2023-07-01,ZAF,Perlis,17,14,3
2023-07-01,ZAF,Pulau Pinang,67,32,35
2023-07-01,ZAF,Sabah,15,8,7
2023-07-01,ZAF,Sarawak,80,42,38
2023-07-01,ZAF,Selangor,1235,706,529
2023-07-01,ZAF,Terengganu,0,0,0
2023-07-01,ZAF,W.P. Labuan,1,1,0
2023-07-01,ZAR,Selangor,1,1,0
2023-07-01,ZMB,Johor,3,2,1
2023-07-01,ZMB,Kedah,5,3,2
2023-07-01,ZMB,Perak,0,0,0
2023-07-01,ZMB,Perlis,0,0,0
2023-07-01,ZMB,Pulau Pinang,0,0,0
2023-07-01,ZMB,Sabah,0,0,0
2023-07-01,ZMB,Sarawak,0,0,0
2023-07-01,ZMB,Selangor,51,28,23
2023-07-01,ZWE,Johor,17,7,10
2023-07-01,ZWE,Kedah,3,2,1
2023-07-01,ZWE,Kelantan,0,0,0
2023-07-01,ZWE,Perak,0,0,0
2023-07-01,ZWE,Perlis,0,0,0
2023-07-01,ZWE,Pulau Pinang,0,0,0
2023-07-01,ZWE,Sabah,1,1,0
2023-07-01,ZWE,Sarawak,1,1,0
2023-07-01,ZWE,Selangor,209,88,121
2023-08-01,ABW,Kedah,0,0,0
2023-08-01,ABW,Pulau Pinang,0,0,0
2023-08-01,AFG,Johor,0,0,0
2023-08-01,AFG,Kedah,0,0,0
2023-08-01,AFG,Perlis,0,0,0
2023-08-01,AFG,Pulau Pinang,0,0,0
2023-08-01,AFG,Sarawak,1,1,0
2023-08-01,AFG,Selangor,93,62,31
2023-08-01,AGO,Johor,0,0,0
2023-08-01,AGO,Kedah,0,0,0
2023-08-01,AGO,Sabah,0,0,0
2023-08-01,AGO,Selangor,4,3,1
2023-08-01,AIA,Selangor,0,0,0
2023-08-01,ALB,Johor,18,14,4
2023-08-01,ALB,Kedah,0,0,0
2023-08-01,ALB,Perak,1,1,0
2023-08-01,ALB,Perlis,0,0,0
2023-08-01,ALB,Pulau Pinang,0,0,0
2023-08-01,ALB,Sabah,0,0,0
2023-08-01,ALB,Sarawak,0,0,0
2023-08-01,ALB,Selangor,49,27,22
2023-08-01,AND,Johor,1,0,1
2023-08-01,AND,Kedah,1,0,1
2023-08-01,AND,Perlis,0,0,0
2023-08-01,AND,Pulau Pinang,1,1,0
2023-08-01,AND,Selangor,14,7,7
2023-08-01,ANT,Selangor,0,0,0
2023-08-01,ARE,Johor,73,34,39
2023-08-01,ARE,Kedah,21,10,11
2023-08-01,ARE,Kelantan,0,0,0
2023-08-01,ARE,Perak,0,0,0
2023-08-01,ARE,Perlis,0,0,0
2023-08-01,ARE,Pulau Pinang,16,6,10
2023-08-01,ARE,Sabah,0,0,0
2023-08-01,ARE,Sarawak,0,0,0
2023-08-01,ARE,Selangor,1408,741,667
2023-08-01,ARG,Johor,98,59,39
2023-08-01,ARG,Kedah,14,8,6
2023-08-01,ARG,Kelantan,0,0,0
2023-08-01,ARG,Melaka,0,0,0
2023-08-01,ARG,Perak,2,1,1
2023-08-01,ARG,Perlis,3,0,3
2023-08-01,ARG,Pulau Pinang,12,9,3
2023-08-01,ARG,Sabah,0,0,0
2023-08-01,ARG,Sarawak,2,2,0
2023-08-01,ARG,Selangor,353,177,176
2023-08-01,ARG,W.P. Labuan,0,0,0
2023-08-01,ARM,Johor,1,0,1
2023-08-01,ARM,Kedah,1,1,0
2023-08-01,ARM,Kelantan,0,0,0
2023-08-01,ARM,Perak,0,0,0
2023-08-01,ARM,Perlis,0,0,0
2023-08-01,ARM,Pulau Pinang,3,1,2
2023-08-01,ARM,Sabah,0,0,0
2023-08-01,ARM,Sarawak,0,0,0
2023-08-01,ARM,Selangor,49,25,24
2023-08-01,ATA,Selangor,0,0,0
2023-08-01,ATG,Johor,12,7,5
2023-08-01,ATG,Kedah,0,0,0
2023-08-01,ATG,Pulau Pinang,0,0,0
2023-08-01,ATG,Sarawak,0,0,0
2023-08-01,ATG,Selangor,26,14,12
2023-08-01,AUS,Johor,4669,2730,1939
2023-08-01,AUS,Kedah,454,247,207
2023-08-01,AUS,Kelantan,6,3,3
2023-08-01,AUS,Melaka,1,1,0
2023-08-01,AUS,Negeri Sembilan,1,1,0
2023-08-01,AUS,Pahang,19,13,6
2023-08-01,AUS,Perak,205,105,100
2023-08-01,AUS,Perlis,183,143,40
2023-08-01,AUS,Pulau Pinang,1896,1014,882
2023-08-01,AUS,Sabah,50,30,20
2023-08-01,AUS,Sarawak,452,278,174
2023-08-01,AUS,Selangor,20995,12471,8524
2023-08-01,AUS,Terengganu,0,0,0
2023-08-01,AUS,W.P. Labuan,9,6,3
2023-08-01,AUT,Johor,288,185,103
2023-08-01,AUT,Kedah,56,32,24
2023-08-01,AUT,Kelantan,2,2,0
2023-08-01,AUT,Melaka,0,0,0
2023-08-01,AUT,Negeri Sembilan,0,0,0
2023-08-01,AUT,Pahang,1,1,0
2023-08-01,AUT,Perak,4,3,1
2023-08-01,AUT,Perlis,23,9,14
2023-08-01,AUT,Pulau Pinang,80,53,27
2023-08-01,AUT,Sabah,5,3,2
2023-08-01,AUT,Sarawak,20,10,10
2023-08-01,AUT,Selangor,1087,649,438
2023-08-01,AUT,Terengganu,0,0,0
2023-08-01,AUT,W.P. Labuan,1,1,0
2023-08-01,AZE,Johor,3,0,3
2023-08-01,AZE,Kedah,3,2,1
2023-08-01,AZE,Kelantan,1,1,0
2023-08-01,AZE,Melaka,0,0,0
2023-08-01,AZE,Perlis,0,0,0
2023-08-01,AZE,Pulau Pinang,0,0,0
2023-08-01,AZE,Sabah,0,0,0
2023-08-01,AZE,Sarawak,2,1,1
2023-08-01,AZE,Selangor,130,70,60
2023-08-01,AZE,W.P. Labuan,0,0,0
2023-08-01,BDI,Pulau Pinang,0,0,0
2023-08-01,BDI,Sarawak,0,0,0
2023-08-01,BDI,Selangor,3,1,2
2023-08-01,BEL,Johor,350,193,157
2023-08-01,BEL,Kedah,44,19,25
2023-08-01,BEL,Kelantan,2,1,1
2023-08-01,BEL,Melaka,0,0,0
2023-08-01,BEL,Negeri Sembilan,0,0,0
2023-08-01,BEL,Pahang,1,1,0
2023-08-01,BEL,Perak,10,1,9
2023-08-01,BEL,Perlis,19,13,6
2023-08-01,BEL,Pulau Pinang,79,55,24
2023-08-01,BEL,Sabah,10,5,5
2023-08-01,BEL,Sarawak,35,19,16
2023-08-01,BEL,Selangor,1787,961,826
2023-08-01,BEL,W.P. Labuan,0,0,0
2023-08-01,BEN,Johor,0,0,0
2023-08-01,BEN,Kedah,0,0,0
2023-08-01,BEN,Perak,0,0,0
2023-08-01,BEN,Pulau Pinang,1,1,0
2023-08-01,BEN,Sabah,0,0,0
2023-08-01,BEN,Sarawak,0,0,0
2023-08-01,BEN,Selangor,7,6,1
2023-08-01,BFA,Perak,0,0,0
2023-08-01,BFA,Pulau Pinang,0,0,0
2023-08-01,BFA,Selangor,8,7,1
2023-08-01,BGD,Johor,3822,3262,560
2023-08-01,BGD,Kedah,108,70,38
2023-08-01,BGD,Kelantan,8,8,0
2023-08-01,BGD,Melaka,0,0,0
2023-08-01,BGD,Negeri Sembilan,0,0,0
2023-08-01,BGD,Pahang,0,0,0
2023-08-01,BGD,Perak,4,3,1
2023-08-01,BGD,Perlis,3,3,0
2023-08-01,BGD,Pulau Pinang,688,646,42
2023-08-01,BGD,Sabah,0,0,0
2023-08-01,BGD,Sarawak,61,51,10
2023-08-01,BGD,Selangor,70816,68473,2343
2023-08-01,BGD,W.P. Labuan,4,4,0
2023-08-01,BGR,Johor,42,24,18
2023-08-01,BGR,Kedah,8,4,4
2023-08-01,BGR,Kelantan,0,0,0
2023-08-01,BGR,Pahang,0,0,0
2023-08-01,BGR,Perak,0,0,0
2023-08-01,BGR,Perlis,0,0,0
2023-08-01,BGR,Pulau Pinang,6,3,3
2023-08-01,BGR,Sabah,0,0,0
2023-08-01,BGR,Sarawak,0,0,0
2023-08-01,BGR,Selangor,193,105,88
2023-08-01,BGR,W.P. Labuan,0,0,0
2023-08-01,BHR,Johor,52,17,35
2023-08-01,BHR,Kedah,3,2,1
2023-08-01,BHR,Kelantan,0,0,0
2023-08-01,BHR,Perlis,1,1,0
2023-08-01,BHR,Pulau Pinang,9,5,4
2023-08-01,BHR,Sabah,0,0,0
2023-08-01,BHR,Sarawak,1,1,0
2023-08-01,BHR,Selangor,542,273,269
2023-08-01,BHS,Johor,1,1,0
2023-08-01,BHS,Kedah,0,0,0
2023-08-01,BHS,Perak,0,0,0
2023-08-01,BHS,Sabah,0,0,0
2023-08-01,BHS,Sarawak,0,0,0
2023-08-01,BHS,Selangor,2,0,2
2023-08-01,BIH,Johor,4,2,2
2023-08-01,BIH,Kedah,1,0,1
2023-08-01,BIH,Perlis,0,0,0
2023-08-01,BIH,Pulau Pinang,0,0,0
2023-08-01,BIH,Sabah,0,0,0
2023-08-01,BIH,Sarawak,1,1,0
2023-08-01,BIH,Selangor,46,30,16
2023-08-01,BLR,Johor,22,10,12
2023-08-01,BLR,Kedah,8,5,3
2023-08-01,BLR,Kelantan,1,0,1
2023-08-01,BLR,Pahang,0,0,0
2023-08-01,BLR,Perak,0,0,0
2023-08-01,BLR,Perlis,0,0,0
2023-08-01,BLR,Pulau Pinang,5,2,3
2023-08-01,BLR,Sabah,0,0,0
2023-08-01,BLR,Sarawak,3,1,2
2023-08-01,BLR,Selangor,243,109,134
2023-08-01,BLR,W.P. Labuan,0,0,0
2023-08-01,BLZ,Johor,1,0,1
2023-08-01,BLZ,Pulau Pinang,0,0,0
2023-08-01,BLZ,Sarawak,0,0,0
2023-08-01,BLZ,Selangor,14,8,6
2023-08-01,BMU,Selangor,1,0,1
2023-08-01,BOL,Johor,13,6,7
2023-08-01,BOL,Kedah,2,0,2
2023-08-01,BOL,Melaka,0,0,0
2023-08-01,BOL,Perak,0,0,0
2023-08-01,BOL,Perlis,0,0,0
2023-08-01,BOL,Pulau Pinang,0,0,0
2023-08-01,BOL,Sabah,0,0,0
2023-08-01,BOL,Sarawak,1,1,0
2023-08-01,BOL,Selangor,24,12,12
2023-08-01,BRA,Johor,308,177,131
2023-08-01,BRA,Kedah,35,18,17
2023-08-01,BRA,Kelantan,0,0,0
2023-08-01,BRA,Melaka,2,2,0
2023-08-01,BRA,Pahang,0,0,0
2023-08-01,BRA,Perak,2,1,1
2023-08-01,BRA,Perlis,5,1,4
2023-08-01,BRA,Pulau Pinang,24,15,9
2023-08-01,BRA,Sabah,4,3,1
2023-08-01,BRA,Sarawak,10,5,5
2023-08-01,BRA,Selangor,914,519,395
2023-08-01,BRA,W.P. Labuan,0,0,0
2023-08-01,BRB,Johor,0,0,0
2023-08-01,BRB,Kedah,0,0,0
2023-08-01,BRB,Perlis,0,0,0
2023-08-01,BRB,Pulau Pinang,0,0,0
2023-08-01,BRB,Selangor,5,3,2
2023-08-01,BRN,Johor,790,379,411
2023-08-01,BRN,Kedah,58,24,34
2023-08-01,BRN,Kelantan,15,12,3
2023-08-01,BRN,Melaka,0,0,0
2023-08-01,BRN,Pahang,1,1,0
2023-08-01,BRN,Perak,1,1,0
2023-08-01,BRN,Perlis,38,23,15
2023-08-01,BRN,Pulau Pinang,9,3,6
2023-08-01,BRN,Sabah,180,82,98
2023-08-01,BRN,Sarawak,67279,36829,30450
2023-08-01,BRN,Selangor,6508,3205,3303
2023-08-01,BRN,W.P. Labuan,1791,1120,671
2023-08-01,BTN,Johor,14,9,5
2023-08-01,BTN,Kedah,0,0,0
2023-08-01,BTN,Perak,1,1,0
2023-08-01,BTN,Perlis,2,1,1
2023-08-01,BTN,Pulau Pinang,0,0,0
2023-08-01,BTN,Sabah,0,0,0
2023-08-01,BTN,Sarawak,1,1,0
2023-08-01,BTN,Selangor,73,36,37
2023-08-01,BWA,Johor,0,0,0
2023-08-01,BWA,Kedah,4,2,2
2023-08-01,BWA,Perlis,0,0,0
2023-08-01,BWA,Pulau Pinang,0,0,0
2023-08-01,BWA,Sabah,0,0,0
2023-08-01,BWA,Sarawak,0,0,0
2023-08-01,BWA,Selangor,11,4,7
2023-08-01,CAF,Kedah,0,0,0
2023-08-01,CAF,Selangor,4,3,1
2023-08-01,CAN,Johor,1600,892,708
2023-08-01,CAN,Kedah,129,77,52
2023-08-01,CAN,Kelantan,4,3,1
2023-08-01,CAN,Melaka,0,0,0
2023-08-01,CAN,Negeri Sembilan,0,0,0
2023-08-01,CAN,Pahang,2,1,1
2023-08-01,CAN,Perak,59,33,26
2023-08-01,CAN,Perlis,29,18,11
2023-08-01,CAN,Pulau Pinang,484,271,213
2023-08-01,CAN,Sabah,29,20,9
2023-08-01,CAN,Sarawak,204,119,85
2023-08-01,CAN,Selangor,4144,2374,1770
2023-08-01,CAN,Terengganu,0,0,0
2023-08-01,CAN,W.P. Labuan,2,2,0
2023-08-01,CCK,Selangor,0,0,0
2023-08-01,CHE,Johor,514,288,226
2023-08-01,CHE,Kedah,76,40,36
2023-08-01,CHE,Kelantan,8,4,4
2023-08-01,CHE,Melaka,0,0,0
2023-08-01,CHE,Negeri Sembilan,1,1,0
2023-08-01,CHE,Pahang,1,1,0
2023-08-01,CHE,Perak,3,3,0
2023-08-01,CHE,Perlis,39,26,13
2023-08-01,CHE,Pulau Pinang,103,63,40
2023-08-01,CHE,Sabah,18,13,5
2023-08-01,CHE,Sarawak,26,13,13
2023-08-01,CHE,Selangor,1612,935,677
2023-08-01,CHE,W.P. Labuan,2,1,1
2023-08-01,CHL,Johor,50,29,21
2023-08-01,CHL,Kedah,15,9,6
2023-08-01,CHL,Kelantan,2,1,1
2023-08-01,CHL,Melaka,0,0,0
2023-08-01,CHL,Pahang,0,0,0
2023-08-01,CHL,Perak,0,0,0
2023-08-01,CHL,Perlis,4,4,0
2023-08-01,CHL,Pulau Pinang,6,3,3
2023-08-01,CHL,Sabah,0,0,0
2023-08-01,CHL,Sarawak,2,1,1
2023-08-01,CHL,Selangor,294,147,147
2023-08-01,CHN,Johor,58998,25424,33574
2023-08-01,CHN,Kedah,1902,827,1075
2023-08-01,CHN,Kelantan,3,1,2
2023-08-01,CHN,Melaka,4,4,0
2023-08-01,CHN,Pahang,36,25,11
2023-08-01,CHN,Perak,282,123,159
2023-08-01,CHN,Perlis,140,56,84
2023-08-01,CHN,Pulau Pinang,10924,5864,5060
2023-08-01,CHN,Sabah,2288,1075,1213
2023-08-01,CHN,Sarawak,1048,497,551
2023-08-01,CHN,Selangor,130284,63643,66641
2023-08-01,CHN,Terengganu,0,0,0
2023-08-01,CHN,W.P. Labuan,33,26,7
2023-08-01,CIV,Johor,6,6,0
2023-08-01,CIV,Kedah,0,0,0
2023-08-01,CIV,Pulau Pinang,0,0,0
2023-08-01,CIV,Sabah,0,0,0
2023-08-01,CIV,Sarawak,0,0,0
2023-08-01,CIV,Selangor,38,27,11
2023-08-01,CMR,Johor,0,0,0
2023-08-01,CMR,Kedah,6,3,3
2023-08-01,CMR,Pulau Pinang,2,1,1
2023-08-01,CMR,Sabah,0,0,0
2023-08-01,CMR,Sarawak,0,0,0
2023-08-01,CMR,Selangor,28,16,12
2023-08-01,COD,Johor,1,1,0
2023-08-01,COD,Pulau Pinang,0,0,0
2023-08-01,COD,Sarawak,0,0,0
2023-08-01,COD,Selangor,15,9,6
2023-08-01,COG,Johor,0,0,0
2023-08-01,COG,Kedah,0,0,0
2023-08-01,COG,Selangor,4,2,2
2023-08-01,COK,Selangor,0,0,0
2023-08-01,COL,Johor,43,20,23
2023-08-01,COL,Kedah,0,0,0
2023-08-01,COL,Perak,1,0,1
2023-08-01,COL,Pulau Pinang,6,2,4
2023-08-01,COL,Sabah,2,1,1
2023-08-01,COL,Sarawak,5,4,1
2023-08-01,COL,Selangor,184,102,82
2023-08-01,COL,W.P. Labuan,0,0,0
2023-08-01,COM,Johor,2,2,0
2023-08-01,COM,Kedah,0,0,0
2023-08-01,COM,Selangor,20,10,10
2023-08-01,CPV,Johor,0,0,0
2023-08-01,CPV,Kedah,0,0,0
2023-08-01,CPV,Pulau Pinang,0,0,0
2023-08-01,CPV,Sabah,0,0,0
2023-08-01,CPV,Selangor,7,4,3
2023-08-01,CRI,Johor,15,9,6
2023-08-01,CRI,Kedah,0,0,0
2023-08-01,CRI,Perak,0,0,0
2023-08-01,CRI,Perlis,0,0,0
2023-08-01,CRI,Pulau Pinang,8,6,2
2023-08-01,CRI,Sabah,0,0,0
2023-08-01,CRI,Sarawak,1,1,0
2023-08-01,CRI,Selangor,58,34,24
2023-08-01,CUB,Johor,9,8,1
2023-08-01,CUB,Kedah,0,0,0
2023-08-01,CUB,Perlis,0,0,0
2023-08-01,CUB,Pulau Pinang,0,0,0
2023-08-01,CUB,Sabah,0,0,0
2023-08-01,CUB,Sarawak,0,0,0
2023-08-01,CUB,Selangor,24,14,10
2023-08-01,CYP,Johor,11,7,4
2023-08-01,CYP,Kedah,6,4,2
2023-08-01,CYP,Perak,0,0,0
2023-08-01,CYP,Perlis,0,0,0
2023-08-01,CYP,Pulau Pinang,1,0,1
2023-08-01,CYP,Sabah,0,0,0
2023-08-01,CYP,Sarawak,0,0,0
2023-08-01,CYP,Selangor,125,78,47
2023-08-01,CZE,Johor,119,62,57
2023-08-01,CZE,Kedah,24,11,13
2023-08-01,CZE,Kelantan,2,2,0
2023-08-01,CZE,Melaka,0,0,0
2023-08-01,CZE,Negeri Sembilan,0,0,0
2023-08-01,CZE,Perak,6,3,3
2023-08-01,CZE,Perlis,5,2,3
2023-08-01,CZE,Pulau Pinang,13,8,5
2023-08-01,CZE,Sabah,3,2,1
2023-08-01,CZE,Sarawak,20,10,10
2023-08-01,CZE,Selangor,479,250,229
2023-08-01,CZE,W.P. Labuan,0,0,0
2023-08-01,DEU,Johor,2781,1665,1116
2023-08-01,DEU,Kedah,378,200,178
2023-08-01,DEU,Kelantan,10,8,2
2023-08-01,DEU,Melaka,6,1,5
2023-08-01,DEU,Negeri Sembilan,1,0,1
2023-08-01,DEU,Pahang,16,11,5
2023-08-01,DEU,Perak,41,23,18
2023-08-01,DEU,Perlis,115,59,56
2023-08-01,DEU,Pulau Pinang,833,537,296
2023-08-01,DEU,Sabah,31,17,14
2023-08-01,DEU,Sarawak,294,165,129
2023-08-01,DEU,Selangor,8639,4935,3704
2023-08-01,DEU,Terengganu,0,0,0
2023-08-01,DEU,W.P. Labuan,7,4,3
2023-08-01,DJI,Johor,0,0,0
2023-08-01,DJI,Selangor,10,5,5
2023-08-01,DMA,Johor,10,7,3
2023-08-01,DMA,Kedah,0,0,0
2023-08-01,DMA,Pulau Pinang,1,1,0
2023-08-01,DMA,Sabah,0,0,0
2023-08-01,DMA,Sarawak,0,0,0
2023-08-01,DMA,Selangor,46,32,14
2023-08-01,DMA,W.P. Labuan,0,0,0
2023-08-01,DNK,Johor,265,190,75
2023-08-01,DNK,Kedah,32,18,14
2023-08-01,DNK,Kelantan,2,1,1
2023-08-01,DNK,Melaka,0,0,0
2023-08-01,DNK,Negeri Sembilan,0,0,0
2023-08-01,DNK,Pahang,0,0,0
2023-08-01,DNK,Perak,1,1,0
2023-08-01,DNK,Perlis,2,2,0
2023-08-01,DNK,Pulau Pinang,41,29,12
2023-08-01,DNK,Sabah,4,3,1
2023-08-01,DNK,Sarawak,23,13,10
2023-08-01,DNK,Selangor,824,482,342
2023-08-01,DNK,W.P. Labuan,0,0,0
2023-08-01,DOM,Johor,2,1,1
2023-08-01,DOM,Kedah,1,0,1
2023-08-01,DOM,Perak,0,0,0
2023-08-01,DOM,Perlis,0,0,0
2023-08-01,DOM,Pulau Pinang,0,0,0
2023-08-01,DOM,Sabah,0,0,0
2023-08-01,DOM,Sarawak,0,0,0
2023-08-01,DOM,Selangor,16,10,6
2023-08-01,DZA,Johor,124,56,68
2023-08-01,DZA,Kedah,5,3,2
2023-08-01,DZA,Kelantan,0,0,0
2023-08-01,DZA,Melaka,0,0,0
2023-08-01,DZA,Perak,0,0,0
2023-08-01,DZA,Perlis,1,1,0
2023-08-01,DZA,Pulau Pinang,3,2,1
2023-08-01,DZA,Sabah,1,0,1
2023-08-01,DZA,Sarawak,3,3,0
2023-08-01,DZA,Selangor,3055,1543,1512
2023-08-01,DZA,W.P. Labuan,0,0,0
2023-08-01,ECU,Johor,15,8,7
2023-08-01,ECU,Kedah,3,1,2
2023-08-01,ECU,Perak,0,0,0
2023-08-01,ECU,Perlis,0,0,0
2023-08-01,ECU,Pulau Pinang,1,0,1
2023-08-01,ECU,Sabah,0,0,0
2023-08-01,ECU,Sarawak,0,0,0
2023-08-01,ECU,Selangor,83,31,52
2023-08-01,EGY,Johor,171,142,29
2023-08-01,EGY,Kedah,12,4,8
2023-08-01,EGY,Kelantan,1,1,0
2023-08-01,EGY,Melaka,0,0,0
2023-08-01,EGY,Pahang,0,0,0
2023-08-01,EGY,Perak,0,0,0
2023-08-01,EGY,Perlis,1,1,0
2023-08-01,EGY,Pulau Pinang,17,11,6
2023-08-01,EGY,Sabah,2,2,0
2023-08-01,EGY,Sarawak,76,60,16
2023-08-01,EGY,Selangor,2548,1601,947
2023-08-01,EGY,Terengganu,0,0,0
2023-08-01,EGY,W.P. Labuan,0,0,0
2023-08-01,ERI,Johor,0,0,0
2023-08-01,ERI,Pulau Pinang,2,1,1
2023-08-01,ERI,Sabah,0,0,0
2023-08-01,ERI,Selangor,33,17,16
2023-08-01,ESP,Johor,1307,695,612
2023-08-01,ESP,Kedah,131,60,71
2023-08-01,ESP,Kelantan,8,5,3
2023-08-01,ESP,Melaka,1,1,0
2023-08-01,ESP,Negeri Sembilan,0,0,0
2023-08-01,ESP,Pahang,0,0,0
2023-08-01,ESP,Perak,12,4,8
2023-08-01,ESP,Perlis,25,15,10
2023-08-01,ESP,Pulau Pinang,322,155,167
2023-08-01,ESP,Sabah,23,11,12
2023-08-01,ESP,Sarawak,145,86,59
2023-08-01,ESP,Selangor,8140,4112,4028
2023-08-01,ESP,W.P. Labuan,10,7,3
2023-08-01,EST,Johor,31,17,14
2023-08-01,EST,Kedah,5,3,2
2023-08-01,EST,Kelantan,0,0,0
2023-08-01,EST,Pahang,1,1,0
2023-08-01,EST,Perak,0,0,0
2023-08-01,EST,Perlis,1,0,1
2023-08-01,EST,Pulau Pinang,5,3,2
2023-08-01,EST,Sabah,0,0,0
2023-08-01,EST,Sarawak,0,0,0
2023-08-01,EST,Selangor,74,32,42
2023-08-01,EST,W.P. Labuan,0,0,0
2023-08-01,ETH,Johor,0,0,0
2023-08-01,ETH,Kedah,0,0,0
2023-08-01,ETH,Pulau Pinang,0,0,0
2023-08-01,ETH,Sarawak,0,0,0
2023-08-01,ETH,Selangor,50,25,25
2023-08-01,FIN,Johor,86,58,28
2023-08-01,FIN,Kedah,6,3,3
2023-08-01,FIN,Kelantan,1,1,0
2023-08-01,FIN,Melaka,0,0,0
2023-08-01,FIN,Negeri Sembilan,0,0,0
2023-08-01,FIN,Pahang,0,0,0
2023-08-01,FIN,Perak,0,0,0
2023-08-01,FIN,Perlis,3,0,3
2023-08-01,FIN,Pulau Pinang,23,13,10
2023-08-01,FIN,Sabah,1,1,0
2023-08-01,FIN,Sarawak,9,6,3
2023-08-01,FIN,Selangor,377,227,150
2023-08-01,FIN,W.P. Labuan,0,0,0
2023-08-01,FJI,Johor,85,46,39
2023-08-01,FJI,Kedah,0,0,0
2023-08-01,FJI,Kelantan,0,0,0
2023-08-01,FJI,Perak,0,0,0
2023-08-01,FJI,Perlis,0,0,0
2023-08-01,FJI,Pulau Pinang,1,1,0
2023-08-01,FJI,Sabah,0,0,0
2023-08-01,FJI,Sarawak,0,0,0
2023-08-01,FJI,Selangor,170,98,72
2023-08-01,FRA,Johor,3410,1930,1480
2023-08-01,FRA,Kedah,302,167,135
2023-08-01,FRA,Kelantan,27,15,12
2023-08-01,FRA,Melaka,3,2,1
2023-08-01,FRA,Negeri Sembilan,2,1,1
2023-08-01,FRA,Pahang,18,9,9
2023-08-01,FRA,Perak,24,16,8
2023-08-01,FRA,Perlis,75,50,25
2023-08-01,FRA,Pulau Pinang,542,312,230
2023-08-01,FRA,Sabah,31,19,12
2023-08-01,FRA,Sarawak,212,120,92
2023-08-01,FRA,Selangor,15193,8035,7158
2023-08-01,FRA,Terengganu,0,0,0
2023-08-01,FRA,W.P. Labuan,1,1,0
2023-08-01,FSM,Johor,0,0,0
2023-08-01,FSM,Pulau Pinang,0,0,0
2023-08-01,FSM,Selangor,0,0,0
2023-08-01,GAB,Johor,2,0,2
2023-08-01,GAB,Pulau Pinang,0,0,0
2023-08-01,GAB,Sarawak,0,0,0
2023-08-01,GAB,Selangor,7,3,4
2023-08-01,GBR,Johor,5811,3632,2179
2023-08-01,GBR,Kedah,950,504,446
2023-08-01,GBR,Kelantan,25,17,8
2023-08-01,GBR,Melaka,1,0,1
2023-08-01,GBR,Negeri Sembilan,0,0,0
2023-08-01,GBR,Pahang,37,20,17
2023-08-01,GBR,Perak,177,98,79
2023-08-01,GBR,Perlis,177,102,75
2023-08-01,GBR,Pulau Pinang,1823,1016,807
2023-08-01,GBR,Sabah,135,82,53
2023-08-01,GBR,Sarawak,884,538,346
2023-08-01,GBR,Selangor,23299,13135,10164
2023-08-01,GBR,Terengganu,0,0,0
2023-08-01,GBR,W.P. Labuan,26,20,6
2023-08-01,GEO,Johor,5,3,2
2023-08-01,GEO,Kedah,2,1,1
2023-08-01,GEO,Melaka,0,0,0
2023-08-01,GEO,Perak,0,0,0
2023-08-01,GEO,Perlis,0,0,0
2023-08-01,GEO,Pulau Pinang,1,0,1
2023-08-01,GEO,Sabah,2,2,0
2023-08-01,GEO,Sarawak,0,0,0
2023-08-01,GEO,Selangor,49,28,21
2023-08-01,GHA,Johor,12,9,3
2023-08-01,GHA,Kedah,1,0,1
2023-08-01,GHA,Kelantan,0,0,0
2023-08-01,GHA,Pulau Pinang,0,0,0
2023-08-01,GHA,Sabah,0,0,0
2023-08-01,GHA,Sarawak,0,0,0
2023-08-01,GHA,Selangor,126,78,48
2023-08-01,GIB,Johor,0,0,0
2023-08-01,GIB,Sarawak,0,0,0
2023-08-01,GIN,Johor,14,9,5
2023-08-01,GIN,Kedah,1,1,0
2023-08-01,GIN,Kelantan,0,0,0
2023-08-01,GIN,Perlis,0,0,0
2023-08-01,GIN,Pulau Pinang,0,0,0
2023-08-01,GIN,Sabah,0,0,0
2023-08-01,GIN,Sarawak,0,0,0
2023-08-01,GIN,Selangor,51,38,13
2023-08-01,GLP,Selangor,0,0,0
2023-08-01,GMB,Johor,6,6,0
2023-08-01,GMB,Kedah,0,0,0
2023-08-01,GMB,Kelantan,0,0,0
2023-08-01,GMB,Pulau Pinang,0,0,0
2023-08-01,GMB,Sabah,0,0,0
2023-08-01,GMB,Sarawak,1,1,0
2023-08-01,GMB,Selangor,35,23,12
2023-08-01,GNB,Johor,0,0,0
2023-08-01,GNB,Selangor,1,1,0
2023-08-01,GNQ,Johor,0,0,0
2023-08-01,GNQ,Selangor,2,1,1
2023-08-01,GRC,Johor,52,34,18
2023-08-01,GRC,Kedah,10,4,6
2023-08-01,GRC,Kelantan,3,1,2
2023-08-01,GRC,Melaka,0,0,0
2023-08-01,GRC,Negeri Sembilan,1,1,0
2023-08-01,GRC,Pahang,0,0,0
2023-08-01,GRC,Perak,0,0,0
2023-08-01,GRC,Perlis,2,2,0
2023-08-01,GRC,Pulau Pinang,8,5,3
2023-08-01,GRC,Sabah,1,1,0
2023-08-01,GRC,Sarawak,21,7,14
2023-08-01,GRC,Selangor,409,267,142
2023-08-01,GRD,Johor,9,6,3
2023-08-01,GRD,Kedah,0,0,0
2023-08-01,GRD,Pulau Pinang,0,0,0
2023-08-01,GRD,Sabah,0,0,0
2023-08-01,GRD,Sarawak,0,0,0
2023-08-01,GRD,Selangor,22,16,6
2023-08-01,GRL,Johor,0,0,0
2023-08-01,GRL,Selangor,0,0,0
2023-08-01,GTM,Johor,3,1,2
2023-08-01,GTM,Kedah,0,0,0
2023-08-01,GTM,Pahang,0,0,0
2023-08-01,GTM,Perak,0,0,0
2023-08-01,GTM,Pulau Pinang,1,1,0
2023-08-01,GTM,Sabah,0,0,0
2023-08-01,GTM,Sarawak,0,0,0
2023-08-01,GTM,Selangor,19,11,8
2023-08-01,GTM,W.P. Labuan,0,0,0
2023-08-01,GUY,Johor,1,1,0
2023-08-01,GUY,Kedah,0,0,0
2023-08-01,GUY,Pulau Pinang,0,0,0
2023-08-01,GUY,Sarawak,0,0,0
2023-08-01,GUY,Selangor,8,4,4
2023-08-01,HKG,Johor,9,6,3
2023-08-01,HKG,Kedah,1,1,0
2023-08-01,HKG,Kelantan,0,0,0
2023-08-01,HKG,Pahang,1,1,0
2023-08-01,HKG,Perak,30,12,18
2023-08-01,HKG,Perlis,1,1,0
2023-08-01,HKG,Pulau Pinang,0,0,0
2023-08-01,HKG,Sabah,0,0,0
2023-08-01,HKG,Sarawak,2,1,1
2023-08-01,HKG,Selangor,13,7,6
2023-08-01,HKG,Terengganu,0,0,0
2023-08-01,HMD,Johor,1,0,1
2023-08-01,HND,Johor,7,4,3
2023-08-01,HND,Kedah,0,0,0
2023-08-01,HND,Perak,0,0,0
2023-08-01,HND,Pulau Pinang,0,0,0
2023-08-01,HND,Sabah,0,0,0
2023-08-01,HND,Sarawak,0,0,0
2023-08-01,HND,Selangor,12,6,6
2023-08-01,HRV,Johor,50,41,9
2023-08-01,HRV,Kedah,0,0,0
2023-08-01,HRV,Kelantan,0,0,0
2023-08-01,HRV,Melaka,0,0,0
2023-08-01,HRV,Pahang,0,0,0
2023-08-01,HRV,Perak,0,0,0
2023-08-01,HRV,Perlis,0,0,0
2023-08-01,HRV,Pulau Pinang,1,1,0
2023-08-01,HRV,Sabah,0,0,0
2023-08-01,HRV,Sarawak,0,0,0
2023-08-01,HRV,Selangor,238,125,113
2023-08-01,HTI,Johor,1,1,0
2023-08-01,HTI,Kedah,0,0,0
2023-08-01,HTI,Kelantan,0,0,0
2023-08-01,HTI,Perak,0,0,0
2023-08-01,HTI,Pulau Pinang,0,0,0
2023-08-01,HTI,Sabah,0,0,0
2023-08-01,HTI,Selangor,3,2,1
2023-08-01,HUN,Johor,96,61,35
2023-08-01,HUN,Kedah,13,5,8
2023-08-01,HUN,Kelantan,0,0,0
2023-08-01,HUN,Pahang,0,0,0
2023-08-01,HUN,Perak,0,0,0
2023-08-01,HUN,Perlis,0,0,0
2023-08-01,HUN,Pulau Pinang,20,11,9
2023-08-01,HUN,Sabah,1,1,0
2023-08-01,HUN,Sarawak,7,4,3
2023-08-01,HUN,Selangor,518,267,251
2023-08-01,HUN,W.P. Labuan,0,0,0
2023-08-01,IDN,Johor,89381,42360,47021
2023-08-01,IDN,Kedah,4629,1647,2982
2023-08-01,IDN,Kelantan,149,94,55
2023-08-01,IDN,Melaka,3374,1618,1756
2023-08-01,IDN,Negeri Sembilan,7265,4703,2562
2023-08-01,IDN,Pahang,23,17,6
2023-08-01,IDN,Perak,297,126,171
2023-08-01,IDN,Perlis,514,255,259
2023-08-01,IDN,Pulau Pinang,37925,15355,22570
2023-08-01,IDN,Sabah,4260,2007,2253
2023-08-01,IDN,Sarawak,31604,16820,14784
2023-08-01,IDN,Selangor,115655,55363,60292
2023-08-01,IDN,Terengganu,0,0,0
2023-08-01,IDN,W.P. Labuan,56,28,28
2023-08-01,IND,Johor,25130,17609,7521
2023-08-01,IND,Kedah,1154,624,530
2023-08-01,IND,Kelantan,1,1,0
2023-08-01,IND,Melaka,1,1,0
2023-08-01,IND,Negeri Sembilan,0,0,0
2023-08-01,IND,Pahang,26,20,6
2023-08-01,IND,Perak,213,146,67
2023-08-01,IND,Perlis,31,22,9
2023-08-01,IND,Pulau Pinang,1011,667,344
2023-08-01,IND,Sabah,77,61,16
2023-08-01,IND,Sarawak,979,814,165
2023-08-01,IND,Selangor,53686,37829,15857
2023-08-01,IND,Terengganu,0,0,0
2023-08-01,IND,W.P. Labuan,76,61,15
2023-08-01,IOT,Pulau Pinang,0,0,0
2023-08-01,IOT,Selangor,0,0,0
2023-08-01,IRL,Johor,297,178,119
2023-08-01,IRL,Kedah,42,24,18
2023-08-01,IRL,Kelantan,0,0,0
2023-08-01,IRL,Negeri Sembilan,0,0,0
2023-08-01,IRL,Pahang,0,0,0
2023-08-01,IRL,Perak,9,7,2
2023-08-01,IRL,Perlis,13,5,8
2023-08-01,IRL,Pulau Pinang,128,77,51
2023-08-01,IRL,Sabah,2,0,2
2023-08-01,IRL,Sarawak,23,16,7
2023-08-01,IRL,Selangor,1651,944,707
2023-08-01,IRL,Terengganu,0,0,0
2023-08-01,IRL,W.P. Labuan,0,0,0
2023-08-01,IRN,Johor,204,116,88
2023-08-01,IRN,Kedah,11,6,5
2023-08-01,IRN,Kelantan,0,0,0
2023-08-01,IRN,Perak,0,0,0
2023-08-01,IRN,Perlis,0,0,0
2023-08-01,IRN,Pulau Pinang,4,0,4
2023-08-01,IRN,Sabah,1,1,0
2023-08-01,IRN,Sarawak,1,0,1
2023-08-01,IRN,Selangor,2006,1017,989
2023-08-01,IRN,W.P. Labuan,0,0,0
2023-08-01,IRQ,Johor,68,35,33
2023-08-01,IRQ,Kedah,0,0,0
2023-08-01,IRQ,Kelantan,0,0,0
2023-08-01,IRQ,Melaka,0,0,0
2023-08-01,IRQ,Pahang,0,0,0
2023-08-01,IRQ,Perak,0,0,0
2023-08-01,IRQ,Perlis,0,0,0
2023-08-01,IRQ,Pulau Pinang,7,5,2
2023-08-01,IRQ,Sabah,0,0,0
2023-08-01,IRQ,Sarawak,2,1,1
2023-08-01,IRQ,Selangor,1324,775,549
2023-08-01,ISL,Johor,23,10,13
2023-08-01,ISL,Kedah,4,1,3
2023-08-01,ISL,Kelantan,0,0,0
2023-08-01,ISL,Perak,1,1,0
2023-08-01,ISL,Perlis,0,0,0
2023-08-01,ISL,Pulau Pinang,0,0,0
2023-08-01,ISL,Sabah,0,0,0
2023-08-01,ISL,Sarawak,4,1,3
2023-08-01,ISL,Selangor,20,12,8
2023-08-01,ISL,W.P. Labuan,0,0,0
2023-08-01,ISR,Pulau Pinang,0,0,0
2023-08-01,ITA,Johor,2138,1138,1000
2023-08-01,ITA,Kedah,139,77,62
2023-08-01,ITA,Kelantan,8,7,1
2023-08-01,ITA,Melaka,3,1,2
2023-08-01,ITA,Negeri Sembilan,0,0,0
2023-08-01,ITA,Pahang,7,5,2
2023-08-01,ITA,Perak,20,11,9
2023-08-01,ITA,Perlis,39,21,18
2023-08-01,ITA,Pulau Pinang,264,164,100
2023-08-01,ITA,Sabah,67,37,30
2023-08-01,ITA,Sarawak,425,231,194
2023-08-01,ITA,Selangor,12253,6534,5719
2023-08-01,ITA,W.P. Labuan,7,5,2
2023-08-01,JAM,Johor,6,3,3
2023-08-01,JAM,Kedah,0,0,0
2023-08-01,JAM,Perak,0,0,0
2023-08-01,JAM,Pulau Pinang,1,1,0
2023-08-01,JAM,Sabah,0,0,0
2023-08-01,JAM,Sarawak,0,0,0
2023-08-01,JAM,Selangor,29,6,23
2023-08-01,JAM,W.P. Labuan,1,0,1
2023-08-01,JOR,Johor,9,6,3
2023-08-01,JOR,Kedah,7,4,3
2023-08-01,JOR,Kelantan,0,0,0
2023-08-01,JOR,Melaka,0,0,0
2023-08-01,JOR,Perlis,0,0,0
2023-08-01,JOR,Pulau Pinang,13,11,2
2023-08-01,JOR,Sabah,1,1,0
2023-08-01,JOR,Sarawak,4,2,2
2023-08-01,JOR,Selangor,1148,631,517
2023-08-01,JOR,W.P. Labuan,0,0,0
2023-08-01,JPN,Johor,7505,4742,2763
2023-08-01,JPN,Kedah,289,147,142
2023-08-01,JPN,Kelantan,20,11,9
2023-08-01,JPN,Melaka,1,1,0
2023-08-01,JPN,Negeri Sembilan,0,0,0
2023-08-01,JPN,Pahang,10,6,4
2023-08-01,JPN,Perak,94,62,32
2023-08-01,JPN,Perlis,110,86,24
2023-08-01,JPN,Pulau Pinang,1973,1225,748
2023-08-01,JPN,Sabah,104,58,46
2023-08-01,JPN,Sarawak,222,128,94
2023-08-01,JPN,Selangor,31511,17150,14361
2023-08-01,JPN,W.P. Labuan,15,9,6
2023-08-01,KAZ,Johor,81,29,52
2023-08-01,KAZ,Kedah,7,4,3
2023-08-01,KAZ,Kelantan,0,0,0
2023-08-01,KAZ,Melaka,0,0,0
2023-08-01,KAZ,Perak,0,0,0
2023-08-01,KAZ,Perlis,8,3,5
2023-08-01,KAZ,Pulau Pinang,1,1,0
2023-08-01,KAZ,Sabah,1,0,1
2023-08-01,KAZ,Sarawak,2,1,1
2023-08-01,KAZ,Selangor,940,407,533
2023-08-01,KAZ,W.P. Labuan,1,0,1
2023-08-01,KEN,Johor,159,65,94
2023-08-01,KEN,Kedah,4,2,2
2023-08-01,KEN,Kelantan,0,0,0
2023-08-01,KEN,Perak,0,0,0
2023-08-01,KEN,Perlis,1,1,0
2023-08-01,KEN,Pulau Pinang,7,1,6
2023-08-01,KEN,Sabah,4,3,1
2023-08-01,KEN,Sarawak,5,2,3
2023-08-01,KEN,Selangor,478,208,270
2023-08-01,KGZ,Johor,24,13,11
2023-08-01,KGZ,Kedah,2,1,1
2023-08-01,KGZ,Kelantan,0,0,0
2023-08-01,KGZ,Perak,0,0,0
2023-08-01,KGZ,Perlis,0,0,0
2023-08-01,KGZ,Pulau Pinang,1,1,0
2023-08-01,KGZ,Sabah,0,0,0
2023-08-01,KGZ,Sarawak,0,0,0
2023-08-01,KGZ,Selangor,264,136,128
2023-08-01,KHM,Johor,2600,1118,1482
2023-08-01,KHM,Kedah,71,29,42
2023-08-01,KHM,Kelantan,525,292,233
2023-08-01,KHM,Melaka,0,0,0
2023-08-01,KHM,Negeri Sembilan,0,0,0
2023-08-01,KHM,Pahang,0,0,0
2023-08-01,KHM,Perak,6,2,4
2023-08-01,KHM,Perlis,688,423,265
2023-08-01,KHM,Pulau Pinang,39,7,32
2023-08-01,KHM,Sabah,4,3,1
2023-08-01,KHM,Sarawak,9,3,6
2023-08-01,KHM,Selangor,5480,2927,2553
2023-08-01,KHM,W.P. Labuan,0,0,0
2023-08-01,KIR,Johor,0,0,0
2023-08-01,KIR,Sabah,0,0,0
2023-08-01,KIR,Selangor,0,0,0
2023-08-01,KNA,Johor,47,34,13
2023-08-01,KNA,Kedah,0,0,0
2023-08-01,KNA,Perlis,0,0,0
2023-08-01,KNA,Pulau Pinang,4,4,0
2023-08-01,KNA,Sabah,1,1,0
2023-08-01,KNA,Selangor,73,57,16
2023-08-01,KNA,W.P. Labuan,0,0,0
2023-08-01,KOR,Johor,14489,7505,6984
2023-08-01,KOR,Kedah,154,75,79
2023-08-01,KOR,Kelantan,2,1,1
2023-08-01,KOR,Melaka,24,15,9
2023-08-01,KOR,Negeri Sembilan,0,0,0
2023-08-01,KOR,Pahang,2,1,1
2023-08-01,KOR,Perak,12,9,3
2023-08-01,KOR,Perlis,72,47,25
2023-08-01,KOR,Pulau Pinang,740,389,351
2023-08-01,KOR,Sabah,753,360,393
2023-08-01,KOR,Sarawak,226,154,72
2023-08-01,KOR,Selangor,19550,10173,9377
2023-08-01,KOR,Terengganu,0,0,0
2023-08-01,KOR,W.P. Labuan,11,6,5
2023-08-01,KWT,Johor,320,165,155
2023-08-01,KWT,Kedah,23,10,13
2023-08-01,KWT,Kelantan,1,0,1
2023-08-01,KWT,Perak,0,0,0
2023-08-01,KWT,Perlis,0,0,0
2023-08-01,KWT,Pulau Pinang,47,22,25
2023-08-01,KWT,Sabah,0,0,0
2023-08-01,KWT,Sarawak,0,0,0
2023-08-01,KWT,Selangor,3652,1771,1881
2023-08-01,KWT,W.P. Labuan,0,0,0
2023-08-01,LAO,Johor,384,125,259
2023-08-01,LAO,Kedah,363,37,326
2023-08-01,LAO,Kelantan,149,43,106
2023-08-01,LAO,Melaka,0,0,0
2023-08-01,LAO,Perak,36,3,33
2023-08-01,LAO,Perlis,377,117,260
2023-08-01,LAO,Pulau Pinang,25,13,12
2023-08-01,LAO,Sabah,0,0,0
2023-08-01,LAO,Sarawak,4,1,3
2023-08-01,LAO,Selangor,575,217,358
2023-08-01,LAO,W.P. Labuan,0,0,0
2023-08-01,LBN,Johor,10,6,4
2023-08-01,LBN,Kedah,2,0,2
2023-08-01,LBN,Kelantan,0,0,0
2023-08-01,LBN,Pahang,0,0,0
2023-08-01,LBN,Perak,0,0,0
2023-08-01,LBN,Perlis,0,0,0
2023-08-01,LBN,Pulau Pinang,0,0,0
2023-08-01,LBN,Sabah,0,0,0
2023-08-01,LBN,Sarawak,5,5,0
2023-08-01,LBN,Selangor,279,160,119
2023-08-01,LBN,W.P. Labuan,0,0,0
2023-08-01,LBR,Johor,2,2,0
2023-08-01,LBR,Kedah,0,0,0
2023-08-01,LBR,Sabah,0,0,0
2023-08-01,LBR,Sarawak,1,1,0
2023-08-01,LBR,Selangor,8,5,3
2023-08-01,LBY,Johor,3,3,0
2023-08-01,LBY,Kedah,2,2,0
2023-08-01,LBY,Perlis,1,1,0
2023-08-01,LBY,Pulau Pinang,6,2,4
2023-08-01,LBY,Sabah,0,0,0
2023-08-01,LBY,Sarawak,0,0,0
2023-08-01,LBY,Selangor,564,395,169
2023-08-01,LCA,Johor,8,7,1
2023-08-01,LCA,Kedah,1,0,1
2023-08-01,LCA,Pulau Pinang,1,1,0
2023-08-01,LCA,Sarawak,3,2,1
2023-08-01,LCA,Selangor,10,9,1
2023-08-01,LIE,Johor,0,0,0
2023-08-01,LIE,Kedah,1,0,1
2023-08-01,LIE,Perlis,0,0,0
2023-08-01,LIE,Pulau Pinang,0,0,0
2023-08-01,LIE,Sabah,0,0,0
2023-08-01,LIE,Sarawak,0,0,0
2023-08-01,LIE,Selangor,4,3,1
2023-08-01,LKA,Johor,1545,990,555
2023-08-01,LKA,Kedah,60,30,30
2023-08-01,LKA,Kelantan,0,0,0
2023-08-01,LKA,Melaka,0,0,0
2023-08-01,LKA,Pahang,1,1,0
2023-08-01,LKA,Perak,6,4,2
2023-08-01,LKA,Perlis,2,1,1
2023-08-01,LKA,Pulau Pinang,45,17,28
2023-08-01,LKA,Sabah,5,4,1
2023-08-01,LKA,Sarawak,25,17,8
2023-08-01,LKA,Selangor,5524,3532,1992
2023-08-01,LKA,W.P. Labuan,1,1,0
2023-08-01,LSO,Johor,1,1,0
2023-08-01,LSO,Kedah,0,0,0
2023-08-01,LSO,Pulau Pinang,0,0,0
2023-08-01,LSO,Sarawak,1,1,0
2023-08-01,LSO,Selangor,4,1,3
2023-08-01,LTU,Johor,38,16,22
2023-08-01,LTU,Kedah,6,3,3
2023-08-01,LTU,Kelantan,1,1,0
2023-08-01,LTU,Pahang,0,0,0
2023-08-01,LTU,Perak,0,0,0
2023-08-01,LTU,Perlis,7,5,2
2023-08-01,LTU,Pulau Pinang,4,1,3
2023-08-01,LTU,Sabah,1,0,1
2023-08-01,LTU,Sarawak,6,2,4
2023-08-01,LTU,Selangor,209,109,100
2023-08-01,LTU,W.P. Labuan,0,0,0
2023-08-01,LUX,Johor,28,17,11
2023-08-01,LUX,Kedah,3,2,1
2023-08-01,LUX,Kelantan,0,0,0
2023-08-01,LUX,Perak,0,0,0
2023-08-01,LUX,Perlis,4,2,2
2023-08-01,LUX,Pulau Pinang,3,2,1
2023-08-01,LUX,Sabah,0,0,0
2023-08-01,LUX,Sarawak,0,0,0
2023-08-01,LUX,Selangor,127,73,54
2023-08-01,LVA,Johor,9,5,4
2023-08-01,LVA,Kedah,0,0,0
2023-08-01,LVA,Kelantan,0,0,0
2023-08-01,LVA,Pahang,0,0,0
2023-08-01,LVA,Perak,0,0,0
2023-08-01,LVA,Perlis,1,1,0
2023-08-01,LVA,Pulau Pinang,1,1,0
2023-08-01,LVA,Sabah,1,1,0
2023-08-01,LVA,Sarawak,2,1,1
2023-08-01,LVA,Selangor,125,69,56
2023-08-01,LVA,W.P. Labuan,0,0,0
2023-08-01,MAC,Johor,4,3,1
2023-08-01,MAC,Pahang,1,1,0
2023-08-01,MAC,Perak,0,0,0
2023-08-01,MAC,Selangor,7,3,4
2023-08-01,MAC,W.P. Labuan,0,0,0
2023-08-01,MAR,Johor,102,58,44
2023-08-01,MAR,Kedah,15,9,6
2023-08-01,MAR,Kelantan,1,0,1
2023-08-01,MAR,Melaka,0,0,0
2023-08-01,MAR,Pahang,0,0,0
2023-08-01,MAR,Perak,0,0,0
2023-08-01,MAR,Perlis,4,4,0
2023-08-01,MAR,Pulau Pinang,15,11,4
2023-08-01,MAR,Sabah,0,0,0
2023-08-01,MAR,Sarawak,6,6,0
2023-08-01,MAR,Selangor,2751,1190,1561
2023-08-01,MAR,W.P. Labuan,1,1,0
2023-08-01,MCO,Johor,0,0,0
2023-08-01,MCO,Kedah,0,0,0
2023-08-01,MCO,Sabah,0,0,0
2023-08-01,MCO,Selangor,4,2,2
2023-08-01,MDA,Johor,5,2,3
2023-08-01,MDA,Kedah,0,0,0
2023-08-01,MDA,Kelantan,0,0,0
2023-08-01,MDA,Negeri Sembilan,0,0,0
2023-08-01,MDA,Perlis,0,0,0
2023-08-01,MDA,Pulau Pinang,1,0,1
2023-08-01,MDA,Sabah,0,0,0
2023-08-01,MDA,Sarawak,0,0,0
2023-08-01,MDA,Selangor,38,24,14
2023-08-01,MDG,Johor,19,8,11
2023-08-01,MDG,Kedah,2,0,2
2023-08-01,MDG,Perak,0,0,0
2023-08-01,MDG,Perlis,1,0,1
2023-08-01,MDG,Pulau Pinang,0,0,0
2023-08-01,MDG,Sabah,0,0,0
2023-08-01,MDG,Sarawak,1,0,1
2023-08-01,MDG,Selangor,318,120,198
2023-08-01,MDV,Johor,121,73,48
2023-08-01,MDV,Kedah,11,6,5
2023-08-01,MDV,Kelantan,0,0,0
2023-08-01,MDV,Perak,0,0,0
2023-08-01,MDV,Perlis,0,0,0
2023-08-01,MDV,Pulau Pinang,12,7,5
2023-08-01,MDV,Sabah,1,1,0
2023-08-01,MDV,Sarawak,1,0,1
2023-08-01,MDV,Selangor,2222,1164,1058
2023-08-01,MEX,Johor,155,70,85
2023-08-01,MEX,Kedah,5,3,2
2023-08-01,MEX,Kelantan,0,0,0
2023-08-01,MEX,Pahang,0,0,0
2023-08-01,MEX,Perak,1,1,0
2023-08-01,MEX,Perlis,1,0,1
2023-08-01,MEX,Pulau Pinang,27,18,9
2023-08-01,MEX,Sabah,2,0,2
2023-08-01,MEX,Sarawak,6,4,2
2023-08-01,MEX,Selangor,499,266,233
2023-08-01,MEX,W.P. Labuan,0,0,0
2023-08-01,MHL,Johor,1,1,0
2023-08-01,MHL,Kedah,0,0,0
2023-08-01,MHL,Perak,0,0,0
2023-08-01,MHL,Pulau Pinang,0,0,0
2023-08-01,MHL,Sabah,0,0,0
2023-08-01,MHL,Selangor,6,5,1
2023-08-01,MKD,Johor,1,1,0
2023-08-01,MKD,Kedah,1,1,0
2023-08-01,MKD,Perak,0,0,0
2023-08-01,MKD,Pulau Pinang,0,0,0
2023-08-01,MKD,Sabah,0,0,0
2023-08-01,MKD,Sarawak,0,0,0
2023-08-01,MKD,Selangor,55,27,28
2023-08-01,MLI,Johor,3,3,0
2023-08-01,MLI,Sabah,0,0,0
2023-08-01,MLI,Selangor,12,9,3
2023-08-01,MLT,Johor,15,9,6
2023-08-01,MLT,Kedah,0,0,0
2023-08-01,MLT,Kelantan,0,0,0
2023-08-01,MLT,Perak,0,0,0
2023-08-01,MLT,Perlis,2,1,1
2023-08-01,MLT,Pulau Pinang,3,3,0
2023-08-01,MLT,Sabah,2,1,1
2023-08-01,MLT,Sarawak,0,0,0
2023-08-01,MLT,Selangor,90,51,39
2023-08-01,MLT,W.P. Labuan,0,0,0
2023-08-01,MMR,Johor,5709,1831,3878
2023-08-01,MMR,Kedah,96,26,70
2023-08-01,MMR,Kelantan,1,0,1
2023-08-01,MMR,Negeri Sembilan,1,1,0
2023-08-01,MMR,Pahang,2,0,2
2023-08-01,MMR,Perak,29,9,20
2023-08-01,MMR,Perlis,6,2,4
2023-08-01,MMR,Pulau Pinang,459,246,213
2023-08-01,MMR,Sabah,7,5,2
2023-08-01,MMR,Sarawak,75,29,46
2023-08-01,MMR,Selangor,7597,5249,2348
2023-08-01,MMR,Terengganu,0,0,0
2023-08-01,MMR,W.P. Labuan,0,0,0
2023-08-01,MNE,Johor,4,4,0
2023-08-01,MNE,Kedah,0,0,0
2023-08-01,MNE,Pulau Pinang,0,0,0
2023-08-01,MNE,Sabah,0,0,0
2023-08-01,MNE,Sarawak,0,0,0
2023-08-01,MNE,Selangor,17,10,7
2023-08-01,MNG,Johor,117,43,74
2023-08-01,MNG,Kedah,7,1,6
2023-08-01,MNG,Kelantan,0,0,0
2023-08-01,MNG,Perak,0,0,0
2023-08-01,MNG,Perlis,5,3,2
2023-08-01,MNG,Pulau Pinang,6,4,2
2023-08-01,MNG,Sabah,1,0,1
2023-08-01,MNG,Sarawak,0,0,0
2023-08-01,MNG,Selangor,320,144,176
2023-08-01,MNP,Selangor,0,0,0
2023-08-01,MOZ,Johor,0,0,0
2023-08-01,MOZ,Kedah,0,0,0
2023-08-01,MOZ,Perak,0,0,0
2023-08-01,MOZ,Pulau Pinang,1,0,1
2023-08-01,MOZ,Sabah,0,0,0
2023-08-01,MOZ,Sarawak,0,0,0
2023-08-01,MOZ,Selangor,31,13,18
2023-08-01,MRT,Johor,4,4,0
2023-08-01,MRT,Kedah,0,0,0
2023-08-01,MRT,Pulau Pinang,0,0,0
2023-08-01,MRT,Sabah,0,0,0
2023-08-01,MRT,Sarawak,0,0,0
2023-08-01,MRT,Selangor,26,20,6
2023-08-01,MUS,Johor,152,67,85
2023-08-01,MUS,Kedah,25,7,18
2023-08-01,MUS,Kelantan,0,0,0
2023-08-01,MUS,Pahang,0,0,0
2023-08-01,MUS,Perak,0,0,0
2023-08-01,MUS,Perlis,6,6,0
2023-08-01,MUS,Pulau Pinang,17,11,6
2023-08-01,MUS,Sabah,0,0,0
2023-08-01,MUS,Sarawak,1,0,1
2023-08-01,MUS,Selangor,1535,791,744
2023-08-01,MWI,Johor,1,1,0
2023-08-01,MWI,Pulau Pinang,0,0,0
2023-08-01,MWI,Sabah,0,0,0
2023-08-01,MWI,Sarawak,0,0,0
2023-08-01,MWI,Selangor,24,7,17
2023-08-01,MYT,Selangor,0,0,0
2023-08-01,NAM,Johor,1,0,1
2023-08-01,NAM,Kedah,0,0,0
2023-08-01,NAM,Perak,0,0,0
2023-08-01,NAM,Perlis,0,0,0
2023-08-01,NAM,Pulau Pinang,0,0,0
2023-08-01,NAM,Sabah,0,0,0
2023-08-01,NAM,Sarawak,0,0,0
2023-08-01,NAM,Selangor,22,16,6
2023-08-01,NCL,Selangor,0,0,0
2023-08-01,NER,Johor,0,0,0
2023-08-01,NER,Sabah,0,0,0
2023-08-01,NER,Selangor,5,2,3
2023-08-01,NGA,Johor,39,34,5
2023-08-01,NGA,Kedah,2,0,2
2023-08-01,NGA,Perlis,0,0,0
2023-08-01,NGA,Pulau Pinang,4,4,0
2023-08-01,NGA,Sabah,0,0,0
2023-08-01,NGA,Sarawak,10,4,6
2023-08-01,NGA,Selangor,488,365,123
2023-08-01,NIC,Johor,3,0,3
2023-08-01,NIC,Kedah,2,0,2
2023-08-01,NIC,Pulau Pinang,0,0,0
2023-08-01,NIC,Sabah,0,0,0
2023-08-01,NIC,Selangor,5,2,3
2023-08-01,NLD,Johor,1630,1012,618
2023-08-01,NLD,Kedah,273,148,125
2023-08-01,NLD,Kelantan,4,3,1
2023-08-01,NLD,Melaka,3,3,0
2023-08-01,NLD,Negeri Sembilan,0,0,0
2023-08-01,NLD,Pahang,0,0,0
2023-08-01,NLD,Perak,20,14,6
2023-08-01,NLD,Perlis,73,41,32
2023-08-01,NLD,Pulau Pinang,316,194,122
2023-08-01,NLD,Sabah,44,26,18
2023-08-01,NLD,Sarawak,175,112,63
2023-08-01,NLD,Selangor,7406,4046,3360
2023-08-01,NLD,Terengganu,0,0,0
2023-08-01,NLD,W.P. Labuan,5,3,2
2023-08-01,NOR,Johor,126,92,34
2023-08-01,NOR,Kedah,12,6,6
2023-08-01,NOR,Kelantan,1,1,0
2023-08-01,NOR,Melaka,0,0,0
2023-08-01,NOR,Pahang,0,0,0
2023-08-01,NOR,Perak,1,1,0
2023-08-01,NOR,Perlis,4,2,2
2023-08-01,NOR,Pulau Pinang,15,6,9
2023-08-01,NOR,Sabah,1,1,0
2023-08-01,NOR,Sarawak,9,6,3
2023-08-01,NOR,Selangor,521,303,218
2023-08-01,NOR,W.P. Labuan,1,0,1
2023-08-01,NPL,Johor,874,629,245
2023-08-01,NPL,Kedah,7,6,1
2023-08-01,NPL,Pahang,0,0,0
2023-08-01,NPL,Perak,0,0,0
2023-08-01,NPL,Perlis,1,1,0
2023-08-01,NPL,Pulau Pinang,11,8,3
2023-08-01,NPL,Sabah,1,0,1
2023-08-01,NPL,Sarawak,269,188,81
2023-08-01,NPL,Selangor,10412,9927,485
2023-08-01,NPL,W.P. Labuan,30,29,1
2023-08-01,NRU,Johor,41,25,16
2023-08-01,NRU,Pulau Pinang,0,0,0
2023-08-01,NRU,Selangor,8,6,2
2023-08-01,NZL,Johor,726,445,281
2023-08-01,NZL,Kedah,55,34,21
2023-08-01,NZL,Kelantan,5,3,2
2023-08-01,NZL,Melaka,0,0,0
2023-08-01,NZL,Negeri Sembilan,0,0,0
2023-08-01,NZL,Pahang,6,4,2
2023-08-01,NZL,Perak,30,22,8
2023-08-01,NZL,Perlis,22,17,5
2023-08-01,NZL,Pulau Pinang,224,124,100
2023-08-01,NZL,Sabah,20,10,10
2023-08-01,NZL,Sarawak,149,91,58
2023-08-01,NZL,Selangor,2726,1646,1080
2023-08-01,NZL,Terengganu,0,0,0
2023-08-01,NZL,W.P. Labuan,2,2,0
2023-08-01,OMN,Johor,180,81,99
2023-08-01,OMN,Kedah,13,7,6
2023-08-01,OMN,Kelantan,0,0,0
2023-08-01,OMN,Melaka,0,0,0
2023-08-01,OMN,Perak,6,3,3
2023-08-01,OMN,Perlis,5,2,3
2023-08-01,OMN,Pulau Pinang,12,6,6
2023-08-01,OMN,Sabah,0,0,0
2023-08-01,OMN,Sarawak,16,10,6
2023-08-01,OMN,Selangor,3188,1603,1585
2023-08-01,PAK,Johor,1162,820,342
2023-08-01,PAK,Kedah,156,104,52
2023-08-01,PAK,Kelantan,13,11,2
2023-08-01,PAK,Melaka,0,0,0
2023-08-01,PAK,Negeri Sembilan,0,0,0
2023-08-01,PAK,Pahang,0,0,0
2023-08-01,PAK,Perak,10,10,0
2023-08-01,PAK,Perlis,15,15,0
2023-08-01,PAK,Pulau Pinang,82,66,16
2023-08-01,PAK,Sabah,20,20,0
2023-08-01,PAK,Sarawak,167,128,39
2023-08-01,PAK,Selangor,12841,10878,1963
2023-08-01,PAK,W.P. Labuan,3,2,1
2023-08-01,PAN,Johor,8,5,3
2023-08-01,PAN,Kedah,0,0,0
2023-08-01,PAN,Perak,0,0,0
2023-08-01,PAN,Perlis,0,0,0
2023-08-01,PAN,Pulau Pinang,0,0,0
2023-08-01,PAN,Sabah,0,0,0
2023-08-01,PAN,Sarawak,0,0,0
2023-08-01,PAN,Selangor,30,18,12
2023-08-01,PER,Johor,40,20,20
2023-08-01,PER,Kedah,1,1,0
2023-08-01,PER,Kelantan,0,0,0
2023-08-01,PER,Pahang,1,1,0
2023-08-01,PER,Perak,0,0,0
2023-08-01,PER,Perlis,0,0,0
2023-08-01,PER,Pulau Pinang,3,0,3
2023-08-01,PER,Sabah,0,0,0
2023-08-01,PER,Sarawak,2,2,0
2023-08-01,PER,Selangor,134,72,62
2023-08-01,PER,W.P. Labuan,0,0,0
2023-08-01,PHL,Johor,24915,8236,16679
2023-08-01,PHL,Kedah,392,134,258
2023-08-01,PHL,Kelantan,23,15,8
2023-08-01,PHL,Melaka,0,0,0
2023-08-01,PHL,Negeri Sembilan,0,0,0
2023-08-01,PHL,Pahang,29,25,4
2023-08-01,PHL,Perak,59,24,35
2023-08-01,PHL,Perlis,168,48,120
2023-08-01,PHL,Pulau Pinang,655,257,398
2023-08-01,PHL,Sabah,616,356,260
2023-08-01,PHL,Sarawak,1941,751,1190
2023-08-01,PHL,Selangor,19043,7691,11352
2023-08-01,PHL,Terengganu,0,0,0
2023-08-01,PHL,W.P. Labuan,125,44,81
2023-08-01,PLW,Johor,1,1,0
2023-08-01,PLW,Pulau Pinang,0,0,0
2023-08-01,PLW,Selangor,0,0,0
2023-08-01,PNG,Johor,8,1,7
2023-08-01,PNG,Kedah,0,0,0
2023-08-01,PNG,Kelantan,0,0,0
2023-08-01,PNG,Perak,0,0,0
2023-08-01,PNG,Pulau Pinang,1,0,1
2023-08-01,PNG,Sabah,0,0,0
2023-08-01,PNG,Sarawak,6,4,2
2023-08-01,PNG,Selangor,29,16,13
2023-08-01,POL,Johor,292,169,123
2023-08-01,POL,Kedah,43,14,29
2023-08-01,POL,Kelantan,0,0,0
2023-08-01,POL,Melaka,0,0,0
2023-08-01,POL,Negeri Sembilan,0,0,0
2023-08-01,POL,Pahang,0,0,0
2023-08-01,POL,Perak,0,0,0
2023-08-01,POL,Perlis,4,1,3
2023-08-01,POL,Pulau Pinang,62,38,24
2023-08-01,POL,Sabah,16,9,7
2023-08-01,POL,Sarawak,80,39,41
2023-08-01,POL,Selangor,1397,662,735
2023-08-01,POL,Terengganu,0,0,0
2023-08-01,POL,W.P. Labuan,0,0,0
2023-08-01,PRK,Selangor,0,0,0
2023-08-01,PRT,Johor,238,127,111
2023-08-01,PRT,Kedah,44,24,20
2023-08-01,PRT,Kelantan,1,1,0
2023-08-01,PRT,Melaka,0,0,0
2023-08-01,PRT,Pahang,0,0,0
2023-08-01,PRT,Perak,1,1,0
2023-08-01,PRT,Perlis,7,6,1
2023-08-01,PRT,Pulau Pinang,64,30,34
2023-08-01,PRT,Sabah,10,7,3
2023-08-01,PRT,Sarawak,14,8,6
2023-08-01,PRT,Selangor,1146,607,539
2023-08-01,PRT,W.P. Labuan,1,1,0
2023-08-01,PRY,Johor,2,2,0
2023-08-01,PRY,Kedah,0,0,0
2023-08-01,PRY,Perak,0,0,0
2023-08-01,PRY,Perlis,0,0,0
2023-08-01,PRY,Pulau Pinang,2,1,1
2023-08-01,PRY,Sabah,0,0,0
2023-08-01,PRY,Sarawak,1,1,0
2023-08-01,PRY,Selangor,14,11,3
2023-08-01,PSE,Johor,30,27,3
2023-08-01,PSE,Kedah,0,0,0
2023-08-01,PSE,Kelantan,0,0,0
2023-08-01,PSE,Melaka,0,0,0
2023-08-01,PSE,Perak,0,0,0
2023-08-01,PSE,Perlis,0,0,0
2023-08-01,PSE,Pulau Pinang,1,1,0
2023-08-01,PSE,Sabah,0,0,0
2023-08-01,PSE,Sarawak,1,1,0
2023-08-01,PSE,Selangor,537,326,211
2023-08-01,QAT,Johor,77,34,43
2023-08-01,QAT,Kedah,5,3,2
2023-08-01,QAT,Perlis,0,0,0
2023-08-01,QAT,Pulau Pinang,0,0,0
2023-08-01,QAT,Sabah,0,0,0
2023-08-01,QAT,Sarawak,1,0,1
2023-08-01,QAT,Selangor,338,190,148
2023-08-01,REU,Johor,0,0,0
2023-08-01,REU,Sarawak,0,0,0
2023-08-01,ROU,Johor,137,82,55
2023-08-01,ROU,Kedah,5,4,1
2023-08-01,ROU,Kelantan,1,1,0
2023-08-01,ROU,Negeri Sembilan,0,0,0
2023-08-01,ROU,Pahang,0,0,0
2023-08-01,ROU,Perak,3,1,2
2023-08-01,ROU,Perlis,4,1,3
2023-08-01,ROU,Pulau Pinang,15,12,3
2023-08-01,ROU,Sabah,1,0,1
2023-08-01,ROU,Sarawak,10,6,4
2023-08-01,ROU,Selangor,667,313,354
2023-08-01,ROU,W.P. Labuan,0,0,0
2023-08-01,RUS,Johor,483,235,248
2023-08-01,RUS,Kedah,264,138,126
2023-08-01,RUS,Kelantan,41,26,15
2023-08-01,RUS,Melaka,0,0,0
2023-08-01,RUS,Negeri Sembilan,1,1,0
2023-08-01,RUS,Pahang,2,1,1
2023-08-01,RUS,Perak,1,0,1
2023-08-01,RUS,Perlis,215,123,92
2023-08-01,RUS,Pulau Pinang,141,65,76
2023-08-01,RUS,Sabah,17,8,9
2023-08-01,RUS,Sarawak,27,15,12
2023-08-01,RUS,Selangor,7069,3601,3468
2023-08-01,RUS,W.P. Labuan,7,5,2
2023-08-01,RWA,Johor,4,2,2
2023-08-01,RWA,Kedah,0,0,0
2023-08-01,RWA,Pulau Pinang,1,1,0
2023-08-01,RWA,Selangor,15,9,6
2023-08-01,SAU,Johor,482,224,258
2023-08-01,SAU,Kedah,84,43,41
2023-08-01,SAU,Kelantan,23,13,10
2023-08-01,SAU,Melaka,0,0,0
2023-08-01,SAU,Perak,10,5,5
2023-08-01,SAU,Perlis,3,3,0
2023-08-01,SAU,Pulau Pinang,85,45,40
2023-08-01,SAU,Sabah,4,2,2
2023-08-01,SAU,Sarawak,3,3,0
2023-08-01,SAU,Selangor,7361,3893,3468
2023-08-01,SAU,W.P. Labuan,0,0,0
2023-08-01,SDN,Johor,12,8,4
2023-08-01,SDN,Kedah,1,1,0
2023-08-01,SDN,Kelantan,0,0,0
2023-08-01,SDN,Perlis,0,0,0
2023-08-01,SDN,Pulau Pinang,2,1,1
2023-08-01,SDN,Sabah,0,0,0
2023-08-01,SDN,Sarawak,0,0,0
2023-08-01,SDN,Selangor,1464,783,681
2023-08-01,SDN,W.P. Labuan,1,1,0
2023-08-01,SEN,Johor,7,5,2
2023-08-01,SEN,Kedah,1,1,0
2023-08-01,SEN,Kelantan,0,0,0
2023-08-01,SEN,Perak,0,0,0
2023-08-01,SEN,Perlis,0,0,0
2023-08-01,SEN,Pulau Pinang,0,0,0
2023-08-01,SEN,Sabah,0,0,0
2023-08-01,SEN,Sarawak,0,0,0
2023-08-01,SEN,Selangor,137,74,63
2023-08-01,SGP,Johor,1198428,694040,504388
2023-08-01,SGP,Kedah,4225,2203,2022
2023-08-01,SGP,Kelantan,67,52,15
2023-08-01,SGP,Melaka,36,24,12
2023-08-01,SGP,Negeri Sembilan,0,0,0
2023-08-01,SGP,Pahang,468,239,229
2023-08-01,SGP,Perak,5898,2601,3297
2023-08-01,SGP,Perlis,192,123,69
2023-08-01,SGP,Pulau Pinang,18427,8890,9537
2023-08-01,SGP,Sabah,610,330,280
2023-08-01,SGP,Sarawak,3789,2226,1563
2023-08-01,SGP,Selangor,43929,22787,21142
2023-08-01,SGP,Terengganu,0,0,0
2023-08-01,SGP,W.P. Labuan,11,11,0
2023-08-01,SGS,Johor,0,0,0
2023-08-01,SGS,Sabah,0,0,0
2023-08-01,SGS,Selangor,0,0,0
2023-08-01,SHN,Sarawak,0,0,0
2023-08-01,SLB,Johor,1,1,0
2023-08-01,SLB,Perlis,0,0,0
2023-08-01,SLB,Pulau Pinang,1,1,0
2023-08-01,SLB,Sabah,0,0,0
2023-08-01,SLB,Sarawak,1,1,0
2023-08-01,SLB,Selangor,4,3,1
2023-08-01,SLB,W.P. Labuan,0,0,0
2023-08-01,SLE,Johor,4,3,1
2023-08-01,SLE,Kedah,0,0,0
2023-08-01,SLE,Perak,0,0,0
2023-08-01,SLE,Pulau Pinang,0,0,0
2023-08-01,SLE,Sabah,0,0,0
2023-08-01,SLE,Selangor,15,12,3
2023-08-01,SLV,Johor,3,0,3
2023-08-01,SLV,Kedah,0,0,0
2023-08-01,SLV,Perak,1,0,1
2023-08-01,SLV,Perlis,0,0,0
2023-08-01,SLV,Pulau Pinang,0,0,0
2023-08-01,SLV,Sabah,1,1,0
2023-08-01,SLV,Selangor,18,6,12
2023-08-01,SLV,W.P. Labuan,0,0,0
2023-08-01,SMR,Johor,0,0,0
2023-08-01,SMR,Selangor,4,2,2
2023-08-01,SOM,Johor,0,0,0
2023-08-01,SOM,Kedah,0,0,0
2023-08-01,SOM,Kelantan,0,0,0
2023-08-01,SOM,Perlis,0,0,0
2023-08-01,SOM,Sabah,0,0,0
2023-08-01,SOM,Sarawak,0,0,0
2023-08-01,SOM,Selangor,248,139,109
2023-08-01,SRB,Johor,17,13,4
2023-08-01,SRB,Kedah,0,0,0
2023-08-01,SRB,Kelantan,1,1,0
2023-08-01,SRB,Pahang,0,0,0
2023-08-01,SRB,Perak,0,0,0
2023-08-01,SRB,Perlis,0,0,0
2023-08-01,SRB,Pulau Pinang,1,1,0
2023-08-01,SRB,Sabah,0,0,0
2023-08-01,SRB,Sarawak,0,0,0
2023-08-01,SRB,Selangor,81,38,43
2023-08-01,SSD,Johor,10,7,3
2023-08-01,SSD,Kedah,0,0,0
2023-08-01,SSD,Sarawak,1,1,0
2023-08-01,SSD,Selangor,59,37,22
2023-08-01,SSD,W.P. Labuan,0,0,0
2023-08-01,STP,Selangor,2,2,0
2023-08-01,SUR,Johor,4,2,2
2023-08-01,SUR,Kedah,0,0,0
2023-08-01,SUR,Kelantan,0,0,0
2023-08-01,SUR,Perak,0,0,0
2023-08-01,SUR,Perlis,0,0,0
2023-08-01,SUR,Pulau Pinang,0,0,0
2023-08-01,SUR,Sabah,0,0,0
2023-08-01,SUR,Sarawak,0,0,0
2023-08-01,SUR,Selangor,38,23,15
2023-08-01,SVK,Johor,49,23,26
2023-08-01,SVK,Kedah,25,10,15
2023-08-01,SVK,Kelantan,2,2,0
2023-08-01,SVK,Negeri Sembilan,0,0,0
2023-08-01,SVK,Pahang,0,0,0
2023-08-01,SVK,Perak,0,0,0
2023-08-01,SVK,Perlis,2,1,1
2023-08-01,SVK,Pulau Pinang,20,13,7
2023-08-01,SVK,Sabah,1,1,0
2023-08-01,SVK,Sarawak,7,4,3
2023-08-01,SVK,Selangor,231,119,112
2023-08-01,SVK,W.P. Labuan,0,0,0
2023-08-01,SVN,Johor,24,8,16
2023-08-01,SVN,Kedah,4,3,1
2023-08-01,SVN,Kelantan,0,0,0
2023-08-01,SVN,Perak,0,0,0
2023-08-01,SVN,Perlis,1,1,0
2023-08-01,SVN,Pulau Pinang,2,1,1
2023-08-01,SVN,Sabah,1,0,1
2023-08-01,SVN,Sarawak,6,4,2
2023-08-01,SVN,Selangor,151,80,71
2023-08-01,SVN,W.P. Labuan,0,0,0
2023-08-01,SWE,Johor,219,142,77
2023-08-01,SWE,Kedah,35,26,9
2023-08-01,SWE,Kelantan,14,8,6
2023-08-01,SWE,Melaka,0,0,0
2023-08-01,SWE,Negeri Sembilan,0,0,0
2023-08-01,SWE,Pahang,0,0,0
2023-08-01,SWE,Perak,3,3,0
2023-08-01,SWE,Perlis,8,7,1
2023-08-01,SWE,Pulau Pinang,50,31,19
2023-08-01,SWE,Sabah,3,0,3
2023-08-01,SWE,Sarawak,49,32,17
2023-08-01,SWE,Selangor,818,525,293
2023-08-01,SWE,W.P. Labuan,0,0,0
2023-08-01,SWZ,Johor,0,0,0
2023-08-01,SWZ,Kedah,1,0,1
2023-08-01,SWZ,Pulau Pinang,0,0,0
2023-08-01,SWZ,Sabah,0,0,0
2023-08-01,SWZ,Selangor,25,12,13
2023-08-01,SYC,Johor,7,4,3
2023-08-01,SYC,Kedah,0,0,0
2023-08-01,SYC,Pulau Pinang,0,0,0
2023-08-01,SYC,Sabah,1,1,0
2023-08-01,SYC,Sarawak,0,0,0
2023-08-01,SYC,Selangor,106,45,61
2023-08-01,SYR,Johor,16,12,4
2023-08-01,SYR,Kedah,1,1,0
2023-08-01,SYR,Kelantan,0,0,0
2023-08-01,SYR,Pahang,0,0,0
2023-08-01,SYR,Perlis,0,0,0
2023-08-01,SYR,Pulau Pinang,8,5,3
2023-08-01,SYR,Sabah,0,0,0
2023-08-01,SYR,Sarawak,2,2,0
2023-08-01,SYR,Selangor,895,486,409
2023-08-01,SYR,W.P. Labuan,0,0,0
2023-08-01,TCA,Perlis,0,0,0
2023-08-01,TCD,Johor,4,2,2
2023-08-01,TCD,Kedah,0,0,0
2023-08-01,TCD,Perlis,0,0,0
2023-08-01,TCD,Selangor,18,14,4
2023-08-01,TGO,Johor,3,2,1
2023-08-01,TGO,Perak,0,0,0
2023-08-01,TGO,Pulau Pinang,0,0,0
2023-08-01,TGO,Selangor,14,11,3
2023-08-01,THA,Johor,6278,1612,4666
2023-08-01,THA,Kedah,58229,34008,24221
2023-08-01,THA,Kelantan,34580,18957,15623
2023-08-01,THA,Melaka,1,1,0
2023-08-01,THA,Negeri Sembilan,0,0,0
2023-08-01,THA,Pahang,16,8,8
2023-08-01,THA,Perak,11287,5454,5833
2023-08-01,THA,Perlis,44145,25712,18433
2023-08-01,THA,Pulau Pinang,2014,821,1193
2023-08-01,THA,Sabah,8,5,3
2023-08-01,THA,Sarawak,322,108,214
2023-08-01,THA,Selangor,14524,5963,8561
2023-08-01,THA,Terengganu,0,0,0
2023-08-01,THA,W.P. Labuan,13,4,9
2023-08-01,TJK,Johor,2,1,1
2023-08-01,TJK,Kedah,1,0,1
2023-08-01,TJK,Perlis,0,0,0
2023-08-01,TJK,Pulau Pinang,5,2,3
2023-08-01,TJK,Sabah,1,1,0
2023-08-01,TJK,Selangor,118,93,25
2023-08-01,TKL,Selangor,0,0,0
2023-08-01,TKM,Johor,4,2,2
2023-08-01,TKM,Kedah,0,0,0
2023-08-01,TKM,Kelantan,0,0,0
2023-08-01,TKM,Perlis,0,0,0
2023-08-01,TKM,Pulau Pinang,1,1,0
2023-08-01,TKM,Sabah,1,1,0
2023-08-01,TKM,Sarawak,0,0,0
2023-08-01,TKM,Selangor,205,112,93
2023-08-01,TLS,Johor,4,0,4
2023-08-01,TLS,Kedah,0,0,0
2023-08-01,TLS,Perlis,0,0,0
2023-08-01,TLS,Pulau Pinang,12,7,5
2023-08-01,TLS,Sabah,0,0,0
2023-08-01,TLS,Sarawak,5,4,1
2023-08-01,TLS,Selangor,270,151,119
2023-08-01,TON,Johor,0,0,0
2023-08-01,TON,Pulau Pinang,2,0,2
2023-08-01,TON,Sarawak,0,0,0
2023-08-01,TON,Selangor,10,3,7
2023-08-01,TTO,Johor,5,2,3
2023-08-01,TTO,Kedah,0,0,0
2023-08-01,TTO,Pahang,0,0,0
2023-08-01,TTO,Pulau Pinang,4,2,2
2023-08-01,TTO,Sabah,0,0,0
2023-08-01,TTO,Sarawak,1,0,1
2023-08-01,TTO,Selangor,50,27,23
2023-08-01,TUN,Johor,10,9,1
2023-08-01,TUN,Kedah,4,3,1
2023-08-01,TUN,Kelantan,2,2,0
2023-08-01,TUN,Melaka,0,0,0
2023-08-01,TUN,Perak,0,0,0
2023-08-01,TUN,Perlis,0,0,0
2023-08-01,TUN,Pulau Pinang,1,1,0
2023-08-01,TUN,Sabah,1,0,1
2023-08-01,TUN,Sarawak,3,3,0
2023-08-01,TUN,Selangor,2252,1014,1238
2023-08-01,TUN,W.P. Labuan,0,0,0
2023-08-01,TUR,Johor,376,271,105
2023-08-01,TUR,Kedah,56,33,23
2023-08-01,TUR,Kelantan,2,2,0
2023-08-01,TUR,Melaka,0,0,0
2023-08-01,TUR,Negeri Sembilan,2,1,1
2023-08-01,TUR,Pahang,0,0,0
2023-08-01,TUR,Perak,1,1,0
2023-08-01,TUR,Perlis,30,27,3
2023-08-01,TUR,Pulau Pinang,27,22,5
2023-08-01,TUR,Sabah,4,2,2
2023-08-01,TUR,Sarawak,23,18,5
2023-08-01,TUR,Selangor,1498,1014,484
2023-08-01,TUR,W.P. Labuan,1,1,0
2023-08-01,TUV,Selangor,0,0,0
2023-08-01,TWN,Johor,9321,4190,5131
2023-08-01,TWN,Kedah,159,75,84
2023-08-01,TWN,Kelantan,0,0,0
2023-08-01,TWN,Melaka,4,3,1
2023-08-01,TWN,Negeri Sembilan,0,0,0
2023-08-01,TWN,Pahang,8,3,5
2023-08-01,TWN,Perak,59,35,24
2023-08-01,TWN,Perlis,33,17,16
2023-08-01,TWN,Pulau Pinang,4854,2338,2516
2023-08-01,TWN,Sabah,241,144,97
2023-08-01,TWN,Sarawak,338,156,182
2023-08-01,TWN,Selangor,20807,10105,10702
2023-08-01,TWN,W.P. Labuan,3,2,1
2023-08-01,TZA,Johor,43,24,19
2023-08-01,TZA,Kedah,0,0,0
2023-08-01,TZA,Perak,0,0,0
2023-08-01,TZA,Perlis,0,0,0
2023-08-01,TZA,Pulau Pinang,0,0,0
2023-08-01,TZA,Sabah,0,0,0
2023-08-01,TZA,Sarawak,4,4,0
2023-08-01,TZA,Selangor,201,107,94
2023-08-01,UGA,Johor,22,8,14
2023-08-01,UGA,Kedah,2,0,2
2023-08-01,UGA,Perak,0,0,0
2023-08-01,UGA,Perlis,0,0,0
2023-08-01,UGA,Pulau Pinang,2,1,1
2023-08-01,UGA,Sabah,0,0,0
2023-08-01,UGA,Sarawak,0,0,0
2023-08-01,UGA,Selangor,112,45,67
2023-08-01,UKR,Johor,122,69,53
2023-08-01,UKR,Kedah,17,8,9
2023-08-01,UKR,Kelantan,1,1,0
2023-08-01,UKR,Melaka,0,0,0
2023-08-01,UKR,Negeri Sembilan,0,0,0
2023-08-01,UKR,Pahang,3,3,0
2023-08-01,UKR,Perak,0,0,0
2023-08-01,UKR,Perlis,7,3,4
2023-08-01,UKR,Pulau Pinang,17,6,11
2023-08-01,UKR,Sabah,1,1,0
2023-08-01,UKR,Sarawak,10,3,7
2023-08-01,UKR,Selangor,950,471,479
2023-08-01,UKR,W.P. Labuan,0,0,0
2023-08-01,URY,Johor,4,2,2
2023-08-01,URY,Kedah,1,1,0
2023-08-01,URY,Kelantan,0,0,0
2023-08-01,URY,Perak,0,0,0
2023-08-01,URY,Perlis,0,0,0
2023-08-01,URY,Pulau Pinang,0,0,0
2023-08-01,URY,Sabah,0,0,0
2023-08-01,URY,Sarawak,1,1,0
2023-08-01,URY,Selangor,78,49,29
2023-08-01,URY,W.P. Labuan,0,0,0
2023-08-01,USA,Johor,4514,2677,1837
2023-08-01,USA,Kedah,389,217,172
2023-08-01,USA,Kelantan,7,5,2
2023-08-01,USA,Melaka,1,0,1
2023-08-01,USA,Negeri Sembilan,0,0,0
2023-08-01,USA,Pahang,13,8,5
2023-08-01,USA,Perak,229,115,114
2023-08-01,USA,Perlis,95,60,35
2023-08-01,USA,Pulau Pinang,2069,1247,822
2023-08-01,USA,Sabah,57,34,23
2023-08-01,USA,Sarawak,282,162,120
2023-08-01,USA,Selangor,14499,8628,5871
2023-08-01,USA,Terengganu,0,0,0
2023-08-01,USA,W.P. Labuan,13,9,4
2023-08-01,UZB,Johor,82,59,23
2023-08-01,UZB,Kedah,5,0,5
2023-08-01,UZB,Kelantan,0,0,0
2023-08-01,UZB,Perak,0,0,0
2023-08-01,UZB,Perlis,1,1,0
2023-08-01,UZB,Pulau Pinang,27,9,18
2023-08-01,UZB,Sabah,3,2,1
2023-08-01,UZB,Sarawak,3,0,3
2023-08-01,UZB,Selangor,1280,773,507
2023-08-01,VAT,Johor,0,0,0
2023-08-01,VAT,Sarawak,0,0,0
2023-08-01,VAT,Selangor,0,0,0
2023-08-01,VCT,Johor,0,0,0
2023-08-01,VCT,Kedah,0,0,0
2023-08-01,VCT,Pulau Pinang,0,0,0
2023-08-01,VCT,Sarawak,0,0,0
2023-08-01,VCT,Selangor,1,1,0
2023-08-01,VEN,Johor,17,9,8
2023-08-01,VEN,Kedah,4,3,1
2023-08-01,VEN,Kelantan,0,0,0
2023-08-01,VEN,Melaka,0,0,0
2023-08-01,VEN,Perak,0,0,0
2023-08-01,VEN,Perlis,0,0,0
2023-08-01,VEN,Pulau Pinang,0,0,0
2023-08-01,VEN,Sabah,0,0,0
2023-08-01,VEN,Sarawak,0,0,0
2023-08-01,VEN,Selangor,91,53,38
2023-08-01,VEN,W.P. Labuan,0,0,0
2023-08-01,VNM,Johor,21679,7775,13904
2023-08-01,VNM,Kedah,241,39,202
2023-08-01,VNM,Kelantan,18,14,4
2023-08-01,VNM,Melaka,0,0,0
2023-08-01,VNM,Negeri Sembilan,0,0,0
2023-08-01,VNM,Pahang,0,0,0
2023-08-01,VNM,Perak,85,9,76
2023-08-01,VNM,Perlis,283,25,258
2023-08-01,VNM,Pulau Pinang,1724,554,1170
2023-08-01,VNM,Sabah,8,5,3
2023-08-01,VNM,Sarawak,135,35,100
2023-08-01,VNM,Selangor,19361,7455,11906
2023-08-01,VNM,Terengganu,0,0,0
2023-08-01,VNM,W.P. Labuan,3,2,1
2023-08-01,VUT,Johor,73,58,15
2023-08-01,VUT,Kedah,0,0,0
2023-08-01,VUT,Pulau Pinang,6,3,3
2023-08-01,VUT,Sabah,2,2,0
2023-08-01,VUT,Sarawak,1,1,0
2023-08-01,VUT,Selangor,83,64,19
2023-08-01,WSM,Johor,2,0,2
2023-08-01,WSM,Sarawak,0,0,0
2023-08-01,WSM,Selangor,1,0,1
2023-08-01,XXX,Johor,84,46,38
2023-08-01,XXX,Kedah,6,5,1
2023-08-01,XXX,Kelantan,0,0,0
2023-08-01,XXX,Melaka,0,0,0
2023-08-01,XXX,Pahang,0,0,0
2023-08-01,XXX,Perak,5,3,2
2023-08-01,XXX,Perlis,0,0,0
2023-08-01,XXX,Pulau Pinang,66,29,37
2023-08-01,XXX,Sabah,6,4,2
2023-08-01,XXX,Sarawak,31,17,14
2023-08-01,XXX,Selangor,484,289,195
2023-08-01,XXX,W.P. Labuan,3,2,1
2023-08-01,YEM,Johor,51,34,17
2023-08-01,YEM,Kedah,1,1,0
2023-08-01,YEM,Kelantan,1,1,0
2023-08-01,YEM,Melaka,0,0,0
2023-08-01,YEM,Pahang,0,0,0
2023-08-01,YEM,Perak,0,0,0
2023-08-01,YEM,Perlis,1,1,0
2023-08-01,YEM,Pulau Pinang,8,6,2
2023-08-01,YEM,Sabah,0,0,0
2023-08-01,YEM,Sarawak,1,0,1
2023-08-01,YEM,Selangor,1707,1107,600
2023-08-01,YEM,W.P. Labuan,0,0,0
2023-08-01,ZAF,Johor,243,143,100
2023-08-01,ZAF,Kedah,23,14,9
2023-08-01,ZAF,Kelantan,2,2,0
2023-08-01,ZAF,Melaka,0,0,0
2023-08-01,ZAF,Pahang,0,0,0
2023-08-01,ZAF,Perak,3,2,1
2023-08-01,ZAF,Perlis,18,9,9
2023-08-01,ZAF,Pulau Pinang,67,37,30
2023-08-01,ZAF,Sabah,8,5,3
2023-08-01,ZAF,Sarawak,112,52,60
2023-08-01,ZAF,Selangor,914,512,402
2023-08-01,ZAF,Terengganu,0,0,0
2023-08-01,ZAF,W.P. Labuan,13,5,8
2023-08-01,ZAR,Selangor,0,0,0
2023-08-01,ZMB,Johor,2,1,1
2023-08-01,ZMB,Kedah,0,0,0
2023-08-01,ZMB,Perak,0,0,0
2023-08-01,ZMB,Perlis,0,0,0
2023-08-01,ZMB,Pulau Pinang,0,0,0
2023-08-01,ZMB,Sabah,0,0,0
2023-08-01,ZMB,Sarawak,1,0,1
2023-08-01,ZMB,Selangor,77,45,32
2023-08-01,ZWE,Johor,3,0,3
2023-08-01,ZWE,Kedah,1,0,1
2023-08-01,ZWE,Kelantan,0,0,0
2023-08-01,ZWE,Perak,0,0,0
2023-08-01,ZWE,Perlis,0,0,0
2023-08-01,ZWE,Pulau Pinang,13,7,6
2023-08-01,ZWE,Sabah,1,1,0
2023-08-01,ZWE,Sarawak,1,1,0
2023-08-01,ZWE,Selangor,179,82,97
2023-09-01,ABW,Kedah,0,0,0
2023-09-01,ABW,Pulau Pinang,0,0,0
2023-09-01,AFG,Johor,2,2,0
2023-09-01,AFG,Kedah,2,2,0
2023-09-01,AFG,Perlis,0,0,0
2023-09-01,AFG,Pulau Pinang,0,0,0
2023-09-01,AFG,Sarawak,0,0,0
2023-09-01,AFG,Selangor,62,50,12
2023-09-01,AGO,Johor,0,0,0
2023-09-01,AGO,Kedah,0,0,0
2023-09-01,AGO,Sabah,0,0,0
2023-09-01,AGO,Selangor,7,3,4
2023-09-01,AIA,Selangor,0,0,0
2023-09-01,ALB,Johor,25,19,6
2023-09-01,ALB,Kedah,1,1,0
2023-09-01,ALB,Perak,0,0,0
2023-09-01,ALB,Perlis,0,0,0
2023-09-01,ALB,Pulau Pinang,0,0,0
2023-09-01,ALB,Sabah,0,0,0
2023-09-01,ALB,Sarawak,0,0,0
2023-09-01,ALB,Selangor,34,17,17
2023-09-01,AND,Johor,1,1,0
2023-09-01,AND,Kedah,0,0,0
2023-09-01,AND,Perlis,0,0,0
2023-09-01,AND,Pulau Pinang,0,0,0
2023-09-01,AND,Selangor,7,3,4
2023-09-01,ANT,Selangor,0,0,0
2023-09-01,ARE,Johor,8,5,3
2023-09-01,ARE,Kedah,4,1,3
2023-09-01,ARE,Kelantan,0,0,0
2023-09-01,ARE,Perak,0,0,0
2023-09-01,ARE,Perlis,0,0,0
2023-09-01,ARE,Pulau Pinang,6,4,2
2023-09-01,ARE,Sabah,0,0,0
2023-09-01,ARE,Sarawak,0,0,0
2023-09-01,ARE,Selangor,361,243,118
2023-09-01,ARG,Johor,51,27,24
2023-09-01,ARG,Kedah,11,5,6
2023-09-01,ARG,Kelantan,4,2,2
2023-09-01,ARG,Melaka,0,0,0
2023-09-01,ARG,Perak,0,0,0
2023-09-01,ARG,Perlis,3,2,1
2023-09-01,ARG,Pulau Pinang,1,0,1
2023-09-01,ARG,Sabah,1,1,0
2023-09-01,ARG,Sarawak,1,1,0
2023-09-01,ARG,Selangor,409,231,178
2023-09-01,ARG,W.P. Labuan,3,1,2
2023-09-01,ARM,Johor,0,0,0
2023-09-01,ARM,Kedah,0,0,0
2023-09-01,ARM,Kelantan,0,0,0
2023-09-01,ARM,Perak,0,0,0
2023-09-01,ARM,Perlis,0,0,0
2023-09-01,ARM,Pulau Pinang,2,0,2
2023-09-01,ARM,Sabah,0,0,0
2023-09-01,ARM,Sarawak,0,0,0
2023-09-01,ARM,Selangor,58,35,23
2023-09-01,ATA,Selangor,0,0,0
2023-09-01,ATG,Johor,6,3,3
2023-09-01,ATG,Kedah,0,0,0
2023-09-01,ATG,Pulau Pinang,0,0,0
2023-09-01,ATG,Sarawak,0,0,0
2023-09-01,ATG,Selangor,19,12,7
2023-09-01,AUS,Johor,5978,3502,2476
2023-09-01,AUS,Kedah,537,273,264
2023-09-01,AUS,Kelantan,3,3,0
2023-09-01,AUS,Melaka,1,1,0
2023-09-01,AUS,Negeri Sembilan,2,2,0
2023-09-01,AUS,Pahang,21,11,10
2023-09-01,AUS,Perak,221,117,104
2023-09-01,AUS,Perlis,67,47,20
2023-09-01,AUS,Pulau Pinang,2032,1123,909
2023-09-01,AUS,Sabah,116,65,51
2023-09-01,AUS,Sarawak,580,305,275
2023-09-01,AUS,Selangor,29390,16640,12750
2023-09-01,AUS,Terengganu,1,1,0
2023-09-01,AUS,W.P. Labuan,3,2,1
2023-09-01,AUT,Johor,203,144,59
2023-09-01,AUT,Kedah,29,12,17
2023-09-01,AUT,Kelantan,3,2,1
2023-09-01,AUT,Melaka,0,0,0
2023-09-01,AUT,Negeri Sembilan,0,0,0
2023-09-01,AUT,Pahang,0,0,0
2023-09-01,AUT,Perak,2,2,0
2023-09-01,AUT,Perlis,1,0,1
2023-09-01,AUT,Pulau Pinang,66,41,25
2023-09-01,AUT,Sabah,0,0,0
2023-09-01,AUT,Sarawak,16,7,9
2023-09-01,AUT,Selangor,810,481,329
2023-09-01,AUT,Terengganu,0,0,0
2023-09-01,AUT,W.P. Labuan,0,0,0
2023-09-01,AZE,Johor,4,3,1
2023-09-01,AZE,Kedah,0,0,0
2023-09-01,AZE,Kelantan,0,0,0
2023-09-01,AZE,Melaka,0,0,0
2023-09-01,AZE,Perlis,0,0,0
2023-09-01,AZE,Pulau Pinang,4,2,2
2023-09-01,AZE,Sabah,0,0,0
2023-09-01,AZE,Sarawak,6,1,5
2023-09-01,AZE,Selangor,138,84,54
2023-09-01,AZE,W.P. Labuan,5,5,0
2023-09-01,BDI,Pulau Pinang,1,0,1
2023-09-01,BDI,Sarawak,0,0,0
2023-09-01,BDI,Selangor,31,9,22
2023-09-01,BEL,Johor,387,217,170
2023-09-01,BEL,Kedah,41,25,16
2023-09-01,BEL,Kelantan,1,1,0
2023-09-01,BEL,Melaka,0,0,0
2023-09-01,BEL,Negeri Sembilan,0,0,0
2023-09-01,BEL,Pahang,6,3,3
2023-09-01,BEL,Perak,2,1,1
2023-09-01,BEL,Perlis,11,6,5
2023-09-01,BEL,Pulau Pinang,69,47,22
2023-09-01,BEL,Sabah,11,6,5
2023-09-01,BEL,Sarawak,25,12,13
2023-09-01,BEL,Selangor,1655,909,746
2023-09-01,BEL,W.P. Labuan,0,0,0
2023-09-01,BEN,Johor,2,2,0
2023-09-01,BEN,Kedah,0,0,0
2023-09-01,BEN,Perak,0,0,0
2023-09-01,BEN,Pulau Pinang,0,0,0
2023-09-01,BEN,Sabah,0,0,0
2023-09-01,BEN,Sarawak,0,0,0
2023-09-01,BEN,Selangor,23,17,6
2023-09-01,BFA,Perak,0,0,0
2023-09-01,BFA,Pulau Pinang,1,1,0
2023-09-01,BFA,Selangor,26,22,4
2023-09-01,BGD,Johor,3848,3272,576
2023-09-01,BGD,Kedah,117,67,50
2023-09-01,BGD,Kelantan,1,1,0
2023-09-01,BGD,Melaka,0,0,0
2023-09-01,BGD,Negeri Sembilan,0,0,0
2023-09-01,BGD,Pahang,2,0,2
2023-09-01,BGD,Perak,3,2,1
2023-09-01,BGD,Perlis,9,6,3
2023-09-01,BGD,Pulau Pinang,413,394,19
2023-09-01,BGD,Sabah,1,0,1
2023-09-01,BGD,Sarawak,49,37,12
2023-09-01,BGD,Selangor,51900,50055,1845
2023-09-01,BGD,W.P. Labuan,3,3,0
2023-09-01,BGR,Johor,44,24,20
2023-09-01,BGR,Kedah,4,4,0
2023-09-01,BGR,Kelantan,0,0,0
2023-09-01,BGR,Pahang,0,0,0
2023-09-01,BGR,Perak,0,0,0
2023-09-01,BGR,Perlis,0,0,0
2023-09-01,BGR,Pulau Pinang,3,1,2
2023-09-01,BGR,Sabah,2,1,1
2023-09-01,BGR,Sarawak,1,1,0
2023-09-01,BGR,Selangor,223,132,91
2023-09-01,BGR,W.P. Labuan,0,0,0
2023-09-01,BHR,Johor,13,7,6
2023-09-01,BHR,Kedah,1,1,0
2023-09-01,BHR,Kelantan,0,0,0
2023-09-01,BHR,Perlis,0,0,0
2023-09-01,BHR,Pulau Pinang,9,5,4
2023-09-01,BHR,Sabah,0,0,0
2023-09-01,BHR,Sarawak,1,1,0
2023-09-01,BHR,Selangor,167,92,75
2023-09-01,BHS,Johor,0,0,0
2023-09-01,BHS,Kedah,0,0,0
2023-09-01,BHS,Perak,0,0,0
2023-09-01,BHS,Sabah,0,0,0
2023-09-01,BHS,Sarawak,0,0,0
2023-09-01,BHS,Selangor,6,3,3
2023-09-01,BIH,Johor,11,7,4
2023-09-01,BIH,Kedah,1,0,1
2023-09-01,BIH,Perlis,0,0,0
2023-09-01,BIH,Pulau Pinang,2,2,0
2023-09-01,BIH,Sabah,0,0,0
2023-09-01,BIH,Sarawak,1,1,0
2023-09-01,BIH,Selangor,90,65,25
2023-09-01,BLR,Johor,12,7,5
2023-09-01,BLR,Kedah,2,2,0
2023-09-01,BLR,Kelantan,1,1,0
2023-09-01,BLR,Pahang,0,0,0
2023-09-01,BLR,Perak,0,0,0
2023-09-01,BLR,Perlis,1,0,1
2023-09-01,BLR,Pulau Pinang,11,7,4
2023-09-01,BLR,Sabah,1,0,1
2023-09-01,BLR,Sarawak,5,3,2
2023-09-01,BLR,Selangor,311,156,155
2023-09-01,BLR,W.P. Labuan,0,0,0
2023-09-01,BLZ,Johor,0,0,0
2023-09-01,BLZ,Pulau Pinang,1,1,0
2023-09-01,BLZ,Sarawak,0,0,0
2023-09-01,BLZ,Selangor,8,2,6
2023-09-01,BMU,Selangor,0,0,0
2023-09-01,BOL,Johor,4,3,1
2023-09-01,BOL,Kedah,0,0,0
2023-09-01,BOL,Melaka,0,0,0
2023-09-01,BOL,Perak,0,0,0
2023-09-01,BOL,Perlis,0,0,0
2023-09-01,BOL,Pulau Pinang,0,0,0
2023-09-01,BOL,Sabah,0,0,0
2023-09-01,BOL,Sarawak,1,1,0
2023-09-01,BOL,Selangor,16,7,9
2023-09-01,BRA,Johor,278,177,101
2023-09-01,BRA,Kedah,35,18,17
2023-09-01,BRA,Kelantan,0,0,0
2023-09-01,BRA,Melaka,0,0,0
2023-09-01,BRA,Pahang,1,0,1
2023-09-01,BRA,Perak,1,1,0
2023-09-01,BRA,Perlis,3,2,1
2023-09-01,BRA,Pulau Pinang,23,14,9
2023-09-01,BRA,Sabah,2,2,0
2023-09-01,BRA,Sarawak,10,3,7
2023-09-01,BRA,Selangor,986,590,396
2023-09-01,BRA,W.P. Labuan,0,0,0
2023-09-01,BRB,Johor,2,0,2
2023-09-01,BRB,Kedah,0,0,0
2023-09-01,BRB,Perlis,0,0,0
2023-09-01,BRB,Pulau Pinang,0,0,0
2023-09-01,BRB,Selangor,7,3,4
2023-09-01,BRN,Johor,423,220,203
2023-09-01,BRN,Kedah,36,16,20
2023-09-01,BRN,Kelantan,5,3,2
2023-09-01,BRN,Melaka,0,0,0
2023-09-01,BRN,Pahang,0,0,0
2023-09-01,BRN,Perak,9,5,4
2023-09-01,BRN,Perlis,23,13,10
2023-09-01,BRN,Pulau Pinang,10,3,7
2023-09-01,BRN,Sabah,148,62,86
2023-09-01,BRN,Sarawak,63606,35362,28244
2023-09-01,BRN,Selangor,5412,2668,2744
2023-09-01,BRN,W.P. Labuan,1036,719,317
2023-09-01,BTN,Johor,3,3,0
2023-09-01,BTN,Kedah,0,0,0
2023-09-01,BTN,Perak,0,0,0
2023-09-01,BTN,Perlis,1,0,1
2023-09-01,BTN,Pulau Pinang,4,4,0
2023-09-01,BTN,Sabah,0,0,0
2023-09-01,BTN,Sarawak,0,0,0
2023-09-01,BTN,Selangor,87,49,38
2023-09-01,BWA,Johor,6,4,2
2023-09-01,BWA,Kedah,1,1,0
2023-09-01,BWA,Perlis,0,0,0
2023-09-01,BWA,Pulau Pinang,0,0,0
2023-09-01,BWA,Sabah,0,0,0
2023-09-01,BWA,Sarawak,0,0,0
2023-09-01,BWA,Selangor,67,17,50
2023-09-01,CAF,Kedah,1,0,1
2023-09-01,CAF,Selangor,1,0,1
2023-09-01,CAN,Johor,1277,754,523
2023-09-01,CAN,Kedah,93,53,40
2023-09-01,CAN,Kelantan,0,0,0
2023-09-01,CAN,Melaka,3,1,2
2023-09-01,CAN,Negeri Sembilan,1,1,0
2023-09-01,CAN,Pahang,4,4,0
2023-09-01,CAN,Perak,17,8,9
2023-09-01,CAN,Perlis,27,18,9
2023-09-01,CAN,Pulau Pinang,389,223,166
2023-09-01,CAN,Sabah,18,7,11
2023-09-01,CAN,Sarawak,206,116,90
2023-09-01,CAN,Selangor,3998,2372,1626
2023-09-01,CAN,Terengganu,0,0,0
2023-09-01,CAN,W.P. Labuan,2,1,1
2023-09-01,CCK,Selangor,0,0,0
2023-09-01,CHE,Johor,383,219,164
2023-09-01,CHE,Kedah,63,33,30
2023-09-01,CHE,Kelantan,1,1,0
2023-09-01,CHE,Melaka,0,0,0
2023-09-01,CHE,Negeri Sembilan,0,0,0
2023-09-01,CHE,Pahang,0,0,0
2023-09-01,CHE,Perak,1,1,0
2023-09-01,CHE,Perlis,19,12,7
2023-09-01,CHE,Pulau Pinang,102,70,32
2023-09-01,CHE,Sabah,8,4,4
2023-09-01,CHE,Sarawak,34,20,14
2023-09-01,CHE,Selangor,1360,846,514
2023-09-01,CHE,W.P. Labuan,1,1,0
2023-09-01,CHL,Johor,41,19,22
2023-09-01,CHL,Kedah,8,4,4
2023-09-01,CHL,Kelantan,1,1,0
2023-09-01,CHL,Melaka,0,0,0
2023-09-01,CHL,Pahang,0,0,0
2023-09-01,CHL,Perak,0,0,0
2023-09-01,CHL,Perlis,6,5,1
2023-09-01,CHL,Pulau Pinang,4,4,0
2023-09-01,CHL,Sabah,1,1,0
2023-09-01,CHL,Sarawak,2,2,0
2023-09-01,CHL,Selangor,249,124,125
2023-09-01,CHN,Johor,49921,21544,28377
2023-09-01,CHN,Kedah,975,398,577
2023-09-01,CHN,Kelantan,3,1,2
2023-09-01,CHN,Melaka,2,1,1
2023-09-01,CHN,Pahang,75,42,33
2023-09-01,CHN,Perak,203,88,115
2023-09-01,CHN,Perlis,73,40,33
2023-09-01,CHN,Pulau Pinang,8074,4341,3733
2023-09-01,CHN,Sabah,2008,929,1079
2023-09-01,CHN,Sarawak,1023,582,441
2023-09-01,CHN,Selangor,109565,54338,55227
2023-09-01,CHN,Terengganu,0,0,0
2023-09-01,CHN,W.P. Labuan,49,40,9
2023-09-01,CIV,Johor,1,0,1
2023-09-01,CIV,Kedah,0,0,0
2023-09-01,CIV,Pulau Pinang,0,0,0
2023-09-01,CIV,Sabah,0,0,0
2023-09-01,CIV,Sarawak,0,0,0
2023-09-01,CIV,Selangor,66,53,13
2023-09-01,CMR,Johor,1,1,0
2023-09-01,CMR,Kedah,0,0,0
2023-09-01,CMR,Pulau Pinang,1,1,0
2023-09-01,CMR,Sabah,0,0,0
2023-09-01,CMR,Sarawak,1,1,0
2023-09-01,CMR,Selangor,77,61,16
2023-09-01,COD,Johor,1,1,0
2023-09-01,COD,Pulau Pinang,0,0,0
2023-09-01,COD,Sarawak,0,0,0
2023-09-01,COD,Selangor,18,12,6
2023-09-01,COG,Johor,0,0,0
2023-09-01,COG,Kedah,0,0,0
2023-09-01,COG,Selangor,18,11,7
2023-09-01,COK,Selangor,0,0,0
2023-09-01,COL,Johor,26,13,13
2023-09-01,COL,Kedah,0,0,0
2023-09-01,COL,Perak,0,0,0
2023-09-01,COL,Pulau Pinang,8,4,4
2023-09-01,COL,Sabah,0,0,0
2023-09-01,COL,Sarawak,1,1,0
2023-09-01,COL,Selangor,394,225,169
2023-09-01,COL,W.P. Labuan,0,0,0
2023-09-01,COM,Johor,0,0,0
2023-09-01,COM,Kedah,0,0,0
2023-09-01,COM,Selangor,37,26,11
2023-09-01,CPV,Johor,0,0,0
2023-09-01,CPV,Kedah,0,0,0
2023-09-01,CPV,Pulau Pinang,0,0,0
2023-09-01,CPV,Sabah,0,0,0
2023-09-01,CPV,Selangor,1,0,1
2023-09-01,CRI,Johor,11,6,5
2023-09-01,CRI,Kedah,0,0,0
2023-09-01,CRI,Perak,0,0,0
2023-09-01,CRI,Perlis,0,0,0
2023-09-01,CRI,Pulau Pinang,3,2,1
2023-09-01,CRI,Sabah,2,2,0
2023-09-01,CRI,Sarawak,1,1,0
2023-09-01,CRI,Selangor,77,41,36
2023-09-01,CUB,Johor,1,0,1
2023-09-01,CUB,Kedah,1,1,0
2023-09-01,CUB,Perlis,0,0,0
2023-09-01,CUB,Pulau Pinang,0,0,0
2023-09-01,CUB,Sabah,1,1,0
2023-09-01,CUB,Sarawak,0,0,0
2023-09-01,CUB,Selangor,22,10,12
2023-09-01,CYP,Johor,11,6,5
2023-09-01,CYP,Kedah,1,1,0
2023-09-01,CYP,Perak,0,0,0
2023-09-01,CYP,Perlis,0,0,0
2023-09-01,CYP,Pulau Pinang,1,1,0
2023-09-01,CYP,Sabah,0,0,0
2023-09-01,CYP,Sarawak,0,0,0
2023-09-01,CYP,Selangor,69,51,18
2023-09-01,CZE,Johor,106,56,50
2023-09-01,CZE,Kedah,10,6,4
2023-09-01,CZE,Kelantan,0,0,0
2023-09-01,CZE,Melaka,0,0,0
2023-09-01,CZE,Negeri Sembilan,0,0,0
2023-09-01,CZE,Perak,0,0,0
2023-09-01,CZE,Perlis,5,5,0
2023-09-01,CZE,Pulau Pinang,13,8,5
2023-09-01,CZE,Sabah,1,0,1
2023-09-01,CZE,Sarawak,24,12,12
2023-09-01,CZE,Selangor,423,258,165
2023-09-01,CZE,W.P. Labuan,0,0,0
2023-09-01,DEU,Johor,2433,1493,940
2023-09-01,DEU,Kedah,322,179,143
2023-09-01,DEU,Kelantan,12,9,3
2023-09-01,DEU,Melaka,3,1,2
2023-09-01,DEU,Negeri Sembilan,3,2,1
2023-09-01,DEU,Pahang,3,2,1
2023-09-01,DEU,Perak,21,17,4
2023-09-01,DEU,Perlis,71,46,25
2023-09-01,DEU,Pulau Pinang,615,442,173
2023-09-01,DEU,Sabah,35,20,15
2023-09-01,DEU,Sarawak,240,141,99
2023-09-01,DEU,Selangor,7620,4619,3001
2023-09-01,DEU,Terengganu,0,0,0
2023-09-01,DEU,W.P. Labuan,3,2,1
2023-09-01,DJI,Johor,1,1,0
2023-09-01,DJI,Selangor,12,8,4
2023-09-01,DMA,Johor,6,5,1
2023-09-01,DMA,Kedah,0,0,0
2023-09-01,DMA,Pulau Pinang,2,1,1
2023-09-01,DMA,Sabah,0,0,0
2023-09-01,DMA,Sarawak,0,0,0
2023-09-01,DMA,Selangor,62,49,13
2023-09-01,DMA,W.P. Labuan,0,0,0
2023-09-01,DNK,Johor,343,243,100
2023-09-01,DNK,Kedah,16,9,7
2023-09-01,DNK,Kelantan,0,0,0
2023-09-01,DNK,Melaka,1,1,0
2023-09-01,DNK,Negeri Sembilan,0,0,0
2023-09-01,DNK,Pahang,0,0,0
2023-09-01,DNK,Perak,1,1,0
2023-09-01,DNK,Perlis,5,2,3
2023-09-01,DNK,Pulau Pinang,45,33,12
2023-09-01,DNK,Sabah,7,3,4
2023-09-01,DNK,Sarawak,11,7,4
2023-09-01,DNK,Selangor,847,529,318
2023-09-01,DNK,W.P. Labuan,6,1,5
2023-09-01,DOM,Johor,7,3,4
2023-09-01,DOM,Kedah,1,0,1
2023-09-01,DOM,Perak,0,0,0
2023-09-01,DOM,Perlis,0,0,0
2023-09-01,DOM,Pulau Pinang,1,1,0
2023-09-01,DOM,Sabah,0,0,0
2023-09-01,DOM,Sarawak,0,0,0
2023-09-01,DOM,Selangor,27,10,17
2023-09-01,DZA,Johor,80,49,31
2023-09-01,DZA,Kedah,5,4,1
2023-09-01,DZA,Kelantan,0,0,0
2023-09-01,DZA,Melaka,0,0,0
2023-09-01,DZA,Perak,1,0,1
2023-09-01,DZA,Perlis,2,2,0
2023-09-01,DZA,Pulau Pinang,0,0,0
2023-09-01,DZA,Sabah,3,0,3
2023-09-01,DZA,Sarawak,3,3,0
2023-09-01,DZA,Selangor,1622,1014,608
2023-09-01,DZA,W.P. Labuan,0,0,0
2023-09-01,ECU,Johor,16,6,10
2023-09-01,ECU,Kedah,0,0,0
2023-09-01,ECU,Perak,0,0,0
2023-09-01,ECU,Perlis,0,0,0
2023-09-01,ECU,Pulau Pinang,4,3,1
2023-09-01,ECU,Sabah,0,0,0
2023-09-01,ECU,Sarawak,0,0,0
2023-09-01,ECU,Selangor,128,58,70
2023-09-01,EGY,Johor,221,175,46
2023-09-01,EGY,Kedah,9,7,2
2023-09-01,EGY,Kelantan,2,1,1
2023-09-01,EGY,Melaka,0,0,0
2023-09-01,EGY,Pahang,0,0,0
2023-09-01,EGY,Perak,0,0,0
2023-09-01,EGY,Perlis,0,0,0
2023-09-01,EGY,Pulau Pinang,15,12,3
2023-09-01,EGY,Sabah,0,0,0
2023-09-01,EGY,Sarawak,91,56,35
2023-09-01,EGY,Selangor,2310,1543,767
2023-09-01,EGY,Terengganu,0,0,0
2023-09-01,EGY,W.P. Labuan,0,0,0
2023-09-01,ERI,Johor,0,0,0
2023-09-01,ERI,Pulau Pinang,0,0,0
2023-09-01,ERI,Sabah,0,0,0
2023-09-01,ERI,Selangor,21,10,11
2023-09-01,ESP,Johor,683,410,273
2023-09-01,ESP,Kedah,56,33,23
2023-09-01,ESP,Kelantan,3,2,1
2023-09-01,ESP,Melaka,0,0,0
2023-09-01,ESP,Negeri Sembilan,0,0,0
2023-09-01,ESP,Pahang,0,0,0
2023-09-01,ESP,Perak,6,3,3
2023-09-01,ESP,Perlis,16,11,5
2023-09-01,ESP,Pulau Pinang,151,82,69
2023-09-01,ESP,Sabah,18,9,9
2023-09-01,ESP,Sarawak,66,43,23
2023-09-01,ESP,Selangor,4142,2211,1931
2023-09-01,ESP,W.P. Labuan,1,0,1
2023-09-01,EST,Johor,21,12,9
2023-09-01,EST,Kedah,4,0,4
2023-09-01,EST,Kelantan,1,0,1
2023-09-01,EST,Pahang,0,0,0
2023-09-01,EST,Perak,0,0,0
2023-09-01,EST,Perlis,1,1,0
2023-09-01,EST,Pulau Pinang,0,0,0
2023-09-01,EST,Sabah,0,0,0
2023-09-01,EST,Sarawak,1,0,1
2023-09-01,EST,Selangor,120,81,39
2023-09-01,EST,W.P. Labuan,0,0,0
2023-09-01,ETH,Johor,2,2,0
2023-09-01,ETH,Kedah,0,0,0
2023-09-01,ETH,Pulau Pinang,1,1,0
2023-09-01,ETH,Sarawak,0,0,0
2023-09-01,ETH,Selangor,48,27,21
2023-09-01,FIN,Johor,164,94,70
2023-09-01,FIN,Kedah,13,4,9
2023-09-01,FIN,Kelantan,0,0,0
2023-09-01,FIN,Melaka,0,0,0
2023-09-01,FIN,Negeri Sembilan,0,0,0
2023-09-01,FIN,Pahang,0,0,0
2023-09-01,FIN,Perak,5,3,2
2023-09-01,FIN,Perlis,4,3,1
2023-09-01,FIN,Pulau Pinang,35,26,9
2023-09-01,FIN,Sabah,1,1,0
2023-09-01,FIN,Sarawak,3,3,0
2023-09-01,FIN,Selangor,358,237,121
2023-09-01,FIN,W.P. Labuan,0,0,0
2023-09-01,FJI,Johor,133,67,66
2023-09-01,FJI,Kedah,4,1,3
2023-09-01,FJI,Kelantan,1,1,0
2023-09-01,FJI,Perak,1,1,0
2023-09-01,FJI,Perlis,0,0,0
2023-09-01,FJI,Pulau Pinang,0,0,0
2023-09-01,FJI,Sabah,0,0,0
2023-09-01,FJI,Sarawak,0,0,0
2023-09-01,FJI,Selangor,186,104,82
2023-09-01,FRA,Johor,1795,1076,719
2023-09-01,FRA,Kedah,171,99,72
2023-09-01,FRA,Kelantan,8,6,2
2023-09-01,FRA,Melaka,10,4,6
2023-09-01,FRA,Negeri Sembilan,4,2,2
2023-09-01,FRA,Pahang,11,7,4
2023-09-01,FRA,Perak,18,10,8
2023-09-01,FRA,Perlis,69,47,22
2023-09-01,FRA,Pulau Pinang,267,191,76
2023-09-01,FRA,Sabah,23,15,8
2023-09-01,FRA,Sarawak,88,55,33
2023-09-01,FRA,Selangor,7963,4633,3330
2023-09-01,FRA,Terengganu,1,1,0
2023-09-01,FRA,W.P. Labuan,2,0,2
2023-09-01,FSM,Johor,0,0,0
2023-09-01,FSM,Pulau Pinang,0,0,0
2023-09-01,FSM,Selangor,1,1,0
2023-09-01,GAB,Johor,1,0,1
2023-09-01,GAB,Pulau Pinang,1,1,0
2023-09-01,GAB,Sarawak,0,0,0
2023-09-01,GAB,Selangor,41,37,4
2023-09-01,GBR,Johor,4488,2942,1546
2023-09-01,GBR,Kedah,480,284,196
2023-09-01,GBR,Kelantan,14,10,4
2023-09-01,GBR,Melaka,2,2,0
2023-09-01,GBR,Negeri Sembilan,1,1,0
2023-09-01,GBR,Pahang,20,16,4
2023-09-01,GBR,Perak,99,55,44
2023-09-01,GBR,Perlis,113,72,41
2023-09-01,GBR,Pulau Pinang,1275,821,454
2023-09-01,GBR,Sabah,146,65,81
2023-09-01,GBR,Sarawak,831,546,285
2023-09-01,GBR,Selangor,16130,10041,6089
2023-09-01,GBR,Terengganu,0,0,0
2023-09-01,GBR,W.P. Labuan,29,24,5
2023-09-01,GEO,Johor,1,1,0
2023-09-01,GEO,Kedah,1,0,1
2023-09-01,GEO,Melaka,0,0,0
2023-09-01,GEO,Perak,0,0,0
2023-09-01,GEO,Perlis,0,0,0
2023-09-01,GEO,Pulau Pinang,4,2,2
2023-09-01,GEO,Sabah,0,0,0
2023-09-01,GEO,Sarawak,1,0,1
2023-09-01,GEO,Selangor,72,46,26
2023-09-01,GHA,Johor,12,11,1
2023-09-01,GHA,Kedah,0,0,0
2023-09-01,GHA,Kelantan,0,0,0
2023-09-01,GHA,Pulau Pinang,8,3,5
2023-09-01,GHA,Sabah,0,0,0
2023-09-01,GHA,Sarawak,0,0,0
2023-09-01,GHA,Selangor,106,83,23
2023-09-01,GIB,Johor,0,0,0
2023-09-01,GIB,Sarawak,0,0,0
2023-09-01,GIN,Johor,2,1,1
2023-09-01,GIN,Kedah,2,2,0
2023-09-01,GIN,Kelantan,0,0,0
2023-09-01,GIN,Perlis,0,0,0
2023-09-01,GIN,Pulau Pinang,0,0,0
2023-09-01,GIN,Sabah,0,0,0
2023-09-01,GIN,Sarawak,1,1,0
2023-09-01,GIN,Selangor,78,55,23
2023-09-01,GLP,Selangor,0,0,0
2023-09-01,GMB,Johor,4,4,0
2023-09-01,GMB,Kedah,0,0,0
2023-09-01,GMB,Kelantan,0,0,0
2023-09-01,GMB,Pulau Pinang,0,0,0
2023-09-01,GMB,Sabah,1,1,0
2023-09-01,GMB,Sarawak,0,0,0
2023-09-01,GMB,Selangor,23,14,9
2023-09-01,GNB,Johor,0,0,0
2023-09-01,GNB,Selangor,1,1,0
2023-09-01,GNQ,Johor,0,0,0
2023-09-01,GNQ,Selangor,0,0,0
2023-09-01,GRC,Johor,50,38,12
2023-09-01,GRC,Kedah,5,2,3
2023-09-01,GRC,Kelantan,0,0,0
2023-09-01,GRC,Melaka,0,0,0
2023-09-01,GRC,Negeri Sembilan,0,0,0
2023-09-01,GRC,Pahang,0,0,0
2023-09-01,GRC,Perak,1,1,0
2023-09-01,GRC,Perlis,1,0,1
2023-09-01,GRC,Pulau Pinang,10,9,1
2023-09-01,GRC,Sabah,0,0,0
2023-09-01,GRC,Sarawak,5,4,1
2023-09-01,GRC,Selangor,226,180,46
2023-09-01,GRD,Johor,8,4,4
2023-09-01,GRD,Kedah,0,0,0
2023-09-01,GRD,Pulau Pinang,1,1,0
2023-09-01,GRD,Sabah,0,0,0
2023-09-01,GRD,Sarawak,0,0,0
2023-09-01,GRD,Selangor,5,5,0
2023-09-01,GRL,Johor,0,0,0
2023-09-01,GRL,Selangor,1,0,1
2023-09-01,GTM,Johor,3,3,0
2023-09-01,GTM,Kedah,0,0,0
2023-09-01,GTM,Pahang,0,0,0
2023-09-01,GTM,Perak,0,0,0
2023-09-01,GTM,Pulau Pinang,0,0,0
2023-09-01,GTM,Sabah,0,0,0
2023-09-01,GTM,Sarawak,0,0,0
2023-09-01,GTM,Selangor,60,25,35
2023-09-01,GTM,W.P. Labuan,0,0,0
2023-09-01,GUY,Johor,0,0,0
2023-09-01,GUY,Kedah,0,0,0
2023-09-01,GUY,Pulau Pinang,0,0,0
2023-09-01,GUY,Sarawak,0,0,0
2023-09-01,GUY,Selangor,7,5,2
2023-09-01,HKG,Johor,9,3,6
2023-09-01,HKG,Kedah,0,0,0
2023-09-01,HKG,Kelantan,0,0,0
2023-09-01,HKG,Pahang,4,1,3
2023-09-01,HKG,Perak,35,21,14
2023-09-01,HKG,Perlis,0,0,0
2023-09-01,HKG,Pulau Pinang,0,0,0
2023-09-01,HKG,Sabah,0,0,0
2023-09-01,HKG,Sarawak,0,0,0
2023-09-01,HKG,Selangor,66,24,42
2023-09-01,HKG,Terengganu,0,0,0
2023-09-01,HMD,Johor,0,0,0
2023-09-01,HND,Johor,8,6,2
2023-09-01,HND,Kedah,1,1,0
2023-09-01,HND,Perak,0,0,0
2023-09-01,HND,Pulau Pinang,0,0,0
2023-09-01,HND,Sabah,0,0,0
2023-09-01,HND,Sarawak,2,0,2
2023-09-01,HND,Selangor,19,14,5
2023-09-01,HRV,Johor,57,43,14
2023-09-01,HRV,Kedah,0,0,0
2023-09-01,HRV,Kelantan,0,0,0
2023-09-01,HRV,Melaka,0,0,0
2023-09-01,HRV,Pahang,1,1,0
2023-09-01,HRV,Perak,0,0,0
2023-09-01,HRV,Perlis,0,0,0
2023-09-01,HRV,Pulau Pinang,6,5,1
2023-09-01,HRV,Sabah,2,0,2
2023-09-01,HRV,Sarawak,0,0,0
2023-09-01,HRV,Selangor,124,87,37
2023-09-01,HTI,Johor,0,0,0
2023-09-01,HTI,Kedah,0,0,0
2023-09-01,HTI,Kelantan,0,0,0
2023-09-01,HTI,Perak,0,0,0
2023-09-01,HTI,Pulau Pinang,0,0,0
2023-09-01,HTI,Sabah,0,0,0
2023-09-01,HTI,Selangor,16,10,6
2023-09-01,HUN,Johor,77,48,29
2023-09-01,HUN,Kedah,12,7,5
2023-09-01,HUN,Kelantan,0,0,0
2023-09-01,HUN,Pahang,0,0,0
2023-09-01,HUN,Perak,0,0,0
2023-09-01,HUN,Perlis,1,1,0
2023-09-01,HUN,Pulau Pinang,16,10,6
2023-09-01,HUN,Sabah,4,2,2
2023-09-01,HUN,Sarawak,3,2,1
2023-09-01,HUN,Selangor,370,208,162
2023-09-01,HUN,W.P. Labuan,0,0,0
2023-09-01,IDN,Johor,95529,44431,51098
2023-09-01,IDN,Kedah,5260,1990,3270
2023-09-01,IDN,Kelantan,171,119,52
2023-09-01,IDN,Melaka,4156,1828,2328
2023-09-01,IDN,Negeri Sembilan,6028,3861,2167
2023-09-01,IDN,Pahang,26,15,11
2023-09-01,IDN,Perak,236,86,150
2023-09-01,IDN,Perlis,604,232,372
2023-09-01,IDN,Pulau Pinang,37833,15124,22709
2023-09-01,IDN,Sabah,4175,2070,2105
2023-09-01,IDN,Sarawak,35887,18905,16982
2023-09-01,IDN,Selangor,118926,56501,62425
2023-09-01,IDN,Terengganu,0,0,0
2023-09-01,IDN,W.P. Labuan,53,34,19
2023-09-01,IND,Johor,28112,18909,9203
2023-09-01,IND,Kedah,1275,695,580
2023-09-01,IND,Kelantan,4,3,1
2023-09-01,IND,Melaka,3,3,0
2023-09-01,IND,Negeri Sembilan,1,1,0
2023-09-01,IND,Pahang,12,9,3
2023-09-01,IND,Perak,207,131,76
2023-09-01,IND,Perlis,25,16,9
2023-09-01,IND,Pulau Pinang,4007,3060,947
2023-09-01,IND,Sabah,85,67,18
2023-09-01,IND,Sarawak,1094,922,172
2023-09-01,IND,Selangor,63166,45168,17998
2023-09-01,IND,Terengganu,0,0,0
2023-09-01,IND,W.P. Labuan,42,39,3
2023-09-01,IOT,Pulau Pinang,0,0,0
2023-09-01,IOT,Selangor,0,0,0
2023-09-01,IRL,Johor,233,152,81
2023-09-01,IRL,Kedah,46,23,23
2023-09-01,IRL,Kelantan,0,0,0
2023-09-01,IRL,Negeri Sembilan,0,0,0
2023-09-01,IRL,Pahang,5,2,3
2023-09-01,IRL,Perak,7,5,2
2023-09-01,IRL,Perlis,9,7,2
2023-09-01,IRL,Pulau Pinang,98,61,37
2023-09-01,IRL,Sabah,4,2,2
2023-09-01,IRL,Sarawak,41,24,17
2023-09-01,IRL,Selangor,1618,1003,615
2023-09-01,IRL,Terengganu,0,0,0
2023-09-01,IRL,W.P. Labuan,0,0,0
2023-09-01,IRN,Johor,532,259,273
2023-09-01,IRN,Kedah,30,15,15
2023-09-01,IRN,Kelantan,0,0,0
2023-09-01,IRN,Perak,0,0,0
2023-09-01,IRN,Perlis,3,1,2
2023-09-01,IRN,Pulau Pinang,7,7,0
2023-09-01,IRN,Sabah,0,0,0
2023-09-01,IRN,Sarawak,3,2,1
2023-09-01,IRN,Selangor,2890,1498,1392
2023-09-01,IRN,W.P. Labuan,0,0,0
2023-09-01,IRQ,Johor,68,43,25
2023-09-01,IRQ,Kedah,5,5,0
2023-09-01,IRQ,Kelantan,0,0,0
2023-09-01,IRQ,Melaka,0,0,0
2023-09-01,IRQ,Pahang,1,1,0
2023-09-01,IRQ,Perak,0,0,0
2023-09-01,IRQ,Perlis,0,0,0
2023-09-01,IRQ,Pulau Pinang,0,0,0
2023-09-01,IRQ,Sabah,1,0,1
2023-09-01,IRQ,Sarawak,3,1,2
2023-09-01,IRQ,Selangor,1510,1030,480
2023-09-01,ISL,Johor,4,2,2
2023-09-01,ISL,Kedah,0,0,0
2023-09-01,ISL,Kelantan,0,0,0
2023-09-01,ISL,Perak,0,0,0
2023-09-01,ISL,Perlis,0,0,0
2023-09-01,ISL,Pulau Pinang,1,0,1
2023-09-01,ISL,Sabah,0,0,0
2023-09-01,ISL,Sarawak,0,0,0
2023-09-01,ISL,Selangor,20,12,8
2023-09-01,ISL,W.P. Labuan,0,0,0
2023-09-01,ISR,Pulau Pinang,0,0,0
2023-09-01,ITA,Johor,596,414,182
2023-09-01,ITA,Kedah,41,24,17
2023-09-01,ITA,Kelantan,3,2,1
2023-09-01,ITA,Melaka,0,0,0
2023-09-01,ITA,Negeri Sembilan,0,0,0
2023-09-01,ITA,Pahang,0,0,0
2023-09-01,ITA,Perak,5,4,1
2023-09-01,ITA,Perlis,11,8,3
2023-09-01,ITA,Pulau Pinang,97,74,23
2023-09-01,ITA,Sabah,7,3,4
2023-09-01,ITA,Sarawak,56,38,18
2023-09-01,ITA,Selangor,3501,2237,1264
2023-09-01,ITA,W.P. Labuan,2,2,0
2023-09-01,JAM,Johor,2,1,1
2023-09-01,JAM,Kedah,0,0,0
2023-09-01,JAM,Perak,0,0,0
2023-09-01,JAM,Pulau Pinang,3,1,2
2023-09-01,JAM,Sabah,0,0,0
2023-09-01,JAM,Sarawak,3,2,1
2023-09-01,JAM,Selangor,13,8,5
2023-09-01,JAM,W.P. Labuan,0,0,0
2023-09-01,JOR,Johor,23,15,8
2023-09-01,JOR,Kedah,10,2,8
2023-09-01,JOR,Kelantan,0,0,0
2023-09-01,JOR,Melaka,0,0,0
2023-09-01,JOR,Perlis,0,0,0
2023-09-01,JOR,Pulau Pinang,11,6,5
2023-09-01,JOR,Sabah,1,1,0
2023-09-01,JOR,Sarawak,0,0,0
2023-09-01,JOR,Selangor,1129,695,434
2023-09-01,JOR,W.P. Labuan,0,0,0
2023-09-01,JPN,Johor,6653,4460,2193
2023-09-01,JPN,Kedah,160,98,62
2023-09-01,JPN,Kelantan,8,5,3
2023-09-01,JPN,Melaka,3,3,0
2023-09-01,JPN,Negeri Sembilan,0,0,0
2023-09-01,JPN,Pahang,5,5,0
2023-09-01,JPN,Perak,44,30,14
2023-09-01,JPN,Perlis,98,78,20
2023-09-01,JPN,Pulau Pinang,1378,972,406
2023-09-01,JPN,Sabah,94,46,48
2023-09-01,JPN,Sarawak,204,145,59
2023-09-01,JPN,Selangor,23590,14379,9211
2023-09-01,JPN,W.P. Labuan,14,11,3
2023-09-01,KAZ,Johor,52,19,33
2023-09-01,KAZ,Kedah,6,1,5
2023-09-01,KAZ,Kelantan,1,1,0
2023-09-01,KAZ,Melaka,0,0,0
2023-09-01,KAZ,Perak,0,0,0
2023-09-01,KAZ,Perlis,1,0,1
2023-09-01,KAZ,Pulau Pinang,10,5,5
2023-09-01,KAZ,Sabah,0,0,0
2023-09-01,KAZ,Sarawak,7,1,6
2023-09-01,KAZ,Selangor,831,365,466
2023-09-01,KAZ,W.P. Labuan,0,0,0
2023-09-01,KEN,Johor,52,31,21
2023-09-01,KEN,Kedah,8,3,5
2023-09-01,KEN,Kelantan,0,0,0
2023-09-01,KEN,Perak,0,0,0
2023-09-01,KEN,Perlis,1,0,1
2023-09-01,KEN,Pulau Pinang,1,0,1
2023-09-01,KEN,Sabah,0,0,0
2023-09-01,KEN,Sarawak,3,2,1
2023-09-01,KEN,Selangor,560,285,275
2023-09-01,KGZ,Johor,38,31,7
2023-09-01,KGZ,Kedah,3,2,1
2023-09-01,KGZ,Kelantan,0,0,0
2023-09-01,KGZ,Perak,0,0,0
2023-09-01,KGZ,Perlis,0,0,0
2023-09-01,KGZ,Pulau Pinang,4,2,2
2023-09-01,KGZ,Sabah,0,0,0
2023-09-01,KGZ,Sarawak,0,0,0
2023-09-01,KGZ,Selangor,236,123,113
2023-09-01,KHM,Johor,1706,696,1010
2023-09-01,KHM,Kedah,104,46,58
2023-09-01,KHM,Kelantan,430,246,184
2023-09-01,KHM,Melaka,0,0,0
2023-09-01,KHM,Negeri Sembilan,0,0,0
2023-09-01,KHM,Pahang,0,0,0
2023-09-01,KHM,Perak,15,2,13
2023-09-01,KHM,Perlis,718,409,309
2023-09-01,KHM,Pulau Pinang,54,31,23
2023-09-01,KHM,Sabah,1,0,1
2023-09-01,KHM,Sarawak,12,4,8
2023-09-01,KHM,Selangor,3519,1681,1838
2023-09-01,KHM,W.P. Labuan,0,0,0
2023-09-01,KIR,Johor,0,0,0
2023-09-01,KIR,Sabah,0,0,0
2023-09-01,KIR,Selangor,1,1,0
2023-09-01,KNA,Johor,17,11,6
2023-09-01,KNA,Kedah,6,5,1
2023-09-01,KNA,Perlis,0,0,0
2023-09-01,KNA,Pulau Pinang,6,4,2
2023-09-01,KNA,Sabah,0,0,0
2023-09-01,KNA,Selangor,62,44,18
2023-09-01,KNA,W.P. Labuan,0,0,0
2023-09-01,KOR,Johor,9916,5561,4355
2023-09-01,KOR,Kedah,160,83,77
2023-09-01,KOR,Kelantan,8,6,2
2023-09-01,KOR,Melaka,2,2,0
2023-09-01,KOR,Negeri Sembilan,0,0,0
2023-09-01,KOR,Pahang,7,3,4
2023-09-01,KOR,Perak,16,10,6
2023-09-01,KOR,Perlis,61,47,14
2023-09-01,KOR,Pulau Pinang,464,279,185
2023-09-01,KOR,Sabah,450,196,254
2023-09-01,KOR,Sarawak,219,134,85
2023-09-01,KOR,Selangor,14842,8207,6635
2023-09-01,KOR,Terengganu,0,0,0
2023-09-01,KOR,W.P. Labuan,6,5,1
2023-09-01,KWT,Johor,34,19,15
2023-09-01,KWT,Kedah,6,2,4
2023-09-01,KWT,Kelantan,0,0,0
2023-09-01,KWT,Perak,0,0,0
2023-09-01,KWT,Perlis,0,0,0
2023-09-01,KWT,Pulau Pinang,8,3,5
2023-09-01,KWT,Sabah,0,0,0
2023-09-01,KWT,Sarawak,1,1,0
2023-09-01,KWT,Selangor,782,417,365
2023-09-01,KWT,W.P. Labuan,0,0,0
2023-09-01,LAO,Johor,198,60,138
2023-09-01,LAO,Kedah,773,47,726
2023-09-01,LAO,Kelantan,188,21,167
2023-09-01,LAO,Melaka,0,0,0
2023-09-01,LAO,Perak,36,2,34
2023-09-01,LAO,Perlis,420,69,351
2023-09-01,LAO,Pulau Pinang,13,7,6
2023-09-01,LAO,Sabah,0,0,0
2023-09-01,LAO,Sarawak,13,10,3
2023-09-01,LAO,Selangor,324,127,197
2023-09-01,LAO,W.P. Labuan,0,0,0
2023-09-01,LBN,Johor,16,12,4
2023-09-01,LBN,Kedah,0,0,0
2023-09-01,LBN,Kelantan,0,0,0
2023-09-01,LBN,Pahang,0,0,0
2023-09-01,LBN,Perak,0,0,0
2023-09-01,LBN,Perlis,0,0,0
2023-09-01,LBN,Pulau Pinang,1,1,0
2023-09-01,LBN,Sabah,0,0,0
2023-09-01,LBN,Sarawak,4,4,0
2023-09-01,LBN,Selangor,317,196,121
2023-09-01,LBN,W.P. Labuan,0,0,0
2023-09-01,LBR,Johor,1,1,0
2023-09-01,LBR,Kedah,1,1,0
2023-09-01,LBR,Sabah,0,0,0
2023-09-01,LBR,Sarawak,0,0,0
2023-09-01,LBR,Selangor,8,8,0
2023-09-01,LBY,Johor,7,4,3
2023-09-01,LBY,Kedah,1,1,0
2023-09-01,LBY,Perlis,1,1,0
2023-09-01,LBY,Pulau Pinang,0,0,0
2023-09-01,LBY,Sabah,0,0,0
2023-09-01,LBY,Sarawak,0,0,0
2023-09-01,LBY,Selangor,669,464,205
2023-09-01,LCA,Johor,10,8,2
2023-09-01,LCA,Kedah,0,0,0
2023-09-01,LCA,Pulau Pinang,0,0,0
2023-09-01,LCA,Sarawak,0,0,0
2023-09-01,LCA,Selangor,16,11,5
2023-09-01,LIE,Johor,1,1,0
2023-09-01,LIE,Kedah,0,0,0
2023-09-01,LIE,Perlis,0,0,0
2023-09-01,LIE,Pulau Pinang,0,0,0
2023-09-01,LIE,Sabah,0,0,0
2023-09-01,LIE,Sarawak,0,0,0
2023-09-01,LIE,Selangor,6,6,0
2023-09-01,LKA,Johor,1605,1027,578
2023-09-01,LKA,Kedah,58,27,31
2023-09-01,LKA,Kelantan,0,0,0
2023-09-01,LKA,Melaka,1,1,0
2023-09-01,LKA,Pahang,0,0,0
2023-09-01,LKA,Perak,2,2,0
2023-09-01,LKA,Perlis,0,0,0
2023-09-01,LKA,Pulau Pinang,44,36,8
2023-09-01,LKA,Sabah,3,2,1
2023-09-01,LKA,Sarawak,36,24,12
2023-09-01,LKA,Selangor,5603,3546,2057
2023-09-01,LKA,W.P. Labuan,0,0,0
2023-09-01,LSO,Johor,0,0,0
2023-09-01,LSO,Kedah,0,0,0
2023-09-01,LSO,Pulau Pinang,0,0,0
2023-09-01,LSO,Sarawak,0,0,0
2023-09-01,LSO,Selangor,6,4,2
2023-09-01,LTU,Johor,52,24,28
2023-09-01,LTU,Kedah,19,4,15
2023-09-01,LTU,Kelantan,1,1,0
2023-09-01,LTU,Pahang,0,0,0
2023-09-01,LTU,Perak,0,0,0
2023-09-01,LTU,Perlis,4,2,2
2023-09-01,LTU,Pulau Pinang,9,5,4
2023-09-01,LTU,Sabah,0,0,0
2023-09-01,LTU,Sarawak,1,1,0
2023-09-01,LTU,Selangor,254,122,132
2023-09-01,LTU,W.P. Labuan,0,0,0
2023-09-01,LUX,Johor,3,2,1
2023-09-01,LUX,Kedah,0,0,0
2023-09-01,LUX,Kelantan,0,0,0
2023-09-01,LUX,Perak,0,0,0
2023-09-01,LUX,Perlis,0,0,0
2023-09-01,LUX,Pulau Pinang,2,2,0
2023-09-01,LUX,Sabah,0,0,0
2023-09-01,LUX,Sarawak,0,0,0
2023-09-01,LUX,Selangor,36,28,8
2023-09-01,LVA,Johor,29,14,15
2023-09-01,LVA,Kedah,2,1,1
2023-09-01,LVA,Kelantan,1,1,0
2023-09-01,LVA,Pahang,0,0,0
2023-09-01,LVA,Perak,0,0,0
2023-09-01,LVA,Perlis,0,0,0
2023-09-01,LVA,Pulau Pinang,7,3,4
2023-09-01,LVA,Sabah,0,0,0
2023-09-01,LVA,Sarawak,6,3,3
2023-09-01,LVA,Selangor,153,95,58
2023-09-01,LVA,W.P. Labuan,0,0,0
2023-09-01,MAC,Johor,0,0,0
2023-09-01,MAC,Pahang,0,0,0
2023-09-01,MAC,Perak,0,0,0
2023-09-01,MAC,Selangor,13,8,5
2023-09-01,MAC,W.P. Labuan,0,0,0
2023-09-01,MAR,Johor,146,71,75
2023-09-01,MAR,Kedah,7,4,3
2023-09-01,MAR,Kelantan,1,1,0
2023-09-01,MAR,Melaka,0,0,0
2023-09-01,MAR,Pahang,0,0,0
2023-09-01,MAR,Perak,0,0,0
2023-09-01,MAR,Perlis,2,2,0
2023-09-01,MAR,Pulau Pinang,9,7,2
2023-09-01,MAR,Sabah,1,1,0
2023-09-01,MAR,Sarawak,5,4,1
2023-09-01,MAR,Selangor,1668,766,902
2023-09-01,MAR,W.P. Labuan,0,0,0
2023-09-01,MCO,Johor,0,0,0
2023-09-01,MCO,Kedah,0,0,0
2023-09-01,MCO,Sabah,0,0,0
2023-09-01,MCO,Selangor,2,1,1
2023-09-01,MDA,Johor,1,1,0
2023-09-01,MDA,Kedah,1,0,1
2023-09-01,MDA,Kelantan,1,0,1
2023-09-01,MDA,Negeri Sembilan,0,0,0
2023-09-01,MDA,Perlis,0,0,0
2023-09-01,MDA,Pulau Pinang,1,1,0
2023-09-01,MDA,Sabah,0,0,0
2023-09-01,MDA,Sarawak,0,0,0
2023-09-01,MDA,Selangor,33,19,14
2023-09-01,MDG,Johor,15,6,9
2023-09-01,MDG,Kedah,0,0,0
2023-09-01,MDG,Perak,0,0,0
2023-09-01,MDG,Perlis,0,0,0
2023-09-01,MDG,Pulau Pinang,0,0,0
2023-09-01,MDG,Sabah,0,0,0
2023-09-01,MDG,Sarawak,0,0,0
2023-09-01,MDG,Selangor,98,45,53
2023-09-01,MDV,Johor,97,51,46
2023-09-01,MDV,Kedah,2,2,0
2023-09-01,MDV,Kelantan,0,0,0
2023-09-01,MDV,Perak,0,0,0
2023-09-01,MDV,Perlis,1,1,0
2023-09-01,MDV,Pulau Pinang,2,0,2
2023-09-01,MDV,Sabah,0,0,0
2023-09-01,MDV,Sarawak,1,0,1
2023-09-01,MDV,Selangor,2728,1477,1251
2023-09-01,MEX,Johor,205,96,109
2023-09-01,MEX,Kedah,1,0,1
2023-09-01,MEX,Kelantan,0,0,0
2023-09-01,MEX,Pahang,0,0,0
2023-09-01,MEX,Perak,1,0,1
2023-09-01,MEX,Perlis,0,0,0
2023-09-01,MEX,Pulau Pinang,38,23,15
2023-09-01,MEX,Sabah,2,2,0
2023-09-01,MEX,Sarawak,4,1,3
2023-09-01,MEX,Selangor,905,420,485
2023-09-01,MEX,W.P. Labuan,0,0,0
2023-09-01,MHL,Johor,0,0,0
2023-09-01,MHL,Kedah,0,0,0
2023-09-01,MHL,Perak,0,0,0
2023-09-01,MHL,Pulau Pinang,0,0,0
2023-09-01,MHL,Sabah,0,0,0
2023-09-01,MHL,Selangor,4,1,3
2023-09-01,MKD,Johor,4,4,0
2023-09-01,MKD,Kedah,1,0,1
2023-09-01,MKD,Perak,0,0,0
2023-09-01,MKD,Pulau Pinang,0,0,0
2023-09-01,MKD,Sabah,0,0,0
2023-09-01,MKD,Sarawak,1,1,0
2023-09-01,MKD,Selangor,43,24,19
2023-09-01,MLI,Johor,2,2,0
2023-09-01,MLI,Sabah,0,0,0
2023-09-01,MLI,Selangor,19,14,5
2023-09-01,MLT,Johor,21,11,10
2023-09-01,MLT,Kedah,5,4,1
2023-09-01,MLT,Kelantan,0,0,0
2023-09-01,MLT,Perak,0,0,0
2023-09-01,MLT,Perlis,0,0,0
2023-09-01,MLT,Pulau Pinang,1,1,0
2023-09-01,MLT,Sabah,1,1,0
2023-09-01,MLT,Sarawak,1,1,0
2023-09-01,MLT,Selangor,51,33,18
2023-09-01,MLT,W.P. Labuan,0,0,0
2023-09-01,MMR,Johor,7130,2139,4991
2023-09-01,MMR,Kedah,82,21,61
2023-09-01,MMR,Kelantan,1,0,1
2023-09-01,MMR,Negeri Sembilan,0,0,0
2023-09-01,MMR,Pahang,5,1,4
2023-09-01,MMR,Perak,26,6,20
2023-09-01,MMR,Perlis,4,1,3
2023-09-01,MMR,Pulau Pinang,242,120,122
2023-09-01,MMR,Sabah,3,2,1
2023-09-01,MMR,Sarawak,72,26,46
2023-09-01,MMR,Selangor,7141,4810,2331
2023-09-01,MMR,Terengganu,0,0,0
2023-09-01,MMR,W.P. Labuan,1,1,0
2023-09-01,MNE,Johor,1,1,0
2023-09-01,MNE,Kedah,0,0,0
2023-09-01,MNE,Pulau Pinang,0,0,0
2023-09-01,MNE,Sabah,0,0,0
2023-09-01,MNE,Sarawak,0,0,0
2023-09-01,MNE,Selangor,10,6,4
2023-09-01,MNG,Johor,98,43,55
2023-09-01,MNG,Kedah,2,0,2
2023-09-01,MNG,Kelantan,0,0,0
2023-09-01,MNG,Perak,0,0,0
2023-09-01,MNG,Perlis,5,5,0
2023-09-01,MNG,Pulau Pinang,6,2,4
2023-09-01,MNG,Sabah,0,0,0
2023-09-01,MNG,Sarawak,1,0,1
2023-09-01,MNG,Selangor,294,115,179
2023-09-01,MNP,Selangor,0,0,0
2023-09-01,MOZ,Johor,0,0,0
2023-09-01,MOZ,Kedah,0,0,0
2023-09-01,MOZ,Perak,0,0,0
2023-09-01,MOZ,Pulau Pinang,1,1,0
2023-09-01,MOZ,Sabah,0,0,0
2023-09-01,MOZ,Sarawak,1,0,1
2023-09-01,MOZ,Selangor,25,13,12
2023-09-01,MRT,Johor,3,2,1
2023-09-01,MRT,Kedah,0,0,0
2023-09-01,MRT,Pulau Pinang,0,0,0
2023-09-01,MRT,Sabah,0,0,0
2023-09-01,MRT,Sarawak,0,0,0
2023-09-01,MRT,Selangor,32,29,3
2023-09-01,MUS,Johor,138,73,65
2023-09-01,MUS,Kedah,8,4,4
2023-09-01,MUS,Kelantan,0,0,0
2023-09-01,MUS,Pahang,0,0,0
2023-09-01,MUS,Perak,1,1,0
2023-09-01,MUS,Perlis,1,1,0
2023-09-01,MUS,Pulau Pinang,8,4,4
2023-09-01,MUS,Sabah,0,0,0
2023-09-01,MUS,Sarawak,0,0,0
2023-09-01,MUS,Selangor,1790,953,837
2023-09-01,MWI,Johor,1,1,0
2023-09-01,MWI,Pulau Pinang,1,1,0
2023-09-01,MWI,Sabah,0,0,0
2023-09-01,MWI,Sarawak,0,0,0
2023-09-01,MWI,Selangor,20,11,9
2023-09-01,MYT,Selangor,0,0,0
2023-09-01,NAM,Johor,3,0,3
2023-09-01,NAM,Kedah,0,0,0
2023-09-01,NAM,Perak,0,0,0
2023-09-01,NAM,Perlis,0,0,0
2023-09-01,NAM,Pulau Pinang,0,0,0
2023-09-01,NAM,Sabah,0,0,0
2023-09-01,NAM,Sarawak,2,2,0
2023-09-01,NAM,Selangor,23,9,14
2023-09-01,NCL,Selangor,0,0,0
2023-09-01,NER,Johor,0,0,0
2023-09-01,NER,Sabah,1,1,0
2023-09-01,NER,Selangor,4,4,0
2023-09-01,NGA,Johor,41,38,3
2023-09-01,NGA,Kedah,0,0,0
2023-09-01,NGA,Perlis,0,0,0
2023-09-01,NGA,Pulau Pinang,2,1,1
2023-09-01,NGA,Sabah,1,1,0
2023-09-01,NGA,Sarawak,13,11,2
2023-09-01,NGA,Selangor,460,342,118
2023-09-01,NIC,Johor,0,0,0
2023-09-01,NIC,Kedah,0,0,0
2023-09-01,NIC,Pulau Pinang,0,0,0
2023-09-01,NIC,Sabah,0,0,0
2023-09-01,NIC,Selangor,10,8,2
2023-09-01,NLD,Johor,1166,735,431
2023-09-01,NLD,Kedah,134,73,61
2023-09-01,NLD,Kelantan,3,3,0
2023-09-01,NLD,Melaka,0,0,0
2023-09-01,NLD,Negeri Sembilan,0,0,0
2023-09-01,NLD,Pahang,7,6,1
2023-09-01,NLD,Perak,13,6,7
2023-09-01,NLD,Perlis,22,12,10
2023-09-01,NLD,Pulau Pinang,191,126,65
2023-09-01,NLD,Sabah,16,7,9
2023-09-01,NLD,Sarawak,136,85,51
2023-09-01,NLD,Selangor,4865,2786,2079
2023-09-01,NLD,Terengganu,0,0,0
2023-09-01,NLD,W.P. Labuan,3,3,0
2023-09-01,NOR,Johor,145,95,50
2023-09-01,NOR,Kedah,14,9,5
2023-09-01,NOR,Kelantan,0,0,0
2023-09-01,NOR,Melaka,0,0,0
2023-09-01,NOR,Pahang,0,0,0
2023-09-01,NOR,Perak,1,0,1
2023-09-01,NOR,Perlis,2,2,0
2023-09-01,NOR,Pulau Pinang,17,8,9
2023-09-01,NOR,Sabah,2,1,1
2023-09-01,NOR,Sarawak,33,23,10
2023-09-01,NOR,Selangor,577,373,204
2023-09-01,NOR,W.P. Labuan,2,2,0
2023-09-01,NPL,Johor,1118,776,342
2023-09-01,NPL,Kedah,23,8,15
2023-09-01,NPL,Pahang,0,0,0
2023-09-01,NPL,Perak,0,0,0
2023-09-01,NPL,Perlis,0,0,0
2023-09-01,NPL,Pulau Pinang,17,15,2
2023-09-01,NPL,Sabah,1,1,0
2023-09-01,NPL,Sarawak,134,100,34
2023-09-01,NPL,Selangor,9283,8827,456
2023-09-01,NPL,W.P. Labuan,46,44,2
2023-09-01,NRU,Johor,1,0,1
2023-09-01,NRU,Pulau Pinang,0,0,0
2023-09-01,NRU,Selangor,9,4,5
2023-09-01,NZL,Johor,930,581,349
2023-09-01,NZL,Kedah,94,55,39
2023-09-01,NZL,Kelantan,1,0,1
2023-09-01,NZL,Melaka,1,0,1
2023-09-01,NZL,Negeri Sembilan,0,0,0
2023-09-01,NZL,Pahang,2,1,1
2023-09-01,NZL,Perak,22,14,8
2023-09-01,NZL,Perlis,19,12,7
2023-09-01,NZL,Pulau Pinang,266,158,108
2023-09-01,NZL,Sabah,8,4,4
2023-09-01,NZL,Sarawak,121,69,52
2023-09-01,NZL,Selangor,3702,2121,1581
2023-09-01,NZL,Terengganu,0,0,0
2023-09-01,NZL,W.P. Labuan,1,1,0
2023-09-01,OMN,Johor,25,12,13
2023-09-01,OMN,Kedah,3,2,1
2023-09-01,OMN,Kelantan,0,0,0
2023-09-01,OMN,Melaka,0,0,0
2023-09-01,OMN,Perak,0,0,0
2023-09-01,OMN,Perlis,1,1,0
2023-09-01,OMN,Pulau Pinang,3,3,0
2023-09-01,OMN,Sabah,1,1,0
2023-09-01,OMN,Sarawak,15,8,7
2023-09-01,OMN,Selangor,1466,910,556
2023-09-01,PAK,Johor,1039,749,290
2023-09-01,PAK,Kedah,128,98,30
2023-09-01,PAK,Kelantan,10,10,0
2023-09-01,PAK,Melaka,0,0,0
2023-09-01,PAK,Negeri Sembilan,0,0,0
2023-09-01,PAK,Pahang,0,0,0
2023-09-01,PAK,Perak,9,8,1
2023-09-01,PAK,Perlis,15,13,2
2023-09-01,PAK,Pulau Pinang,58,52,6
2023-09-01,PAK,Sabah,9,9,0
2023-09-01,PAK,Sarawak,136,112,24
2023-09-01,PAK,Selangor,11875,10367,1508
2023-09-01,PAK,W.P. Labuan,1,0,1
2023-09-01,PAN,Johor,9,4,5
2023-09-01,PAN,Kedah,0,0,0
2023-09-01,PAN,Perak,0,0,0
2023-09-01,PAN,Perlis,0,0,0
2023-09-01,PAN,Pulau Pinang,0,0,0
2023-09-01,PAN,Sabah,0,0,0
2023-09-01,PAN,Sarawak,0,0,0
2023-09-01,PAN,Selangor,30,14,16
2023-09-01,PER,Johor,37,22,15
2023-09-01,PER,Kedah,3,1,2
2023-09-01,PER,Kelantan,0,0,0
2023-09-01,PER,Pahang,0,0,0
2023-09-01,PER,Perak,0,0,0
2023-09-01,PER,Perlis,0,0,0
2023-09-01,PER,Pulau Pinang,4,2,2
2023-09-01,PER,Sabah,0,0,0
2023-09-01,PER,Sarawak,0,0,0
2023-09-01,PER,Selangor,147,72,75
2023-09-01,PER,W.P. Labuan,0,0,0
2023-09-01,PHL,Johor,23504,7221,16283
2023-09-01,PHL,Kedah,337,111,226
2023-09-01,PHL,Kelantan,27,21,6
2023-09-01,PHL,Melaka,2,1,1
2023-09-01,PHL,Negeri Sembilan,0,0,0
2023-09-01,PHL,Pahang,13,12,1
2023-09-01,PHL,Perak,55,13,42
2023-09-01,PHL,Perlis,210,63,147
2023-09-01,PHL,Pulau Pinang,732,271,461
2023-09-01,PHL,Sabah,631,358,273
2023-09-01,PHL,Sarawak,1857,774,1083
2023-09-01,PHL,Selangor,17431,6932,10499
2023-09-01,PHL,Terengganu,0,0,0
2023-09-01,PHL,W.P. Labuan,94,26,68
2023-09-01,PLW,Johor,0,0,0
2023-09-01,PLW,Pulau Pinang,0,0,0
2023-09-01,PLW,Selangor,2,1,1
2023-09-01,PNG,Johor,16,10,6
2023-09-01,PNG,Kedah,0,0,0
2023-09-01,PNG,Kelantan,0,0,0
2023-09-01,PNG,Perak,1,1,0
2023-09-01,PNG,Pulau Pinang,3,3,0
2023-09-01,PNG,Sabah,1,0,1
2023-09-01,PNG,Sarawak,4,3,1
2023-09-01,PNG,Selangor,72,51,21
2023-09-01,POL,Johor,391,224,167
2023-09-01,POL,Kedah,38,16,22
2023-09-01,POL,Kelantan,0,0,0
2023-09-01,POL,Melaka,0,0,0
2023-09-01,POL,Negeri Sembilan,0,0,0
2023-09-01,POL,Pahang,0,0,0
2023-09-01,POL,Perak,2,1,1
2023-09-01,POL,Perlis,16,12,4
2023-09-01,POL,Pulau Pinang,38,24,14
2023-09-01,POL,Sabah,9,5,4
2023-09-01,POL,Sarawak,39,20,19
2023-09-01,POL,Selangor,1339,684,655
2023-09-01,POL,Terengganu,0,0,0
2023-09-01,POL,W.P. Labuan,0,0,0
2023-09-01,PRK,Selangor,0,0,0
2023-09-01,PRT,Johor,153,88,65
2023-09-01,PRT,Kedah,14,6,8
2023-09-01,PRT,Kelantan,0,0,0
2023-09-01,PRT,Melaka,0,0,0
2023-09-01,PRT,Pahang,0,0,0
2023-09-01,PRT,Perak,3,3,0
2023-09-01,PRT,Perlis,1,0,1
2023-09-01,PRT,Pulau Pinang,51,22,29
2023-09-01,PRT,Sabah,6,3,3
2023-09-01,PRT,Sarawak,5,2,3
2023-09-01,PRT,Selangor,855,495,360
2023-09-01,PRT,W.P. Labuan,0,0,0
2023-09-01,PRY,Johor,4,3,1
2023-09-01,PRY,Kedah,1,0,1
2023-09-01,PRY,Perak,0,0,0
2023-09-01,PRY,Perlis,0,0,0
2023-09-01,PRY,Pulau Pinang,3,1,2
2023-09-01,PRY,Sabah,0,0,0
2023-09-01,PRY,Sarawak,0,0,0
2023-09-01,PRY,Selangor,24,13,11
2023-09-01,PSE,Johor,32,28,4
2023-09-01,PSE,Kedah,1,1,0
2023-09-01,PSE,Kelantan,0,0,0
2023-09-01,PSE,Melaka,0,0,0
2023-09-01,PSE,Perak,0,0,0
2023-09-01,PSE,Perlis,0,0,0
2023-09-01,PSE,Pulau Pinang,2,2,0
2023-09-01,PSE,Sabah,0,0,0
2023-09-01,PSE,Sarawak,1,1,0
2023-09-01,PSE,Selangor,492,338,154
2023-09-01,QAT,Johor,2,1,1
2023-09-01,QAT,Kedah,0,0,0
2023-09-01,QAT,Perlis,2,2,0
2023-09-01,QAT,Pulau Pinang,1,1,0
2023-09-01,QAT,Sabah,1,1,0
2023-09-01,QAT,Sarawak,0,0,0
2023-09-01,QAT,Selangor,118,89,29
2023-09-01,REU,Johor,1,0,1
2023-09-01,REU,Sarawak,0,0,0
2023-09-01,ROU,Johor,139,86,53
2023-09-01,ROU,Kedah,9,8,1
2023-09-01,ROU,Kelantan,0,0,0
2023-09-01,ROU,Negeri Sembilan,0,0,0
2023-09-01,ROU,Pahang,1,1,0
2023-09-01,ROU,Perak,0,0,0
2023-09-01,ROU,Perlis,0,0,0
2023-09-01,ROU,Pulau Pinang,13,5,8
2023-09-01,ROU,Sabah,3,1,2
2023-09-01,ROU,Sarawak,9,6,3
2023-09-01,ROU,Selangor,557,304,253
2023-09-01,ROU,W.P. Labuan,0,0,0
2023-09-01,RUS,Johor,399,208,191
2023-09-01,RUS,Kedah,213,110,103
2023-09-01,RUS,Kelantan,54,36,18
2023-09-01,RUS,Melaka,2,2,0
2023-09-01,RUS,Negeri Sembilan,3,3,0
2023-09-01,RUS,Pahang,1,1,0
2023-09-01,RUS,Perak,2,1,1
2023-09-01,RUS,Perlis,170,106,64
2023-09-01,RUS,Pulau Pinang,154,82,72
2023-09-01,RUS,Sabah,3,1,2
2023-09-01,RUS,Sarawak,48,31,17
2023-09-01,RUS,Selangor,6843,3476,3367
2023-09-01,RUS,W.P. Labuan,6,4,2
2023-09-01,RWA,Johor,0,0,0
2023-09-01,RWA,Kedah,0,0,0
2023-09-01,RWA,Pulau Pinang,1,1,0
2023-09-01,RWA,Selangor,10,6,4
2023-09-01,SAU,Johor,138,73,65
2023-09-01,SAU,Kedah,19,11,8
2023-09-01,SAU,Kelantan,6,3,3
2023-09-01,SAU,Melaka,0,0,0
2023-09-01,SAU,Perak,2,0,2
2023-09-01,SAU,Perlis,2,1,1
2023-09-01,SAU,Pulau Pinang,19,11,8
2023-09-01,SAU,Sabah,2,2,0
2023-09-01,SAU,Sarawak,11,7,4
2023-09-01,SAU,Selangor,3386,2126,1260
2023-09-01,SAU,W.P. Labuan,0,0,0
2023-09-01,SDN,Johor,12,8,4
2023-09-01,SDN,Kedah,2,1,1
2023-09-01,SDN,Kelantan,0,0,0
2023-09-01,SDN,Perlis,0,0,0
2023-09-01,SDN,Pulau Pinang,2,1,1
2023-09-01,SDN,Sabah,0,0,0
2023-09-01,SDN,Sarawak,2,1,1
2023-09-01,SDN,Selangor,1047,583,464
2023-09-01,SDN,W.P. Labuan,1,0,1
2023-09-01,SEN,Johor,11,8,3
2023-09-01,SEN,Kedah,0,0,0
2023-09-01,SEN,Kelantan,0,0,0
2023-09-01,SEN,Perak,0,0,0
2023-09-01,SEN,Perlis,0,0,0
2023-09-01,SEN,Pulau Pinang,0,0,0
2023-09-01,SEN,Sabah,0,0,0
2023-09-01,SEN,Sarawak,0,0,0
2023-09-01,SEN,Selangor,145,116,29
2023-09-01,SGP,Johor,1310305,742628,567677
2023-09-01,SGP,Kedah,5433,2819,2614
2023-09-01,SGP,Kelantan,77,52,25
2023-09-01,SGP,Melaka,13,12,1
2023-09-01,SGP,Negeri Sembilan,0,0,0
2023-09-01,SGP,Pahang,791,402,389
2023-09-01,SGP,Perak,6499,2981,3518
2023-09-01,SGP,Perlis,220,115,105
2023-09-01,SGP,Pulau Pinang,18568,9203,9365
2023-09-01,SGP,Sabah,537,267,270
2023-09-01,SGP,Sarawak,4662,2661,2001
2023-09-01,SGP,Selangor,52584,27079,25505
2023-09-01,SGP,Terengganu,0,0,0
2023-09-01,SGP,W.P. Labuan,9,6,3
2023-09-01,SGS,Johor,0,0,0
2023-09-01,SGS,Sabah,0,0,0
2023-09-01,SGS,Selangor,0,0,0
2023-09-01,SHN,Sarawak,0,0,0
2023-09-01,SLB,Johor,0,0,0
2023-09-01,SLB,Perlis,0,0,0
2023-09-01,SLB,Pulau Pinang,0,0,0
2023-09-01,SLB,Sabah,0,0,0
2023-09-01,SLB,Sarawak,2,2,0
2023-09-01,SLB,Selangor,5,4,1
2023-09-01,SLB,W.P. Labuan,0,0,0
2023-09-01,SLE,Johor,1,1,0
2023-09-01,SLE,Kedah,0,0,0
2023-09-01,SLE,Perak,0,0,0
2023-09-01,SLE,Pulau Pinang,1,1,0
2023-09-01,SLE,Sabah,0,0,0
2023-09-01,SLE,Selangor,31,23,8
2023-09-01,SLV,Johor,4,1,3
2023-09-01,SLV,Kedah,0,0,0
2023-09-01,SLV,Perak,0,0,0
2023-09-01,SLV,Perlis,0,0,0
2023-09-01,SLV,Pulau Pinang,2,2,0
2023-09-01,SLV,Sabah,1,0,1
2023-09-01,SLV,Selangor,26,17,9
2023-09-01,SLV,W.P. Labuan,0,0,0
2023-09-01,SMR,Johor,0,0,0
2023-09-01,SMR,Selangor,0,0,0
2023-09-01,SOM,Johor,0,0,0
2023-09-01,SOM,Kedah,0,0,0
2023-09-01,SOM,Kelantan,0,0,0
2023-09-01,SOM,Perlis,0,0,0
2023-09-01,SOM,Sabah,0,0,0
2023-09-01,SOM,Sarawak,0,0,0
2023-09-01,SOM,Selangor,251,162,89
2023-09-01,SRB,Johor,7,6,1
2023-09-01,SRB,Kedah,3,2,1
2023-09-01,SRB,Kelantan,0,0,0
2023-09-01,SRB,Pahang,0,0,0
2023-09-01,SRB,Perak,0,0,0
2023-09-01,SRB,Perlis,0,0,0
2023-09-01,SRB,Pulau Pinang,1,1,0
2023-09-01,SRB,Sabah,0,0,0
2023-09-01,SRB,Sarawak,1,0,1
2023-09-01,SRB,Selangor,96,47,49
2023-09-01,SSD,Johor,0,0,0
2023-09-01,SSD,Kedah,0,0,0
2023-09-01,SSD,Sarawak,1,1,0
2023-09-01,SSD,Selangor,33,21,12
2023-09-01,SSD,W.P. Labuan,0,0,0
2023-09-01,STP,Selangor,2,2,0
2023-09-01,SUR,Johor,12,5,7
2023-09-01,SUR,Kedah,0,0,0
2023-09-01,SUR,Kelantan,0,0,0
2023-09-01,SUR,Perak,0,0,0
2023-09-01,SUR,Perlis,0,0,0
2023-09-01,SUR,Pulau Pinang,3,1,2
2023-09-01,SUR,Sabah,0,0,0
2023-09-01,SUR,Sarawak,0,0,0
2023-09-01,SUR,Selangor,68,35,33
2023-09-01,SVK,Johor,26,19,7
2023-09-01,SVK,Kedah,24,11,13
2023-09-01,SVK,Kelantan,0,0,0
2023-09-01,SVK,Negeri Sembilan,0,0,0
2023-09-01,SVK,Pahang,0,0,0
2023-09-01,SVK,Perak,0,0,0
2023-09-01,SVK,Perlis,0,0,0
2023-09-01,SVK,Pulau Pinang,7,5,2
2023-09-01,SVK,Sabah,2,2,0
2023-09-01,SVK,Sarawak,1,0,1
2023-09-01,SVK,Selangor,272,156,116
2023-09-01,SVK,W.P. Labuan,0,0,0
2023-09-01,SVN,Johor,14,6,8
2023-09-01,SVN,Kedah,6,2,4
2023-09-01,SVN,Kelantan,0,0,0
2023-09-01,SVN,Perak,0,0,0
2023-09-01,SVN,Perlis,0,0,0
2023-09-01,SVN,Pulau Pinang,3,1,2
2023-09-01,SVN,Sabah,0,0,0
2023-09-01,SVN,Sarawak,4,3,1
2023-09-01,SVN,Selangor,138,77,61
2023-09-01,SVN,W.P. Labuan,0,0,0
2023-09-01,SWE,Johor,287,187,100
2023-09-01,SWE,Kedah,41,21,20
2023-09-01,SWE,Kelantan,2,2,0
2023-09-01,SWE,Melaka,0,0,0
2023-09-01,SWE,Negeri Sembilan,1,1,0
2023-09-01,SWE,Pahang,0,0,0
2023-09-01,SWE,Perak,7,7,0
2023-09-01,SWE,Perlis,16,12,4
2023-09-01,SWE,Pulau Pinang,57,43,14
2023-09-01,SWE,Sabah,3,2,1
2023-09-01,SWE,Sarawak,37,25,12
2023-09-01,SWE,Selangor,771,527,244
2023-09-01,SWE,W.P. Labuan,0,0,0
2023-09-01,SWZ,Johor,0,0,0
2023-09-01,SWZ,Kedah,0,0,0
2023-09-01,SWZ,Pulau Pinang,0,0,0
2023-09-01,SWZ,Sabah,0,0,0
2023-09-01,SWZ,Selangor,22,8,14
2023-09-01,SYC,Johor,2,0,2
2023-09-01,SYC,Kedah,0,0,0
2023-09-01,SYC,Pulau Pinang,2,1,1
2023-09-01,SYC,Sabah,0,0,0
2023-09-01,SYC,Sarawak,1,1,0
2023-09-01,SYC,Selangor,117,49,68
2023-09-01,SYR,Johor,22,13,9
2023-09-01,SYR,Kedah,1,1,0
2023-09-01,SYR,Kelantan,0,0,0
2023-09-01,SYR,Pahang,0,0,0
2023-09-01,SYR,Perlis,0,0,0
2023-09-01,SYR,Pulau Pinang,2,1,1
2023-09-01,SYR,Sabah,1,1,0
2023-09-01,SYR,Sarawak,6,6,0
2023-09-01,SYR,Selangor,755,466,289
2023-09-01,SYR,W.P. Labuan,0,0,0
2023-09-01,TCA,Perlis,0,0,0
2023-09-01,TCD,Johor,2,2,0
2023-09-01,TCD,Kedah,0,0,0
2023-09-01,TCD,Perlis,1,1,0
2023-09-01,TCD,Selangor,31,25,6
2023-09-01,TGO,Johor,3,1,2
2023-09-01,TGO,Perak,0,0,0
2023-09-01,TGO,Pulau Pinang,0,0,0
2023-09-01,TGO,Selangor,8,6,2
2023-09-01,THA,Johor,6671,1797,4874
2023-09-01,THA,Kedah,67381,41054,26327
2023-09-01,THA,Kelantan,34118,18894,15224
2023-09-01,THA,Melaka,10,7,3
2023-09-01,THA,Negeri Sembilan,0,0,0
2023-09-01,THA,Pahang,27,20,7
2023-09-01,THA,Perak,9355,4370,4985
2023-09-01,THA,Perlis,50060,29338,20722
2023-09-01,THA,Pulau Pinang,1810,766,1044
2023-09-01,THA,Sabah,8,1,7
2023-09-01,THA,Sarawak,319,120,199
2023-09-01,THA,Selangor,14375,5911,8464
2023-09-01,THA,Terengganu,1,0,1
2023-09-01,THA,W.P. Labuan,15,5,10
2023-09-01,TJK,Johor,2,1,1
2023-09-01,TJK,Kedah,0,0,0
2023-09-01,TJK,Perlis,0,0,0
2023-09-01,TJK,Pulau Pinang,1,1,0
2023-09-01,TJK,Sabah,0,0,0
2023-09-01,TJK,Selangor,108,67,41
2023-09-01,TKL,Selangor,0,0,0
2023-09-01,TKM,Johor,2,0,2
2023-09-01,TKM,Kedah,0,0,0
2023-09-01,TKM,Kelantan,0,0,0
2023-09-01,TKM,Perlis,0,0,0
2023-09-01,TKM,Pulau Pinang,0,0,0
2023-09-01,TKM,Sabah,0,0,0
2023-09-01,TKM,Sarawak,1,1,0
2023-09-01,TKM,Selangor,127,76,51
2023-09-01,TLS,Johor,3,3,0
2023-09-01,TLS,Kedah,0,0,0
2023-09-01,TLS,Perlis,0,0,0
2023-09-01,TLS,Pulau Pinang,9,6,3
2023-09-01,TLS,Sabah,0,0,0
2023-09-01,TLS,Sarawak,1,1,0
2023-09-01,TLS,Selangor,247,138,109
2023-09-01,TON,Johor,2,1,1
2023-09-01,TON,Pulau Pinang,2,1,1
2023-09-01,TON,Sarawak,0,0,0
2023-09-01,TON,Selangor,15,5,10
2023-09-01,TTO,Johor,8,3,5
2023-09-01,TTO,Kedah,2,1,1
2023-09-01,TTO,Pahang,0,0,0
2023-09-01,TTO,Pulau Pinang,1,1,0
2023-09-01,TTO,Sabah,2,1,1
2023-09-01,TTO,Sarawak,2,2,0
2023-09-01,TTO,Selangor,39,23,16
2023-09-01,TUN,Johor,11,4,7
2023-09-01,TUN,Kedah,1,1,0
2023-09-01,TUN,Kelantan,0,0,0
2023-09-01,TUN,Melaka,0,0,0
2023-09-01,TUN,Perak,2,1,1
2023-09-01,TUN,Perlis,0,0,0
2023-09-01,TUN,Pulau Pinang,4,3,1
2023-09-01,TUN,Sabah,0,0,0
2023-09-01,TUN,Sarawak,1,1,0
2023-09-01,TUN,Selangor,1746,847,899
2023-09-01,TUN,W.P. Labuan,0,0,0
2023-09-01,TUR,Johor,332,221,111
2023-09-01,TUR,Kedah,28,15,13
2023-09-01,TUR,Kelantan,0,0,0
2023-09-01,TUR,Melaka,1,1,0
2023-09-01,TUR,Negeri Sembilan,0,0,0
2023-09-01,TUR,Pahang,2,2,0
2023-09-01,TUR,Perak,2,2,0
2023-09-01,TUR,Perlis,11,9,2
2023-09-01,TUR,Pulau Pinang,24,16,8
2023-09-01,TUR,Sabah,1,1,0
2023-09-01,TUR,Sarawak,18,12,6
2023-09-01,TUR,Selangor,2170,1302,868
2023-09-01,TUR,W.P. Labuan,0,0,0
2023-09-01,TUV,Selangor,2,1,1
2023-09-01,TWN,Johor,5692,2405,3287
2023-09-01,TWN,Kedah,113,55,58
2023-09-01,TWN,Kelantan,1,1,0
2023-09-01,TWN,Melaka,4,3,1
2023-09-01,TWN,Negeri Sembilan,0,0,0
2023-09-01,TWN,Pahang,15,8,7
2023-09-01,TWN,Perak,48,26,22
2023-09-01,TWN,Perlis,26,15,11
2023-09-01,TWN,Pulau Pinang,3634,1749,1885
2023-09-01,TWN,Sabah,281,135,146
2023-09-01,TWN,Sarawak,323,147,176
2023-09-01,TWN,Selangor,18179,8828,9351
2023-09-01,TWN,W.P. Labuan,20,9,11
2023-09-01,TZA,Johor,20,13,7
2023-09-01,TZA,Kedah,0,0,0
2023-09-01,TZA,Perak,0,0,0
2023-09-01,TZA,Perlis,0,0,0
2023-09-01,TZA,Pulau Pinang,1,1,0
2023-09-01,TZA,Sabah,0,0,0
2023-09-01,TZA,Sarawak,2,2,0
2023-09-01,TZA,Selangor,294,173,121
2023-09-01,UGA,Johor,15,7,8
2023-09-01,UGA,Kedah,0,0,0
2023-09-01,UGA,Perak,0,0,0
2023-09-01,UGA,Perlis,0,0,0
2023-09-01,UGA,Pulau Pinang,3,2,1
2023-09-01,UGA,Sabah,0,0,0
2023-09-01,UGA,Sarawak,0,0,0
2023-09-01,UGA,Selangor,157,64,93
2023-09-01,UKR,Johor,98,52,46
2023-09-01,UKR,Kedah,25,10,15
2023-09-01,UKR,Kelantan,1,1,0
2023-09-01,UKR,Melaka,0,0,0
2023-09-01,UKR,Negeri Sembilan,0,0,0
2023-09-01,UKR,Pahang,4,4,0
2023-09-01,UKR,Perak,1,1,0
2023-09-01,UKR,Perlis,6,5,1
2023-09-01,UKR,Pulau Pinang,15,11,4
2023-09-01,UKR,Sabah,2,2,0
2023-09-01,UKR,Sarawak,4,3,1
2023-09-01,UKR,Selangor,870,448,422
2023-09-01,UKR,W.P. Labuan,1,0,1
2023-09-01,URY,Johor,7,4,3
2023-09-01,URY,Kedah,0,0,0
2023-09-01,URY,Kelantan,0,0,0
2023-09-01,URY,Perak,0,0,0
2023-09-01,URY,Perlis,0,0,0
2023-09-01,URY,Pulau Pinang,0,0,0
2023-09-01,URY,Sabah,0,0,0
2023-09-01,URY,Sarawak,1,0,1
2023-09-01,URY,Selangor,33,18,15
2023-09-01,URY,W.P. Labuan,0,0,0
2023-09-01,USA,Johor,4192,2446,1746
2023-09-01,USA,Kedah,293,166,127
2023-09-01,USA,Kelantan,11,6,5
2023-09-01,USA,Melaka,3,3,0
2023-09-01,USA,Negeri Sembilan,1,1,0
2023-09-01,USA,Pahang,30,19,11
2023-09-01,USA,Perak,148,77,71
2023-09-01,USA,Perlis,105,67,38
2023-09-01,USA,Pulau Pinang,1816,1189,627
2023-09-01,USA,Sabah,137,70,67
2023-09-01,USA,Sarawak,268,153,115
2023-09-01,USA,Selangor,14022,8338,5684
2023-09-01,USA,Terengganu,0,0,0
2023-09-01,USA,W.P. Labuan,5,4,1
2023-09-01,UZB,Johor,89,58,31
2023-09-01,UZB,Kedah,4,3,1
2023-09-01,UZB,Kelantan,0,0,0
2023-09-01,UZB,Perak,1,0,1
2023-09-01,UZB,Perlis,0,0,0
2023-09-01,UZB,Pulau Pinang,22,14,8
2023-09-01,UZB,Sabah,0,0,0
2023-09-01,UZB,Sarawak,1,0,1
2023-09-01,UZB,Selangor,968,560,408
2023-09-01,VAT,Johor,0,0,0
2023-09-01,VAT,Sarawak,0,0,0
2023-09-01,VAT,Selangor,1,1,0
2023-09-01,VCT,Johor,0,0,0
2023-09-01,VCT,Kedah,0,0,0
2023-09-01,VCT,Pulau Pinang,0,0,0
2023-09-01,VCT,Sarawak,0,0,0
2023-09-01,VCT,Selangor,2,1,1
2023-09-01,VEN,Johor,7,2,5
2023-09-01,VEN,Kedah,0,0,0
2023-09-01,VEN,Kelantan,0,0,0
2023-09-01,VEN,Melaka,0,0,0
2023-09-01,VEN,Perak,0,0,0
2023-09-01,VEN,Perlis,1,0,1
2023-09-01,VEN,Pulau Pinang,0,0,0
2023-09-01,VEN,Sabah,0,0,0
2023-09-01,VEN,Sarawak,7,5,2
2023-09-01,VEN,Selangor,92,43,49
2023-09-01,VEN,W.P. Labuan,0,0,0
2023-09-01,VNM,Johor,14872,4843,10029
2023-09-01,VNM,Kedah,246,31,215
2023-09-01,VNM,Kelantan,31,10,21
2023-09-01,VNM,Melaka,0,0,0
2023-09-01,VNM,Negeri Sembilan,0,0,0
2023-09-01,VNM,Pahang,1,1,0
2023-09-01,VNM,Perak,130,11,119
2023-09-01,VNM,Perlis,211,27,184
2023-09-01,VNM,Pulau Pinang,1586,614,972
2023-09-01,VNM,Sabah,7,4,3
2023-09-01,VNM,Sarawak,210,45,165
2023-09-01,VNM,Selangor,16439,6033,10406
2023-09-01,VNM,Terengganu,0,0,0
2023-09-01,VNM,W.P. Labuan,3,3,0
2023-09-01,VUT,Johor,44,36,8
2023-09-01,VUT,Kedah,0,0,0
2023-09-01,VUT,Pulau Pinang,8,7,1
2023-09-01,VUT,Sabah,1,1,0
2023-09-01,VUT,Sarawak,0,0,0
2023-09-01,VUT,Selangor,121,110,11
2023-09-01,WSM,Johor,0,0,0
2023-09-01,WSM,Sarawak,0,0,0
2023-09-01,WSM,Selangor,7,4,3
2023-09-01,XXX,Johor,66,44,22
2023-09-01,XXX,Kedah,11,6,5
2023-09-01,XXX,Kelantan,0,0,0
2023-09-01,XXX,Melaka,0,0,0
2023-09-01,XXX,Pahang,0,0,0
2023-09-01,XXX,Perak,2,1,1
2023-09-01,XXX,Perlis,2,2,0
2023-09-01,XXX,Pulau Pinang,61,37,24
2023-09-01,XXX,Sabah,3,2,1
2023-09-01,XXX,Sarawak,22,17,5
2023-09-01,XXX,Selangor,404,246,158
2023-09-01,XXX,W.P. Labuan,0,0,0
2023-09-01,YEM,Johor,20,18,2
2023-09-01,YEM,Kedah,4,3,1
2023-09-01,YEM,Kelantan,0,0,0
2023-09-01,YEM,Melaka,4,2,2
2023-09-01,YEM,Pahang,0,0,0
2023-09-01,YEM,Perak,0,0,0
2023-09-01,YEM,Perlis,1,1,0
2023-09-01,YEM,Pulau Pinang,5,3,2
2023-09-01,YEM,Sabah,1,1,0
2023-09-01,YEM,Sarawak,3,3,0
2023-09-01,YEM,Selangor,1472,1059,413
2023-09-01,YEM,W.P. Labuan,0,0,0
2023-09-01,ZAF,Johor,301,182,119
2023-09-01,ZAF,Kedah,28,16,12
2023-09-01,ZAF,Kelantan,0,0,0
2023-09-01,ZAF,Melaka,0,0,0
2023-09-01,ZAF,Pahang,0,0,0
2023-09-01,ZAF,Perak,3,1,2
2023-09-01,ZAF,Perlis,8,4,4
2023-09-01,ZAF,Pulau Pinang,32,21,11
2023-09-01,ZAF,Sabah,6,2,4
2023-09-01,ZAF,Sarawak,80,39,41
2023-09-01,ZAF,Selangor,1133,679,454
2023-09-01,ZAF,Terengganu,0,0,0
2023-09-01,ZAF,W.P. Labuan,1,0,1
2023-09-01,ZAR,Selangor,0,0,0
2023-09-01,ZMB,Johor,3,1,2
2023-09-01,ZMB,Kedah,0,0,0
2023-09-01,ZMB,Perak,0,0,0
2023-09-01,ZMB,Perlis,0,0,0
2023-09-01,ZMB,Pulau Pinang,0,0,0
2023-09-01,ZMB,Sabah,0,0,0
2023-09-01,ZMB,Sarawak,0,0,0
2023-09-01,ZMB,Selangor,118,49,69
2023-09-01,ZWE,Johor,14,6,8
2023-09-01,ZWE,Kedah,0,0,0
2023-09-01,ZWE,Kelantan,0,0,0
2023-09-01,ZWE,Perak,1,0,1
2023-09-01,ZWE,Perlis,0,0,0
2023-09-01,ZWE,Pulau Pinang,0,0,0
2023-09-01,ZWE,Sabah,1,1,0
2023-09-01,ZWE,Sarawak,2,2,0
2023-09-01,ZWE,Selangor,181,95,86
2023-10-01,ABW,Kedah,0,0,0
2023-10-01,ABW,Pulau Pinang,0,0,0
2023-10-01,AFG,Johor,0,0,0
2023-10-01,AFG,Kedah,0,0,0
2023-10-01,AFG,Perlis,0,0,0
2023-10-01,AFG,Pulau Pinang,1,0,1
2023-10-01,AFG,Sarawak,0,0,0
2023-10-01,AFG,Selangor,72,57,15
2023-10-01,AGO,Johor,1,1,0
2023-10-01,AGO,Kedah,0,0,0
2023-10-01,AGO,Sabah,0,0,0
2023-10-01,AGO,Selangor,4,3,1
2023-10-01,AIA,Selangor,0,0,0
2023-10-01,ALB,Johor,27,20,7
2023-10-01,ALB,Kedah,1,0,1
2023-10-01,ALB,Perak,0,0,0
2023-10-01,ALB,Perlis,0,0,0
2023-10-01,ALB,Pulau Pinang,1,0,1
2023-10-01,ALB,Sabah,0,0,0
2023-10-01,ALB,Sarawak,1,1,0
2023-10-01,ALB,Selangor,32,17,15
2023-10-01,AND,Johor,3,1,2
2023-10-01,AND,Kedah,0,0,0
2023-10-01,AND,Perlis,0,0,0
2023-10-01,AND,Pulau Pinang,1,1,0
2023-10-01,AND,Selangor,11,9,2
2023-10-01,ANT,Selangor,0,0,0
2023-10-01,ARE,Johor,17,9,8
2023-10-01,ARE,Kedah,2,1,1
2023-10-01,ARE,Kelantan,0,0,0
2023-10-01,ARE,Perak,0,0,0
2023-10-01,ARE,Perlis,1,1,0
2023-10-01,ARE,Pulau Pinang,1,1,0
2023-10-01,ARE,Sabah,0,0,0
2023-10-01,ARE,Sarawak,0,0,0
2023-10-01,ARE,Selangor,406,250,156
2023-10-01,ARG,Johor,83,49,34
2023-10-01,ARG,Kedah,30,18,12
2023-10-01,ARG,Kelantan,0,0,0
2023-10-01,ARG,Melaka,0,0,0
2023-10-01,ARG,Perak,1,1,0
2023-10-01,ARG,Perlis,4,2,2
2023-10-01,ARG,Pulau Pinang,7,3,4
2023-10-01,ARG,Sabah,0,0,0
2023-10-01,ARG,Sarawak,4,3,1
2023-10-01,ARG,Selangor,383,219,164
2023-10-01,ARG,W.P. Labuan,0,0,0
2023-10-01,ARM,Johor,23,5,18
2023-10-01,ARM,Kedah,21,8,13
2023-10-01,ARM,Kelantan,0,0,0
2023-10-01,ARM,Perak,0,0,0
2023-10-01,ARM,Perlis,1,1,0
2023-10-01,ARM,Pulau Pinang,0,0,0
2023-10-01,ARM,Sabah,0,0,0
2023-10-01,ARM,Sarawak,1,1,0
2023-10-01,ARM,Selangor,236,72,164
2023-10-01,ATA,Selangor,0,0,0
2023-10-01,ATG,Johor,6,5,1
2023-10-01,ATG,Kedah,0,0,0
2023-10-01,ATG,Pulau Pinang,0,0,0
2023-10-01,ATG,Sarawak,0,0,0
2023-10-01,ATG,Selangor,8,7,1
2023-10-01,AUS,Johor,5758,3403,2355
2023-10-01,AUS,Kedah,528,318,210
2023-10-01,AUS,Kelantan,2,1,1
2023-10-01,AUS,Melaka,1,1,0
2023-10-01,AUS,Negeri Sembilan,2,2,0
2023-10-01,AUS,Pahang,26,13,13
2023-10-01,AUS,Perak,214,117,97
2023-10-01,AUS,Perlis,78,42,36
2023-10-01,AUS,Pulau Pinang,1817,959,858
2023-10-01,AUS,Sabah,85,42,43
2023-10-01,AUS,Sarawak,501,272,229
2023-10-01,AUS,Selangor,24006,13843,10163
2023-10-01,AUS,Terengganu,0,0,0
2023-10-01,AUS,W.P. Labuan,5,3,2
2023-10-01,AUT,Johor,182,121,61
2023-10-01,AUT,Kedah,28,19,9
2023-10-01,AUT,Kelantan,6,6,0
2023-10-01,AUT,Melaka,0,0,0
2023-10-01,AUT,Negeri Sembilan,0,0,0
2023-10-01,AUT,Pahang,0,0,0
2023-10-01,AUT,Perak,1,1,0
2023-10-01,AUT,Perlis,5,3,2
2023-10-01,AUT,Pulau Pinang,78,55,23
2023-10-01,AUT,Sabah,1,0,1
2023-10-01,AUT,Sarawak,16,8,8
2023-10-01,AUT,Selangor,750,462,288
2023-10-01,AUT,Terengganu,0,0,0
2023-10-01,AUT,W.P. Labuan,0,0,0
2023-10-01,AZE,Johor,1,0,1
2023-10-01,AZE,Kedah,1,1,0
2023-10-01,AZE,Kelantan,0,0,0
2023-10-01,AZE,Melaka,0,0,0
2023-10-01,AZE,Perlis,1,1,0
2023-10-01,AZE,Pulau Pinang,0,0,0
2023-10-01,AZE,Sabah,0,0,0
2023-10-01,AZE,Sarawak,0,0,0
2023-10-01,AZE,Selangor,133,70,63
2023-10-01,AZE,W.P. Labuan,0,0,0
2023-10-01,BDI,Pulau Pinang,0,0,0
2023-10-01,BDI,Sarawak,0,0,0
2023-10-01,BDI,Selangor,1,0,1
2023-10-01,BEL,Johor,277,189,88
2023-10-01,BEL,Kedah,58,27,31
2023-10-01,BEL,Kelantan,3,2,1
2023-10-01,BEL,Melaka,0,0,0
2023-10-01,BEL,Negeri Sembilan,0,0,0
2023-10-01,BEL,Pahang,0,0,0
2023-10-01,BEL,Perak,1,1,0
2023-10-01,BEL,Perlis,15,9,6
2023-10-01,BEL,Pulau Pinang,72,45,27
2023-10-01,BEL,Sabah,2,2,0
2023-10-01,BEL,Sarawak,20,9,11
2023-10-01,BEL,Selangor,1245,762,483
2023-10-01,BEL,W.P. Labuan,0,0,0
2023-10-01,BEN,Johor,3,3,0
2023-10-01,BEN,Kedah,0,0,0
2023-10-01,BEN,Perak,0,0,0
2023-10-01,BEN,Pulau Pinang,0,0,0
2023-10-01,BEN,Sabah,0,0,0
2023-10-01,BEN,Sarawak,0,0,0
2023-10-01,BEN,Selangor,8,6,2
2023-10-01,BFA,Perak,0,0,0
2023-10-01,BFA,Pulau Pinang,0,0,0
2023-10-01,BFA,Selangor,7,6,1
2023-10-01,BGD,Johor,3629,3020,609
2023-10-01,BGD,Kedah,129,83,46
2023-10-01,BGD,Kelantan,2,2,0
2023-10-01,BGD,Melaka,0,0,0
2023-10-01,BGD,Negeri Sembilan,0,0,0
2023-10-01,BGD,Pahang,0,0,0
2023-10-01,BGD,Perak,11,9,2
2023-10-01,BGD,Perlis,6,6,0
2023-10-01,BGD,Pulau Pinang,218,208,10
2023-10-01,BGD,Sabah,9,6,3
2023-10-01,BGD,Sarawak,38,31,7
2023-10-01,BGD,Selangor,39230,37522,1708
2023-10-01,BGD,W.P. Labuan,18,18,0
2023-10-01,BGR,Johor,32,18,14
2023-10-01,BGR,Kedah,6,3,3
2023-10-01,BGR,Kelantan,0,0,0
2023-10-01,BGR,Pahang,0,0,0
2023-10-01,BGR,Perak,0,0,0
2023-10-01,BGR,Perlis,1,1,0
2023-10-01,BGR,Pulau Pinang,9,6,3
2023-10-01,BGR,Sabah,0,0,0
2023-10-01,BGR,Sarawak,1,1,0
2023-10-01,BGR,Selangor,173,93,80
2023-10-01,BGR,W.P. Labuan,0,0,0
2023-10-01,BHR,Johor,18,13,5
2023-10-01,BHR,Kedah,2,1,1
2023-10-01,BHR,Kelantan,0,0,0
2023-10-01,BHR,Perlis,3,3,0
2023-10-01,BHR,Pulau Pinang,0,0,0
2023-10-01,BHR,Sabah,0,0,0
2023-10-01,BHR,Sarawak,0,0,0
2023-10-01,BHR,Selangor,175,122,53
2023-10-01,BHS,Johor,1,0,1
2023-10-01,BHS,Kedah,1,0,1
2023-10-01,BHS,Perak,0,0,0
2023-10-01,BHS,Sabah,0,0,0
2023-10-01,BHS,Sarawak,0,0,0
2023-10-01,BHS,Selangor,7,4,3
2023-10-01,BIH,Johor,9,6,3
2023-10-01,BIH,Kedah,0,0,0
2023-10-01,BIH,Perlis,1,1,0
2023-10-01,BIH,Pulau Pinang,0,0,0
2023-10-01,BIH,Sabah,0,0,0
2023-10-01,BIH,Sarawak,0,0,0
2023-10-01,BIH,Selangor,41,23,18
2023-10-01,BLR,Johor,24,11,13
2023-10-01,BLR,Kedah,12,6,6
2023-10-01,BLR,Kelantan,1,1,0
2023-10-01,BLR,Pahang,0,0,0
2023-10-01,BLR,Perak,0,0,0
2023-10-01,BLR,Perlis,1,0,1
2023-10-01,BLR,Pulau Pinang,6,3,3
2023-10-01,BLR,Sabah,0,0,0
2023-10-01,BLR,Sarawak,1,0,1
2023-10-01,BLR,Selangor,333,152,181
2023-10-01,BLR,W.P. Labuan,0,0,0
2023-10-01,BLZ,Johor,0,0,0
2023-10-01,BLZ,Pulau Pinang,0,0,0
2023-10-01,BLZ,Sarawak,0,0,0
2023-10-01,BLZ,Selangor,1,1,0
2023-10-01,BMU,Selangor,0,0,0
2023-10-01,BOL,Johor,2,1,1
2023-10-01,BOL,Kedah,0,0,0
2023-10-01,BOL,Melaka,0,0,0
2023-10-01,BOL,Perak,0,0,0
2023-10-01,BOL,Perlis,0,0,0
2023-10-01,BOL,Pulau Pinang,0,0,0
2023-10-01,BOL,Sabah,0,0,0
2023-10-01,BOL,Sarawak,0,0,0
2023-10-01,BOL,Selangor,277,139,138
2023-10-01,BRA,Johor,252,146,106
2023-10-01,BRA,Kedah,42,18,24
2023-10-01,BRA,Kelantan,2,1,1
2023-10-01,BRA,Melaka,0,0,0
2023-10-01,BRA,Pahang,0,0,0
2023-10-01,BRA,Perak,2,1,1
2023-10-01,BRA,Perlis,6,5,1
2023-10-01,BRA,Pulau Pinang,26,17,9
2023-10-01,BRA,Sabah,5,4,1
2023-10-01,BRA,Sarawak,9,7,2
2023-10-01,BRA,Selangor,1032,628,404
2023-10-01,BRA,W.P. Labuan,2,2,0
2023-10-01,BRB,Johor,2,2,0
2023-10-01,BRB,Kedah,0,0,0
2023-10-01,BRB,Perlis,0,0,0
2023-10-01,BRB,Pulau Pinang,0,0,0
2023-10-01,BRB,Selangor,5,3,2
2023-10-01,BRN,Johor,327,156,171
2023-10-01,BRN,Kedah,17,8,9
2023-10-01,BRN,Kelantan,9,8,1
2023-10-01,BRN,Melaka,0,0,0
2023-10-01,BRN,Pahang,0,0,0
2023-10-01,BRN,Perak,1,1,0
2023-10-01,BRN,Perlis,27,10,17
2023-10-01,BRN,Pulau Pinang,22,10,12
2023-10-01,BRN,Sabah,134,61,73
2023-10-01,BRN,Sarawak,58974,33361,25613
2023-10-01,BRN,Selangor,4375,2176,2199
2023-10-01,BRN,W.P. Labuan,871,646,225
2023-10-01,BTN,Johor,10,7,3
2023-10-01,BTN,Kedah,0,0,0
2023-10-01,BTN,Perak,0,0,0
2023-10-01,BTN,Perlis,0,0,0
2023-10-01,BTN,Pulau Pinang,0,0,0
2023-10-01,BTN,Sabah,0,0,0
2023-10-01,BTN,Sarawak,0,0,0
2023-10-01,BTN,Selangor,48,32,16
2023-10-01,BWA,Johor,2,2,0
2023-10-01,BWA,Kedah,0,0,0
2023-10-01,BWA,Perlis,0,0,0
2023-10-01,BWA,Pulau Pinang,0,0,0
2023-10-01,BWA,Sabah,0,0,0
2023-10-01,BWA,Sarawak,0,0,0
2023-10-01,BWA,Selangor,14,4,10
2023-10-01,CAF,Kedah,0,0,0
2023-10-01,CAF,Selangor,1,0,1
2023-10-01,CAN,Johor,1558,889,669
2023-10-01,CAN,Kedah,168,84,84
2023-10-01,CAN,Kelantan,0,0,0
2023-10-01,CAN,Melaka,0,0,0
2023-10-01,CAN,Negeri Sembilan,0,0,0
2023-10-01,CAN,Pahang,6,4,2
2023-10-01,CAN,Perak,34,20,14
2023-10-01,CAN,Perlis,41,28,13
2023-10-01,CAN,Pulau Pinang,479,266,213
2023-10-01,CAN,Sabah,46,28,18
2023-10-01,CAN,Sarawak,242,146,96
2023-10-01,CAN,Selangor,4518,2586,1932
2023-10-01,CAN,Terengganu,0,0,0
2023-10-01,CAN,W.P. Labuan,4,3,1
2023-10-01,CCK,Selangor,0,0,0
2023-10-01,CHE,Johor,403,246,157
2023-10-01,CHE,Kedah,106,58,48
2023-10-01,CHE,Kelantan,1,0,1
2023-10-01,CHE,Melaka,0,0,0
2023-10-01,CHE,Negeri Sembilan,0,0,0
2023-10-01,CHE,Pahang,1,1,0
2023-10-01,CHE,Perak,5,2,3
2023-10-01,CHE,Perlis,20,8,12
2023-10-01,CHE,Pulau Pinang,157,93,64
2023-10-01,CHE,Sabah,9,6,3
2023-10-01,CHE,Sarawak,47,22,25
2023-10-01,CHE,Selangor,1372,845,527
2023-10-01,CHE,W.P. Labuan,5,3,2
2023-10-01,CHL,Johor,40,17,23
2023-10-01,CHL,Kedah,9,3,6
2023-10-01,CHL,Kelantan,1,0,1
2023-10-01,CHL,Melaka,0,0,0
2023-10-01,CHL,Pahang,0,0,0
2023-10-01,CHL,Perak,0,0,0
2023-10-01,CHL,Perlis,2,1,1
2023-10-01,CHL,Pulau Pinang,10,5,5
2023-10-01,CHL,Sabah,0,0,0
2023-10-01,CHL,Sarawak,1,1,0
2023-10-01,CHL,Selangor,247,130,117
2023-10-01,CHN,Johor,48690,21231,27459
2023-10-01,CHN,Kedah,1156,521,635
2023-10-01,CHN,Kelantan,12,7,5
2023-10-01,CHN,Melaka,3,3,0
2023-10-01,CHN,Pahang,28,14,14
2023-10-01,CHN,Perak,237,97,140
2023-10-01,CHN,Perlis,94,53,41
2023-10-01,CHN,Pulau Pinang,9209,4790,4419
2023-10-01,CHN,Sabah,1575,765,810
2023-10-01,CHN,Sarawak,957,490,467
2023-10-01,CHN,Selangor,96676,49199,47477
2023-10-01,CHN,Terengganu,1,1,0
2023-10-01,CHN,W.P. Labuan,44,39,5
2023-10-01,CIV,Johor,2,2,0
2023-10-01,CIV,Kedah,0,0,0
2023-10-01,CIV,Pulau Pinang,0,0,0
2023-10-01,CIV,Sabah,0,0,0
2023-10-01,CIV,Sarawak,0,0,0
2023-10-01,CIV,Selangor,16,11,5
2023-10-01,CMR,Johor,2,2,0
2023-10-01,CMR,Kedah,1,1,0
2023-10-01,CMR,Pulau Pinang,0,0,0
2023-10-01,CMR,Sabah,1,1,0
2023-10-01,CMR,Sarawak,0,0,0
2023-10-01,CMR,Selangor,25,20,5
2023-10-01,COD,Johor,3,3,0
2023-10-01,COD,Pulau Pinang,0,0,0
2023-10-01,COD,Sarawak,0,0,0
2023-10-01,COD,Selangor,13,10,3
2023-10-01,COG,Johor,0,0,0
2023-10-01,COG,Kedah,0,0,0
2023-10-01,COG,Selangor,17,14,3
2023-10-01,COK,Selangor,0,0,0
2023-10-01,COL,Johor,47,33,14
2023-10-01,COL,Kedah,8,3,5
2023-10-01,COL,Perak,0,0,0
2023-10-01,COL,Pulau Pinang,6,3,3
2023-10-01,COL,Sabah,2,1,1
2023-10-01,COL,Sarawak,1,1,0
2023-10-01,COL,Selangor,241,127,114
2023-10-01,COL,W.P. Labuan,1,1,0
2023-10-01,COM,Johor,0,0,0
2023-10-01,COM,Kedah,0,0,0
2023-10-01,COM,Selangor,21,13,8
2023-10-01,CPV,Johor,0,0,0
2023-10-01,CPV,Kedah,0,0,0
2023-10-01,CPV,Pulau Pinang,0,0,0
2023-10-01,CPV,Sabah,0,0,0
2023-10-01,CPV,Selangor,5,2,3
2023-10-01,CRI,Johor,22,15,7
2023-10-01,CRI,Kedah,3,1,2
2023-10-01,CRI,Perak,0,0,0
2023-10-01,CRI,Perlis,0,0,0
2023-10-01,CRI,Pulau Pinang,13,7,6
2023-10-01,CRI,Sabah,0,0,0
2023-10-01,CRI,Sarawak,3,3,0
2023-10-01,CRI,Selangor,58,33,25
2023-10-01,CUB,Johor,5,3,2
2023-10-01,CUB,Kedah,0,0,0
2023-10-01,CUB,Perlis,0,0,0
2023-10-01,CUB,Pulau Pinang,0,0,0
2023-10-01,CUB,Sabah,0,0,0
2023-10-01,CUB,Sarawak,0,0,0
2023-10-01,CUB,Selangor,13,6,7
2023-10-01,CYP,Johor,20,14,6
2023-10-01,CYP,Kedah,0,0,0
2023-10-01,CYP,Perak,0,0,0
2023-10-01,CYP,Perlis,0,0,0
2023-10-01,CYP,Pulau Pinang,2,1,1
2023-10-01,CYP,Sabah,0,0,0
2023-10-01,CYP,Sarawak,1,0,1
2023-10-01,CYP,Selangor,73,42,31
2023-10-01,CZE,Johor,81,41,40
2023-10-01,CZE,Kedah,39,18,21
2023-10-01,CZE,Kelantan,0,0,0
2023-10-01,CZE,Melaka,0,0,0
2023-10-01,CZE,Negeri Sembilan,0,0,0
2023-10-01,CZE,Perak,0,0,0
2023-10-01,CZE,Perlis,2,1,1
2023-10-01,CZE,Pulau Pinang,11,5,6
2023-10-01,CZE,Sabah,2,1,1
2023-10-01,CZE,Sarawak,5,5,0
2023-10-01,CZE,Selangor,503,302,201
2023-10-01,CZE,W.P. Labuan,0,0,0
2023-10-01,DEU,Johor,2566,1575,991
2023-10-01,DEU,Kedah,368,197,171
2023-10-01,DEU,Kelantan,16,10,6
2023-10-01,DEU,Melaka,3,1,2
2023-10-01,DEU,Negeri Sembilan,1,1,0
2023-10-01,DEU,Pahang,12,10,2
2023-10-01,DEU,Perak,39,21,18
2023-10-01,DEU,Perlis,68,41,27
2023-10-01,DEU,Pulau Pinang,786,540,246
2023-10-01,DEU,Sabah,31,16,15
2023-10-01,DEU,Sarawak,230,153,77
2023-10-01,DEU,Selangor,6844,4246,2598
2023-10-01,DEU,Terengganu,0,0,0
2023-10-01,DEU,W.P. Labuan,5,2,3
2023-10-01,DJI,Johor,1,1,0
2023-10-01,DJI,Selangor,12,8,4
2023-10-01,DMA,Johor,4,3,1
2023-10-01,DMA,Kedah,0,0,0
2023-10-01,DMA,Pulau Pinang,0,0,0
2023-10-01,DMA,Sabah,0,0,0
2023-10-01,DMA,Sarawak,0,0,0
2023-10-01,DMA,Selangor,44,38,6
2023-10-01,DMA,W.P. Labuan,0,0,0
2023-10-01,DNK,Johor,358,243,115
2023-10-01,DNK,Kedah,46,28,18
2023-10-01,DNK,Kelantan,0,0,0
2023-10-01,DNK,Melaka,0,0,0
2023-10-01,DNK,Negeri Sembilan,0,0,0
2023-10-01,DNK,Pahang,0,0,0
2023-10-01,DNK,Perak,0,0,0
2023-10-01,DNK,Perlis,6,4,2
2023-10-01,DNK,Pulau Pinang,62,39,23
2023-10-01,DNK,Sabah,16,8,8
2023-10-01,DNK,Sarawak,17,9,8
2023-10-01,DNK,Selangor,1113,654,459
2023-10-01,DNK,W.P. Labuan,0,0,0
2023-10-01,DOM,Johor,0,0,0
2023-10-01,DOM,Kedah,0,0,0
2023-10-01,DOM,Perak,0,0,0
2023-10-01,DOM,Perlis,0,0,0
2023-10-01,DOM,Pulau Pinang,2,1,1
2023-10-01,DOM,Sabah,0,0,0
2023-10-01,DOM,Sarawak,0,0,0
2023-10-01,DOM,Selangor,20,9,11
2023-10-01,DZA,Johor,34,21,13
2023-10-01,DZA,Kedah,2,2,0
2023-10-01,DZA,Kelantan,1,1,0
2023-10-01,DZA,Melaka,0,0,0
2023-10-01,DZA,Perak,0,0,0
2023-10-01,DZA,Perlis,0,0,0
2023-10-01,DZA,Pulau Pinang,2,1,1
2023-10-01,DZA,Sabah,0,0,0
2023-10-01,DZA,Sarawak,2,2,0
2023-10-01,DZA,Selangor,1145,741,404
2023-10-01,DZA,W.P. Labuan,0,0,0
2023-10-01,ECU,Johor,9,5,4
2023-10-01,ECU,Kedah,1,1,0
2023-10-01,ECU,Perak,0,0,0
2023-10-01,ECU,Perlis,0,0,0
2023-10-01,ECU,Pulau Pinang,0,0,0
2023-10-01,ECU,Sabah,0,0,0
2023-10-01,ECU,Sarawak,0,0,0
2023-10-01,ECU,Selangor,72,42,30
2023-10-01,EGY,Johor,239,211,28
2023-10-01,EGY,Kedah,5,4,1
2023-10-01,EGY,Kelantan,2,2,0
2023-10-01,EGY,Melaka,0,0,0
2023-10-01,EGY,Pahang,0,0,0
2023-10-01,EGY,Perak,1,0,1
2023-10-01,EGY,Perlis,1,1,0
2023-10-01,EGY,Pulau Pinang,9,9,0
2023-10-01,EGY,Sabah,1,1,0
2023-10-01,EGY,Sarawak,73,41,32
2023-10-01,EGY,Selangor,2259,1559,700
2023-10-01,EGY,Terengganu,0,0,0
2023-10-01,EGY,W.P. Labuan,0,0,0
2023-10-01,ERI,Johor,0,0,0
2023-10-01,ERI,Pulau Pinang,0,0,0
2023-10-01,ERI,Sabah,0,0,0
2023-10-01,ERI,Selangor,13,10,3
2023-10-01,ESP,Johor,586,340,246
2023-10-01,ESP,Kedah,109,57,52
2023-10-01,ESP,Kelantan,8,4,4
2023-10-01,ESP,Melaka,0,0,0
2023-10-01,ESP,Negeri Sembilan,0,0,0
2023-10-01,ESP,Pahang,3,2,1
2023-10-01,ESP,Perak,8,5,3
2023-10-01,ESP,Perlis,15,9,6
2023-10-01,ESP,Pulau Pinang,112,73,39
2023-10-01,ESP,Sabah,13,5,8
2023-10-01,ESP,Sarawak,60,35,25
2023-10-01,ESP,Selangor,3213,1795,1418
2023-10-01,ESP,W.P. Labuan,2,1,1
2023-10-01,EST,Johor,23,11,12
2023-10-01,EST,Kedah,27,14,13
2023-10-01,EST,Kelantan,0,0,0
2023-10-01,EST,Pahang,0,0,0
2023-10-01,EST,Perak,0,0,0
2023-10-01,EST,Perlis,0,0,0
2023-10-01,EST,Pulau Pinang,9,3,6
2023-10-01,EST,Sabah,3,2,1
2023-10-01,EST,Sarawak,3,2,1
2023-10-01,EST,Selangor,198,101,97
2023-10-01,EST,W.P. Labuan,1,0,1
2023-10-01,ETH,Johor,0,0,0
2023-10-01,ETH,Kedah,0,0,0
2023-10-01,ETH,Pulau Pinang,0,0,0
2023-10-01,ETH,Sarawak,0,0,0
2023-10-01,ETH,Selangor,61,42,19
2023-10-01,FIN,Johor,203,113,90
2023-10-01,FIN,Kedah,37,20,17
2023-10-01,FIN,Kelantan,0,0,0
2023-10-01,FIN,Melaka,0,0,0
2023-10-01,FIN,Negeri Sembilan,0,0,0
2023-10-01,FIN,Pahang,0,0,0
2023-10-01,FIN,Perak,5,3,2
2023-10-01,FIN,Perlis,2,2,0
2023-10-01,FIN,Pulau Pinang,62,31,31
2023-10-01,FIN,Sabah,1,1,0
2023-10-01,FIN,Sarawak,10,6,4
2023-10-01,FIN,Selangor,470,255,215
2023-10-01,FIN,W.P. Labuan,0,0,0
2023-10-01,FJI,Johor,63,34,29
2023-10-01,FJI,Kedah,3,3,0
2023-10-01,FJI,Kelantan,0,0,0
2023-10-01,FJI,Perak,0,0,0
2023-10-01,FJI,Perlis,0,0,0
2023-10-01,FJI,Pulau Pinang,6,4,2
2023-10-01,FJI,Sabah,0,0,0
2023-10-01,FJI,Sarawak,1,1,0
2023-10-01,FJI,Selangor,166,76,90
2023-10-01,FRA,Johor,2135,1285,850
2023-10-01,FRA,Kedah,322,169,153
2023-10-01,FRA,Kelantan,24,16,8
2023-10-01,FRA,Melaka,7,4,3
2023-10-01,FRA,Negeri Sembilan,3,0,3
2023-10-01,FRA,Pahang,24,14,10
2023-10-01,FRA,Perak,27,22,5
2023-10-01,FRA,Perlis,45,29,16
2023-10-01,FRA,Pulau Pinang,329,207,122
2023-10-01,FRA,Sabah,34,25,9
2023-10-01,FRA,Sarawak,80,50,30
2023-10-01,FRA,Selangor,7994,4822,3172
2023-10-01,FRA,Terengganu,0,0,0
2023-10-01,FRA,W.P. Labuan,6,3,3
2023-10-01,FSM,Johor,0,0,0
2023-10-01,FSM,Pulau Pinang,0,0,0
2023-10-01,FSM,Selangor,1,0,1
2023-10-01,GAB,Johor,1,0,1
2023-10-01,GAB,Pulau Pinang,0,0,0
2023-10-01,GAB,Sarawak,0,0,0
2023-10-01,GAB,Selangor,10,4,6
2023-10-01,GBR,Johor,5482,3422,2060
2023-10-01,GBR,Kedah,747,413,334
2023-10-01,GBR,Kelantan,23,14,9
2023-10-01,GBR,Melaka,1,1,0
2023-10-01,GBR,Negeri Sembilan,2,2,0
2023-10-01,GBR,Pahang,35,25,10
2023-10-01,GBR,Perak,86,58,28
2023-10-01,GBR,Perlis,122,76,46
2023-10-01,GBR,Pulau Pinang,1587,957,630
2023-10-01,GBR,Sabah,106,58,48
2023-10-01,GBR,Sarawak,991,585,406
2023-10-01,GBR,Selangor,17730,10854,6876
2023-10-01,GBR,Terengganu,0,0,0
2023-10-01,GBR,W.P. Labuan,45,35,10
2023-10-01,GEO,Johor,3,2,1
2023-10-01,GEO,Kedah,2,1,1
2023-10-01,GEO,Melaka,0,0,0
2023-10-01,GEO,Perak,0,0,0
2023-10-01,GEO,Perlis,0,0,0
2023-10-01,GEO,Pulau Pinang,4,2,2
2023-10-01,GEO,Sabah,2,1,1
2023-10-01,GEO,Sarawak,0,0,0
2023-10-01,GEO,Selangor,42,24,18
2023-10-01,GHA,Johor,8,7,1
2023-10-01,GHA,Kedah,0,0,0
2023-10-01,GHA,Kelantan,0,0,0
2023-10-01,GHA,Pulau Pinang,0,0,0
2023-10-01,GHA,Sabah,0,0,0
2023-10-01,GHA,Sarawak,0,0,0
2023-10-01,GHA,Selangor,94,59,35
2023-10-01,GIB,Johor,1,0,1
2023-10-01,GIB,Sarawak,0,0,0
2023-10-01,GIN,Johor,4,2,2
2023-10-01,GIN,Kedah,1,1,0
2023-10-01,GIN,Kelantan,1,1,0
2023-10-01,GIN,Perlis,0,0,0
2023-10-01,GIN,Pulau Pinang,0,0,0
2023-10-01,GIN,Sabah,0,0,0
2023-10-01,GIN,Sarawak,0,0,0
2023-10-01,GIN,Selangor,57,37,20
2023-10-01,GLP,Selangor,0,0,0
2023-10-01,GMB,Johor,4,4,0
2023-10-01,GMB,Kedah,0,0,0
2023-10-01,GMB,Kelantan,0,0,0
2023-10-01,GMB,Pulau Pinang,0,0,0
2023-10-01,GMB,Sabah,2,2,0
2023-10-01,GMB,Sarawak,0,0,0
2023-10-01,GMB,Selangor,34,25,9
2023-10-01,GNB,Johor,0,0,0
2023-10-01,GNB,Selangor,0,0,0
2023-10-01,GNQ,Johor,1,1,0
2023-10-01,GNQ,Selangor,2,1,1
2023-10-01,GRC,Johor,80,62,18
2023-10-01,GRC,Kedah,1,0,1
2023-10-01,GRC,Kelantan,0,0,0
2023-10-01,GRC,Melaka,0,0,0
2023-10-01,GRC,Negeri Sembilan,1,1,0
2023-10-01,GRC,Pahang,0,0,0
2023-10-01,GRC,Perak,0,0,0
2023-10-01,GRC,Perlis,1,1,0
2023-10-01,GRC,Pulau Pinang,13,11,2
2023-10-01,GRC,Sabah,3,2,1
2023-10-01,GRC,Sarawak,19,13,6
2023-10-01,GRC,Selangor,251,174,77
2023-10-01,GRD,Johor,11,4,7
2023-10-01,GRD,Kedah,0,0,0
2023-10-01,GRD,Pulau Pinang,1,1,0
2023-10-01,GRD,Sabah,0,0,0
2023-10-01,GRD,Sarawak,0,0,0
2023-10-01,GRD,Selangor,20,17,3
2023-10-01,GRL,Johor,0,0,0
2023-10-01,GRL,Selangor,0,0,0
2023-10-01,GTM,Johor,2,2,0
2023-10-01,GTM,Kedah,0,0,0
2023-10-01,GTM,Pahang,0,0,0
2023-10-01,GTM,Perak,0,0,0
2023-10-01,GTM,Pulau Pinang,1,1,0
2023-10-01,GTM,Sabah,0,0,0
2023-10-01,GTM,Sarawak,0,0,0
2023-10-01,GTM,Selangor,45,24,21
2023-10-01,GTM,W.P. Labuan,0,0,0
2023-10-01,GUY,Johor,0,0,0
2023-10-01,GUY,Kedah,0,0,0
2023-10-01,GUY,Pulau Pinang,0,0,0
2023-10-01,GUY,Sarawak,0,0,0
2023-10-01,GUY,Selangor,3,0,3
2023-10-01,HKG,Johor,6,5,1
2023-10-01,HKG,Kedah,0,0,0
2023-10-01,HKG,Kelantan,0,0,0
2023-10-01,HKG,Pahang,2,2,0
2023-10-01,HKG,Perak,21,10,11
2023-10-01,HKG,Perlis,0,0,0
2023-10-01,HKG,Pulau Pinang,0,0,0
2023-10-01,HKG,Sabah,0,0,0
2023-10-01,HKG,Sarawak,0,0,0
2023-10-01,HKG,Selangor,2,1,1
2023-10-01,HKG,Terengganu,1,1,0
2023-10-01,HMD,Johor,0,0,0
2023-10-01,HND,Johor,3,3,0
2023-10-01,HND,Kedah,1,1,0
2023-10-01,HND,Perak,0,0,0
2023-10-01,HND,Pulau Pinang,0,0,0
2023-10-01,HND,Sabah,0,0,0
2023-10-01,HND,Sarawak,0,0,0
2023-10-01,HND,Selangor,21,13,8
2023-10-01,HRV,Johor,49,37,12
2023-10-01,HRV,Kedah,1,1,0
2023-10-01,HRV,Kelantan,0,0,0
2023-10-01,HRV,Melaka,0,0,0
2023-10-01,HRV,Pahang,2,2,0
2023-10-01,HRV,Perak,0,0,0
2023-10-01,HRV,Perlis,0,0,0
2023-10-01,HRV,Pulau Pinang,7,3,4
2023-10-01,HRV,Sabah,0,0,0
2023-10-01,HRV,Sarawak,0,0,0
2023-10-01,HRV,Selangor,201,135,66
2023-10-01,HTI,Johor,1,1,0
2023-10-01,HTI,Kedah,0,0,0
2023-10-01,HTI,Kelantan,0,0,0
2023-10-01,HTI,Perak,0,0,0
2023-10-01,HTI,Pulau Pinang,0,0,0
2023-10-01,HTI,Sabah,0,0,0
2023-10-01,HTI,Selangor,4,4,0
2023-10-01,HUN,Johor,106,66,40
2023-10-01,HUN,Kedah,21,10,11
2023-10-01,HUN,Kelantan,0,0,0
2023-10-01,HUN,Pahang,0,0,0
2023-10-01,HUN,Perak,3,3,0
2023-10-01,HUN,Perlis,2,1,1
2023-10-01,HUN,Pulau Pinang,24,15,9
2023-10-01,HUN,Sabah,2,1,1
2023-10-01,HUN,Sarawak,7,4,3
2023-10-01,HUN,Selangor,492,268,224
2023-10-01,HUN,W.P. Labuan,0,0,0
2023-10-01,IDN,Johor,93484,43240,50244
2023-10-01,IDN,Kedah,6462,2392,4070
2023-10-01,IDN,Kelantan,278,133,145
2023-10-01,IDN,Melaka,3476,1526,1950
2023-10-01,IDN,Negeri Sembilan,5078,3032,2046
2023-10-01,IDN,Pahang,16,11,5
2023-10-01,IDN,Perak,262,122,140
2023-10-01,IDN,Perlis,616,315,301
2023-10-01,IDN,Pulau Pinang,38534,15377,23157
2023-10-01,IDN,Sabah,3845,1995,1850
2023-10-01,IDN,Sarawak,34683,18599,16084
2023-10-01,IDN,Selangor,126287,59676,66611
2023-10-01,IDN,Terengganu,0,0,0
2023-10-01,IDN,W.P. Labuan,55,37,18
2023-10-01,IND,Johor,26747,18215,8532
2023-10-01,IND,Kedah,1245,660,585
2023-10-01,IND,Kelantan,3,3,0
2023-10-01,IND,Melaka,2,2,0
2023-10-01,IND,Negeri Sembilan,2,2,0
2023-10-01,IND,Pahang,10,9,1
2023-10-01,IND,Perak,151,115,36
2023-10-01,IND,Perlis,30,26,4
2023-10-01,IND,Pulau Pinang,920,675,245
2023-10-01,IND,Sabah,96,76,20
2023-10-01,IND,Sarawak,1091,938,153
2023-10-01,IND,Selangor,52719,35647,17072
2023-10-01,IND,Terengganu,0,0,0
2023-10-01,IND,W.P. Labuan,28,27,1
2023-10-01,IOT,Pulau Pinang,0,0,0
2023-10-01,IOT,Selangor,0,0,0
2023-10-01,IRL,Johor,297,187,110
2023-10-01,IRL,Kedah,58,29,29
2023-10-01,IRL,Kelantan,2,1,1
2023-10-01,IRL,Negeri Sembilan,0,0,0
2023-10-01,IRL,Pahang,0,0,0
2023-10-01,IRL,Perak,7,5,2
2023-10-01,IRL,Perlis,13,9,4
2023-10-01,IRL,Pulau Pinang,91,57,34
2023-10-01,IRL,Sabah,6,3,3
2023-10-01,IRL,Sarawak,43,22,21
2023-10-01,IRL,Selangor,1375,818,557
2023-10-01,IRL,Terengganu,0,0,0
2023-10-01,IRL,W.P. Labuan,1,0,1
2023-10-01,IRN,Johor,314,163,151
2023-10-01,IRN,Kedah,12,8,4
2023-10-01,IRN,Kelantan,0,0,0
2023-10-01,IRN,Perak,0,0,0
2023-10-01,IRN,Perlis,3,2,1
2023-10-01,IRN,Pulau Pinang,6,2,4
2023-10-01,IRN,Sabah,0,0,0
2023-10-01,IRN,Sarawak,2,2,0
2023-10-01,IRN,Selangor,1857,1000,857
2023-10-01,IRN,W.P. Labuan,0,0,0
2023-10-01,IRQ,Johor,22,14,8
2023-10-01,IRQ,Kedah,4,1,3
2023-10-01,IRQ,Kelantan,0,0,0
2023-10-01,IRQ,Melaka,0,0,0
2023-10-01,IRQ,Pahang,0,0,0
2023-10-01,IRQ,Perak,0,0,0
2023-10-01,IRQ,Perlis,0,0,0
2023-10-01,IRQ,Pulau Pinang,6,5,1
2023-10-01,IRQ,Sabah,1,1,0
2023-10-01,IRQ,Sarawak,4,2,2
2023-10-01,IRQ,Selangor,1482,1030,452
2023-10-01,ISL,Johor,3,2,1
2023-10-01,ISL,Kedah,0,0,0
2023-10-01,ISL,Kelantan,0,0,0
2023-10-01,ISL,Perak,2,1,1
2023-10-01,ISL,Perlis,2,0,2
2023-10-01,ISL,Pulau Pinang,1,1,0
2023-10-01,ISL,Sabah,1,0,1
2023-10-01,ISL,Sarawak,2,2,0
2023-10-01,ISL,Selangor,19,10,9
2023-10-01,ISL,W.P. Labuan,0,0,0
2023-10-01,ISR,Pulau Pinang,0,0,0
2023-10-01,ITA,Johor,600,427,173
2023-10-01,ITA,Kedah,87,54,33
2023-10-01,ITA,Kelantan,4,3,1
2023-10-01,ITA,Melaka,2,1,1
2023-10-01,ITA,Negeri Sembilan,0,0,0
2023-10-01,ITA,Pahang,5,3,2
2023-10-01,ITA,Perak,6,4,2
2023-10-01,ITA,Perlis,13,10,3
2023-10-01,ITA,Pulau Pinang,129,97,32
2023-10-01,ITA,Sabah,10,5,5
2023-10-01,ITA,Sarawak,34,20,14
2023-10-01,ITA,Selangor,2554,1749,805
2023-10-01,ITA,W.P. Labuan,2,2,0
2023-10-01,JAM,Johor,8,1,7
2023-10-01,JAM,Kedah,0,0,0
2023-10-01,JAM,Perak,0,0,0
2023-10-01,JAM,Pulau Pinang,0,0,0
2023-10-01,JAM,Sabah,0,0,0
2023-10-01,JAM,Sarawak,0,0,0
2023-10-01,JAM,Selangor,18,5,13
2023-10-01,JAM,W.P. Labuan,0,0,0
2023-10-01,JOR,Johor,31,19,12
2023-10-01,JOR,Kedah,5,2,3
2023-10-01,JOR,Kelantan,0,0,0
2023-10-01,JOR,Melaka,0,0,0
2023-10-01,JOR,Perlis,4,2,2
2023-10-01,JOR,Pulau Pinang,1,0,1
2023-10-01,JOR,Sabah,0,0,0
2023-10-01,JOR,Sarawak,1,1,0
2023-10-01,JOR,Selangor,896,548,348
2023-10-01,JOR,W.P. Labuan,0,0,0
2023-10-01,JPN,Johor,7275,4752,2523
2023-10-01,JPN,Kedah,204,116,88
2023-10-01,JPN,Kelantan,6,4,2
2023-10-01,JPN,Melaka,3,2,1
2023-10-01,JPN,Negeri Sembilan,0,0,0
2023-10-01,JPN,Pahang,10,7,3
2023-10-01,JPN,Perak,36,25,11
2023-10-01,JPN,Perlis,52,42,10
2023-10-01,JPN,Pulau Pinang,1246,911,335
2023-10-01,JPN,Sabah,66,36,30
2023-10-01,JPN,Sarawak,204,129,75
2023-10-01,JPN,Selangor,19869,12610,7259
2023-10-01,JPN,W.P. Labuan,13,9,4
2023-10-01,KAZ,Johor,71,29,42
2023-10-01,KAZ,Kedah,10,2,8
2023-10-01,KAZ,Kelantan,5,0,5
2023-10-01,KAZ,Melaka,0,0,0
2023-10-01,KAZ,Perak,0,0,0
2023-10-01,KAZ,Perlis,6,2,4
2023-10-01,KAZ,Pulau Pinang,3,1,2
2023-10-01,KAZ,Sabah,3,2,1
2023-10-01,KAZ,Sarawak,5,3,2
2023-10-01,KAZ,Selangor,780,321,459
2023-10-01,KAZ,W.P. Labuan,0,0,0
2023-10-01,KEN,Johor,52,22,30
2023-10-01,KEN,Kedah,3,1,2
2023-10-01,KEN,Kelantan,0,0,0
2023-10-01,KEN,Perak,0,0,0
2023-10-01,KEN,Perlis,1,0,1
2023-10-01,KEN,Pulau Pinang,1,0,1
2023-10-01,KEN,Sabah,2,2,0
2023-10-01,KEN,Sarawak,1,0,1
2023-10-01,KEN,Selangor,530,271,259
2023-10-01,KGZ,Johor,46,31,15
2023-10-01,KGZ,Kedah,2,1,1
2023-10-01,KGZ,Kelantan,0,0,0
2023-10-01,KGZ,Perak,0,0,0
2023-10-01,KGZ,Perlis,0,0,0
2023-10-01,KGZ,Pulau Pinang,2,1,1
2023-10-01,KGZ,Sabah,0,0,0
2023-10-01,KGZ,Sarawak,0,0,0
2023-10-01,KGZ,Selangor,237,116,121
2023-10-01,KHM,Johor,2180,960,1220
2023-10-01,KHM,Kedah,123,53,70
2023-10-01,KHM,Kelantan,434,228,206
2023-10-01,KHM,Melaka,0,0,0
2023-10-01,KHM,Negeri Sembilan,0,0,0
2023-10-01,KHM,Pahang,0,0,0
2023-10-01,KHM,Perak,3,2,1
2023-10-01,KHM,Perlis,672,386,286
2023-10-01,KHM,Pulau Pinang,44,20,24
2023-10-01,KHM,Sabah,2,0,2
2023-10-01,KHM,Sarawak,18,11,7
2023-10-01,KHM,Selangor,4039,1962,2077
2023-10-01,KHM,W.P. Labuan,0,0,0
2023-10-01,KIR,Johor,0,0,0
2023-10-01,KIR,Sabah,0,0,0
2023-10-01,KIR,Selangor,0,0,0
2023-10-01,KNA,Johor,21,14,7
2023-10-01,KNA,Kedah,2,1,1
2023-10-01,KNA,Perlis,0,0,0
2023-10-01,KNA,Pulau Pinang,2,2,0
2023-10-01,KNA,Sabah,0,0,0
2023-10-01,KNA,Selangor,70,52,18
2023-10-01,KNA,W.P. Labuan,0,0,0
2023-10-01,KOR,Johor,10225,5654,4571
2023-10-01,KOR,Kedah,198,99,99
2023-10-01,KOR,Kelantan,2,0,2
2023-10-01,KOR,Melaka,4,2,2
2023-10-01,KOR,Negeri Sembilan,0,0,0
2023-10-01,KOR,Pahang,3,0,3
2023-10-01,KOR,Perak,20,14,6
2023-10-01,KOR,Perlis,61,36,25
2023-10-01,KOR,Pulau Pinang,572,323,249
2023-10-01,KOR,Sabah,372,190,182
2023-10-01,KOR,Sarawak,258,159,99
2023-10-01,KOR,Selangor,13234,7452,5782
2023-10-01,KOR,Terengganu,0,0,0
2023-10-01,KOR,W.P. Labuan,3,3,0
2023-10-01,KWT,Johor,11,5,6
2023-10-01,KWT,Kedah,2,2,0
2023-10-01,KWT,Kelantan,0,0,0
2023-10-01,KWT,Perak,0,0,0
2023-10-01,KWT,Perlis,0,0,0
2023-10-01,KWT,Pulau Pinang,2,1,1
2023-10-01,KWT,Sabah,0,0,0
2023-10-01,KWT,Sarawak,0,0,0
2023-10-01,KWT,Selangor,410,267,143
2023-10-01,KWT,W.P. Labuan,0,0,0
2023-10-01,LAO,Johor,232,64,168
2023-10-01,LAO,Kedah,906,61,845
2023-10-01,LAO,Kelantan,160,12,148
2023-10-01,LAO,Melaka,0,0,0
2023-10-01,LAO,Perak,33,3,30
2023-10-01,LAO,Perlis,414,69,345
2023-10-01,LAO,Pulau Pinang,22,11,11
2023-10-01,LAO,Sabah,2,0,2
2023-10-01,LAO,Sarawak,14,9,5
2023-10-01,LAO,Selangor,358,159,199
2023-10-01,LAO,W.P. Labuan,0,0,0
2023-10-01,LBN,Johor,26,12,14
2023-10-01,LBN,Kedah,0,0,0
2023-10-01,LBN,Kelantan,0,0,0
2023-10-01,LBN,Pahang,0,0,0
2023-10-01,LBN,Perak,1,1,0
2023-10-01,LBN,Perlis,0,0,0
2023-10-01,LBN,Pulau Pinang,0,0,0
2023-10-01,LBN,Sabah,0,0,0
2023-10-01,LBN,Sarawak,2,2,0
2023-10-01,LBN,Selangor,284,195,89
2023-10-01,LBN,W.P. Labuan,0,0,0
2023-10-01,LBR,Johor,3,2,1
2023-10-01,LBR,Kedah,0,0,0
2023-10-01,LBR,Sabah,0,0,0
2023-10-01,LBR,Sarawak,0,0,0
2023-10-01,LBR,Selangor,9,7,2
2023-10-01,LBY,Johor,7,5,2
2023-10-01,LBY,Kedah,0,0,0
2023-10-01,LBY,Perlis,0,0,0
2023-10-01,LBY,Pulau Pinang,0,0,0
2023-10-01,LBY,Sabah,0,0,0
2023-10-01,LBY,Sarawak,3,3,0
2023-10-01,LBY,Selangor,437,313,124
2023-10-01,LCA,Johor,6,6,0
2023-10-01,LCA,Kedah,0,0,0
2023-10-01,LCA,Pulau Pinang,1,1,0
2023-10-01,LCA,Sarawak,2,1,1
2023-10-01,LCA,Selangor,7,6,1
2023-10-01,LIE,Johor,5,2,3
2023-10-01,LIE,Kedah,1,0,1
2023-10-01,LIE,Perlis,0,0,0
2023-10-01,LIE,Pulau Pinang,2,2,0
2023-10-01,LIE,Sabah,0,0,0
2023-10-01,LIE,Sarawak,0,0,0
2023-10-01,LIE,Selangor,9,1,8
2023-10-01,LKA,Johor,1196,770,426
2023-10-01,LKA,Kedah,55,35,20
2023-10-01,LKA,Kelantan,0,0,0
2023-10-01,LKA,Melaka,1,1,0
2023-10-01,LKA,Pahang,0,0,0
2023-10-01,LKA,Perak,8,6,2
2023-10-01,LKA,Perlis,1,1,0
2023-10-01,LKA,Pulau Pinang,42,27,15
2023-10-01,LKA,Sabah,3,2,1
2023-10-01,LKA,Sarawak,49,31,18
2023-10-01,LKA,Selangor,4199,2712,1487
2023-10-01,LKA,W.P. Labuan,0,0,0
2023-10-01,LSO,Johor,1,0,1
2023-10-01,LSO,Kedah,1,0,1
2023-10-01,LSO,Pulau Pinang,0,0,0
2023-10-01,LSO,Sarawak,0,0,0
2023-10-01,LSO,Selangor,9,4,5
2023-10-01,LTU,Johor,89,42,47
2023-10-01,LTU,Kedah,25,14,11
2023-10-01,LTU,Kelantan,0,0,0
2023-10-01,LTU,Pahang,0,0,0
2023-10-01,LTU,Perak,0,0,0
2023-10-01,LTU,Perlis,1,1,0
2023-10-01,LTU,Pulau Pinang,4,0,4
2023-10-01,LTU,Sabah,6,1,5
2023-10-01,LTU,Sarawak,4,3,1
2023-10-01,LTU,Selangor,332,180,152
2023-10-01,LTU,W.P. Labuan,14,5,9
2023-10-01,LUX,Johor,9,7,2
2023-10-01,LUX,Kedah,7,4,3
2023-10-01,LUX,Kelantan,0,0,0
2023-10-01,LUX,Perak,0,0,0
2023-10-01,LUX,Perlis,0,0,0
2023-10-01,LUX,Pulau Pinang,3,3,0
2023-10-01,LUX,Sabah,0,0,0
2023-10-01,LUX,Sarawak,0,0,0
2023-10-01,LUX,Selangor,57,36,21
2023-10-01,LVA,Johor,32,13,19
2023-10-01,LVA,Kedah,7,2,5
2023-10-01,LVA,Kelantan,0,0,0
2023-10-01,LVA,Pahang,0,0,0
2023-10-01,LVA,Perak,0,0,0
2023-10-01,LVA,Perlis,0,0,0
2023-10-01,LVA,Pulau Pinang,1,0,1
2023-10-01,LVA,Sabah,2,0,2
2023-10-01,LVA,Sarawak,1,0,1
2023-10-01,LVA,Selangor,169,88,81
2023-10-01,LVA,W.P. Labuan,6,2,4
2023-10-01,MAC,Johor,0,0,0
2023-10-01,MAC,Pahang,0,0,0
2023-10-01,MAC,Perak,1,1,0
2023-10-01,MAC,Selangor,0,0,0
2023-10-01,MAC,W.P. Labuan,0,0,0
2023-10-01,MAR,Johor,78,45,33
2023-10-01,MAR,Kedah,8,5,3
2023-10-01,MAR,Kelantan,2,2,0
2023-10-01,MAR,Melaka,0,0,0
2023-10-01,MAR,Pahang,0,0,0
2023-10-01,MAR,Perak,0,0,0
2023-10-01,MAR,Perlis,5,4,1
2023-10-01,MAR,Pulau Pinang,13,9,4
2023-10-01,MAR,Sabah,0,0,0
2023-10-01,MAR,Sarawak,2,2,0
2023-10-01,MAR,Selangor,1357,693,664
2023-10-01,MAR,W.P. Labuan,0,0,0
2023-10-01,MCO,Johor,0,0,0
2023-10-01,MCO,Kedah,0,0,0
2023-10-01,MCO,Sabah,0,0,0
2023-10-01,MCO,Selangor,1,1,0
2023-10-01,MDA,Johor,1,1,0
2023-10-01,MDA,Kedah,1,0,1
2023-10-01,MDA,Kelantan,0,0,0
2023-10-01,MDA,Negeri Sembilan,1,1,0
2023-10-01,MDA,Perlis,0,0,0
2023-10-01,MDA,Pulau Pinang,0,0,0
2023-10-01,MDA,Sabah,0,0,0
2023-10-01,MDA,Sarawak,0,0,0
2023-10-01,MDA,Selangor,42,23,19
2023-10-01,MDG,Johor,7,4,3
2023-10-01,MDG,Kedah,1,0,1
2023-10-01,MDG,Perak,0,0,0
2023-10-01,MDG,Perlis,0,0,0
2023-10-01,MDG,Pulau Pinang,2,2,0
2023-10-01,MDG,Sabah,0,0,0
2023-10-01,MDG,Sarawak,0,0,0
2023-10-01,MDG,Selangor,87,42,45
2023-10-01,MDV,Johor,158,65,93
2023-10-01,MDV,Kedah,2,1,1
2023-10-01,MDV,Kelantan,0,0,0
2023-10-01,MDV,Perak,0,0,0
2023-10-01,MDV,Perlis,0,0,0
2023-10-01,MDV,Pulau Pinang,1,1,0
2023-10-01,MDV,Sabah,0,0,0
2023-10-01,MDV,Sarawak,0,0,0
2023-10-01,MDV,Selangor,2499,1371,1128
2023-10-01,MEX,Johor,227,104,123
2023-10-01,MEX,Kedah,9,4,5
2023-10-01,MEX,Kelantan,0,0,0
2023-10-01,MEX,Pahang,0,0,0
2023-10-01,MEX,Perak,0,0,0
2023-10-01,MEX,Perlis,2,1,1
2023-10-01,MEX,Pulau Pinang,32,28,4
2023-10-01,MEX,Sabah,1,1,0
2023-10-01,MEX,Sarawak,6,3,3
2023-10-01,MEX,Selangor,882,455,427
2023-10-01,MEX,W.P. Labuan,0,0,0
2023-10-01,MHL,Johor,2,1,1
2023-10-01,MHL,Kedah,0,0,0
2023-10-01,MHL,Perak,2,1,1
2023-10-01,MHL,Pulau Pinang,0,0,0
2023-10-01,MHL,Sabah,0,0,0
2023-10-01,MHL,Selangor,0,0,0
2023-10-01,MKD,Johor,4,2,2
2023-10-01,MKD,Kedah,0,0,0
2023-10-01,MKD,Perak,0,0,0
2023-10-01,MKD,Pulau Pinang,2,1,1
2023-10-01,MKD,Sabah,0,0,0
2023-10-01,MKD,Sarawak,1,0,1
2023-10-01,MKD,Selangor,57,27,30
2023-10-01,MLI,Johor,3,3,0
2023-10-01,MLI,Sabah,0,0,0
2023-10-01,MLI,Selangor,11,5,6
2023-10-01,MLT,Johor,7,6,1
2023-10-01,MLT,Kedah,0,0,0
2023-10-01,MLT,Kelantan,0,0,0
2023-10-01,MLT,Perak,0,0,0
2023-10-01,MLT,Perlis,0,0,0
2023-10-01,MLT,Pulau Pinang,3,2,1
2023-10-01,MLT,Sabah,0,0,0
2023-10-01,MLT,Sarawak,0,0,0
2023-10-01,MLT,Selangor,27,20,7
2023-10-01,MLT,W.P. Labuan,0,0,0
2023-10-01,MMR,Johor,6179,1980,4199
2023-10-01,MMR,Kedah,77,21,56
2023-10-01,MMR,Kelantan,0,0,0
2023-10-01,MMR,Negeri Sembilan,0,0,0
2023-10-01,MMR,Pahang,3,1,2
2023-10-01,MMR,Perak,21,6,15
2023-10-01,MMR,Perlis,1,0,1
2023-10-01,MMR,Pulau Pinang,293,157,136
2023-10-01,MMR,Sabah,7,1,6
2023-10-01,MMR,Sarawak,92,45,47
2023-10-01,MMR,Selangor,6339,4111,2228
2023-10-01,MMR,Terengganu,0,0,0
2023-10-01,MMR,W.P. Labuan,0,0,0
2023-10-01,MNE,Johor,3,3,0
2023-10-01,MNE,Kedah,0,0,0
2023-10-01,MNE,Pulau Pinang,0,0,0
2023-10-01,MNE,Sabah,0,0,0
2023-10-01,MNE,Sarawak,1,1,0
2023-10-01,MNE,Selangor,11,11,0
2023-10-01,MNG,Johor,106,26,80
2023-10-01,MNG,Kedah,9,3,6
2023-10-01,MNG,Kelantan,2,2,0
2023-10-01,MNG,Perak,0,0,0
2023-10-01,MNG,Perlis,1,0,1
2023-10-01,MNG,Pulau Pinang,20,8,12
2023-10-01,MNG,Sabah,0,0,0
2023-10-01,MNG,Sarawak,0,0,0
2023-10-01,MNG,Selangor,358,130,228
2023-10-01,MNP,Selangor,0,0,0
2023-10-01,MOZ,Johor,0,0,0
2023-10-01,MOZ,Kedah,0,0,0
2023-10-01,MOZ,Perak,0,0,0
2023-10-01,MOZ,Pulau Pinang,0,0,0
2023-10-01,MOZ,Sabah,0,0,0
2023-10-01,MOZ,Sarawak,0,0,0
2023-10-01,MOZ,Selangor,14,10,4
2023-10-01,MRT,Johor,3,1,2
2023-10-01,MRT,Kedah,0,0,0
2023-10-01,MRT,Pulau Pinang,1,1,0
2023-10-01,MRT,Sabah,0,0,0
2023-10-01,MRT,Sarawak,0,0,0
2023-10-01,MRT,Selangor,23,21,2
2023-10-01,MUS,Johor,101,58,43
2023-10-01,MUS,Kedah,0,0,0
2023-10-01,MUS,Kelantan,0,0,0
2023-10-01,MUS,Pahang,0,0,0
2023-10-01,MUS,Perak,2,2,0
2023-10-01,MUS,Perlis,2,1,1
2023-10-01,MUS,Pulau Pinang,3,1,2
2023-10-01,MUS,Sabah,1,1,0
2023-10-01,MUS,Sarawak,0,0,0
2023-10-01,MUS,Selangor,1766,928,838
2023-10-01,MWI,Johor,2,0,2
2023-10-01,MWI,Pulau Pinang,0,0,0
2023-10-01,MWI,Sabah,0,0,0
2023-10-01,MWI,Sarawak,0,0,0
2023-10-01,MWI,Selangor,20,13,7
2023-10-01,MYT,Selangor,0,0,0
2023-10-01,NAM,Johor,1,1,0
2023-10-01,NAM,Kedah,0,0,0
2023-10-01,NAM,Perak,0,0,0
2023-10-01,NAM,Perlis,1,1,0
2023-10-01,NAM,Pulau Pinang,0,0,0
2023-10-01,NAM,Sabah,0,0,0
2023-10-01,NAM,Sarawak,1,1,0
2023-10-01,NAM,Selangor,32,20,12
2023-10-01,NCL,Selangor,0,0,0
2023-10-01,NER,Johor,0,0,0
2023-10-01,NER,Sabah,0,0,0
2023-10-01,NER,Selangor,3,2,1
2023-10-01,NGA,Johor,32,27,5
2023-10-01,NGA,Kedah,1,1,0
2023-10-01,NGA,Perlis,1,1,0
2023-10-01,NGA,Pulau Pinang,0,0,0
2023-10-01,NGA,Sabah,0,0,0
2023-10-01,NGA,Sarawak,9,8,1
2023-10-01,NGA,Selangor,457,333,124
2023-10-01,NIC,Johor,0,0,0
2023-10-01,NIC,Kedah,0,0,0
2023-10-01,NIC,Pulau Pinang,0,0,0
2023-10-01,NIC,Sabah,0,0,0
2023-10-01,NIC,Selangor,2,2,0
2023-10-01,NLD,Johor,1115,704,411
2023-10-01,NLD,Kedah,156,87,69
2023-10-01,NLD,Kelantan,7,3,4
2023-10-01,NLD,Melaka,1,1,0
2023-10-01,NLD,Negeri Sembilan,0,0,0
2023-10-01,NLD,Pahang,2,1,1
2023-10-01,NLD,Perak,6,4,2
2023-10-01,NLD,Perlis,36,22,14
2023-10-01,NLD,Pulau Pinang,252,173,79
2023-10-01,NLD,Sabah,21,9,12
2023-10-01,NLD,Sarawak,144,71,73
2023-10-01,NLD,Selangor,4256,2507,1749
2023-10-01,NLD,Terengganu,0,0,0
2023-10-01,NLD,W.P. Labuan,1,1,0
2023-10-01,NOR,Johor,193,117,76
2023-10-01,NOR,Kedah,21,12,9
2023-10-01,NOR,Kelantan,0,0,0
2023-10-01,NOR,Melaka,0,0,0
2023-10-01,NOR,Pahang,0,0,0
2023-10-01,NOR,Perak,1,1,0
2023-10-01,NOR,Perlis,3,3,0
2023-10-01,NOR,Pulau Pinang,43,23,20
2023-10-01,NOR,Sabah,0,0,0
2023-10-01,NOR,Sarawak,12,10,2
2023-10-01,NOR,Selangor,673,440,233
2023-10-01,NOR,W.P. Labuan,0,0,0
2023-10-01,NPL,Johor,944,587,357
2023-10-01,NPL,Kedah,19,12,7
2023-10-01,NPL,Pahang,1,1,0
2023-10-01,NPL,Perak,0,0,0
2023-10-01,NPL,Perlis,1,1,0
2023-10-01,NPL,Pulau Pinang,11,7,4
2023-10-01,NPL,Sabah,2,2,0
2023-10-01,NPL,Sarawak,130,91,39
2023-10-01,NPL,Selangor,7181,6586,595
2023-10-01,NPL,W.P. Labuan,18,17,1
2023-10-01,NRU,Johor,0,0,0
2023-10-01,NRU,Pulau Pinang,0,0,0
2023-10-01,NRU,Selangor,0,0,0
2023-10-01,NZL,Johor,956,590,366
2023-10-01,NZL,Kedah,97,44,53
2023-10-01,NZL,Kelantan,1,1,0
2023-10-01,NZL,Melaka,0,0,0
2023-10-01,NZL,Negeri Sembilan,2,2,0
2023-10-01,NZL,Pahang,23,13,10
2023-10-01,NZL,Perak,35,18,17
2023-10-01,NZL,Perlis,20,13,7
2023-10-01,NZL,Pulau Pinang,225,128,97
2023-10-01,NZL,Sabah,7,3,4
2023-10-01,NZL,Sarawak,131,80,51
2023-10-01,NZL,Selangor,3365,1970,1395
2023-10-01,NZL,Terengganu,0,0,0
2023-10-01,NZL,W.P. Labuan,5,3,2
2023-10-01,OMN,Johor,29,19,10
2023-10-01,OMN,Kedah,4,3,1
2023-10-01,OMN,Kelantan,0,0,0
2023-10-01,OMN,Melaka,0,0,0
2023-10-01,OMN,Perak,1,1,0
2023-10-01,OMN,Perlis,5,5,0
2023-10-01,OMN,Pulau Pinang,5,5,0
2023-10-01,OMN,Sabah,0,0,0
2023-10-01,OMN,Sarawak,2,2,0
2023-10-01,OMN,Selangor,1135,744,391
2023-10-01,PAK,Johor,1109,810,299
2023-10-01,PAK,Kedah,78,54,24
2023-10-01,PAK,Kelantan,17,17,0
2023-10-01,PAK,Melaka,0,0,0
2023-10-01,PAK,Negeri Sembilan,0,0,0
2023-10-01,PAK,Pahang,2,2,0
2023-10-01,PAK,Perak,13,13,0
2023-10-01,PAK,Perlis,14,13,1
2023-10-01,PAK,Pulau Pinang,76,67,9
2023-10-01,PAK,Sabah,6,6,0
2023-10-01,PAK,Sarawak,124,105,19
2023-10-01,PAK,Selangor,10590,9067,1523
2023-10-01,PAK,W.P. Labuan,0,0,0
2023-10-01,PAN,Johor,5,2,3
2023-10-01,PAN,Kedah,1,0,1
2023-10-01,PAN,Perak,0,0,0
2023-10-01,PAN,Perlis,0,0,0
2023-10-01,PAN,Pulau Pinang,0,0,0
2023-10-01,PAN,Sabah,1,1,0
2023-10-01,PAN,Sarawak,0,0,0
2023-10-01,PAN,Selangor,41,23,18
2023-10-01,PER,Johor,43,23,20
2023-10-01,PER,Kedah,3,1,2
2023-10-01,PER,Kelantan,0,0,0
2023-10-01,PER,Pahang,0,0,0
2023-10-01,PER,Perak,2,1,1
2023-10-01,PER,Perlis,0,0,0
2023-10-01,PER,Pulau Pinang,5,1,4
2023-10-01,PER,Sabah,1,0,1
2023-10-01,PER,Sarawak,0,0,0
2023-10-01,PER,Selangor,396,171,225
2023-10-01,PER,W.P. Labuan,0,0,0
2023-10-01,PHL,Johor,22838,6909,15929
2023-10-01,PHL,Kedah,458,132,326
2023-10-01,PHL,Kelantan,39,19,20
2023-10-01,PHL,Melaka,0,0,0
2023-10-01,PHL,Negeri Sembilan,0,0,0
2023-10-01,PHL,Pahang,28,20,8
2023-10-01,PHL,Perak,55,13,42
2023-10-01,PHL,Perlis,281,91,190
2023-10-01,PHL,Pulau Pinang,721,304,417
2023-10-01,PHL,Sabah,576,304,272
2023-10-01,PHL,Sarawak,1928,793,1135
2023-10-01,PHL,Selangor,16866,7263,9603
2023-10-01,PHL,Terengganu,2,2,0
2023-10-01,PHL,W.P. Labuan,115,33,82
2023-10-01,PLW,Johor,0,0,0
2023-10-01,PLW,Pulau Pinang,0,0,0
2023-10-01,PLW,Selangor,1,1,0
2023-10-01,PNG,Johor,12,5,7
2023-10-01,PNG,Kedah,0,0,0
2023-10-01,PNG,Kelantan,0,0,0
2023-10-01,PNG,Perak,0,0,0
2023-10-01,PNG,Pulau Pinang,3,1,2
2023-10-01,PNG,Sabah,0,0,0
2023-10-01,PNG,Sarawak,1,0,1
2023-10-01,PNG,Selangor,106,72,34
2023-10-01,POL,Johor,394,201,193
2023-10-01,POL,Kedah,58,25,33
2023-10-01,POL,Kelantan,1,1,0
2023-10-01,POL,Melaka,0,0,0
2023-10-01,POL,Negeri Sembilan,0,0,0
2023-10-01,POL,Pahang,0,0,0
2023-10-01,POL,Perak,7,4,3
2023-10-01,POL,Perlis,4,3,1
2023-10-01,POL,Pulau Pinang,58,30,28
2023-10-01,POL,Sabah,4,2,2
2023-10-01,POL,Sarawak,37,20,17
2023-10-01,POL,Selangor,1342,695,647
2023-10-01,POL,Terengganu,0,0,0
2023-10-01,POL,W.P. Labuan,0,0,0
2023-10-01,PRK,Selangor,0,0,0
2023-10-01,PRT,Johor,153,85,68
2023-10-01,PRT,Kedah,19,6,13
2023-10-01,PRT,Kelantan,0,0,0
2023-10-01,PRT,Melaka,0,0,0
2023-10-01,PRT,Pahang,1,1,0
2023-10-01,PRT,Perak,0,0,0
2023-10-01,PRT,Perlis,1,1,0
2023-10-01,PRT,Pulau Pinang,58,32,26
2023-10-01,PRT,Sabah,7,5,2
2023-10-01,PRT,Sarawak,6,3,3
2023-10-01,PRT,Selangor,817,484,333
2023-10-01,PRT,W.P. Labuan,0,0,0
2023-10-01,PRY,Johor,8,6,2
2023-10-01,PRY,Kedah,0,0,0
2023-10-01,PRY,Perak,0,0,0
2023-10-01,PRY,Perlis,0,0,0
2023-10-01,PRY,Pulau Pinang,0,0,0
2023-10-01,PRY,Sabah,0,0,0
2023-10-01,PRY,Sarawak,0,0,0
2023-10-01,PRY,Selangor,5,1,4
2023-10-01,PSE,Johor,21,17,4
2023-10-01,PSE,Kedah,1,0,1
2023-10-01,PSE,Kelantan,0,0,0
2023-10-01,PSE,Melaka,0,0,0
2023-10-01,PSE,Perak,1,1,0
2023-10-01,PSE,Perlis,0,0,0
2023-10-01,PSE,Pulau Pinang,0,0,0
2023-10-01,PSE,Sabah,0,0,0
2023-10-01,PSE,Sarawak,2,2,0
2023-10-01,PSE,Selangor,374,248,126
2023-10-01,QAT,Johor,14,8,6
2023-10-01,QAT,Kedah,0,0,0
2023-10-01,QAT,Perlis,0,0,0
2023-10-01,QAT,Pulau Pinang,0,0,0
2023-10-01,QAT,Sabah,0,0,0
2023-10-01,QAT,Sarawak,1,1,0
2023-10-01,QAT,Selangor,131,83,48
2023-10-01,REU,Johor,0,0,0
2023-10-01,REU,Sarawak,0,0,0
2023-10-01,ROU,Johor,122,72,50
2023-10-01,ROU,Kedah,14,3,11
2023-10-01,ROU,Kelantan,2,1,1
2023-10-01,ROU,Negeri Sembilan,0,0,0
2023-10-01,ROU,Pahang,1,1,0
2023-10-01,ROU,Perak,0,0,0
2023-10-01,ROU,Perlis,0,0,0
2023-10-01,ROU,Pulau Pinang,21,11,10
2023-10-01,ROU,Sabah,0,0,0
2023-10-01,ROU,Sarawak,6,2,4
2023-10-01,ROU,Selangor,676,357,319
2023-10-01,ROU,W.P. Labuan,0,0,0
2023-10-01,RUS,Johor,407,195,212
2023-10-01,RUS,Kedah,266,124,142
2023-10-01,RUS,Kelantan,54,27,27
2023-10-01,RUS,Melaka,1,1,0
2023-10-01,RUS,Negeri Sembilan,0,0,0
2023-10-01,RUS,Pahang,7,4,3
2023-10-01,RUS,Perak,1,0,1
2023-10-01,RUS,Perlis,141,88,53
2023-10-01,RUS,Pulau Pinang,180,100,80
2023-10-01,RUS,Sabah,23,7,16
2023-10-01,RUS,Sarawak,43,25,18
2023-10-01,RUS,Selangor,7294,3721,3573
2023-10-01,RUS,W.P. Labuan,10,6,4
2023-10-01,RWA,Johor,0,0,0
2023-10-01,RWA,Kedah,1,0,1
2023-10-01,RWA,Pulau Pinang,0,0,0
2023-10-01,RWA,Selangor,11,6,5
2023-10-01,SAU,Johor,143,82,61
2023-10-01,SAU,Kedah,28,15,13
2023-10-01,SAU,Kelantan,6,2,4
2023-10-01,SAU,Melaka,0,0,0
2023-10-01,SAU,Perak,1,0,1
2023-10-01,SAU,Perlis,7,6,1
2023-10-01,SAU,Pulau Pinang,20,12,8
2023-10-01,SAU,Sabah,0,0,0
2023-10-01,SAU,Sarawak,11,7,4
2023-10-01,SAU,Selangor,3761,2280,1481
2023-10-01,SAU,W.P. Labuan,0,0,0
2023-10-01,SDN,Johor,6,2,4
2023-10-01,SDN,Kedah,0,0,0
2023-10-01,SDN,Kelantan,0,0,0
2023-10-01,SDN,Perlis,0,0,0
2023-10-01,SDN,Pulau Pinang,0,0,0
2023-10-01,SDN,Sabah,1,1,0
2023-10-01,SDN,Sarawak,1,1,0
2023-10-01,SDN,Selangor,1236,748,488
2023-10-01,SDN,W.P. Labuan,0,0,0
2023-10-01,SEN,Johor,2,1,1
2023-10-01,SEN,Kedah,0,0,0
2023-10-01,SEN,Kelantan,0,0,0
2023-10-01,SEN,Perak,0,0,0
2023-10-01,SEN,Perlis,1,1,0
2023-10-01,SEN,Pulau Pinang,1,1,0
2023-10-01,SEN,Sabah,0,0,0
2023-10-01,SEN,Sarawak,0,0,0
2023-10-01,SEN,Selangor,51,39,12
2023-10-01,SGP,Johor,1284587,740290,544297
2023-10-01,SGP,Kedah,4531,2459,2072
2023-10-01,SGP,Kelantan,73,43,30
2023-10-01,SGP,Melaka,13,10,3
2023-10-01,SGP,Negeri Sembilan,5,5,0
2023-10-01,SGP,Pahang,681,397,284
2023-10-01,SGP,Perak,5582,2557,3025
2023-10-01,SGP,Perlis,229,142,87
2023-10-01,SGP,Pulau Pinang,16645,8224,8421
2023-10-01,SGP,Sabah,527,280,247
2023-10-01,SGP,Sarawak,3958,2260,1698
2023-10-01,SGP,Selangor,38965,21247,17718
2023-10-01,SGP,Terengganu,0,0,0
2023-10-01,SGP,W.P. Labuan,25,19,6
2023-10-01,SGS,Johor,0,0,0
2023-10-01,SGS,Sabah,0,0,0
2023-10-01,SGS,Selangor,0,0,0
2023-10-01,SHN,Sarawak,0,0,0
2023-10-01,SLB,Johor,2,1,1
2023-10-01,SLB,Perlis,0,0,0
2023-10-01,SLB,Pulau Pinang,0,0,0
2023-10-01,SLB,Sabah,0,0,0
2023-10-01,SLB,Sarawak,1,0,1
2023-10-01,SLB,Selangor,5,3,2
2023-10-01,SLB,W.P. Labuan,0,0,0
2023-10-01,SLE,Johor,2,1,1
2023-10-01,SLE,Kedah,0,0,0
2023-10-01,SLE,Perak,0,0,0
2023-10-01,SLE,Pulau Pinang,1,0,1
2023-10-01,SLE,Sabah,1,1,0
2023-10-01,SLE,Selangor,21,14,7
2023-10-01,SLV,Johor,2,0,2
2023-10-01,SLV,Kedah,0,0,0
2023-10-01,SLV,Perak,0,0,0
2023-10-01,SLV,Perlis,0,0,0
2023-10-01,SLV,Pulau Pinang,2,1,1
2023-10-01,SLV,Sabah,0,0,0
2023-10-01,SLV,Selangor,17,9,8
2023-10-01,SLV,W.P. Labuan,0,0,0
2023-10-01,SMR,Johor,0,0,0
2023-10-01,SMR,Selangor,1,1,0
2023-10-01,SOM,Johor,0,0,0
2023-10-01,SOM,Kedah,0,0,0
2023-10-01,SOM,Kelantan,0,0,0
2023-10-01,SOM,Perlis,0,0,0
2023-10-01,SOM,Sabah,0,0,0
2023-10-01,SOM,Sarawak,0,0,0
2023-10-01,SOM,Selangor,268,168,100
2023-10-01,SRB,Johor,7,6,1
2023-10-01,SRB,Kedah,4,3,1
2023-10-01,SRB,Kelantan,0,0,0
2023-10-01,SRB,Pahang,0,0,0
2023-10-01,SRB,Perak,0,0,0
2023-10-01,SRB,Perlis,0,0,0
2023-10-01,SRB,Pulau Pinang,15,4,11
2023-10-01,SRB,Sabah,0,0,0
2023-10-01,SRB,Sarawak,1,0,1
2023-10-01,SRB,Selangor,101,59,42
2023-10-01,SSD,Johor,0,0,0
2023-10-01,SSD,Kedah,0,0,0
2023-10-01,SSD,Sarawak,0,0,0
2023-10-01,SSD,Selangor,18,10,8
2023-10-01,SSD,W.P. Labuan,0,0,0
2023-10-01,STP,Selangor,2,2,0
2023-10-01,SUR,Johor,5,2,3
2023-10-01,SUR,Kedah,0,0,0
2023-10-01,SUR,Kelantan,0,0,0
2023-10-01,SUR,Perak,0,0,0
2023-10-01,SUR,Perlis,0,0,0
2023-10-01,SUR,Pulau Pinang,0,0,0
2023-10-01,SUR,Sabah,0,0,0
2023-10-01,SUR,Sarawak,0,0,0
2023-10-01,SUR,Selangor,18,11,7
2023-10-01,SVK,Johor,29,20,9
2023-10-01,SVK,Kedah,54,28,26
2023-10-01,SVK,Kelantan,0,0,0
2023-10-01,SVK,Negeri Sembilan,0,0,0
2023-10-01,SVK,Pahang,0,0,0
2023-10-01,SVK,Perak,0,0,0
2023-10-01,SVK,Perlis,1,1,0
2023-10-01,SVK,Pulau Pinang,17,13,4
2023-10-01,SVK,Sabah,1,0,1
2023-10-01,SVK,Sarawak,2,2,0
2023-10-01,SVK,Selangor,358,202,156
2023-10-01,SVK,W.P. Labuan,0,0,0
2023-10-01,SVN,Johor,22,13,9
2023-10-01,SVN,Kedah,3,1,2
2023-10-01,SVN,Kelantan,0,0,0
2023-10-01,SVN,Perak,0,0,0
2023-10-01,SVN,Perlis,0,0,0
2023-10-01,SVN,Pulau Pinang,7,5,2
2023-10-01,SVN,Sabah,1,0,1
2023-10-01,SVN,Sarawak,2,2,0
2023-10-01,SVN,Selangor,136,80,56
2023-10-01,SVN,W.P. Labuan,0,0,0
2023-10-01,SWE,Johor,317,158,159
2023-10-01,SWE,Kedah,66,21,45
2023-10-01,SWE,Kelantan,4,2,2
2023-10-01,SWE,Melaka,1,1,0
2023-10-01,SWE,Negeri Sembilan,0,0,0
2023-10-01,SWE,Pahang,0,0,0
2023-10-01,SWE,Perak,7,5,2
2023-10-01,SWE,Perlis,7,6,1
2023-10-01,SWE,Pulau Pinang,75,47,28
2023-10-01,SWE,Sabah,14,9,5
2023-10-01,SWE,Sarawak,50,32,18
2023-10-01,SWE,Selangor,1022,616,406
2023-10-01,SWE,W.P. Labuan,0,0,0
2023-10-01,SWZ,Johor,1,1,0
2023-10-01,SWZ,Kedah,0,0,0
2023-10-01,SWZ,Pulau Pinang,0,0,0
2023-10-01,SWZ,Sabah,1,0,1
2023-10-01,SWZ,Selangor,29,19,10
2023-10-01,SYC,Johor,10,2,8
2023-10-01,SYC,Kedah,0,0,0
2023-10-01,SYC,Pulau Pinang,3,1,2
2023-10-01,SYC,Sabah,0,0,0
2023-10-01,SYC,Sarawak,1,1,0
2023-10-01,SYC,Selangor,57,23,34
2023-10-01,SYR,Johor,14,10,4
2023-10-01,SYR,Kedah,0,0,0
2023-10-01,SYR,Kelantan,0,0,0
2023-10-01,SYR,Pahang,0,0,0
2023-10-01,SYR,Perlis,1,1,0
2023-10-01,SYR,Pulau Pinang,2,2,0
2023-10-01,SYR,Sabah,0,0,0
2023-10-01,SYR,Sarawak,2,2,0
2023-10-01,SYR,Selangor,687,467,220
2023-10-01,SYR,W.P. Labuan,0,0,0
2023-10-01,TCA,Perlis,0,0,0
2023-10-01,TCD,Johor,1,1,0
2023-10-01,TCD,Kedah,1,1,0
2023-10-01,TCD,Perlis,1,1,0
2023-10-01,TCD,Selangor,45,32,13
2023-10-01,TGO,Johor,8,8,0
2023-10-01,TGO,Perak,0,0,0
2023-10-01,TGO,Pulau Pinang,0,0,0
2023-10-01,TGO,Selangor,12,9,3
2023-10-01,THA,Johor,11757,3601,8156
2023-10-01,THA,Kedah,78352,46416,31936
2023-10-01,THA,Kelantan,46426,24852,21574
2023-10-01,THA,Melaka,2,2,0
2023-10-01,THA,Negeri Sembilan,1,0,1
2023-10-01,THA,Pahang,10,6,4
2023-10-01,THA,Perak,11505,5283,6222
2023-10-01,THA,Perlis,56604,31372,25232
2023-10-01,THA,Pulau Pinang,2810,1048,1762
2023-10-01,THA,Sabah,20,13,7
2023-10-01,THA,Sarawak,320,115,205
2023-10-01,THA,Selangor,19691,7707,11984
2023-10-01,THA,Terengganu,0,0,0
2023-10-01,THA,W.P. Labuan,11,3,8
2023-10-01,TJK,Johor,7,6,1
2023-10-01,TJK,Kedah,0,0,0
2023-10-01,TJK,Perlis,0,0,0
2023-10-01,TJK,Pulau Pinang,0,0,0
2023-10-01,TJK,Sabah,0,0,0
2023-10-01,TJK,Selangor,157,120,37
2023-10-01,TKL,Selangor,0,0,0
2023-10-01,TKM,Johor,0,0,0
2023-10-01,TKM,Kedah,0,0,0
2023-10-01,TKM,Kelantan,0,0,0
2023-10-01,TKM,Perlis,0,0,0
2023-10-01,TKM,Pulau Pinang,0,0,0
2023-10-01,TKM,Sabah,0,0,0
2023-10-01,TKM,Sarawak,2,2,0
2023-10-01,TKM,Selangor,121,83,38
2023-10-01,TLS,Johor,5,1,4
2023-10-01,TLS,Kedah,2,0,2
2023-10-01,TLS,Perlis,0,0,0
2023-10-01,TLS,Pulau Pinang,12,8,4
2023-10-01,TLS,Sabah,0,0,0
2023-10-01,TLS,Sarawak,4,4,0
2023-10-01,TLS,Selangor,183,112,71
2023-10-01,TON,Johor,1,1,0
2023-10-01,TON,Pulau Pinang,3,1,2
2023-10-01,TON,Sarawak,0,0,0
2023-10-01,TON,Selangor,33,7,26
2023-10-01,TTO,Johor,14,6,8
2023-10-01,TTO,Kedah,0,0,0
2023-10-01,TTO,Pahang,0,0,0
2023-10-01,TTO,Pulau Pinang,1,0,1
2023-10-01,TTO,Sabah,0,0,0
2023-10-01,TTO,Sarawak,3,1,2
2023-10-01,TTO,Selangor,32,19,13
2023-10-01,TUN,Johor,9,7,2
2023-10-01,TUN,Kedah,1,1,0
2023-10-01,TUN,Kelantan,0,0,0
2023-10-01,TUN,Melaka,0,0,0
2023-10-01,TUN,Perak,0,0,0
2023-10-01,TUN,Perlis,0,0,0
2023-10-01,TUN,Pulau Pinang,6,5,1
2023-10-01,TUN,Sabah,0,0,0
2023-10-01,TUN,Sarawak,0,0,0
2023-10-01,TUN,Selangor,937,475,462
2023-10-01,TUN,W.P. Labuan,0,0,0
2023-10-01,TUR,Johor,346,259,87
2023-10-01,TUR,Kedah,34,23,11
2023-10-01,TUR,Kelantan,1,1,0
2023-10-01,TUR,Melaka,0,0,0
2023-10-01,TUR,Negeri Sembilan,0,0,0
2023-10-01,TUR,Pahang,2,0,2
2023-10-01,TUR,Perak,1,1,0
2023-10-01,TUR,Perlis,10,9,1
2023-10-01,TUR,Pulau Pinang,39,29,10
2023-10-01,TUR,Sabah,1,0,1
2023-10-01,TUR,Sarawak,25,16,9
2023-10-01,TUR,Selangor,1607,1183,424
2023-10-01,TUR,W.P. Labuan,0,0,0
2023-10-01,TUV,Selangor,0,0,0
2023-10-01,TWN,Johor,6859,2862,3997
2023-10-01,TWN,Kedah,118,64,54
2023-10-01,TWN,Kelantan,3,3,0
2023-10-01,TWN,Melaka,1,1,0
2023-10-01,TWN,Negeri Sembilan,0,0,0
2023-10-01,TWN,Pahang,5,3,2
2023-10-01,TWN,Perak,53,25,28
2023-10-01,TWN,Perlis,6,2,4
2023-10-01,TWN,Pulau Pinang,4338,2089,2249
2023-10-01,TWN,Sabah,106,46,60
2023-10-01,TWN,Sarawak,263,119,144
2023-10-01,TWN,Selangor,17862,8281,9581
2023-10-01,TWN,W.P. Labuan,6,5,1
2023-10-01,TZA,Johor,17,11,6
2023-10-01,TZA,Kedah,1,0,1
2023-10-01,TZA,Perak,0,0,0
2023-10-01,TZA,Perlis,0,0,0
2023-10-01,TZA,Pulau Pinang,1,1,0
2023-10-01,TZA,Sabah,0,0,0
2023-10-01,TZA,Sarawak,4,4,0
2023-10-01,TZA,Selangor,263,117,146
2023-10-01,UGA,Johor,26,8,18
2023-10-01,UGA,Kedah,0,0,0
2023-10-01,UGA,Perak,0,0,0
2023-10-01,UGA,Perlis,0,0,0
2023-10-01,UGA,Pulau Pinang,0,0,0
2023-10-01,UGA,Sabah,0,0,0
2023-10-01,UGA,Sarawak,0,0,0
2023-10-01,UGA,Selangor,158,82,76
2023-10-01,UKR,Johor,96,42,54
2023-10-01,UKR,Kedah,22,10,12
2023-10-01,UKR,Kelantan,0,0,0
2023-10-01,UKR,Melaka,5,5,0
2023-10-01,UKR,Negeri Sembilan,0,0,0
2023-10-01,UKR,Pahang,0,0,0
2023-10-01,UKR,Perak,1,0,1
2023-10-01,UKR,Perlis,7,4,3
2023-10-01,UKR,Pulau Pinang,20,9,11
2023-10-01,UKR,Sabah,5,2,3
2023-10-01,UKR,Sarawak,0,0,0
2023-10-01,UKR,Selangor,906,442,464
2023-10-01,UKR,W.P. Labuan,1,1,0
2023-10-01,URY,Johor,3,2,1
2023-10-01,URY,Kedah,1,1,0
2023-10-01,URY,Kelantan,0,0,0
2023-10-01,URY,Perak,0,0,0
2023-10-01,URY,Perlis,0,0,0
2023-10-01,URY,Pulau Pinang,1,1,0
2023-10-01,URY,Sabah,0,0,0
2023-10-01,URY,Sarawak,1,1,0
2023-10-01,URY,Selangor,64,36,28
2023-10-01,URY,W.P. Labuan,0,0,0
2023-10-01,USA,Johor,4641,2658,1983
2023-10-01,USA,Kedah,369,203,166
2023-10-01,USA,Kelantan,14,10,4
2023-10-01,USA,Melaka,12,6,6
2023-10-01,USA,Negeri Sembilan,0,0,0
2023-10-01,USA,Pahang,21,18,3
2023-10-01,USA,Perak,104,59,45
2023-10-01,USA,Perlis,49,30,19
2023-10-01,USA,Pulau Pinang,2064,1233,831
2023-10-01,USA,Sabah,71,39,32
2023-10-01,USA,Sarawak,288,156,132
2023-10-01,USA,Selangor,14060,8310,5750
2023-10-01,USA,Terengganu,0,0,0
2023-10-01,USA,W.P. Labuan,3,3,0
2023-10-01,UZB,Johor,66,49,17
2023-10-01,UZB,Kedah,8,5,3
2023-10-01,UZB,Kelantan,0,0,0
2023-10-01,UZB,Perak,0,0,0
2023-10-01,UZB,Perlis,2,2,0
2023-10-01,UZB,Pulau Pinang,12,5,7
2023-10-01,UZB,Sabah,2,2,0
2023-10-01,UZB,Sarawak,0,0,0
2023-10-01,UZB,Selangor,900,545,355
2023-10-01,VAT,Johor,0,0,0
2023-10-01,VAT,Sarawak,0,0,0
2023-10-01,VAT,Selangor,0,0,0
2023-10-01,VCT,Johor,0,0,0
2023-10-01,VCT,Kedah,0,0,0
2023-10-01,VCT,Pulau Pinang,0,0,0
2023-10-01,VCT,Sarawak,0,0,0
2023-10-01,VCT,Selangor,1,0,1
2023-10-01,VEN,Johor,13,8,5
2023-10-01,VEN,Kedah,0,0,0
2023-10-01,VEN,Kelantan,0,0,0
2023-10-01,VEN,Melaka,0,0,0
2023-10-01,VEN,Perak,0,0,0
2023-10-01,VEN,Perlis,0,0,0
2023-10-01,VEN,Pulau Pinang,6,4,2
2023-10-01,VEN,Sabah,0,0,0
2023-10-01,VEN,Sarawak,5,3,2
2023-10-01,VEN,Selangor,87,48,39
2023-10-01,VEN,W.P. Labuan,0,0,0
2023-10-01,VNM,Johor,14353,4405,9948
2023-10-01,VNM,Kedah,367,75,292
2023-10-01,VNM,Kelantan,15,5,10
2023-10-01,VNM,Melaka,0,0,0
2023-10-01,VNM,Negeri Sembilan,0,0,0
2023-10-01,VNM,Pahang,1,0,1
2023-10-01,VNM,Perak,186,10,176
2023-10-01,VNM,Perlis,131,28,103
2023-10-01,VNM,Pulau Pinang,1245,367,878
2023-10-01,VNM,Sabah,14,7,7
2023-10-01,VNM,Sarawak,219,69,150
2023-10-01,VNM,Selangor,15135,5369,9766
2023-10-01,VNM,Terengganu,0,0,0
2023-10-01,VNM,W.P. Labuan,1,1,0
2023-10-01,VUT,Johor,56,41,15
2023-10-01,VUT,Kedah,0,0,0
2023-10-01,VUT,Pulau Pinang,5,3,2
2023-10-01,VUT,Sabah,0,0,0
2023-10-01,VUT,Sarawak,0,0,0
2023-10-01,VUT,Selangor,85,67,18
2023-10-01,WSM,Johor,1,1,0
2023-10-01,WSM,Sarawak,0,0,0
2023-10-01,WSM,Selangor,4,3,1
2023-10-01,XXX,Johor,62,38,24
2023-10-01,XXX,Kedah,7,2,5
2023-10-01,XXX,Kelantan,0,0,0
2023-10-01,XXX,Melaka,0,0,0
2023-10-01,XXX,Pahang,1,0,1
2023-10-01,XXX,Perak,2,0,2
2023-10-01,XXX,Perlis,2,2,0
2023-10-01,XXX,Pulau Pinang,59,35,24
2023-10-01,XXX,Sabah,5,3,2
2023-10-01,XXX,Sarawak,27,20,7
2023-10-01,XXX,Selangor,408,264,144
2023-10-01,XXX,W.P. Labuan,1,1,0
2023-10-01,YEM,Johor,31,18,13
2023-10-01,YEM,Kedah,2,2,0
2023-10-01,YEM,Kelantan,2,0,2
2023-10-01,YEM,Melaka,0,0,0
2023-10-01,YEM,Pahang,0,0,0
2023-10-01,YEM,Perak,1,1,0
2023-10-01,YEM,Perlis,2,2,0
2023-10-01,YEM,Pulau Pinang,2,2,0
2023-10-01,YEM,Sabah,0,0,0
2023-10-01,YEM,Sarawak,2,1,1
2023-10-01,YEM,Selangor,1710,1303,407
2023-10-01,YEM,W.P. Labuan,0,0,0
2023-10-01,ZAF,Johor,289,182,107
2023-10-01,ZAF,Kedah,37,20,17
2023-10-01,ZAF,Kelantan,2,1,1
2023-10-01,ZAF,Melaka,0,0,0
2023-10-01,ZAF,Pahang,0,0,0
2023-10-01,ZAF,Perak,2,2,0
2023-10-01,ZAF,Perlis,21,12,9
2023-10-01,ZAF,Pulau Pinang,55,26,29
2023-10-01,ZAF,Sabah,7,5,2
2023-10-01,ZAF,Sarawak,59,33,26
2023-10-01,ZAF,Selangor,1058,619,439
2023-10-01,ZAF,Terengganu,0,0,0
2023-10-01,ZAF,W.P. Labuan,0,0,0
2023-10-01,ZAR,Selangor,0,0,0
2023-10-01,ZMB,Johor,6,4,2
2023-10-01,ZMB,Kedah,1,0,1
2023-10-01,ZMB,Perak,0,0,0
2023-10-01,ZMB,Perlis,1,1,0
2023-10-01,ZMB,Pulau Pinang,1,0,1
2023-10-01,ZMB,Sabah,0,0,0
2023-10-01,ZMB,Sarawak,0,0,0
2023-10-01,ZMB,Selangor,47,26,21
2023-10-01,ZWE,Johor,7,3,4
2023-10-01,ZWE,Kedah,0,0,0
2023-10-01,ZWE,Kelantan,0,0,0
2023-10-01,ZWE,Perak,0,0,0
2023-10-01,ZWE,Perlis,1,0,1
2023-10-01,ZWE,Pulau Pinang,3,2,1
2023-10-01,ZWE,Sabah,0,0,0
2023-10-01,ZWE,Sarawak,0,0,0
2023-10-01,ZWE,Selangor,189,86,103
2023-11-01,ABW,Kedah,0,0,0
2023-11-01,ABW,Pulau Pinang,0,0,0
2023-11-01,AFG,Johor,1,1,0
2023-11-01,AFG,Kedah,0,0,0
2023-11-01,AFG,Perlis,0,0,0
2023-11-01,AFG,Pulau Pinang,1,1,0
2023-11-01,AFG,Sarawak,0,0,0
2023-11-01,AFG,Selangor,42,32,10
2023-11-01,AGO,Johor,0,0,0
2023-11-01,AGO,Kedah,0,0,0
2023-11-01,AGO,Sabah,0,0,0
2023-11-01,AGO,Selangor,3,3,0
2023-11-01,AIA,Selangor,1,1,0
2023-11-01,ALB,Johor,15,13,2
2023-11-01,ALB,Kedah,1,1,0
2023-11-01,ALB,Perak,0,0,0
2023-11-01,ALB,Perlis,0,0,0
2023-11-01,ALB,Pulau Pinang,1,1,0
2023-11-01,ALB,Sabah,0,0,0
2023-11-01,ALB,Sarawak,0,0,0
2023-11-01,ALB,Selangor,38,23,15
2023-11-01,AND,Johor,3,1,2
2023-11-01,AND,Kedah,0,0,0
2023-11-01,AND,Perlis,0,0,0
2023-11-01,AND,Pulau Pinang,0,0,0
2023-11-01,AND,Selangor,6,3,3
2023-11-01,ANT,Selangor,0,0,0
2023-11-01,ARE,Johor,15,9,6
2023-11-01,ARE,Kedah,0,0,0
2023-11-01,ARE,Kelantan,0,0,0
2023-11-01,ARE,Perak,0,0,0
2023-11-01,ARE,Perlis,1,1,0
2023-11-01,ARE,Pulau Pinang,0,0,0
2023-11-01,ARE,Sabah,0,0,0
2023-11-01,ARE,Sarawak,0,0,0
2023-11-01,ARE,Selangor,369,235,134
2023-11-01,ARG,Johor,80,54,26
2023-11-01,ARG,Kedah,41,15,26
2023-11-01,ARG,Kelantan,0,0,0
2023-11-01,ARG,Melaka,1,1,0
2023-11-01,ARG,Perak,0,0,0
2023-11-01,ARG,Perlis,1,1,0
2023-11-01,ARG,Pulau Pinang,15,5,10
2023-11-01,ARG,Sabah,4,3,1
2023-11-01,ARG,Sarawak,3,3,0
2023-11-01,ARG,Selangor,411,230,181
2023-11-01,ARG,W.P. Labuan,0,0,0
2023-11-01,ARM,Johor,2,2,0
2023-11-01,ARM,Kedah,0,0,0
2023-11-01,ARM,Kelantan,1,1,0
2023-11-01,ARM,Perak,0,0,0
2023-11-01,ARM,Perlis,0,0,0
2023-11-01,ARM,Pulau Pinang,3,2,1
2023-11-01,ARM,Sabah,1,1,0
2023-11-01,ARM,Sarawak,0,0,0
2023-11-01,ARM,Selangor,32,17,15
2023-11-01,ATA,Selangor,0,0,0
2023-11-01,ATG,Johor,3,3,0
2023-11-01,ATG,Kedah,0,0,0
2023-11-01,ATG,Pulau Pinang,0,0,0
2023-11-01,ATG,Sarawak,0,0,0
2023-11-01,ATG,Selangor,15,10,5
2023-11-01,AUS,Johor,5161,3050,2111
2023-11-01,AUS,Kedah,684,346,338
2023-11-01,AUS,Kelantan,4,3,1
2023-11-01,AUS,Melaka,4,2,2
2023-11-01,AUS,Negeri Sembilan,3,3,0
2023-11-01,AUS,Pahang,10,8,2
2023-11-01,AUS,Perak,228,122,106
2023-11-01,AUS,Perlis,94,57,37
2023-11-01,AUS,Pulau Pinang,2127,1142,985
2023-11-01,AUS,Sabah,265,124,141
2023-11-01,AUS,Sarawak,481,272,209
2023-11-01,AUS,Selangor,26398,15601,10797
2023-11-01,AUS,Terengganu,4,3,1
2023-11-01,AUS,W.P. Labuan,8,6,2
2023-11-01,AUT,Johor,183,130,53
2023-11-01,AUT,Kedah,66,38,28
2023-11-01,AUT,Kelantan,5,5,0
2023-11-01,AUT,Melaka,0,0,0
2023-11-01,AUT,Negeri Sembilan,2,1,1
2023-11-01,AUT,Pahang,0,0,0
2023-11-01,AUT,Perak,4,4,0
2023-11-01,AUT,Perlis,16,9,7
2023-11-01,AUT,Pulau Pinang,103,81,22
2023-11-01,AUT,Sabah,10,6,4
2023-11-01,AUT,Sarawak,9,5,4
2023-11-01,AUT,Selangor,941,635,306
2023-11-01,AUT,Terengganu,0,0,0
2023-11-01,AUT,W.P. Labuan,0,0,0
2023-11-01,AZE,Johor,9,7,2
2023-11-01,AZE,Kedah,2,0,2
2023-11-01,AZE,Kelantan,0,0,0
2023-11-01,AZE,Melaka,0,0,0
2023-11-01,AZE,Perlis,0,0,0
2023-11-01,AZE,Pulau Pinang,1,1,0
2023-11-01,AZE,Sabah,0,0,0
2023-11-01,AZE,Sarawak,2,1,1
2023-11-01,AZE,Selangor,151,82,69
2023-11-01,AZE,W.P. Labuan,0,0,0
2023-11-01,BDI,Pulau Pinang,1,0,1
2023-11-01,BDI,Sarawak,0,0,0
2023-11-01,BDI,Selangor,2,1,1
2023-11-01,BEL,Johor,259,170,89
2023-11-01,BEL,Kedah,68,41,27
2023-11-01,BEL,Kelantan,3,2,1
2023-11-01,BEL,Melaka,5,2,3
2023-11-01,BEL,Negeri Sembilan,0,0,0
2023-11-01,BEL,Pahang,0,0,0
2023-11-01,BEL,Perak,0,0,0
2023-11-01,BEL,Perlis,7,4,3
2023-11-01,BEL,Pulau Pinang,76,51,25
2023-11-01,BEL,Sabah,18,10,8
2023-11-01,BEL,Sarawak,12,9,3
2023-11-01,BEL,Selangor,1217,817,400
2023-11-01,BEL,W.P. Labuan,2,2,0
2023-11-01,BEN,Johor,1,1,0
2023-11-01,BEN,Kedah,0,0,0
2023-11-01,BEN,Perak,0,0,0
2023-11-01,BEN,Pulau Pinang,0,0,0
2023-11-01,BEN,Sabah,2,2,0
2023-11-01,BEN,Sarawak,1,1,0
2023-11-01,BEN,Selangor,11,8,3
2023-11-01,BFA,Perak,0,0,0
2023-11-01,BFA,Pulau Pinang,0,0,0
2023-11-01,BFA,Selangor,5,3,2
2023-11-01,BGD,Johor,2690,2231,459
2023-11-01,BGD,Kedah,62,41,21
2023-11-01,BGD,Kelantan,2,2,0
2023-11-01,BGD,Melaka,0,0,0
2023-11-01,BGD,Negeri Sembilan,0,0,0
2023-11-01,BGD,Pahang,1,1,0
2023-11-01,BGD,Perak,2,1,1
2023-11-01,BGD,Perlis,4,3,1
2023-11-01,BGD,Pulau Pinang,190,172,18
2023-11-01,BGD,Sabah,7,7,0
2023-11-01,BGD,Sarawak,42,32,10
2023-11-01,BGD,Selangor,35940,34250,1690
2023-11-01,BGD,W.P. Labuan,11,11,0
2023-11-01,BGR,Johor,57,32,25
2023-11-01,BGR,Kedah,20,10,10
2023-11-01,BGR,Kelantan,1,1,0
2023-11-01,BGR,Pahang,0,0,0
2023-11-01,BGR,Perak,0,0,0
2023-11-01,BGR,Perlis,0,0,0
2023-11-01,BGR,Pulau Pinang,19,13,6
2023-11-01,BGR,Sabah,1,1,0
2023-11-01,BGR,Sarawak,0,0,0
2023-11-01,BGR,Selangor,375,175,200
2023-11-01,BGR,W.P. Labuan,0,0,0
2023-11-01,BHR,Johor,6,5,1
2023-11-01,BHR,Kedah,1,1,0
2023-11-01,BHR,Kelantan,0,0,0
2023-11-01,BHR,Perlis,0,0,0
2023-11-01,BHR,Pulau Pinang,2,1,1
2023-11-01,BHR,Sabah,0,0,0
2023-11-01,BHR,Sarawak,1,1,0
2023-11-01,BHR,Selangor,139,83,56
2023-11-01,BHS,Johor,2,1,1
2023-11-01,BHS,Kedah,0,0,0
2023-11-01,BHS,Perak,0,0,0
2023-11-01,BHS,Sabah,0,0,0
2023-11-01,BHS,Sarawak,0,0,0
2023-11-01,BHS,Selangor,0,0,0
2023-11-01,BIH,Johor,2,2,0
2023-11-01,BIH,Kedah,0,0,0
2023-11-01,BIH,Perlis,0,0,0
2023-11-01,BIH,Pulau Pinang,4,2,2
2023-11-01,BIH,Sabah,0,0,0
2023-11-01,BIH,Sarawak,4,4,0
2023-11-01,BIH,Selangor,65,35,30
2023-11-01,BLR,Johor,13,4,9
2023-11-01,BLR,Kedah,22,9,13
2023-11-01,BLR,Kelantan,2,1,1
2023-11-01,BLR,Pahang,0,0,0
2023-11-01,BLR,Perak,0,0,0
2023-11-01,BLR,Perlis,0,0,0
2023-11-01,BLR,Pulau Pinang,15,4,11
2023-11-01,BLR,Sabah,4,1,3
2023-11-01,BLR,Sarawak,3,0,3
2023-11-01,BLR,Selangor,409,181,228
2023-11-01,BLR,W.P. Labuan,0,0,0
2023-11-01,BLZ,Johor,6,2,4
2023-11-01,BLZ,Pulau Pinang,0,0,0
2023-11-01,BLZ,Sarawak,0,0,0
2023-11-01,BLZ,Selangor,5,3,2
2023-11-01,BMU,Selangor,0,0,0
2023-11-01,BOL,Johor,4,3,1
2023-11-01,BOL,Kedah,0,0,0
2023-11-01,BOL,Melaka,0,0,0
2023-11-01,BOL,Perak,0,0,0
2023-11-01,BOL,Perlis,0,0,0
2023-11-01,BOL,Pulau Pinang,0,0,0
2023-11-01,BOL,Sabah,0,0,0
2023-11-01,BOL,Sarawak,0,0,0
2023-11-01,BOL,Selangor,40,29,11
2023-11-01,BRA,Johor,360,216,144
2023-11-01,BRA,Kedah,60,27,33
2023-11-01,BRA,Kelantan,0,0,0
2023-11-01,BRA,Melaka,4,3,1
2023-11-01,BRA,Pahang,4,3,1
2023-11-01,BRA,Perak,6,3,3
2023-11-01,BRA,Perlis,8,2,6
2023-11-01,BRA,Pulau Pinang,19,12,7
2023-11-01,BRA,Sabah,8,6,2
2023-11-01,BRA,Sarawak,16,12,4
2023-11-01,BRA,Selangor,996,579,417
2023-11-01,BRA,W.P. Labuan,0,0,0
2023-11-01,BRB,Johor,1,0,1
2023-11-01,BRB,Kedah,0,0,0
2023-11-01,BRB,Perlis,0,0,0
2023-11-01,BRB,Pulau Pinang,0,0,0
2023-11-01,BRB,Selangor,5,5,0
2023-11-01,BRN,Johor,502,264,238
2023-11-01,BRN,Kedah,31,14,17
2023-11-01,BRN,Kelantan,23,12,11
2023-11-01,BRN,Melaka,0,0,0
2023-11-01,BRN,Pahang,0,0,0
2023-11-01,BRN,Perak,3,1,2
2023-11-01,BRN,Perlis,37,22,15
2023-11-01,BRN,Pulau Pinang,29,15,14
2023-11-01,BRN,Sabah,1075,451,624
2023-11-01,BRN,Sarawak,64400,36057,28343
2023-11-01,BRN,Selangor,6185,3123,3062
2023-11-01,BRN,W.P. Labuan,1189,825,364
2023-11-01,BTN,Johor,18,11,7
2023-11-01,BTN,Kedah,2,2,0
2023-11-01,BTN,Perak,0,0,0
2023-11-01,BTN,Perlis,0,0,0
2023-11-01,BTN,Pulau Pinang,2,1,1
2023-11-01,BTN,Sabah,1,1,0
2023-11-01,BTN,Sarawak,0,0,0
2023-11-01,BTN,Selangor,44,34,10
2023-11-01,BWA,Johor,1,0,1
2023-11-01,BWA,Kedah,1,1,0
2023-11-01,BWA,Perlis,1,1,0
2023-11-01,BWA,Pulau Pinang,1,1,0
2023-11-01,BWA,Sabah,0,0,0
2023-11-01,BWA,Sarawak,0,0,0
2023-11-01,BWA,Selangor,10,5,5
2023-11-01,CAF,Kedah,0,0,0
2023-11-01,CAF,Selangor,0,0,0
2023-11-01,CAN,Johor,1605,891,714
2023-11-01,CAN,Kedah,209,114,95
2023-11-01,CAN,Kelantan,7,4,3
2023-11-01,CAN,Melaka,0,0,0
2023-11-01,CAN,Negeri Sembilan,0,0,0
2023-11-01,CAN,Pahang,5,4,1
2023-11-01,CAN,Perak,52,26,26
2023-11-01,CAN,Perlis,44,28,16
2023-11-01,CAN,Pulau Pinang,638,346,292
2023-11-01,CAN,Sabah,112,61,51
2023-11-01,CAN,Sarawak,235,133,102
2023-11-01,CAN,Selangor,4874,2820,2054
2023-11-01,CAN,Terengganu,0,0,0
2023-11-01,CAN,W.P. Labuan,7,3,4
2023-11-01,CCK,Selangor,0,0,0
2023-11-01,CHE,Johor,439,258,181
2023-11-01,CHE,Kedah,151,76,75
2023-11-01,CHE,Kelantan,4,3,1
2023-11-01,CHE,Melaka,0,0,0
2023-11-01,CHE,Negeri Sembilan,4,1,3
2023-11-01,CHE,Pahang,6,4,2
2023-11-01,CHE,Perak,7,5,2
2023-11-01,CHE,Perlis,19,10,9
2023-11-01,CHE,Pulau Pinang,147,100,47
2023-11-01,CHE,Sabah,22,14,8
2023-11-01,CHE,Sarawak,30,15,15
2023-11-01,CHE,Selangor,1347,822,525
2023-11-01,CHE,W.P. Labuan,1,1,0
2023-11-01,CHL,Johor,33,20,13
2023-11-01,CHL,Kedah,12,5,7
2023-11-01,CHL,Kelantan,0,0,0
2023-11-01,CHL,Melaka,0,0,0
2023-11-01,CHL,Pahang,0,0,0
2023-11-01,CHL,Perak,0,0,0
2023-11-01,CHL,Perlis,2,0,2
2023-11-01,CHL,Pulau Pinang,5,3,2
2023-11-01,CHL,Sabah,6,1,5
2023-11-01,CHL,Sarawak,3,2,1
2023-11-01,CHL,Selangor,314,166,148
2023-11-01,CHN,Johor,40105,17947,22158
2023-11-01,CHN,Kedah,1155,525,630
2023-11-01,CHN,Kelantan,14,12,2
2023-11-01,CHN,Melaka,2,2,0
2023-11-01,CHN,Pahang,41,23,18
2023-11-01,CHN,Perak,259,112,147
2023-11-01,CHN,Perlis,139,73,66
2023-11-01,CHN,Pulau Pinang,7833,4314,3519
2023-11-01,CHN,Sabah,8287,3955,4332
2023-11-01,CHN,Sarawak,991,499,492
2023-11-01,CHN,Selangor,81817,44534,37283
2023-11-01,CHN,Terengganu,0,0,0
2023-11-01,CHN,W.P. Labuan,51,42,9
2023-11-01,CIV,Johor,1,1,0
2023-11-01,CIV,Kedah,0,0,0
2023-11-01,CIV,Pulau Pinang,0,0,0
2023-11-01,CIV,Sabah,0,0,0
2023-11-01,CIV,Sarawak,0,0,0
2023-11-01,CIV,Selangor,39,23,16
2023-11-01,CMR,Johor,0,0,0
2023-11-01,CMR,Kedah,0,0,0
2023-11-01,CMR,Pulau Pinang,0,0,0
2023-11-01,CMR,Sabah,0,0,0
2023-11-01,CMR,Sarawak,0,0,0
2023-11-01,CMR,Selangor,28,14,14
2023-11-01,COD,Johor,2,2,0
2023-11-01,COD,Pulau Pinang,0,0,0
2023-11-01,COD,Sarawak,0,0,0
2023-11-01,COD,Selangor,11,7,4
2023-11-01,COG,Johor,0,0,0
2023-11-01,COG,Kedah,0,0,0
2023-11-01,COG,Selangor,1,0,1
2023-11-01,COK,Selangor,0,0,0
2023-11-01,COL,Johor,11,8,3
2023-11-01,COL,Kedah,6,4,2
2023-11-01,COL,Perak,0,0,0
2023-11-01,COL,Pulau Pinang,4,2,2
2023-11-01,COL,Sabah,0,0,0
2023-11-01,COL,Sarawak,1,1,0
2023-11-01,COL,Selangor,198,110,88
2023-11-01,COL,W.P. Labuan,0,0,0
2023-11-01,COM,Johor,1,1,0
2023-11-01,COM,Kedah,0,0,0
2023-11-01,COM,Selangor,16,10,6
2023-11-01,CPV,Johor,1,0,1
2023-11-01,CPV,Kedah,0,0,0
2023-11-01,CPV,Pulau Pinang,0,0,0
2023-11-01,CPV,Sabah,0,0,0
2023-11-01,CPV,Selangor,1,0,1
2023-11-01,CRI,Johor,19,13,6
2023-11-01,CRI,Kedah,0,0,0
2023-11-01,CRI,Perak,0,0,0
2023-11-01,CRI,Perlis,0,0,0
2023-11-01,CRI,Pulau Pinang,3,3,0
2023-11-01,CRI,Sabah,1,1,0
2023-11-01,CRI,Sarawak,0,0,0
2023-11-01,CRI,Selangor,57,37,20
2023-11-01,CUB,Johor,5,4,1
2023-11-01,CUB,Kedah,0,0,0
2023-11-01,CUB,Perlis,0,0,0
2023-11-01,CUB,Pulau Pinang,1,0,1
2023-11-01,CUB,Sabah,0,0,0
2023-11-01,CUB,Sarawak,0,0,0
2023-11-01,CUB,Selangor,33,17,16
2023-11-01,CYP,Johor,12,4,8
2023-11-01,CYP,Kedah,0,0,0
2023-11-01,CYP,Perak,0,0,0
2023-11-01,CYP,Perlis,0,0,0
2023-11-01,CYP,Pulau Pinang,0,0,0
2023-11-01,CYP,Sabah,1,1,0
2023-11-01,CYP,Sarawak,1,1,0
2023-11-01,CYP,Selangor,111,74,37
2023-11-01,CZE,Johor,170,91,79
2023-11-01,CZE,Kedah,117,49,68
2023-11-01,CZE,Kelantan,1,0,1
2023-11-01,CZE,Melaka,0,0,0
2023-11-01,CZE,Negeri Sembilan,0,0,0
2023-11-01,CZE,Perak,0,0,0
2023-11-01,CZE,Perlis,0,0,0
2023-11-01,CZE,Pulau Pinang,19,11,8
2023-11-01,CZE,Sabah,14,9,5
2023-11-01,CZE,Sarawak,12,7,5
2023-11-01,CZE,Selangor,669,388,281
2023-11-01,CZE,W.P. Labuan,12,4,8
2023-11-01,DEU,Johor,2467,1562,905
2023-11-01,DEU,Kedah,784,393,391
2023-11-01,DEU,Kelantan,7,6,1
2023-11-01,DEU,Melaka,0,0,0
2023-11-01,DEU,Negeri Sembilan,1,1,0
2023-11-01,DEU,Pahang,6,5,1
2023-11-01,DEU,Perak,21,16,5
2023-11-01,DEU,Perlis,87,52,35
2023-11-01,DEU,Pulau Pinang,845,648,197
2023-11-01,DEU,Sabah,110,74,36
2023-11-01,DEU,Sarawak,158,106,52
2023-11-01,DEU,Selangor,7252,4649,2603
2023-11-01,DEU,Terengganu,1,1,0
2023-11-01,DEU,W.P. Labuan,7,4,3
2023-11-01,DJI,Johor,0,0,0
2023-11-01,DJI,Selangor,14,9,5
2023-11-01,DMA,Johor,2,2,0
2023-11-01,DMA,Kedah,0,0,0
2023-11-01,DMA,Pulau Pinang,0,0,0
2023-11-01,DMA,Sabah,0,0,0
2023-11-01,DMA,Sarawak,0,0,0
2023-11-01,DMA,Selangor,37,32,5
2023-11-01,DMA,W.P. Labuan,0,0,0
2023-11-01,DNK,Johor,276,216,60
2023-11-01,DNK,Kedah,141,67,74
2023-11-01,DNK,Kelantan,1,1,0
2023-11-01,DNK,Melaka,0,0,0
2023-11-01,DNK,Negeri Sembilan,4,2,2
2023-11-01,DNK,Pahang,0,0,0
2023-11-01,DNK,Perak,4,3,1
2023-11-01,DNK,Perlis,26,15,11
2023-11-01,DNK,Pulau Pinang,85,58,27
2023-11-01,DNK,Sabah,22,15,7
2023-11-01,DNK,Sarawak,9,6,3
2023-11-01,DNK,Selangor,1015,649,366
2023-11-01,DNK,W.P. Labuan,0,0,0
2023-11-01,DOM,Johor,2,0,2
2023-11-01,DOM,Kedah,0,0,0
2023-11-01,DOM,Perak,0,0,0
2023-11-01,DOM,Perlis,0,0,0
2023-11-01,DOM,Pulau Pinang,1,1,0
2023-11-01,DOM,Sabah,1,0,1
2023-11-01,DOM,Sarawak,0,0,0
2023-11-01,DOM,Selangor,92,46,46
2023-11-01,DZA,Johor,20,14,6
2023-11-01,DZA,Kedah,2,2,0
2023-11-01,DZA,Kelantan,0,0,0
2023-11-01,DZA,Melaka,0,0,0
2023-11-01,DZA,Perak,0,0,0
2023-11-01,DZA,Perlis,0,0,0
2023-11-01,DZA,Pulau Pinang,1,1,0
2023-11-01,DZA,Sabah,2,2,0
2023-11-01,DZA,Sarawak,3,3,0
2023-11-01,DZA,Selangor,767,514,253
2023-11-01,DZA,W.P. Labuan,0,0,0
2023-11-01,ECU,Johor,9,6,3
2023-11-01,ECU,Kedah,3,0,3
2023-11-01,ECU,Perak,0,0,0
2023-11-01,ECU,Perlis,0,0,0
2023-11-01,ECU,Pulau Pinang,3,1,2
2023-11-01,ECU,Sabah,3,2,1
2023-11-01,ECU,Sarawak,0,0,0
2023-11-01,ECU,Selangor,105,55,50
2023-11-01,EGY,Johor,193,160,33
2023-11-01,EGY,Kedah,7,5,2
2023-11-01,EGY,Kelantan,4,1,3
2023-11-01,EGY,Melaka,0,0,0
2023-11-01,EGY,Pahang,0,0,0
2023-11-01,EGY,Perak,0,0,0
2023-11-01,EGY,Perlis,0,0,0
2023-11-01,EGY,Pulau Pinang,14,10,4
2023-11-01,EGY,Sabah,0,0,0
2023-11-01,EGY,Sarawak,52,42,10
2023-11-01,EGY,Selangor,1948,1329,619
2023-11-01,EGY,Terengganu,0,0,0
2023-11-01,EGY,W.P. Labuan,0,0,0
2023-11-01,ERI,Johor,0,0,0
2023-11-01,ERI,Pulau Pinang,0,0,0
2023-11-01,ERI,Sabah,0,0,0
2023-11-01,ERI,Selangor,26,14,12
2023-11-01,ESP,Johor,526,330,196
2023-11-01,ESP,Kedah,277,138,139
2023-11-01,ESP,Kelantan,3,2,1
2023-11-01,ESP,Melaka,2,1,1
2023-11-01,ESP,Negeri Sembilan,1,1,0
2023-11-01,ESP,Pahang,0,0,0
2023-11-01,ESP,Perak,9,7,2
2023-11-01,ESP,Perlis,14,10,4
2023-11-01,ESP,Pulau Pinang,116,69,47
2023-11-01,ESP,Sabah,31,21,10
2023-11-01,ESP,Sarawak,49,29,20
2023-11-01,ESP,Selangor,3435,2110,1325
2023-11-01,ESP,W.P. Labuan,3,2,1
2023-11-01,EST,Johor,36,17,19
2023-11-01,EST,Kedah,25,13,12
2023-11-01,EST,Kelantan,6,2,4
2023-11-01,EST,Pahang,0,0,0
2023-11-01,EST,Perak,0,0,0
2023-11-01,EST,Perlis,3,1,2
2023-11-01,EST,Pulau Pinang,3,3,0
2023-11-01,EST,Sabah,2,1,1
2023-11-01,EST,Sarawak,18,8,10
2023-11-01,EST,Selangor,283,148,135
2023-11-01,EST,W.P. Labuan,0,0,0
2023-11-01,ETH,Johor,1,1,0
2023-11-01,ETH,Kedah,1,0,1
2023-11-01,ETH,Pulau Pinang,0,0,0
2023-11-01,ETH,Sarawak,0,0,0
2023-11-01,ETH,Selangor,35,26,9
2023-11-01,FIN,Johor,238,148,90
2023-11-01,FIN,Kedah,112,46,66
2023-11-01,FIN,Kelantan,0,0,0
2023-11-01,FIN,Melaka,0,0,0
2023-11-01,FIN,Negeri Sembilan,3,3,0
2023-11-01,FIN,Pahang,0,0,0
2023-11-01,FIN,Perak,3,3,0
2023-11-01,FIN,Perlis,2,2,0
2023-11-01,FIN,Pulau Pinang,67,47,20
2023-11-01,FIN,Sabah,10,8,2
2023-11-01,FIN,Sarawak,22,10,12
2023-11-01,FIN,Selangor,585,325,260
2023-11-01,FIN,W.P. Labuan,0,0,0
2023-11-01,FJI,Johor,58,39,19
2023-11-01,FJI,Kedah,2,0,2
2023-11-01,FJI,Kelantan,0,0,0
2023-11-01,FJI,Perak,0,0,0
2023-11-01,FJI,Perlis,0,0,0
2023-11-01,FJI,Pulau Pinang,1,1,0
2023-11-01,FJI,Sabah,0,0,0
2023-11-01,FJI,Sarawak,1,1,0
2023-11-01,FJI,Selangor,127,59,68
2023-11-01,FRA,Johor,1868,1182,686
2023-11-01,FRA,Kedah,412,242,170
2023-11-01,FRA,Kelantan,16,12,4
2023-11-01,FRA,Melaka,3,1,2
2023-11-01,FRA,Negeri Sembilan,5,3,2
2023-11-01,FRA,Pahang,13,7,6
2023-11-01,FRA,Perak,27,22,5
2023-11-01,FRA,Perlis,44,33,11
2023-11-01,FRA,Pulau Pinang,425,282,143
2023-11-01,FRA,Sabah,78,49,29
2023-11-01,FRA,Sarawak,82,54,28
2023-11-01,FRA,Selangor,7412,4785,2627
2023-11-01,FRA,Terengganu,0,0,0
2023-11-01,FRA,W.P. Labuan,3,3,0
2023-11-01,FSM,Johor,0,0,0
2023-11-01,FSM,Pulau Pinang,0,0,0
2023-11-01,FSM,Selangor,10,5,5
2023-11-01,GAB,Johor,1,0,1
2023-11-01,GAB,Pulau Pinang,0,0,0
2023-11-01,GAB,Sarawak,0,0,0
2023-11-01,GAB,Selangor,11,7,4
2023-11-01,GBR,Johor,4695,2980,1715
2023-11-01,GBR,Kedah,1202,650,552
2023-11-01,GBR,Kelantan,23,15,8
2023-11-01,GBR,Melaka,5,4,1
2023-11-01,GBR,Negeri Sembilan,0,0,0
2023-11-01,GBR,Pahang,14,10,4
2023-11-01,GBR,Perak,88,55,33
2023-11-01,GBR,Perlis,138,89,49
2023-11-01,GBR,Pulau Pinang,1688,1001,687
2023-11-01,GBR,Sabah,265,140,125
2023-11-01,GBR,Sarawak,669,431,238
2023-11-01,GBR,Selangor,17675,11303,6372
2023-11-01,GBR,Terengganu,0,0,0
2023-11-01,GBR,W.P. Labuan,39,31,8
2023-11-01,GEO,Johor,12,9,3
2023-11-01,GEO,Kedah,1,1,0
2023-11-01,GEO,Melaka,0,0,0
2023-11-01,GEO,Perak,0,0,0
2023-11-01,GEO,Perlis,0,0,0
2023-11-01,GEO,Pulau Pinang,3,0,3
2023-11-01,GEO,Sabah,0,0,0
2023-11-01,GEO,Sarawak,0,0,0
2023-11-01,GEO,Selangor,48,30,18
2023-11-01,GHA,Johor,6,4,2
2023-11-01,GHA,Kedah,0,0,0
2023-11-01,GHA,Kelantan,0,0,0
2023-11-01,GHA,Pulau Pinang,0,0,0
2023-11-01,GHA,Sabah,0,0,0
2023-11-01,GHA,Sarawak,0,0,0
2023-11-01,GHA,Selangor,125,84,41
2023-11-01,GIB,Johor,0,0,0
2023-11-01,GIB,Sarawak,0,0,0
2023-11-01,GIN,Johor,4,2,2
2023-11-01,GIN,Kedah,1,0,1
2023-11-01,GIN,Kelantan,0,0,0
2023-11-01,GIN,Perlis,0,0,0
2023-11-01,GIN,Pulau Pinang,0,0,0
2023-11-01,GIN,Sabah,0,0,0
2023-11-01,GIN,Sarawak,0,0,0
2023-11-01,GIN,Selangor,61,44,17
2023-11-01,GLP,Selangor,0,0,0
2023-11-01,GMB,Johor,1,0,1
2023-11-01,GMB,Kedah,0,0,0
2023-11-01,GMB,Kelantan,0,0,0
2023-11-01,GMB,Pulau Pinang,0,0,0
2023-11-01,GMB,Sabah,0,0,0
2023-11-01,GMB,Sarawak,0,0,0
2023-11-01,GMB,Selangor,28,21,7
2023-11-01,GNB,Johor,0,0,0
2023-11-01,GNB,Selangor,1,0,1
2023-11-01,GNQ,Johor,0,0,0
2023-11-01,GNQ,Selangor,0,0,0
2023-11-01,GRC,Johor,71,48,23
2023-11-01,GRC,Kedah,6,2,4
2023-11-01,GRC,Kelantan,0,0,0
2023-11-01,GRC,Melaka,0,0,0
2023-11-01,GRC,Negeri Sembilan,0,0,0
2023-11-01,GRC,Pahang,0,0,0
2023-11-01,GRC,Perak,0,0,0
2023-11-01,GRC,Perlis,3,1,2
2023-11-01,GRC,Pulau Pinang,21,12,9
2023-11-01,GRC,Sabah,2,2,0
2023-11-01,GRC,Sarawak,4,4,0
2023-11-01,GRC,Selangor,293,212,81
2023-11-01,GRD,Johor,2,0,2
2023-11-01,GRD,Kedah,0,0,0
2023-11-01,GRD,Pulau Pinang,1,1,0
2023-11-01,GRD,Sabah,0,0,0
2023-11-01,GRD,Sarawak,0,0,0
2023-11-01,GRD,Selangor,9,8,1
2023-11-01,GRL,Johor,0,0,0
2023-11-01,GRL,Selangor,0,0,0
2023-11-01,GTM,Johor,6,2,4
2023-11-01,GTM,Kedah,1,1,0
2023-11-01,GTM,Pahang,0,0,0
2023-11-01,GTM,Perak,0,0,0
2023-11-01,GTM,Pulau Pinang,7,5,2
2023-11-01,GTM,Sabah,0,0,0
2023-11-01,GTM,Sarawak,0,0,0
2023-11-01,GTM,Selangor,63,39,24
2023-11-01,GTM,W.P. Labuan,0,0,0
2023-11-01,GUY,Johor,1,0,1
2023-11-01,GUY,Kedah,0,0,0
2023-11-01,GUY,Pulau Pinang,0,0,0
2023-11-01,GUY,Sarawak,0,0,0
2023-11-01,GUY,Selangor,16,10,6
2023-11-01,HKG,Johor,6,1,5
2023-11-01,HKG,Kedah,0,0,0
2023-11-01,HKG,Kelantan,0,0,0
2023-11-01,HKG,Pahang,4,2,2
2023-11-01,HKG,Perak,51,29,22
2023-11-01,HKG,Perlis,2,2,0
2023-11-01,HKG,Pulau Pinang,0,0,0
2023-11-01,HKG,Sabah,53,28,25
2023-11-01,HKG,Sarawak,0,0,0
2023-11-01,HKG,Selangor,42,15,27
2023-11-01,HKG,Terengganu,0,0,0
2023-11-01,HMD,Johor,0,0,0
2023-11-01,HND,Johor,6,4,2
2023-11-01,HND,Kedah,1,1,0
2023-11-01,HND,Perak,0,0,0
2023-11-01,HND,Pulau Pinang,0,0,0
2023-11-01,HND,Sabah,0,0,0
2023-11-01,HND,Sarawak,0,0,0
2023-11-01,HND,Selangor,26,16,10
2023-11-01,HRV,Johor,60,31,29
2023-11-01,HRV,Kedah,2,0,2
2023-11-01,HRV,Kelantan,0,0,0
2023-11-01,HRV,Melaka,1,1,0
2023-11-01,HRV,Pahang,0,0,0
2023-11-01,HRV,Perak,0,0,0
2023-11-01,HRV,Perlis,0,0,0
2023-11-01,HRV,Pulau Pinang,3,2,1
2023-11-01,HRV,Sabah,8,7,1
2023-11-01,HRV,Sarawak,1,1,0
2023-11-01,HRV,Selangor,243,139,104
2023-11-01,HTI,Johor,1,1,0
2023-11-01,HTI,Kedah,0,0,0
2023-11-01,HTI,Kelantan,0,0,0
2023-11-01,HTI,Perak,0,0,0
2023-11-01,HTI,Pulau Pinang,0,0,0
2023-11-01,HTI,Sabah,0,0,0
2023-11-01,HTI,Selangor,9,6,3
2023-11-01,HUN,Johor,108,66,42
2023-11-01,HUN,Kedah,30,13,17
2023-11-01,HUN,Kelantan,0,0,0
2023-11-01,HUN,Pahang,0,0,0
2023-11-01,HUN,Perak,1,1,0
2023-11-01,HUN,Perlis,2,0,2
2023-11-01,HUN,Pulau Pinang,30,15,15
2023-11-01,HUN,Sabah,1,0,1
2023-11-01,HUN,Sarawak,6,4,2
2023-11-01,HUN,Selangor,550,299,251
2023-11-01,HUN,W.P. Labuan,0,0,0
2023-11-01,IDN,Johor,96612,45154,51458
2023-11-01,IDN,Kedah,5183,1900,3283
2023-11-01,IDN,Kelantan,139,80,59
2023-11-01,IDN,Melaka,3624,1639,1985
2023-11-01,IDN,Negeri Sembilan,5507,3369,2138
2023-11-01,IDN,Pahang,17,7,10
2023-11-01,IDN,Perak,217,84,133
2023-11-01,IDN,Perlis,652,255,397
2023-11-01,IDN,Pulau Pinang,39593,15700,23893
2023-11-01,IDN,Sabah,4552,2211,2341
2023-11-01,IDN,Sarawak,35677,19271,16406
2023-11-01,IDN,Selangor,139070,66141,72929
2023-11-01,IDN,Terengganu,0,0,0
2023-11-01,IDN,W.P. Labuan,43,22,21
2023-11-01,IND,Johor,19940,13134,6806
2023-11-01,IND,Kedah,1165,622,543
2023-11-01,IND,Kelantan,7,5,2
2023-11-01,IND,Melaka,12,12,0
2023-11-01,IND,Negeri Sembilan,1,1,0
2023-11-01,IND,Pahang,15,12,3
2023-11-01,IND,Perak,163,122,41
2023-11-01,IND,Perlis,18,14,4
2023-11-01,IND,Pulau Pinang,895,674,221
2023-11-01,IND,Sabah,189,143,46
2023-11-01,IND,Sarawak,1029,824,205
2023-11-01,IND,Selangor,48321,33365,14956
2023-11-01,IND,Terengganu,0,0,0
2023-11-01,IND,W.P. Labuan,31,29,2
2023-11-01,IOT,Pulau Pinang,1,0,1
2023-11-01,IOT,Selangor,1,0,1
2023-11-01,IRL,Johor,296,192,104
2023-11-01,IRL,Kedah,69,35,34
2023-11-01,IRL,Kelantan,1,1,0
2023-11-01,IRL,Negeri Sembilan,0,0,0
2023-11-01,IRL,Pahang,0,0,0
2023-11-01,IRL,Perak,2,0,2
2023-11-01,IRL,Perlis,17,12,5
2023-11-01,IRL,Pulau Pinang,100,66,34
2023-11-01,IRL,Sabah,12,9,3
2023-11-01,IRL,Sarawak,36,13,23
2023-11-01,IRL,Selangor,1383,861,522
2023-11-01,IRL,Terengganu,2,2,0
2023-11-01,IRL,W.P. Labuan,2,1,1
2023-11-01,IRN,Johor,256,134,122
2023-11-01,IRN,Kedah,7,4,3
2023-11-01,IRN,Kelantan,0,0,0
2023-11-01,IRN,Perak,0,0,0
2023-11-01,IRN,Perlis,2,2,0
2023-11-01,IRN,Pulau Pinang,12,7,5
2023-11-01,IRN,Sabah,2,2,0
2023-11-01,IRN,Sarawak,5,5,0
2023-11-01,IRN,Selangor,2308,1253,1055
2023-11-01,IRN,W.P. Labuan,0,0,0
2023-11-01,IRQ,Johor,17,14,3
2023-11-01,IRQ,Kedah,2,1,1
2023-11-01,IRQ,Kelantan,0,0,0
2023-11-01,IRQ,Melaka,0,0,0
2023-11-01,IRQ,Pahang,0,0,0
2023-11-01,IRQ,Perak,0,0,0
2023-11-01,IRQ,Perlis,0,0,0
2023-11-01,IRQ,Pulau Pinang,3,2,1
2023-11-01,IRQ,Sabah,0,0,0
2023-11-01,IRQ,Sarawak,3,1,2
2023-11-01,IRQ,Selangor,1358,947,411
2023-11-01,ISL,Johor,16,9,7
2023-11-01,ISL,Kedah,1,1,0
2023-11-01,ISL,Kelantan,0,0,0
2023-11-01,ISL,Perak,0,0,0
2023-11-01,ISL,Perlis,0,0,0
2023-11-01,ISL,Pulau Pinang,1,1,0
2023-11-01,ISL,Sabah,5,4,1
2023-11-01,ISL,Sarawak,0,0,0
2023-11-01,ISL,Selangor,34,18,16
2023-11-01,ISL,W.P. Labuan,0,0,0
2023-11-01,ISR,Pulau Pinang,0,0,0
2023-11-01,ITA,Johor,586,407,179
2023-11-01,ITA,Kedah,200,108,92
2023-11-01,ITA,Kelantan,3,3,0
2023-11-01,ITA,Melaka,0,0,0
2023-11-01,ITA,Negeri Sembilan,0,0,0
2023-11-01,ITA,Pahang,2,2,0
2023-11-01,ITA,Perak,3,2,1
2023-11-01,ITA,Perlis,17,10,7
2023-11-01,ITA,Pulau Pinang,141,107,34
2023-11-01,ITA,Sabah,19,12,7
2023-11-01,ITA,Sarawak,33,26,7
2023-11-01,ITA,Selangor,3126,2253,873
2023-11-01,ITA,W.P. Labuan,0,0,0
2023-11-01,JAM,Johor,0,0,0
2023-11-01,JAM,Kedah,0,0,0
2023-11-01,JAM,Perak,0,0,0
2023-11-01,JAM,Pulau Pinang,1,1,0
2023-11-01,JAM,Sabah,0,0,0
2023-11-01,JAM,Sarawak,1,1,0
2023-11-01,JAM,Selangor,36,10,26
2023-11-01,JAM,W.P. Labuan,0,0,0
2023-11-01,JOR,Johor,15,11,4
2023-11-01,JOR,Kedah,5,4,1
2023-11-01,JOR,Kelantan,0,0,0
2023-11-01,JOR,Melaka,0,0,0
2023-11-01,JOR,Perlis,1,1,0
2023-11-01,JOR,Pulau Pinang,14,11,3
2023-11-01,JOR,Sabah,0,0,0
2023-11-01,JOR,Sarawak,0,0,0
2023-11-01,JOR,Selangor,709,470,239
2023-11-01,JOR,W.P. Labuan,0,0,0
2023-11-01,JPN,Johor,7015,4526,2489
2023-11-01,JPN,Kedah,279,136,143
2023-11-01,JPN,Kelantan,12,9,3
2023-11-01,JPN,Melaka,2,2,0
2023-11-01,JPN,Negeri Sembilan,0,0,0
2023-11-01,JPN,Pahang,18,14,4
2023-11-01,JPN,Perak,85,59,26
2023-11-01,JPN,Perlis,53,46,7
2023-11-01,JPN,Pulau Pinang,1327,982,345
2023-11-01,JPN,Sabah,225,132,93
2023-11-01,JPN,Sarawak,227,148,79
2023-11-01,JPN,Selangor,20707,13397,7310
2023-11-01,JPN,W.P. Labuan,13,8,5
2023-11-01,KAZ,Johor,36,17,19
2023-11-01,KAZ,Kedah,8,4,4
2023-11-01,KAZ,Kelantan,1,0,1
2023-11-01,KAZ,Melaka,0,0,0
2023-11-01,KAZ,Perak,0,0,0
2023-11-01,KAZ,Perlis,6,2,4
2023-11-01,KAZ,Pulau Pinang,12,5,7
2023-11-01,KAZ,Sabah,4,1,3
2023-11-01,KAZ,Sarawak,13,6,7
2023-11-01,KAZ,Selangor,892,375,517
2023-11-01,KAZ,W.P. Labuan,0,0,0
2023-11-01,KEN,Johor,68,26,42
2023-11-01,KEN,Kedah,2,1,1
2023-11-01,KEN,Kelantan,0,0,0
2023-11-01,KEN,Perak,0,0,0
2023-11-01,KEN,Perlis,0,0,0
2023-11-01,KEN,Pulau Pinang,6,4,2
2023-11-01,KEN,Sabah,0,0,0
2023-11-01,KEN,Sarawak,3,1,2
2023-11-01,KEN,Selangor,582,286,296
2023-11-01,KGZ,Johor,26,18,8
2023-11-01,KGZ,Kedah,3,3,0
2023-11-01,KGZ,Kelantan,0,0,0
2023-11-01,KGZ,Perak,0,0,0
2023-11-01,KGZ,Perlis,1,0,1
2023-11-01,KGZ,Pulau Pinang,2,2,0
2023-11-01,KGZ,Sabah,0,0,0
2023-11-01,KGZ,Sarawak,0,0,0
2023-11-01,KGZ,Selangor,281,157,124
2023-11-01,KHM,Johor,2846,1218,1628
2023-11-01,KHM,Kedah,109,57,52
2023-11-01,KHM,Kelantan,354,181,173
2023-11-01,KHM,Melaka,0,0,0
2023-11-01,KHM,Negeri Sembilan,0,0,0
2023-11-01,KHM,Pahang,0,0,0
2023-11-01,KHM,Perak,14,4,10
2023-11-01,KHM,Perlis,618,344,274
2023-11-01,KHM,Pulau Pinang,45,22,23
2023-11-01,KHM,Sabah,3,0,3
2023-11-01,KHM,Sarawak,7,1,6
2023-11-01,KHM,Selangor,4255,1991,2264
2023-11-01,KHM,W.P. Labuan,0,0,0
2023-11-01,KIR,Johor,0,0,0
2023-11-01,KIR,Sabah,0,0,0
2023-11-01,KIR,Selangor,0,0,0
2023-11-01,KNA,Johor,26,16,10
2023-11-01,KNA,Kedah,2,1,1
2023-11-01,KNA,Perlis,0,0,0
2023-11-01,KNA,Pulau Pinang,0,0,0
2023-11-01,KNA,Sabah,0,0,0
2023-11-01,KNA,Selangor,56,44,12
2023-11-01,KNA,W.P. Labuan,0,0,0
2023-11-01,KOR,Johor,9723,5285,4438
2023-11-01,KOR,Kedah,209,106,103
2023-11-01,KOR,Kelantan,2,1,1
2023-11-01,KOR,Melaka,1,1,0
2023-11-01,KOR,Negeri Sembilan,0,0,0
2023-11-01,KOR,Pahang,5,3,2
2023-11-01,KOR,Perak,31,14,17
2023-11-01,KOR,Perlis,52,34,18
2023-11-01,KOR,Pulau Pinang,475,289,186
2023-11-01,KOR,Sabah,9304,3884,5420
2023-11-01,KOR,Sarawak,194,116,78
2023-11-01,KOR,Selangor,14482,8292,6190
2023-11-01,KOR,Terengganu,0,0,0
2023-11-01,KOR,W.P. Labuan,1,0,1
2023-11-01,KWT,Johor,18,8,10
2023-11-01,KWT,Kedah,4,2,2
2023-11-01,KWT,Kelantan,0,0,0
2023-11-01,KWT,Perak,0,0,0
2023-11-01,KWT,Perlis,3,3,0
2023-11-01,KWT,Pulau Pinang,2,1,1
2023-11-01,KWT,Sabah,0,0,0
2023-11-01,KWT,Sarawak,0,0,0
2023-11-01,KWT,Selangor,287,184,103
2023-11-01,KWT,W.P. Labuan,0,0,0
2023-11-01,LAO,Johor,186,60,126
2023-11-01,LAO,Kedah,873,72,801
2023-11-01,LAO,Kelantan,138,7,131
2023-11-01,LAO,Melaka,0,0,0
2023-11-01,LAO,Perak,36,5,31
2023-11-01,LAO,Perlis,463,76,387
2023-11-01,LAO,Pulau Pinang,21,7,14
2023-11-01,LAO,Sabah,0,0,0
2023-11-01,LAO,Sarawak,8,2,6
2023-11-01,LAO,Selangor,318,154,164
2023-11-01,LAO,W.P. Labuan,1,0,1
2023-11-01,LBN,Johor,13,9,4
2023-11-01,LBN,Kedah,7,3,4
2023-11-01,LBN,Kelantan,0,0,0
2023-11-01,LBN,Pahang,0,0,0
2023-11-01,LBN,Perak,1,1,0
2023-11-01,LBN,Perlis,0,0,0
2023-11-01,LBN,Pulau Pinang,3,2,1
2023-11-01,LBN,Sabah,2,2,0
2023-11-01,LBN,Sarawak,2,2,0
2023-11-01,LBN,Selangor,301,194,107
2023-11-01,LBN,W.P. Labuan,0,0,0
2023-11-01,LBR,Johor,0,0,0
2023-11-01,LBR,Kedah,0,0,0
2023-11-01,LBR,Sabah,0,0,0
2023-11-01,LBR,Sarawak,1,1,0
2023-11-01,LBR,Selangor,8,8,0
2023-11-01,LBY,Johor,0,0,0
2023-11-01,LBY,Kedah,0,0,0
2023-11-01,LBY,Perlis,0,0,0
2023-11-01,LBY,Pulau Pinang,0,0,0
2023-11-01,LBY,Sabah,0,0,0
2023-11-01,LBY,Sarawak,2,1,1
2023-11-01,LBY,Selangor,405,301,104
2023-11-01,LCA,Johor,4,3,1
2023-11-01,LCA,Kedah,0,0,0
2023-11-01,LCA,Pulau Pinang,2,2,0
2023-11-01,LCA,Sarawak,1,1,0
2023-11-01,LCA,Selangor,6,6,0
2023-11-01,LIE,Johor,0,0,0
2023-11-01,LIE,Kedah,1,1,0
2023-11-01,LIE,Perlis,0,0,0
2023-11-01,LIE,Pulau Pinang,3,2,1
2023-11-01,LIE,Sabah,0,0,0
2023-11-01,LIE,Sarawak,0,0,0
2023-11-01,LIE,Selangor,7,6,1
2023-11-01,LKA,Johor,817,539,278
2023-11-01,LKA,Kedah,48,33,15
2023-11-01,LKA,Kelantan,0,0,0
2023-11-01,LKA,Melaka,0,0,0
2023-11-01,LKA,Pahang,0,0,0
2023-11-01,LKA,Perak,2,1,1
2023-11-01,LKA,Perlis,0,0,0
2023-11-01,LKA,Pulau Pinang,39,22,17
2023-11-01,LKA,Sabah,15,10,5
2023-11-01,LKA,Sarawak,17,14,3
2023-11-01,LKA,Selangor,4946,3188,1758
2023-11-01,LKA,W.P. Labuan,0,0,0
2023-11-01,LSO,Johor,0,0,0
2023-11-01,LSO,Kedah,0,0,0
2023-11-01,LSO,Pulau Pinang,0,0,0
2023-11-01,LSO,Sarawak,0,0,0
2023-11-01,LSO,Selangor,3,0,3
2023-11-01,LTU,Johor,107,44,63
2023-11-01,LTU,Kedah,65,29,36
2023-11-01,LTU,Kelantan,1,1,0
2023-11-01,LTU,Pahang,0,0,0
2023-11-01,LTU,Perak,1,0,1
2023-11-01,LTU,Perlis,1,1,0
2023-11-01,LTU,Pulau Pinang,14,5,9
2023-11-01,LTU,Sabah,2,1,1
2023-11-01,LTU,Sarawak,4,1,3
2023-11-01,LTU,Selangor,486,247,239
2023-11-01,LTU,W.P. Labuan,22,10,12
2023-11-01,LUX,Johor,12,10,2
2023-11-01,LUX,Kedah,4,3,1
2023-11-01,LUX,Kelantan,0,0,0
2023-11-01,LUX,Perak,0,0,0
2023-11-01,LUX,Perlis,0,0,0
2023-11-01,LUX,Pulau Pinang,5,3,2
2023-11-01,LUX,Sabah,0,0,0
2023-11-01,LUX,Sarawak,0,0,0
2023-11-01,LUX,Selangor,51,37,14
2023-11-01,LVA,Johor,69,20,49
2023-11-01,LVA,Kedah,6,4,2
2023-11-01,LVA,Kelantan,1,0,1
2023-11-01,LVA,Pahang,0,0,0
2023-11-01,LVA,Perak,1,1,0
2023-11-01,LVA,Perlis,2,2,0
2023-11-01,LVA,Pulau Pinang,6,2,4
2023-11-01,LVA,Sabah,3,1,2
2023-11-01,LVA,Sarawak,16,5,11
2023-11-01,LVA,Selangor,208,96,112
2023-11-01,LVA,W.P. Labuan,0,0,0
2023-11-01,MAC,Johor,0,0,0
2023-11-01,MAC,Pahang,0,0,0
2023-11-01,MAC,Perak,0,0,0
2023-11-01,MAC,Selangor,0,0,0
2023-11-01,MAC,W.P. Labuan,0,0,0
2023-11-01,MAR,Johor,78,50,28
2023-11-01,MAR,Kedah,12,7,5
2023-11-01,MAR,Kelantan,1,1,0
2023-11-01,MAR,Melaka,0,0,0
2023-11-01,MAR,Pahang,0,0,0
2023-11-01,MAR,Perak,0,0,0
2023-11-01,MAR,Perlis,0,0,0
2023-11-01,MAR,Pulau Pinang,8,8,0
2023-11-01,MAR,Sabah,0,0,0
2023-11-01,MAR,Sarawak,8,5,3
2023-11-01,MAR,Selangor,835,456,379
2023-11-01,MAR,W.P. Labuan,0,0,0
2023-11-01,MCO,Johor,0,0,0
2023-11-01,MCO,Kedah,1,1,0
2023-11-01,MCO,Sabah,1,1,0
2023-11-01,MCO,Selangor,5,5,0
2023-11-01,MDA,Johor,1,1,0
2023-11-01,MDA,Kedah,0,0,0
2023-11-01,MDA,Kelantan,0,0,0
2023-11-01,MDA,Negeri Sembilan,0,0,0
2023-11-01,MDA,Perlis,0,0,0
2023-11-01,MDA,Pulau Pinang,0,0,0
2023-11-01,MDA,Sabah,0,0,0
2023-11-01,MDA,Sarawak,0,0,0
2023-11-01,MDA,Selangor,33,20,13
2023-11-01,MDG,Johor,3,1,2
2023-11-01,MDG,Kedah,0,0,0
2023-11-01,MDG,Perak,0,0,0
2023-11-01,MDG,Perlis,0,0,0
2023-11-01,MDG,Pulau Pinang,0,0,0
2023-11-01,MDG,Sabah,0,0,0
2023-11-01,MDG,Sarawak,0,0,0
2023-11-01,MDG,Selangor,42,21,21
2023-11-01,MDV,Johor,128,66,62
2023-11-01,MDV,Kedah,1,0,1
2023-11-01,MDV,Kelantan,0,0,0
2023-11-01,MDV,Perak,0,0,0
2023-11-01,MDV,Perlis,0,0,0
2023-11-01,MDV,Pulau Pinang,4,2,2
2023-11-01,MDV,Sabah,0,0,0
2023-11-01,MDV,Sarawak,0,0,0
2023-11-01,MDV,Selangor,2354,1339,1015
2023-11-01,MEX,Johor,278,127,151
2023-11-01,MEX,Kedah,11,3,8
2023-11-01,MEX,Kelantan,2,1,1
2023-11-01,MEX,Pahang,0,0,0
2023-11-01,MEX,Perak,0,0,0
2023-11-01,MEX,Perlis,4,1,3
2023-11-01,MEX,Pulau Pinang,39,27,12
2023-11-01,MEX,Sabah,2,1,1
2023-11-01,MEX,Sarawak,4,2,2
2023-11-01,MEX,Selangor,866,428,438
2023-11-01,MEX,W.P. Labuan,0,0,0
2023-11-01,MHL,Johor,1,1,0
2023-11-01,MHL,Kedah,0,0,0
2023-11-01,MHL,Perak,0,0,0
2023-11-01,MHL,Pulau Pinang,0,0,0
2023-11-01,MHL,Sabah,0,0,0
2023-11-01,MHL,Selangor,3,3,0
2023-11-01,MKD,Johor,5,3,2
2023-11-01,MKD,Kedah,2,1,1
2023-11-01,MKD,Perak,0,0,0
2023-11-01,MKD,Pulau Pinang,0,0,0
2023-11-01,MKD,Sabah,0,0,0
2023-11-01,MKD,Sarawak,1,1,0
2023-11-01,MKD,Selangor,32,23,9
2023-11-01,MLI,Johor,1,1,0
2023-11-01,MLI,Sabah,0,0,0
2023-11-01,MLI,Selangor,9,7,2
2023-11-01,MLT,Johor,3,1,2
2023-11-01,MLT,Kedah,0,0,0
2023-11-01,MLT,Kelantan,0,0,0
2023-11-01,MLT,Perak,0,0,0
2023-11-01,MLT,Perlis,0,0,0
2023-11-01,MLT,Pulau Pinang,37,20,17
2023-11-01,MLT,Sabah,0,0,0
2023-11-01,MLT,Sarawak,0,0,0
2023-11-01,MLT,Selangor,55,37,18
2023-11-01,MLT,W.P. Labuan,0,0,0
2023-11-01,MMR,Johor,6026,1643,4383
2023-11-01,MMR,Kedah,64,9,55
2023-11-01,MMR,Kelantan,2,1,1
2023-11-01,MMR,Negeri Sembilan,0,0,0
2023-11-01,MMR,Pahang,1,0,1
2023-11-01,MMR,Perak,39,10,29
2023-11-01,MMR,Perlis,3,1,2
2023-11-01,MMR,Pulau Pinang,438,209,229
2023-11-01,MMR,Sabah,18,5,13
2023-11-01,MMR,Sarawak,49,20,29
2023-11-01,MMR,Selangor,6648,4479,2169
2023-11-01,MMR,Terengganu,0,0,0
2023-11-01,MMR,W.P. Labuan,0,0,0
2023-11-01,MNE,Johor,5,5,0
2023-11-01,MNE,Kedah,0,0,0
2023-11-01,MNE,Pulau Pinang,0,0,0
2023-11-01,MNE,Sabah,0,0,0
2023-11-01,MNE,Sarawak,0,0,0
2023-11-01,MNE,Selangor,14,12,2
2023-11-01,MNG,Johor,137,51,86
2023-11-01,MNG,Kedah,22,9,13
2023-11-01,MNG,Kelantan,1,0,1
2023-11-01,MNG,Perak,2,1,1
2023-11-01,MNG,Perlis,0,0,0
2023-11-01,MNG,Pulau Pinang,9,2,7
2023-11-01,MNG,Sabah,5,2,3
2023-11-01,MNG,Sarawak,0,0,0
2023-11-01,MNG,Selangor,445,177,268
2023-11-01,MNP,Selangor,0,0,0
2023-11-01,MOZ,Johor,0,0,0
2023-11-01,MOZ,Kedah,0,0,0
2023-11-01,MOZ,Perak,0,0,0
2023-11-01,MOZ,Pulau Pinang,0,0,0
2023-11-01,MOZ,Sabah,0,0,0
2023-11-01,MOZ,Sarawak,0,0,0
2023-11-01,MOZ,Selangor,19,8,11
2023-11-01,MRT,Johor,0,0,0
2023-11-01,MRT,Kedah,0,0,0
2023-11-01,MRT,Pulau Pinang,0,0,0
2023-11-01,MRT,Sabah,0,0,0
2023-11-01,MRT,Sarawak,0,0,0
2023-11-01,MRT,Selangor,25,19,6
2023-11-01,MUS,Johor,380,172,208
2023-11-01,MUS,Kedah,12,4,8
2023-11-01,MUS,Kelantan,0,0,0
2023-11-01,MUS,Pahang,0,0,0
2023-11-01,MUS,Perak,0,0,0
2023-11-01,MUS,Perlis,2,2,0
2023-11-01,MUS,Pulau Pinang,10,5,5
2023-11-01,MUS,Sabah,2,1,1
2023-11-01,MUS,Sarawak,2,0,2
2023-11-01,MUS,Selangor,2568,1205,1363
2023-11-01,MWI,Johor,5,2,3
2023-11-01,MWI,Pulau Pinang,0,0,0
2023-11-01,MWI,Sabah,0,0,0
2023-11-01,MWI,Sarawak,0,0,0
2023-11-01,MWI,Selangor,27,18,9
2023-11-01,MYT,Selangor,1,0,1
2023-11-01,NAM,Johor,2,0,2
2023-11-01,NAM,Kedah,0,0,0
2023-11-01,NAM,Perak,5,2,3
2023-11-01,NAM,Perlis,0,0,0
2023-11-01,NAM,Pulau Pinang,1,1,0
2023-11-01,NAM,Sabah,1,1,0
2023-11-01,NAM,Sarawak,0,0,0
2023-11-01,NAM,Selangor,32,12,20
2023-11-01,NCL,Selangor,0,0,0
2023-11-01,NER,Johor,0,0,0
2023-11-01,NER,Sabah,0,0,0
2023-11-01,NER,Selangor,1,0,1
2023-11-01,NGA,Johor,33,28,5
2023-11-01,NGA,Kedah,1,1,0
2023-11-01,NGA,Perlis,0,0,0
2023-11-01,NGA,Pulau Pinang,5,5,0
2023-11-01,NGA,Sabah,0,0,0
2023-11-01,NGA,Sarawak,6,2,4
2023-11-01,NGA,Selangor,484,369,115
2023-11-01,NIC,Johor,0,0,0
2023-11-01,NIC,Kedah,1,1,0
2023-11-01,NIC,Pulau Pinang,0,0,0
2023-11-01,NIC,Sabah,0,0,0
2023-11-01,NIC,Selangor,6,3,3
2023-11-01,NLD,Johor,970,624,346
2023-11-01,NLD,Kedah,315,158,157
2023-11-01,NLD,Kelantan,2,1,1
2023-11-01,NLD,Melaka,4,2,2
2023-11-01,NLD,Negeri Sembilan,4,3,1
2023-11-01,NLD,Pahang,0,0,0
2023-11-01,NLD,Perak,12,10,2
2023-11-01,NLD,Perlis,16,12,4
2023-11-01,NLD,Pulau Pinang,252,152,100
2023-11-01,NLD,Sabah,48,26,22
2023-11-01,NLD,Sarawak,103,57,46
2023-11-01,NLD,Selangor,4250,2637,1613
2023-11-01,NLD,Terengganu,2,2,0
2023-11-01,NLD,W.P. Labuan,4,3,1
2023-11-01,NOR,Johor,178,111,67
2023-11-01,NOR,Kedah,81,38,43
2023-11-01,NOR,Kelantan,1,1,0
2023-11-01,NOR,Melaka,1,1,0
2023-11-01,NOR,Pahang,0,0,0
2023-11-01,NOR,Perak,2,1,1
2023-11-01,NOR,Perlis,5,4,1
2023-11-01,NOR,Pulau Pinang,38,24,14
2023-11-01,NOR,Sabah,9,7,2
2023-11-01,NOR,Sarawak,13,11,2
2023-11-01,NOR,Selangor,749,475,274
2023-11-01,NOR,W.P. Labuan,1,1,0
2023-11-01,NPL,Johor,856,534,322
2023-11-01,NPL,Kedah,18,11,7
2023-11-01,NPL,Pahang,1,1,0
2023-11-01,NPL,Perak,0,0,0
2023-11-01,NPL,Perlis,0,0,0
2023-11-01,NPL,Pulau Pinang,23,15,8
2023-11-01,NPL,Sabah,3,2,1
2023-11-01,NPL,Sarawak,141,110,31
2023-11-01,NPL,Selangor,8471,7874,597
2023-11-01,NPL,W.P. Labuan,35,35,0
2023-11-01,NRU,Johor,5,3,2
2023-11-01,NRU,Pulau Pinang,0,0,0
2023-11-01,NRU,Selangor,3,3,0
2023-11-01,NZL,Johor,693,414,279
2023-11-01,NZL,Kedah,89,44,45
2023-11-01,NZL,Kelantan,7,5,2
2023-11-01,NZL,Melaka,4,2,2
2023-11-01,NZL,Negeri Sembilan,0,0,0
2023-11-01,NZL,Pahang,0,0,0
2023-11-01,NZL,Perak,19,9,10
2023-11-01,NZL,Perlis,7,5,2
2023-11-01,NZL,Pulau Pinang,245,143,102
2023-11-01,NZL,Sabah,31,21,10
2023-11-01,NZL,Sarawak,110,64,46
2023-11-01,NZL,Selangor,3530,2105,1425
2023-11-01,NZL,Terengganu,0,0,0
2023-11-01,NZL,W.P. Labuan,0,0,0
2023-11-01,OMN,Johor,47,25,22
2023-11-01,OMN,Kedah,5,5,0
2023-11-01,OMN,Kelantan,0,0,0
2023-11-01,OMN,Melaka,0,0,0
2023-11-01,OMN,Perak,1,1,0
2023-11-01,OMN,Perlis,0,0,0
2023-11-01,OMN,Pulau Pinang,0,0,0
2023-11-01,OMN,Sabah,0,0,0
2023-11-01,OMN,Sarawak,4,4,0
2023-11-01,OMN,Selangor,1617,1048,569
2023-11-01,PAK,Johor,718,523,195
2023-11-01,PAK,Kedah,98,65,33
2023-11-01,PAK,Kelantan,19,19,0
2023-11-01,PAK,Melaka,3,3,0
2023-11-01,PAK,Negeri Sembilan,0,0,0
2023-11-01,PAK,Pahang,0,0,0
2023-11-01,PAK,Perak,11,10,1
2023-11-01,PAK,Perlis,15,15,0
2023-11-01,PAK,Pulau Pinang,78,71,7
2023-11-01,PAK,Sabah,20,19,1
2023-11-01,PAK,Sarawak,126,111,15
2023-11-01,PAK,Selangor,8964,7439,1525
2023-11-01,PAK,W.P. Labuan,4,3,1
2023-11-01,PAN,Johor,2,1,1
2023-11-01,PAN,Kedah,0,0,0
2023-11-01,PAN,Perak,0,0,0
2023-11-01,PAN,Perlis,0,0,0
2023-11-01,PAN,Pulau Pinang,3,2,1
2023-11-01,PAN,Sabah,1,0,1
2023-11-01,PAN,Sarawak,0,0,0
2023-11-01,PAN,Selangor,43,20,23
2023-11-01,PER,Johor,24,8,16
2023-11-01,PER,Kedah,4,3,1
2023-11-01,PER,Kelantan,0,0,0
2023-11-01,PER,Pahang,0,0,0
2023-11-01,PER,Perak,0,0,0
2023-11-01,PER,Perlis,2,0,2
2023-11-01,PER,Pulau Pinang,6,1,5
2023-11-01,PER,Sabah,2,2,0
2023-11-01,PER,Sarawak,0,0,0
2023-11-01,PER,Selangor,151,83,68
2023-11-01,PER,W.P. Labuan,0,0,0
2023-11-01,PHL,Johor,24853,7657,17196
2023-11-01,PHL,Kedah,415,123,292
2023-11-01,PHL,Kelantan,24,8,16
2023-11-01,PHL,Melaka,0,0,0
2023-11-01,PHL,Negeri Sembilan,0,0,0
2023-11-01,PHL,Pahang,34,27,7
2023-11-01,PHL,Perak,82,21,61
2023-11-01,PHL,Perlis,202,62,140
2023-11-01,PHL,Pulau Pinang,800,345,455
2023-11-01,PHL,Sabah,1444,680,764
2023-11-01,PHL,Sarawak,1883,777,1106
2023-11-01,PHL,Selangor,16484,6894,9590
2023-11-01,PHL,Terengganu,0,0,0
2023-11-01,PHL,W.P. Labuan,117,36,81
2023-11-01,PLW,Johor,3,0,3
2023-11-01,PLW,Pulau Pinang,0,0,0
2023-11-01,PLW,Selangor,3,3,0
2023-11-01,PNG,Johor,71,32,39
2023-11-01,PNG,Kedah,1,1,0
2023-11-01,PNG,Kelantan,0,0,0
2023-11-01,PNG,Perak,0,0,0
2023-11-01,PNG,Pulau Pinang,2,1,1
2023-11-01,PNG,Sabah,4,2,2
2023-11-01,PNG,Sarawak,8,8,0
2023-11-01,PNG,Selangor,117,83,34
2023-11-01,POL,Johor,551,283,268
2023-11-01,POL,Kedah,176,79,97
2023-11-01,POL,Kelantan,2,1,1
2023-11-01,POL,Melaka,0,0,0
2023-11-01,POL,Negeri Sembilan,0,0,0
2023-11-01,POL,Pahang,0,0,0
2023-11-01,POL,Perak,2,1,1
2023-11-01,POL,Perlis,22,13,9
2023-11-01,POL,Pulau Pinang,87,57,30
2023-11-01,POL,Sabah,28,15,13
2023-11-01,POL,Sarawak,37,22,15
2023-11-01,POL,Selangor,1738,938,800
2023-11-01,POL,Terengganu,1,1,0
2023-11-01,POL,W.P. Labuan,1,1,0
2023-11-01,PRK,Selangor,0,0,0
2023-11-01,PRT,Johor,179,102,77
2023-11-01,PRT,Kedah,69,42,27
2023-11-01,PRT,Kelantan,2,2,0
2023-11-01,PRT,Melaka,0,0,0
2023-11-01,PRT,Pahang,0,0,0
2023-11-01,PRT,Perak,3,2,1
2023-11-01,PRT,Perlis,1,1,0
2023-11-01,PRT,Pulau Pinang,62,39,23
2023-11-01,PRT,Sabah,16,10,6
2023-11-01,PRT,Sarawak,4,1,3
2023-11-01,PRT,Selangor,897,532,365
2023-11-01,PRT,W.P. Labuan,0,0,0
2023-11-01,PRY,Johor,5,3,2
2023-11-01,PRY,Kedah,0,0,0
2023-11-01,PRY,Perak,0,0,0
2023-11-01,PRY,Perlis,0,0,0
2023-11-01,PRY,Pulau Pinang,0,0,0
2023-11-01,PRY,Sabah,2,1,1
2023-11-01,PRY,Sarawak,0,0,0
2023-11-01,PRY,Selangor,8,5,3
2023-11-01,PSE,Johor,22,21,1
2023-11-01,PSE,Kedah,0,0,0
2023-11-01,PSE,Kelantan,0,0,0
2023-11-01,PSE,Melaka,0,0,0
2023-11-01,PSE,Perak,0,0,0
2023-11-01,PSE,Perlis,0,0,0
2023-11-01,PSE,Pulau Pinang,2,2,0
2023-11-01,PSE,Sabah,0,0,0
2023-11-01,PSE,Sarawak,0,0,0
2023-11-01,PSE,Selangor,262,187,75
2023-11-01,QAT,Johor,6,0,6
2023-11-01,QAT,Kedah,1,0,1
2023-11-01,QAT,Perlis,0,0,0
2023-11-01,QAT,Pulau Pinang,0,0,0
2023-11-01,QAT,Sabah,0,0,0
2023-11-01,QAT,Sarawak,2,2,0
2023-11-01,QAT,Selangor,93,68,25
2023-11-01,REU,Johor,0,0,0
2023-11-01,REU,Sarawak,0,0,0
2023-11-01,ROU,Johor,177,106,71
2023-11-01,ROU,Kedah,29,15,14
2023-11-01,ROU,Kelantan,0,0,0
2023-11-01,ROU,Negeri Sembilan,0,0,0
2023-11-01,ROU,Pahang,0,0,0
2023-11-01,ROU,Perak,0,0,0
2023-11-01,ROU,Perlis,1,0,1
2023-11-01,ROU,Pulau Pinang,26,14,12
2023-11-01,ROU,Sabah,5,4,1
2023-11-01,ROU,Sarawak,3,3,0
2023-11-01,ROU,Selangor,719,379,340
2023-11-01,ROU,W.P. Labuan,0,0,0
2023-11-01,RUS,Johor,432,205,227
2023-11-01,RUS,Kedah,388,176,212
2023-11-01,RUS,Kelantan,38,21,17
2023-11-01,RUS,Melaka,0,0,0
2023-11-01,RUS,Negeri Sembilan,0,0,0
2023-11-01,RUS,Pahang,3,1,2
2023-11-01,RUS,Perak,6,4,2
2023-11-01,RUS,Perlis,171,96,75
2023-11-01,RUS,Pulau Pinang,236,118,118
2023-11-01,RUS,Sabah,45,23,22
2023-11-01,RUS,Sarawak,82,42,40
2023-11-01,RUS,Selangor,9052,4526,4526
2023-11-01,RUS,W.P. Labuan,7,5,2
2023-11-01,RWA,Johor,3,1,2
2023-11-01,RWA,Kedah,0,0,0
2023-11-01,RWA,Pulau Pinang,1,1,0
2023-11-01,RWA,Selangor,6,4,2
2023-11-01,SAU,Johor,284,176,108
2023-11-01,SAU,Kedah,66,37,29
2023-11-01,SAU,Kelantan,8,6,2
2023-11-01,SAU,Melaka,0,0,0
2023-11-01,SAU,Perak,2,2,0
2023-11-01,SAU,Perlis,8,5,3
2023-11-01,SAU,Pulau Pinang,46,22,24
2023-11-01,SAU,Sabah,2,1,1
2023-11-01,SAU,Sarawak,8,8,0
2023-11-01,SAU,Selangor,6825,3703,3122
2023-11-01,SAU,W.P. Labuan,0,0,0
2023-11-01,SDN,Johor,18,8,10
2023-11-01,SDN,Kedah,2,1,1
2023-11-01,SDN,Kelantan,0,0,0
2023-11-01,SDN,Perlis,0,0,0
2023-11-01,SDN,Pulau Pinang,0,0,0
2023-11-01,SDN,Sabah,0,0,0
2023-11-01,SDN,Sarawak,5,4,1
2023-11-01,SDN,Selangor,1508,835,673
2023-11-01,SDN,W.P. Labuan,0,0,0
2023-11-01,SEN,Johor,5,4,1
2023-11-01,SEN,Kedah,1,0,1
2023-11-01,SEN,Kelantan,0,0,0
2023-11-01,SEN,Perak,0,0,0
2023-11-01,SEN,Perlis,0,0,0
2023-11-01,SEN,Pulau Pinang,0,0,0
2023-11-01,SEN,Sabah,0,0,0
2023-11-01,SEN,Sarawak,0,0,0
2023-11-01,SEN,Selangor,90,75,15
2023-11-01,SGP,Johor,1289911,729528,560383
2023-11-01,SGP,Kedah,6692,3385,3307
2023-11-01,SGP,Kelantan,64,34,30
2023-11-01,SGP,Melaka,23,19,4
2023-11-01,SGP,Negeri Sembilan,0,0,0
2023-11-01,SGP,Pahang,533,251,282
2023-11-01,SGP,Perak,7407,3400,4007
2023-11-01,SGP,Perlis,284,152,132
2023-11-01,SGP,Pulau Pinang,24374,11929,12445
2023-11-01,SGP,Sabah,2712,1410,1302
2023-11-01,SGP,Sarawak,4567,2481,2086
2023-11-01,SGP,Selangor,46627,24446,22181
2023-11-01,SGP,Terengganu,0,0,0
2023-11-01,SGP,W.P. Labuan,5,4,1
2023-11-01,SGS,Johor,0,0,0
2023-11-01,SGS,Sabah,1,0,1
2023-11-01,SGS,Selangor,0,0,0
2023-11-01,SHN,Sarawak,0,0,0
2023-11-01,SLB,Johor,46,27,19
2023-11-01,SLB,Perlis,0,0,0
2023-11-01,SLB,Pulau Pinang,1,1,0
2023-11-01,SLB,Sabah,0,0,0
2023-11-01,SLB,Sarawak,6,2,4
2023-11-01,SLB,Selangor,19,10,9
2023-11-01,SLB,W.P. Labuan,0,0,0
2023-11-01,SLE,Johor,1,1,0
2023-11-01,SLE,Kedah,1,0,1
2023-11-01,SLE,Perak,0,0,0
2023-11-01,SLE,Pulau Pinang,0,0,0
2023-11-01,SLE,Sabah,0,0,0
2023-11-01,SLE,Selangor,44,27,17
2023-11-01,SLV,Johor,0,0,0
2023-11-01,SLV,Kedah,0,0,0
2023-11-01,SLV,Perak,0,0,0
2023-11-01,SLV,Perlis,1,0,1
2023-11-01,SLV,Pulau Pinang,1,0,1
2023-11-01,SLV,Sabah,0,0,0
2023-11-01,SLV,Selangor,12,7,5
2023-11-01,SLV,W.P. Labuan,0,0,0
2023-11-01,SMR,Johor,0,0,0
2023-11-01,SMR,Selangor,4,4,0
2023-11-01,SOM,Johor,1,1,0
2023-11-01,SOM,Kedah,0,0,0
2023-11-01,SOM,Kelantan,0,0,0
2023-11-01,SOM,Perlis,0,0,0
2023-11-01,SOM,Sabah,0,0,0
2023-11-01,SOM,Sarawak,0,0,0
2023-11-01,SOM,Selangor,305,186,119
2023-11-01,SRB,Johor,3,2,1
2023-11-01,SRB,Kedah,1,1,0
2023-11-01,SRB,Kelantan,0,0,0
2023-11-01,SRB,Pahang,0,0,0
2023-11-01,SRB,Perak,1,0,1
2023-11-01,SRB,Perlis,0,0,0
2023-11-01,SRB,Pulau Pinang,7,6,1
2023-11-01,SRB,Sabah,0,0,0
2023-11-01,SRB,Sarawak,1,1,0
2023-11-01,SRB,Selangor,97,46,51
2023-11-01,SSD,Johor,1,0,1
2023-11-01,SSD,Kedah,0,0,0
2023-11-01,SSD,Sarawak,0,0,0
2023-11-01,SSD,Selangor,34,22,12
2023-11-01,SSD,W.P. Labuan,0,0,0
2023-11-01,STP,Selangor,1,1,0
2023-11-01,SUR,Johor,3,1,2
2023-11-01,SUR,Kedah,0,0,0
2023-11-01,SUR,Kelantan,0,0,0
2023-11-01,SUR,Perak,0,0,0
2023-11-01,SUR,Perlis,0,0,0
2023-11-01,SUR,Pulau Pinang,0,0,0
2023-11-01,SUR,Sabah,0,0,0
2023-11-01,SUR,Sarawak,0,0,0
2023-11-01,SUR,Selangor,17,13,4
2023-11-01,SVK,Johor,44,22,22
2023-11-01,SVK,Kedah,54,26,28
2023-11-01,SVK,Kelantan,0,0,0
2023-11-01,SVK,Negeri Sembilan,0,0,0
2023-11-01,SVK,Pahang,0,0,0
2023-11-01,SVK,Perak,0,0,0
2023-11-01,SVK,Perlis,2,2,0
2023-11-01,SVK,Pulau Pinang,21,14,7
2023-11-01,SVK,Sabah,6,3,3
2023-11-01,SVK,Sarawak,1,1,0
2023-11-01,SVK,Selangor,394,221,173
2023-11-01,SVK,W.P. Labuan,4,2,2
2023-11-01,SVN,Johor,24,14,10
2023-11-01,SVN,Kedah,12,4,8
2023-11-01,SVN,Kelantan,0,0,0
2023-11-01,SVN,Perak,0,0,0
2023-11-01,SVN,Perlis,1,1,0
2023-11-01,SVN,Pulau Pinang,10,5,5
2023-11-01,SVN,Sabah,1,1,0
2023-11-01,SVN,Sarawak,0,0,0
2023-11-01,SVN,Selangor,181,105,76
2023-11-01,SVN,W.P. Labuan,0,0,0
2023-11-01,SWE,Johor,347,207,140
2023-11-01,SWE,Kedah,146,64,82
2023-11-01,SWE,Kelantan,2,0,2
2023-11-01,SWE,Melaka,0,0,0
2023-11-01,SWE,Negeri Sembilan,0,0,0
2023-11-01,SWE,Pahang,1,1,0
2023-11-01,SWE,Perak,6,5,1
2023-11-01,SWE,Perlis,14,12,2
2023-11-01,SWE,Pulau Pinang,113,74,39
2023-11-01,SWE,Sabah,11,6,5
2023-11-01,SWE,Sarawak,40,22,18
2023-11-01,SWE,Selangor,1269,753,516
2023-11-01,SWE,W.P. Labuan,2,1,1
2023-11-01,SWZ,Johor,3,2,1
2023-11-01,SWZ,Kedah,0,0,0
2023-11-01,SWZ,Pulau Pinang,0,0,0
2023-11-01,SWZ,Sabah,0,0,0
2023-11-01,SWZ,Selangor,25,14,11
2023-11-01,SYC,Johor,0,0,0
2023-11-01,SYC,Kedah,1,1,0
2023-11-01,SYC,Pulau Pinang,0,0,0
2023-11-01,SYC,Sabah,0,0,0
2023-11-01,SYC,Sarawak,0,0,0
2023-11-01,SYC,Selangor,70,29,41
2023-11-01,SYR,Johor,12,8,4
2023-11-01,SYR,Kedah,0,0,0
2023-11-01,SYR,Kelantan,1,0,1
2023-11-01,SYR,Pahang,0,0,0
2023-11-01,SYR,Perlis,0,0,0
2023-11-01,SYR,Pulau Pinang,5,5,0
2023-11-01,SYR,Sabah,0,0,0
2023-11-01,SYR,Sarawak,1,1,0
2023-11-01,SYR,Selangor,813,539,274
2023-11-01,SYR,W.P. Labuan,0,0,0
2023-11-01,TCA,Perlis,0,0,0
2023-11-01,TCD,Johor,2,2,0
2023-11-01,TCD,Kedah,0,0,0
2023-11-01,TCD,Perlis,0,0,0
2023-11-01,TCD,Selangor,46,40,6
2023-11-01,TGO,Johor,0,0,0
2023-11-01,TGO,Perak,0,0,0
2023-11-01,TGO,Pulau Pinang,0,0,0
2023-11-01,TGO,Selangor,13,10,3
2023-11-01,THA,Johor,6138,1699,4439
2023-11-01,THA,Kedah,66908,40495,26413
2023-11-01,THA,Kelantan,39482,20641,18841
2023-11-01,THA,Melaka,3,1,2
2023-11-01,THA,Negeri Sembilan,0,0,0
2023-11-01,THA,Pahang,6,4,2
2023-11-01,THA,Perak,9890,4626,5264
2023-11-01,THA,Perlis,52035,30442,21593
2023-11-01,THA,Pulau Pinang,2374,959,1415
2023-11-01,THA,Sabah,32,11,21
2023-11-01,THA,Sarawak,310,106,204
2023-11-01,THA,Selangor,13787,5643,8144
2023-11-01,THA,Terengganu,2,0,2
2023-11-01,THA,W.P. Labuan,13,4,9
2023-11-01,TJK,Johor,4,3,1
2023-11-01,TJK,Kedah,0,0,0
2023-11-01,TJK,Perlis,0,0,0
2023-11-01,TJK,Pulau Pinang,0,0,0
2023-11-01,TJK,Sabah,0,0,0
2023-11-01,TJK,Selangor,144,105,39
2023-11-01,TKL,Selangor,0,0,0
2023-11-01,TKM,Johor,0,0,0
2023-11-01,TKM,Kedah,3,0,3
2023-11-01,TKM,Kelantan,0,0,0
2023-11-01,TKM,Perlis,0,0,0
2023-11-01,TKM,Pulau Pinang,5,4,1
2023-11-01,TKM,Sabah,0,0,0
2023-11-01,TKM,Sarawak,0,0,0
2023-11-01,TKM,Selangor,93,52,41
2023-11-01,TLS,Johor,5,2,3
2023-11-01,TLS,Kedah,0,0,0
2023-11-01,TLS,Perlis,0,0,0
2023-11-01,TLS,Pulau Pinang,10,4,6
2023-11-01,TLS,Sabah,3,3,0
2023-11-01,TLS,Sarawak,4,3,1
2023-11-01,TLS,Selangor,211,134,77
2023-11-01,TON,Johor,2,0,2
2023-11-01,TON,Pulau Pinang,8,4,4
2023-11-01,TON,Sarawak,0,0,0
2023-11-01,TON,Selangor,19,12,7
2023-11-01,TTO,Johor,3,1,2
2023-11-01,TTO,Kedah,0,0,0
2023-11-01,TTO,Pahang,0,0,0
2023-11-01,TTO,Pulau Pinang,0,0,0
2023-11-01,TTO,Sabah,0,0,0
2023-11-01,TTO,Sarawak,0,0,0
2023-11-01,TTO,Selangor,43,24,19
2023-11-01,TUN,Johor,18,7,11
2023-11-01,TUN,Kedah,0,0,0
2023-11-01,TUN,Kelantan,1,1,0
2023-11-01,TUN,Melaka,0,0,0
2023-11-01,TUN,Perak,0,0,0
2023-11-01,TUN,Perlis,1,1,0
2023-11-01,TUN,Pulau Pinang,2,2,0
2023-11-01,TUN,Sabah,0,0,0
2023-11-01,TUN,Sarawak,1,1,0
2023-11-01,TUN,Selangor,665,371,294
2023-11-01,TUN,W.P. Labuan,0,0,0
2023-11-01,TUR,Johor,353,262,91
2023-11-01,TUR,Kedah,47,31,16
2023-11-01,TUR,Kelantan,1,0,1
2023-11-01,TUR,Melaka,0,0,0
2023-11-01,TUR,Negeri Sembilan,0,0,0
2023-11-01,TUR,Pahang,0,0,0
2023-11-01,TUR,Perak,2,2,0
2023-11-01,TUR,Perlis,23,16,7
2023-11-01,TUR,Pulau Pinang,28,24,4
2023-11-01,TUR,Sabah,9,6,3
2023-11-01,TUR,Sarawak,20,18,2
2023-11-01,TUR,Selangor,1495,1065,430
2023-11-01,TUR,W.P. Labuan,0,0,0
2023-11-01,TUV,Selangor,1,1,0
2023-11-01,TWN,Johor,5648,2240,3408
2023-11-01,TWN,Kedah,129,60,69
2023-11-01,TWN,Kelantan,0,0,0
2023-11-01,TWN,Melaka,3,1,2
2023-11-01,TWN,Negeri Sembilan,0,0,0
2023-11-01,TWN,Pahang,3,1,2
2023-11-01,TWN,Perak,47,26,21
2023-11-01,TWN,Perlis,23,18,5
2023-11-01,TWN,Pulau Pinang,4032,2028,2004
2023-11-01,TWN,Sabah,1021,497,524
2023-11-01,TWN,Sarawak,293,121,172
2023-11-01,TWN,Selangor,15768,7249,8519
2023-11-01,TWN,W.P. Labuan,5,4,1
2023-11-01,TZA,Johor,38,29,9
2023-11-01,TZA,Kedah,0,0,0
2023-11-01,TZA,Perak,0,0,0
2023-11-01,TZA,Perlis,0,0,0
2023-11-01,TZA,Pulau Pinang,1,0,1
2023-11-01,TZA,Sabah,0,0,0
2023-11-01,TZA,Sarawak,2,2,0
2023-11-01,TZA,Selangor,245,133,112
2023-11-01,UGA,Johor,15,4,11
2023-11-01,UGA,Kedah,0,0,0
2023-11-01,UGA,Perak,0,0,0
2023-11-01,UGA,Perlis,0,0,0
2023-11-01,UGA,Pulau Pinang,2,1,1
2023-11-01,UGA,Sabah,0,0,0
2023-11-01,UGA,Sarawak,0,0,0
2023-11-01,UGA,Selangor,132,55,77
2023-11-01,UKR,Johor,105,50,55
2023-11-01,UKR,Kedah,36,15,21
2023-11-01,UKR,Kelantan,4,4,0
2023-11-01,UKR,Melaka,6,6,0
2023-11-01,UKR,Negeri Sembilan,0,0,0
2023-11-01,UKR,Pahang,5,4,1
2023-11-01,UKR,Perak,3,1,2
2023-11-01,UKR,Perlis,3,2,1
2023-11-01,UKR,Pulau Pinang,21,11,10
2023-11-01,UKR,Sabah,4,1,3
2023-11-01,UKR,Sarawak,1,1,0
2023-11-01,UKR,Selangor,920,455,465
2023-11-01,UKR,W.P. Labuan,0,0,0
2023-11-01,URY,Johor,4,1,3
2023-11-01,URY,Kedah,1,0,1
2023-11-01,URY,Kelantan,0,0,0
2023-11-01,URY,Perak,0,0,0
2023-11-01,URY,Perlis,0,0,0
2023-11-01,URY,Pulau Pinang,0,0,0
2023-11-01,URY,Sabah,0,0,0
2023-11-01,URY,Sarawak,0,0,0
2023-11-01,URY,Selangor,77,33,44
2023-11-01,URY,W.P. Labuan,0,0,0
2023-11-01,USA,Johor,4676,2673,2003
2023-11-01,USA,Kedah,460,256,204
2023-11-01,USA,Kelantan,18,13,5
2023-11-01,USA,Melaka,3,2,1
2023-11-01,USA,Negeri Sembilan,0,0,0
2023-11-01,USA,Pahang,11,5,6
2023-11-01,USA,Perak,170,87,83
2023-11-01,USA,Perlis,70,46,24
2023-11-01,USA,Pulau Pinang,2101,1305,796
2023-11-01,USA,Sabah,259,144,115
2023-11-01,USA,Sarawak,246,130,116
2023-11-01,USA,Selangor,15372,9055,6317
2023-11-01,USA,Terengganu,3,3,0
2023-11-01,USA,W.P. Labuan,7,5,2
2023-11-01,UZB,Johor,81,69,12
2023-11-01,UZB,Kedah,20,12,8
2023-11-01,UZB,Kelantan,0,0,0
2023-11-01,UZB,Perak,1,0,1
2023-11-01,UZB,Perlis,4,1,3
2023-11-01,UZB,Pulau Pinang,11,6,5
2023-11-01,UZB,Sabah,2,1,1
2023-11-01,UZB,Sarawak,0,0,0
2023-11-01,UZB,Selangor,1260,763,497
2023-11-01,VAT,Johor,0,0,0
2023-11-01,VAT,Sarawak,0,0,0
2023-11-01,VAT,Selangor,0,0,0
2023-11-01,VCT,Johor,0,0,0
2023-11-01,VCT,Kedah,0,0,0
2023-11-01,VCT,Pulau Pinang,0,0,0
2023-11-01,VCT,Sarawak,0,0,0
2023-11-01,VCT,Selangor,0,0,0
2023-11-01,VEN,Johor,13,8,5
2023-11-01,VEN,Kedah,1,0,1
2023-11-01,VEN,Kelantan,0,0,0
2023-11-01,VEN,Melaka,0,0,0
2023-11-01,VEN,Perak,0,0,0
2023-11-01,VEN,Perlis,1,0,1
2023-11-01,VEN,Pulau Pinang,2,1,1
2023-11-01,VEN,Sabah,0,0,0
2023-11-01,VEN,Sarawak,1,0,1
2023-11-01,VEN,Selangor,78,45,33
2023-11-01,VEN,W.P. Labuan,0,0,0
2023-11-01,VNM,Johor,12151,3617,8534
2023-11-01,VNM,Kedah,296,42,254
2023-11-01,VNM,Kelantan,13,3,10
2023-11-01,VNM,Melaka,0,0,0
2023-11-01,VNM,Negeri Sembilan,0,0,0
2023-11-01,VNM,Pahang,1,0,1
2023-11-01,VNM,Perak,190,12,178
2023-11-01,VNM,Perlis,186,19,167
2023-11-01,VNM,Pulau Pinang,1156,367,789
2023-11-01,VNM,Sabah,29,10,19
2023-11-01,VNM,Sarawak,248,44,204
2023-11-01,VNM,Selangor,14854,5712,9142
2023-11-01,VNM,Terengganu,0,0,0
2023-11-01,VNM,W.P. Labuan,0,0,0
2023-11-01,VUT,Johor,58,43,15
2023-11-01,VUT,Kedah,0,0,0
2023-11-01,VUT,Pulau Pinang,0,0,0
2023-11-01,VUT,Sabah,2,2,0
2023-11-01,VUT,Sarawak,0,0,0
2023-11-01,VUT,Selangor,71,62,9
2023-11-01,WSM,Johor,2,2,0
2023-11-01,WSM,Sarawak,0,0,0
2023-11-01,WSM,Selangor,8,0,8
2023-11-01,XXX,Johor,82,45,37
2023-11-01,XXX,Kedah,5,1,4
2023-11-01,XXX,Kelantan,0,0,0
2023-11-01,XXX,Melaka,0,0,0
2023-11-01,XXX,Pahang,0,0,0
2023-11-01,XXX,Perak,3,2,1
2023-11-01,XXX,Perlis,1,0,1
2023-11-01,XXX,Pulau Pinang,62,36,26
2023-11-01,XXX,Sabah,9,7,2
2023-11-01,XXX,Sarawak,33,22,11
2023-11-01,XXX,Selangor,445,270,175
2023-11-01,XXX,W.P. Labuan,0,0,0
2023-11-01,YEM,Johor,37,29,8
2023-11-01,YEM,Kedah,8,6,2
2023-11-01,YEM,Kelantan,0,0,0
2023-11-01,YEM,Melaka,0,0,0
2023-11-01,YEM,Pahang,0,0,0
2023-11-01,YEM,Perak,1,1,0
2023-11-01,YEM,Perlis,3,3,0
2023-11-01,YEM,Pulau Pinang,5,4,1
2023-11-01,YEM,Sabah,0,0,0
2023-11-01,YEM,Sarawak,4,4,0
2023-11-01,YEM,Selangor,1595,1117,478
2023-11-01,YEM,W.P. Labuan,0,0,0
2023-11-01,ZAF,Johor,228,142,86
2023-11-01,ZAF,Kedah,32,18,14
2023-11-01,ZAF,Kelantan,0,0,0
2023-11-01,ZAF,Melaka,0,0,0
2023-11-01,ZAF,Pahang,1,1,0
2023-11-01,ZAF,Perak,2,0,2
2023-11-01,ZAF,Perlis,10,7,3
2023-11-01,ZAF,Pulau Pinang,46,27,19
2023-11-01,ZAF,Sabah,7,4,3
2023-11-01,ZAF,Sarawak,81,35,46
2023-11-01,ZAF,Selangor,1178,756,422
2023-11-01,ZAF,Terengganu,2,2,0
2023-11-01,ZAF,W.P. Labuan,0,0,0
2023-11-01,ZAR,Selangor,1,1,0
2023-11-01,ZMB,Johor,2,1,1
2023-11-01,ZMB,Kedah,0,0,0
2023-11-01,ZMB,Perak,0,0,0
2023-11-01,ZMB,Perlis,0,0,0
2023-11-01,ZMB,Pulau Pinang,4,1,3
2023-11-01,ZMB,Sabah,1,0,1
2023-11-01,ZMB,Sarawak,0,0,0
2023-11-01,ZMB,Selangor,102,61,41
2023-11-01,ZWE,Johor,12,7,5
2023-11-01,ZWE,Kedah,0,0,0
2023-11-01,ZWE,Kelantan,0,0,0
2023-11-01,ZWE,Perak,0,0,0
2023-11-01,ZWE,Perlis,0,0,0
2023-11-01,ZWE,Pulau Pinang,0,0,0
2023-11-01,ZWE,Sabah,1,0,1
2023-11-01,ZWE,Sarawak,0,0,0
2023-11-01,ZWE,Selangor,169,73,96
2023-12-01,AFG,Perlis,1,1,0
2023-12-01,AFG,Sarawak,2,2,0
2023-12-01,AFG,Selangor,70,51,19
2023-12-01,AGO,Johor,1,0,1
2023-12-01,AGO,Selangor,2,1,1
2023-12-01,ALB,Johor,17,15,2
2023-12-01,ALB,Kedah,5,3,2
2023-12-01,ALB,Pulau Pinang,1,1,0
2023-12-01,ALB,Sabah,1,0,1
2023-12-01,ALB,Selangor,50,34,16
2023-12-01,AND,Pulau Pinang,6,3,3
2023-12-01,AND,Selangor,10,5,5
2023-12-01,ARE,Johor,45,22,23
2023-12-01,ARE,Kedah,3,1,2
2023-12-01,ARE,Selangor,1108,580,528
2023-12-01,ARG,Johor,83,51,32
2023-12-01,ARG,Kedah,45,21,24
2023-12-01,ARG,Perlis,3,2,1
2023-12-01,ARG,Pulau Pinang,8,3,5
2023-12-01,ARG,Sabah,3,2,1
2023-12-01,ARG,Sarawak,1,1,0
2023-12-01,ARG,Selangor,485,236,249
2023-12-01,ARM,Johor,3,2,1
2023-12-01,ARM,Pulau Pinang,4,0,4
2023-12-01,ARM,Selangor,56,28,28
2023-12-01,ATA,Selangor,2,1,1
2023-12-01,ATG,Johor,5,3,2
2023-12-01,ATG,Sabah,1,0,1
2023-12-01,ATG,Selangor,24,14,10
2023-12-01,AUS,Johor,7092,3949,3143
2023-12-01,AUS,Kedah,1182,632,550
2023-12-01,AUS,Kelantan,8,5,3
2023-12-01,AUS,Pahang,34,20,14
2023-12-01,AUS,Perak,356,187,169
2023-12-01,AUS,Perlis,100,56,44
2023-12-01,AUS,Pulau Pinang,2988,1536,1452
2023-12-01,AUS,Sabah,590,302,288
2023-12-01,AUS,Sarawak,864,472,392
2023-12-01,AUS,Selangor,41444,23064,18380
2023-12-01,AUS,W.P. Labuan,15,13,2
2023-12-01,AUT,Johor,201,131,70
2023-12-01,AUT,Kedah,167,82,85
2023-12-01,AUT,Kelantan,2,1,1
2023-12-01,AUT,Perlis,11,6,5
2023-12-01,AUT,Pulau Pinang,74,50,24
2023-12-01,AUT,Sabah,7,5,2
2023-12-01,AUT,Sarawak,18,13,5
2023-12-01,AUT,Selangor,997,578,419
2023-12-01,AUT,W.P. Labuan,1,1,0
2023-12-01,AZE,Johor,20,15,5
2023-12-01,AZE,Kedah,5,2,3
2023-12-01,AZE,Sarawak,3,1,2
2023-12-01,AZE,Selangor,208,98,110
2023-12-01,BDI,Selangor,8,4,4
2023-12-01,BEL,Johor,192,116,76
2023-12-01,BEL,Kedah,155,82,73
2023-12-01,BEL,Kelantan,3,3,0
2023-12-01,BEL,Perak,5,2,3
2023-12-01,BEL,Perlis,18,12,6
2023-12-01,BEL,Pulau Pinang,88,61,27
2023-12-01,BEL,Sabah,17,9,8
2023-12-01,BEL,Sarawak,23,17,6
2023-12-01,BEL,Selangor,1138,720,418
2023-12-01,BEL,W.P. Labuan,2,2,0
2023-12-01,BEN,Johor,1,1,0
2023-12-01,BEN,Sarawak,1,0,1
2023-12-01,BEN,Selangor,14,7,7
2023-12-01,BFA,Johor,2,2,0
2023-12-01,BFA,Selangor,4,4,0
2023-12-01,BGD,Johor,2916,2203,713
2023-12-01,BGD,Kedah,58,36,22
2023-12-01,BGD,Kelantan,2,2,0
2023-12-01,BGD,Perak,4,2,2
2023-12-01,BGD,Perlis,3,2,1
2023-12-01,BGD,Pulau Pinang,176,155,21
2023-12-01,BGD,Sabah,6,4,2
2023-12-01,BGD,Sarawak,80,49,31
2023-12-01,BGD,Selangor,38847,36343,2504
2023-12-01,BGD,W.P. Labuan,21,20,1
2023-12-01,BGR,Johor,44,27,17
2023-12-01,BGR,Kedah,35,18,17
2023-12-01,BGR,Perak,1,0,1
2023-12-01,BGR,Pulau Pinang,16,11,5
2023-12-01,BGR,Sabah,5,4,1
2023-12-01,BGR,Sarawak,2,2,0
2023-12-01,BGR,Selangor,409,215,194
2023-12-01,BHR,Johor,9,4,5
2023-12-01,BHR,Kedah,8,4,4
2023-12-01,BHR,Selangor,149,82,67
2023-12-01,BHS,Kedah,2,1,1
2023-12-01,BHS,Selangor,20,13,7
2023-12-01,BIH,Johor,11,7,4
2023-12-01,BIH,Kedah,5,3,2
2023-12-01,BIH,Pulau Pinang,1,1,0
2023-12-01,BIH,Sabah,1,0,1
2023-12-01,BIH,Sarawak,1,1,0
2023-12-01,BIH,Selangor,60,30,30
2023-12-01,BLR,Johor,16,6,10
2023-12-01,BLR,Kedah,20,8,12
2023-12-01,BLR,Kelantan,1,1,0
2023-12-01,BLR,Pulau Pinang,8,4,4
2023-12-01,BLR,Sabah,2,1,1
2023-12-01,BLR,Sarawak,4,1,3
2023-12-01,BLR,Selangor,393,183,210
2023-12-01,BLZ,Johor,12,6,6
2023-12-01,BLZ,Pulau Pinang,2,1,1
2023-12-01,BLZ,Sarawak,1,1,0
2023-12-01,BLZ,Selangor,6,5,1
2023-12-01,BOL,Kedah,2,0,2
2023-12-01,BOL,Pulau Pinang,2,1,1
2023-12-01,BOL,Sabah,1,1,0
2023-12-01,BOL,Selangor,24,12,12
2023-12-01,BRA,Johor,297,152,145
2023-12-01,BRA,Kedah,163,88,75
2023-12-01,BRA,Pahang,3,2,1
2023-12-01,BRA,Perlis,6,3,3
2023-12-01,BRA,Pulau Pinang,44,27,17
2023-12-01,BRA,Sabah,14,6,8
2023-12-01,BRA,Sarawak,1,0,1
2023-12-01,BRA,Selangor,1193,626,567
2023-12-01,BRB,Johor,1,0,1
2023-12-01,BRB,Selangor,6,3,3
2023-12-01,BRN,Johor,1917,975,942
2023-12-01,BRN,Kedah,105,51,54
2023-12-01,BRN,Kelantan,22,8,14
2023-12-01,BRN,Melaka,5,2,3
2023-12-01,BRN,Perak,5,2,3
2023-12-01,BRN,Perlis,116,58,58
2023-12-01,BRN,Pulau Pinang,31,15,16
2023-12-01,BRN,Sabah,2833,1266,1567
2023-12-01,BRN,Sarawak,151340,81793,69547
2023-12-01,BRN,Selangor,10737,5165,5572
2023-12-01,BRN,W.P. Labuan,3106,1821,1285
2023-12-01,BTN,Johor,16,16,0
2023-12-01,BTN,Selangor,48,32,16
2023-12-01,BVT,Selangor,1,0,1
2023-12-01,BWA,Selangor,16,6,10
2023-12-01,CAN,Johor,1513,832,681
2023-12-01,CAN,Kedah,431,230,201
2023-12-01,CAN,Kelantan,2,2,0
2023-12-01,CAN,Pahang,5,3,2
2023-12-01,CAN,Perak,44,19,25
2023-12-01,CAN,Perlis,43,25,18
2023-12-01,CAN,Pulau Pinang,644,331,313
2023-12-01,CAN,Sabah,205,107,98
2023-12-01,CAN,Sarawak,311,167,144
2023-12-01,CAN,Selangor,6274,3453,2821
2023-12-01,CAN,W.P. Labuan,5,1,4
2023-12-01,CHE,Johor,384,208,176
2023-12-01,CHE,Kedah,310,161,149
2023-12-01,CHE,Kelantan,3,3,0
2023-12-01,CHE,Perak,2,1,1
2023-12-01,CHE,Perlis,27,18,9
2023-12-01,CHE,Pulau Pinang,168,102,66
2023-12-01,CHE,Sabah,21,9,12
2023-12-01,CHE,Sarawak,22,10,12
2023-12-01,CHE,Selangor,1707,1020,687
2023-12-01,CHL,Johor,32,18,14
2023-12-01,CHL,Kedah,26,13,13
2023-12-01,CHL,Perlis,6,3,3
2023-12-01,CHL,Pulau Pinang,6,4,2
2023-12-01,CHL,Sabah,4,1,3
2023-12-01,CHL,Selangor,267,125,142
2023-12-01,CHN,Johor,57202,25651,31551
2023-12-01,CHN,Kedah,1430,646,784
2023-12-01,CHN,Kelantan,28,21,7
2023-12-01,CHN,Melaka,2,0,2
2023-12-01,CHN,Negeri Sembilan,5,4,1
2023-12-01,CHN,Pahang,52,24,28
2023-12-01,CHN,Perak,357,169,188
2023-12-01,CHN,Perlis,328,171,157
2023-12-01,CHN,Pulau Pinang,8862,4588,4274
2023-12-01,CHN,Sabah,7294,3348,3946
2023-12-01,CHN,Sarawak,1634,877,757
2023-12-01,CHN,Selangor,102109,52914,49195
2023-12-01,CHN,W.P. Labuan,91,77,14
2023-12-01,CIV,Johor,3,3,0
2023-12-01,CIV,Selangor,5,1,4
2023-12-01,CMR,Kedah,1,1,0
2023-12-01,CMR,Selangor,21,14,7
2023-12-01,COD,Johor,2,2,0
2023-12-01,COD,Selangor,15,7,8
2023-12-01,COG,Selangor,4,4,0
2023-12-01,COL,Johor,20,9,11
2023-12-01,COL,Kedah,8,4,4
2023-12-01,COL,Perlis,1,1,0
2023-12-01,COL,Pulau Pinang,10,2,8
2023-12-01,COL,Sabah,1,0,1
2023-12-01,COL,Sarawak,4,4,0
2023-12-01,COL,Selangor,227,123,104
2023-12-01,COM,Johor,5,0,5
2023-12-01,COM,Kedah,1,1,0
2023-12-01,COM,Selangor,12,8,4
2023-12-01,CPV,Selangor,1,0,1
2023-12-01,CRI,Johor,10,3,7
2023-12-01,CRI,Kedah,6,4,2
2023-12-01,CRI,Pulau Pinang,12,8,4
2023-12-01,CRI,Sabah,1,1,0
2023-12-01,CRI,Selangor,52,33,19
2023-12-01,CUB,Johor,7,6,1
2023-12-01,CUB,Pulau Pinang,1,1,0
2023-12-01,CUB,Selangor,20,13,7
2023-12-01,CYP,Johor,6,4,2
2023-12-01,CYP,Kedah,7,3,4
2023-12-01,CYP,Pulau Pinang,2,0,2
2023-12-01,CYP,Sabah,7,3,4
2023-12-01,CYP,Sarawak,1,0,1
2023-12-01,CYP,Selangor,81,43,38
2023-12-01,CZE,Johor,105,66,39
2023-12-01,CZE,Kedah,181,105,76
2023-12-01,CZE,Perak,1,0,1
2023-12-01,CZE,Perlis,6,3,3
2023-12-01,CZE,Pulau Pinang,29,19,10
2023-12-01,CZE,Sabah,10,7,3
2023-12-01,CZE,Sarawak,4,2,2
2023-12-01,CZE,Selangor,960,536,424
2023-12-01,DEU,Johor,2039,1351,688
2023-12-01,DEU,Kedah,2860,1463,1397
2023-12-01,DEU,Kelantan,17,12,5
2023-12-01,DEU,Melaka,4,2,2
2023-12-01,DEU,Pahang,6,3,3
2023-12-01,DEU,Perak,15,11,4
2023-12-01,DEU,Perlis,127,78,49
2023-12-01,DEU,Pulau Pinang,660,422,238
2023-12-01,DEU,Sabah,150,99,51
2023-12-01,DEU,Sarawak,146,85,61
2023-12-01,DEU,Selangor,10513,6023,4490
2023-12-01,DEU,W.P. Labuan,6,5,1
2023-12-01,DJI,Selangor,13,6,7
2023-12-01,DMA,Johor,9,7,2
2023-12-01,DMA,Sarawak,2,1,1
2023-12-01,DMA,Selangor,60,40,20
2023-12-01,DNK,Johor,258,184,74
2023-12-01,DNK,Kedah,177,86,91
2023-12-01,DNK,Kelantan,1,1,0
2023-12-01,DNK,Melaka,6,3,3
2023-12-01,DNK,Perak,3,2,1
2023-12-01,DNK,Perlis,11,9,2
2023-12-01,DNK,Pulau Pinang,66,41,25
2023-12-01,DNK,Sabah,23,14,9
2023-12-01,DNK,Sarawak,13,6,7
2023-12-01,DNK,Selangor,1176,689,487
2023-12-01,DOM,Johor,2,0,2
2023-12-01,DOM,Pulau Pinang,2,0,2
2023-12-01,DOM,Sarawak,1,0,1
2023-12-01,DOM,Selangor,10,5,5
2023-12-01,DZA,Johor,41,25,16
2023-12-01,DZA,Kedah,6,6,0
2023-12-01,DZA,Perlis,2,2,0
2023-12-01,DZA,Pulau Pinang,3,2,1
2023-12-01,DZA,Sabah,2,1,1
2023-12-01,DZA,Sarawak,9,8,1
2023-12-01,DZA,Selangor,924,537,387
2023-12-01,ECU,Johor,17,7,10
2023-12-01,ECU,Kedah,2,0,2
2023-12-01,ECU,Perlis,2,0,2
2023-12-01,ECU,Pulau Pinang,5,2,3
2023-12-01,ECU,Selangor,78,40,38
2023-12-01,EGY,Johor,266,207,59
2023-12-01,EGY,Kedah,5,3,2
2023-12-01,EGY,Perak,2,1,1
2023-12-01,EGY,Perlis,1,0,1
2023-12-01,EGY,Pulau Pinang,14,10,4
2023-12-01,EGY,Sabah,16,10,6
2023-12-01,EGY,Sarawak,220,132,88
2023-12-01,EGY,Selangor,1888,1258,630
2023-12-01,EGY,W.P. Labuan,1,1,0
2023-12-01,ERI,Selangor,14,5,9
2023-12-01,ESP,Johor,348,209,139
2023-12-01,ESP,Kedah,266,129,137
2023-12-01,ESP,Kelantan,2,2,0
2023-12-01,ESP,Pahang,1,1,0
2023-12-01,ESP,Perlis,18,14,4
2023-12-01,ESP,Pulau Pinang,105,55,50
2023-12-01,ESP,Sabah,38,21,17
2023-12-01,ESP,Sarawak,37,24,13
2023-12-01,ESP,Selangor,2692,1471,1221
2023-12-01,ESP,W.P. Labuan,5,3,2
2023-12-01,EST,Johor,32,15,17
2023-12-01,EST,Kedah,32,12,20
2023-12-01,EST,Perlis,5,2,3
2023-12-01,EST,Pulau Pinang,8,5,3
2023-12-01,EST,Sabah,5,4,1
2023-12-01,EST,Sarawak,4,1,3
2023-12-01,EST,Selangor,424,215,209
2023-12-01,ETH,Sabah,1,0,1
2023-12-01,ETH,Selangor,27,15,12
2023-12-01,FIN,Johor,164,102,62
2023-12-01,FIN,Kedah,117,64,53
2023-12-01,FIN,Melaka,3,3,0
2023-12-01,FIN,Perlis,12,8,4
2023-12-01,FIN,Pulau Pinang,69,41,28
2023-12-01,FIN,Sabah,18,9,9
2023-12-01,FIN,Sarawak,16,12,4
2023-12-01,FIN,Selangor,835,463,372
2023-12-01,FJI,Johor,184,79,105
2023-12-01,FJI,Kedah,4,2,2
2023-12-01,FJI,Pulau Pinang,2,2,0
2023-12-01,FJI,Sabah,1,0,1
2023-12-01,FJI,Sarawak,3,0,3
2023-12-01,FJI,Selangor,295,134,161
2023-12-01,FRA,Johor,1773,1137,636
2023-12-01,FRA,Kedah,770,425,345
2023-12-01,FRA,Kelantan,13,8,5
2023-12-01,FRA,Melaka,1,1,0
2023-12-01,FRA,Negeri Sembilan,5,3,2
2023-12-01,FRA,Pahang,37,17,20
2023-12-01,FRA,Perak,44,25,19
2023-12-01,FRA,Perlis,71,49,22
2023-12-01,FRA,Pulau Pinang,459,280,179
2023-12-01,FRA,Sabah,143,86,57
2023-12-01,FRA,Sarawak,72,51,21
2023-12-01,FRA,Selangor,7563,4513,3050
2023-12-01,FRA,W.P. Labuan,3,2,1
2023-12-01,GAB,Selangor,8,4,4
2023-12-01,GBR,Johor,4739,3036,1703
2023-12-01,GBR,Kedah,3896,2029,1867
2023-12-01,GBR,Kelantan,13,10,3
2023-12-01,GBR,Melaka,1,0,1
2023-12-01,GBR,Pahang,33,18,15
2023-12-01,GBR,Perak,96,52,44
2023-12-01,GBR,Perlis,153,102,51
2023-12-01,GBR,Pulau Pinang,1877,1116,761
2023-12-01,GBR,Sabah,492,277,215
2023-12-01,GBR,Sarawak,1579,921,658
2023-12-01,GBR,Selangor,22293,12978,9315
2023-12-01,GBR,W.P. Labuan,34,23,11
2023-12-01,GEO,Johor,3,2,1
2023-12-01,GEO,Kedah,3,1,2
2023-12-01,GEO,Pulau Pinang,1,1,0
2023-12-01,GEO,Selangor,68,37,31
2023-12-01,GHA,Johor,7,6,1
2023-12-01,GHA,Kedah,6,2,4
2023-12-01,GHA,Perlis,2,1,1
2023-12-01,GHA,Pulau Pinang,3,2,1
2023-12-01,GHA,Sabah,1,1,0
2023-12-01,GHA,Sarawak,1,1,0
2023-12-01,GHA,Selangor,127,68,59
2023-12-01,GIN,Johor,11,8,3
2023-12-01,GIN,Perlis,1,0,1
2023-12-01,GIN,Sabah,1,1,0
2023-12-01,GIN,Selangor,55,42,13
2023-12-01,GMB,Johor,1,1,0
2023-12-01,GMB,Selangor,25,17,8
2023-12-01,GNQ,Johor,1,1,0
2023-12-01,GRC,Johor,51,33,18
2023-12-01,GRC,Kedah,34,20,14
2023-12-01,GRC,Perlis,2,2,0
2023-12-01,GRC,Pulau Pinang,10,5,5
2023-12-01,GRC,Sabah,5,2,3
2023-12-01,GRC,Sarawak,4,3,1
2023-12-01,GRC,Selangor,463,275,188
2023-12-01,GRD,Kedah,4,1,3
2023-12-01,GRD,Selangor,10,6,4
2023-12-01,GTM,Johor,4,2,2
2023-12-01,GTM,Kedah,5,2,3
2023-12-01,GTM,Selangor,38,20,18
2023-12-01,GUY,Johor,7,4,3
2023-12-01,GUY,Selangor,9,6,3
2023-12-01,HKG,Johor,1,0,1
2023-12-01,HKG,Kedah,3,1,2
2023-12-01,HKG,Pahang,3,1,2
2023-12-01,HKG,Perak,51,24,27
2023-12-01,HKG,Sabah,6470,2834,3636
2023-12-01,HKG,Selangor,2750,1481,1269
2023-12-01,HND,Johor,3,3,0
2023-12-01,HND,Kedah,1,1,0
2023-12-01,HND,Selangor,9,6,3
2023-12-01,HRV,Johor,27,19,8
2023-12-01,HRV,Kedah,9,5,4
2023-12-01,HRV,Pulau Pinang,6,5,1
2023-12-01,HRV,Sabah,1,1,0
2023-12-01,HRV,Sarawak,5,5,0
2023-12-01,HRV,Selangor,325,181,144
2023-12-01,HTI,Johor,5,3,2
2023-12-01,HTI,Selangor,8,5,3
2023-12-01,HUN,Johor,102,66,36
2023-12-01,HUN,Kedah,78,44,34
2023-12-01,HUN,Kelantan,2,1,1
2023-12-01,HUN,Perak,1,1,0
2023-12-01,HUN,Perlis,6,5,1
2023-12-01,HUN,Pulau Pinang,47,25,22
2023-12-01,HUN,Sabah,3,0,3
2023-12-01,HUN,Sarawak,8,5,3
2023-12-01,HUN,Selangor,843,423,420
2023-12-01,IDN,Johor,120074,52520,67554
2023-12-01,IDN,Kedah,6403,2358,4045
2023-12-01,IDN,Kelantan,124,83,41
2023-12-01,IDN,Melaka,5327,2256,3071
2023-12-01,IDN,Negeri Sembilan,5111,2637,2474
2023-12-01,IDN,Pahang,45,34,11
2023-12-01,IDN,Perak,338,87,251
2023-12-01,IDN,Perlis,719,257,462
2023-12-01,IDN,Pulau Pinang,40678,16866,23812
2023-12-01,IDN,Sabah,7170,3155,4015
2023-12-01,IDN,Sarawak,55980,26397,29583
2023-12-01,IDN,Selangor,161439,74219,87220
2023-12-01,IDN,W.P. Labuan,73,38,35
2023-12-01,IND,Johor,37891,24550,13341
2023-12-01,IND,Kedah,1460,805,655
2023-12-01,IND,Kelantan,4,3,1
2023-12-01,IND,Melaka,3,2,1
2023-12-01,IND,Pahang,19,9,10
2023-12-01,IND,Perak,399,279,120
2023-12-01,IND,Perlis,60,46,14
2023-12-01,IND,Pulau Pinang,1269,776,493
2023-12-01,IND,Sabah,230,156,74
2023-12-01,IND,Sarawak,3061,2401,660
2023-12-01,IND,Selangor,67889,43330,24559
2023-12-01,IND,W.P. Labuan,121,107,14
2023-12-01,IOT,Selangor,2,0,2
2023-12-01,IRL,Johor,208,122,86
2023-12-01,IRL,Kedah,151,79,72
2023-12-01,IRL,Kelantan,3,3,0
2023-12-01,IRL,Perak,8,6,2
2023-12-01,IRL,Perlis,10,6,4
2023-12-01,IRL,Pulau Pinang,130,72,58
2023-12-01,IRL,Sabah,14,9,5
2023-12-01,IRL,Sarawak,43,26,17
2023-12-01,IRL,Selangor,1330,795,535
2023-12-01,IRN,Johor,352,193,159
2023-12-01,IRN,Kedah,11,6,5
2023-12-01,IRN,Perlis,3,3,0
2023-12-01,IRN,Pulau Pinang,10,6,4
2023-12-01,IRN,Sabah,2,1,1
2023-12-01,IRN,Sarawak,6,4,2
2023-12-01,IRN,Selangor,2481,1322,1159
2023-12-01,IRQ,Johor,72,49,23
2023-12-01,IRQ,Pulau Pinang,1,1,0
2023-12-01,IRQ,Sabah,1,1,0
2023-12-01,IRQ,Sarawak,4,3,1
2023-12-01,IRQ,Selangor,1498,1038,460
2023-12-01,ISL,Johor,10,8,2
2023-12-01,ISL,Kedah,1,1,0
2023-12-01,ISL,Perak,6,3,3
2023-12-01,ISL,Pulau Pinang,7,3,4
2023-12-01,ISL,Sabah,1,1,0
2023-12-01,ISL,Sarawak,1,1,0
2023-12-01,ISL,Selangor,47,28,19
2023-12-01,ISR,Pulau Pinang,1,0,1
2023-12-01,ITA,Johor,576,358,218
2023-12-01,ITA,Kedah,441,251,190
2023-12-01,ITA,Kelantan,3,3,0
2023-12-01,ITA,Negeri Sembilan,1,1,0
2023-12-01,ITA,Perak,6,5,1
2023-12-01,ITA,Perlis,27,23,4
2023-12-01,ITA,Pulau Pinang,144,95,49
2023-12-01,ITA,Sabah,38,27,11
2023-12-01,ITA,Sarawak,51,34,17
2023-12-01,ITA,Selangor,3479,2093,1386
2023-12-01,ITA,W.P. Labuan,2,2,0
2023-12-01,JAM,Johor,3,1,2
2023-12-01,JAM,Kedah,1,0,1
2023-12-01,JAM,Pulau Pinang,1,0,1
2023-12-01,JAM,Selangor,12,7,5
2023-12-01,JOR,Johor,15,14,1
2023-12-01,JOR,Kedah,2,2,0
2023-12-01,JOR,Pahang,1,1,0
2023-12-01,JOR,Perak,1,1,0
2023-12-01,JOR,Pulau Pinang,18,8,10
2023-12-01,JOR,Sabah,1,1,0
2023-12-01,JOR,Selangor,897,529,368
2023-12-01,JPN,Johor,6394,4020,2374
2023-12-01,JPN,Kedah,508,262,246
2023-12-01,JPN,Kelantan,10,7,3
2023-12-01,JPN,Melaka,1,1,0
2023-12-01,JPN,Negeri Sembilan,1,1,0
2023-12-01,JPN,Pahang,24,15,9
2023-12-01,JPN,Perak,53,27,26
2023-12-01,JPN,Perlis,76,60,16
2023-12-01,JPN,Pulau Pinang,1614,1023,591
2023-12-01,JPN,Sabah,507,275,232
2023-12-01,JPN,Sarawak,212,116,96
2023-12-01,JPN,Selangor,20372,12029,8343
2023-12-01,JPN,W.P. Labuan,19,13,6
2023-12-01,KAZ,Johor,68,29,39
2023-12-01,KAZ,Kedah,25,13,12
2023-12-01,KAZ,Kelantan,2,1,1
2023-12-01,KAZ,Perlis,8,3,5
2023-12-01,KAZ,Pulau Pinang,9,3,6
2023-12-01,KAZ,Sabah,1,0,1
2023-12-01,KAZ,Sarawak,3,0,3
2023-12-01,KAZ,Selangor,1156,478,678
2023-12-01,KAZ,W.P. Labuan,1,0,1
2023-12-01,KEN,Johor,96,52,44
2023-12-01,KEN,Kedah,10,6,4
2023-12-01,KEN,Pulau Pinang,20,9,11
2023-12-01,KEN,Selangor,800,406,394
2023-12-01,KGZ,Johor,37,27,10
2023-12-01,KGZ,Kedah,6,4,2
2023-12-01,KGZ,Pulau Pinang,6,2,4
2023-12-01,KGZ,Sabah,5,3,2
2023-12-01,KGZ,Selangor,311,136,175
2023-12-01,KHM,Johor,2487,1059,1428
2023-12-01,KHM,Kedah,334,263,71
2023-12-01,KHM,Kelantan,423,231,192
2023-12-01,KHM,Melaka,1,0,1
2023-12-01,KHM,Perak,7,1,6
2023-12-01,KHM,Perlis,551,327,224
2023-12-01,KHM,Pulau Pinang,36,17,19
2023-12-01,KHM,Sabah,3,2,1
2023-12-01,KHM,Sarawak,9,3,6
2023-12-01,KHM,Selangor,4017,1746,2271
2023-12-01,KIR,Johor,1,0,1
2023-12-01,KIR,Selangor,7,2,5
2023-12-01,KNA,Johor,18,12,6
2023-12-01,KNA,Kedah,3,2,1
2023-12-01,KNA,Perak,1,0,1
2023-12-01,KNA,Pulau Pinang,2,2,0
2023-12-01,KNA,Sabah,7,3,4
2023-12-01,KNA,Selangor,83,59,24
2023-12-01,KOR,Johor,12417,6647,5770
2023-12-01,KOR,Kedah,371,173,198
2023-12-01,KOR,Kelantan,6,4,2
2023-12-01,KOR,Pahang,3,1,2
2023-12-01,KOR,Perak,32,18,14
2023-12-01,KOR,Perlis,131,77,54
2023-12-01,KOR,Pulau Pinang,567,283,284
2023-12-01,KOR,Sabah,17290,7509,9781
2023-12-01,KOR,Sarawak,319,175,144
2023-12-01,KOR,Selangor,18135,9782,8353
2023-12-01,KOR,W.P. Labuan,10,5,5
2023-12-01,KWT,Johor,13,10,3
2023-12-01,KWT,Kedah,1,1,0
2023-12-01,KWT,Pulau Pinang,3,2,1
2023-12-01,KWT,Sarawak,1,1,0
2023-12-01,KWT,Selangor,375,226,149
2023-12-01,LAO,Johor,211,73,138
2023-12-01,LAO,Kedah,994,76,918
2023-12-01,LAO,Kelantan,166,8,158
2023-12-01,LAO,Perak,43,7,36
2023-12-01,LAO,Perlis,347,63,284
2023-12-01,LAO,Pulau Pinang,29,3,26
2023-12-01,LAO,Sabah,1,0,1
2023-12-01,LAO,Sarawak,28,9,19
2023-12-01,LAO,Selangor,257,88,169
2023-12-01,LBN,Johor,43,25,18
2023-12-01,LBN,Kedah,8,4,4
2023-12-01,LBN,Pulau Pinang,9,5,4
2023-12-01,LBN,Sarawak,6,5,1
2023-12-01,LBN,Selangor,424,258,166
2023-12-01,LBR,Johor,2,2,0
2023-12-01,LBR,Selangor,9,9,0
2023-12-01,LBY,Johor,5,4,1
2023-12-01,LBY,Pulau Pinang,7,5,2
2023-12-01,LBY,Sarawak,1,1,0
2023-12-01,LBY,Selangor,375,274,101
2023-12-01,LCA,Johor,5,3,2
2023-12-01,LCA,Kedah,1,0,1
2023-12-01,LCA,Sarawak,5,3,2
2023-12-01,LCA,Selangor,15,12,3
2023-12-01,LIE,Pulau Pinang,5,4,1
2023-12-01,LIE,Selangor,3,1,2
2023-12-01,LKA,Johor,1132,660,472
2023-12-01,LKA,Kedah,39,19,20
2023-12-01,LKA,Melaka,1,1,0
2023-12-01,LKA,Perak,10,6,4
2023-12-01,LKA,Perlis,9,6,3
2023-12-01,LKA,Pulau Pinang,75,43,32
2023-12-01,LKA,Sabah,7,4,3
2023-12-01,LKA,Sarawak,53,40,13
2023-12-01,LKA,Selangor,5552,3192,2360
2023-12-01,LKA,W.P. Labuan,3,3,0
2023-12-01,LSO,Selangor,4,1,3
2023-12-01,LTU,Johor,43,20,23
2023-12-01,LTU,Kedah,88,43,45
2023-12-01,LTU,Kelantan,1,1,0
2023-12-01,LTU,Perlis,7,4,3
2023-12-01,LTU,Pulau Pinang,19,9,10
2023-12-01,LTU,Sabah,2,1,1
2023-12-01,LTU,Sarawak,24,7,17
2023-12-01,LTU,Selangor,589,303,286
2023-12-01,LUX,Johor,5,4,1
2023-12-01,LUX,Kedah,9,6,3
2023-12-01,LUX,Pulau Pinang,2,2,0
2023-12-01,LUX,Sabah,1,1,0
2023-12-01,LUX,Selangor,43,24,19
2023-12-01,LVA,Johor,29,13,16
2023-12-01,LVA,Kedah,20,9,11
2023-12-01,LVA,Perak,1,0,1
2023-12-01,LVA,Perlis,1,1,0
2023-12-01,LVA,Pulau Pinang,3,1,2
2023-12-01,LVA,Sabah,2,1,1
2023-12-01,LVA,Sarawak,10,4,6
2023-12-01,LVA,Selangor,254,129,125
2023-12-01,MAC,Selangor,25,14,11
2023-12-01,MAR,Johor,113,70,43
2023-12-01,MAR,Kedah,10,4,6
2023-12-01,MAR,Kelantan,3,2,1
2023-12-01,MAR,Perak,1,0,1
2023-12-01,MAR,Perlis,4,3,1
2023-12-01,MAR,Pulau Pinang,10,8,2
2023-12-01,MAR,Sabah,5,4,1
2023-12-01,MAR,Sarawak,14,12,2
2023-12-01,MAR,Selangor,952,486,466
2023-12-01,MCO,Johor,1,1,0
2023-12-01,MCO,Selangor,2,2,0
2023-12-01,MDA,Johor,8,4,4
2023-12-01,MDA,Pulau Pinang,1,1,0
2023-12-01,MDA,Selangor,28,18,10
2023-12-01,MDG,Johor,16,6,10
2023-12-01,MDG,Pulau Pinang,4,1,3
2023-12-01,MDG,Selangor,73,37,36
2023-12-01,MDV,Johor,299,138,161
2023-12-01,MDV,Kedah,4,4,0
2023-12-01,MDV,Pulau Pinang,1,1,0
2023-12-01,MDV,Sabah,8,4,4
2023-12-01,MDV,Sarawak,4,4,0
2023-12-01,MDV,Selangor,4511,2194,2317
2023-12-01,MEX,Johor,174,76,98
2023-12-01,MEX,Kedah,103,49,54
2023-12-01,MEX,Kelantan,1,0,1
2023-12-01,MEX,Pahang,1,1,0
2023-12-01,MEX,Perak,6,4,2
2023-12-01,MEX,Perlis,3,2,1
2023-12-01,MEX,Pulau Pinang,24,16,8
2023-12-01,MEX,Sabah,3,1,2
2023-12-01,MEX,Sarawak,3,2,1
2023-12-01,MEX,Selangor,836,419,417
2023-12-01,MHL,Sarawak,1,1,0
2023-12-01,MHL,Selangor,2,1,1
2023-12-01,MKD,Johor,10,4,6
2023-12-01,MKD,Kedah,3,2,1
2023-12-01,MKD,Pulau Pinang,1,0,1
2023-12-01,MKD,Sarawak,2,1,1
2023-12-01,MKD,Selangor,50,26,24
2023-12-01,MLI,Selangor,13,12,1
2023-12-01,MLT,Johor,11,6,5
2023-12-01,MLT,Kedah,12,8,4
2023-12-01,MLT,Selangor,61,32,29
2023-12-01,MMR,Johor,8500,2412,6088
2023-12-01,MMR,Kedah,91,20,71
2023-12-01,MMR,Kelantan,3,3,0
2023-12-01,MMR,Pahang,3,1,2
2023-12-01,MMR,Perak,40,7,33
2023-12-01,MMR,Perlis,5,1,4
2023-12-01,MMR,Pulau Pinang,551,243,308
2023-12-01,MMR,Sabah,28,11,17
2023-12-01,MMR,Sarawak,117,57,60
2023-12-01,MMR,Selangor,6539,4251,2288
2023-12-01,MMR,W.P. Labuan,1,1,0
2023-12-01,MNE,Selangor,26,20,6
2023-12-01,MNG,Johor,293,137,156
2023-12-01,MNG,Kedah,22,11,11
2023-12-01,MNG,Perlis,6,3,3
2023-12-01,MNG,Pulau Pinang,13,5,8
2023-12-01,MNG,Sabah,17,5,12
2023-12-01,MNG,Selangor,622,273,349
2023-12-01,MOZ,Selangor,41,22,19
2023-12-01,MRT,Selangor,30,22,8
2023-12-01,MUS,Johor,443,221,222
2023-12-01,MUS,Kedah,5,3,2
2023-12-01,MUS,Pahang,1,1,0
2023-12-01,MUS,Pulau Pinang,11,6,5
2023-12-01,MUS,Sabah,2,1,1
2023-12-01,MUS,Selangor,2884,1374,1510
2023-12-01,MWI,Sabah,1,0,1
2023-12-01,MWI,Selangor,37,21,16
2023-12-01,NAM,Johor,4,1,3
2023-12-01,NAM,Kedah,1,1,0
2023-12-01,NAM,Sabah,1,0,1
2023-12-01,NAM,Selangor,25,14,11
2023-12-01,NER,Selangor,1,1,0
2023-12-01,NGA,Johor,28,25,3
2023-12-01,NGA,Pulau Pinang,5,3,2
2023-12-01,NGA,Sabah,1,1,0
2023-12-01,NGA,Sarawak,22,17,5
2023-12-01,NGA,Selangor,346,261,85
2023-12-01,NIC,Johor,5,3,2
2023-12-01,NIC,Selangor,4,2,2
2023-12-01,NLD,Johor,861,546,315
2023-12-01,NLD,Kedah,397,201,196
2023-12-01,NLD,Melaka,1,1,0
2023-12-01,NLD,Pahang,11,5,6
2023-12-01,NLD,Perak,13,9,4
2023-12-01,NLD,Perlis,29,19,10
2023-12-01,NLD,Pulau Pinang,268,157,111
2023-12-01,NLD,Sabah,74,45,29
2023-12-01,NLD,Sarawak,114,67,47
2023-12-01,NLD,Selangor,4556,2656,1900
2023-12-01,NLD,W.P. Labuan,4,2,2
2023-12-01,NOR,Johor,135,75,60
2023-12-01,NOR,Kedah,124,58,66
2023-12-01,NOR,Kelantan,3,3,0
2023-12-01,NOR,Perlis,5,2,3
2023-12-01,NOR,Pulau Pinang,42,24,18
2023-12-01,NOR,Sabah,7,3,4
2023-12-01,NOR,Sarawak,14,11,3
2023-12-01,NOR,Selangor,946,514,432
2023-12-01,NPL,Johor,759,621,138
2023-12-01,NPL,Kedah,4,2,2
2023-12-01,NPL,Perak,1,1,0
2023-12-01,NPL,Pulau Pinang,20,15,5
2023-12-01,NPL,Sabah,9,8,1
2023-12-01,NPL,Sarawak,496,347,149
2023-12-01,NPL,Selangor,10982,10428,554
2023-12-01,NPL,W.P. Labuan,71,65,6
2023-12-01,NRU,Selangor,2,2,0
2023-12-01,NZL,Johor,1101,615,486
2023-12-01,NZL,Kedah,200,115,85
2023-12-01,NZL,Kelantan,1,1,0
2023-12-01,NZL,Melaka,2,1,1
2023-12-01,NZL,Pahang,4,3,1
2023-12-01,NZL,Perak,37,16,21
2023-12-01,NZL,Perlis,20,17,3
2023-12-01,NZL,Pulau Pinang,364,194,170
2023-12-01,NZL,Sabah,118,64,54
2023-12-01,NZL,Sarawak,216,125,91
2023-12-01,NZL,Selangor,4693,2618,2075
2023-12-01,NZL,W.P. Labuan,1,0,1
2023-12-01,OMN,Johor,41,20,21
2023-12-01,OMN,Kedah,7,5,2
2023-12-01,OMN,Pulau Pinang,3,2,1
2023-12-01,OMN,Sabah,4,0,4
2023-12-01,OMN,Sarawak,8,4,4
2023-12-01,OMN,Selangor,1852,1094,758
2023-12-01,OMN,W.P. Labuan,1,1,0
2023-12-01,PAK,Johor,695,480,215
2023-12-01,PAK,Kedah,69,58,11
2023-12-01,PAK,Kelantan,16,16,0
2023-12-01,PAK,Melaka,1,1,0
2023-12-01,PAK,Perak,14,14,0
2023-12-01,PAK,Perlis,18,18,0
2023-12-01,PAK,Pulau Pinang,95,86,9
2023-12-01,PAK,Sabah,24,21,3
2023-12-01,PAK,Sarawak,215,168,47
2023-12-01,PAK,Selangor,11072,8723,2349
2023-12-01,PAK,W.P. Labuan,7,4,3
2023-12-01,PAN,Johor,1,1,0
2023-12-01,PAN,Selangor,22,10,12
2023-12-01,PER,Johor,23,13,10
2023-12-01,PER,Kedah,21,8,13
2023-12-01,PER,Perlis,1,0,1
2023-12-01,PER,Pulau Pinang,3,3,0
2023-12-01,PER,Sabah,6,4,2
2023-12-01,PER,Selangor,161,75,86
2023-12-01,PHL,Johor,27937,8557,19380
2023-12-01,PHL,Kedah,586,193,393
2023-12-01,PHL,Kelantan,20,7,13
2023-12-01,PHL,Negeri Sembilan,1,1,0
2023-12-01,PHL,Pahang,10,1,9
2023-12-01,PHL,Perak,78,18,60
2023-12-01,PHL,Perlis,248,72,176
2023-12-01,PHL,Pulau Pinang,818,320,498
2023-12-01,PHL,Sabah,1733,712,1021
2023-12-01,PHL,Sarawak,4368,1836,2532
2023-12-01,PHL,Selangor,19207,7604,11603
2023-12-01,PHL,Terengganu,1,1,0
2023-12-01,PHL,W.P. Labuan,139,52,87
2023-12-01,PNG,Johor,31,15,16
2023-12-01,PNG,Perak,2,1,1
2023-12-01,PNG,Pulau Pinang,2,2,0
2023-12-01,PNG,Sarawak,2,0,2
2023-12-01,PNG,Selangor,39,22,17
2023-12-01,POL,Johor,365,196,169
2023-12-01,POL,Kedah,197,102,95
2023-12-01,POL,Kelantan,1,1,0
2023-12-01,POL,Pahang,7,3,4
2023-12-01,POL,Perlis,18,10,8
2023-12-01,POL,Pulau Pinang,65,42,23
2023-12-01,POL,Sabah,41,21,20
2023-12-01,POL,Sarawak,24,15,9
2023-12-01,POL,Selangor,1705,883,822
2023-12-01,POL,W.P. Labuan,1,1,0
2023-12-01,PRT,Johor,162,91,71
2023-12-01,PRT,Kedah,83,47,36
2023-12-01,PRT,Perak,1,1,0
2023-12-01,PRT,Perlis,8,6,2
2023-12-01,PRT,Pulau Pinang,54,25,29
2023-12-01,PRT,Sabah,23,9,14
2023-12-01,PRT,Sarawak,13,7,6
2023-12-01,PRT,Selangor,848,484,364
2023-12-01,PRY,Johor,10,4,6
2023-12-01,PRY,Selangor,19,15,4
2023-12-01,PSE,Johor,15,14,1
2023-12-01,PSE,Pulau Pinang,1,1,0
2023-12-01,PSE,Sabah,2,2,0
2023-12-01,PSE,Sarawak,3,2,1
2023-12-01,PSE,Selangor,287,205,82
2023-12-01,QAT,Johor,9,6,3
2023-12-01,QAT,Perlis,1,1,0
2023-12-01,QAT,Pulau Pinang,10,7,3
2023-12-01,QAT,Sarawak,2,2,0
2023-12-01,QAT,Selangor,164,96,68
2023-12-01,ROU,Johor,136,76,60
2023-12-01,ROU,Kedah,166,75,91
2023-12-01,ROU,Perak,1,1,0
2023-12-01,ROU,Perlis,1,0,1
2023-12-01,ROU,Pulau Pinang,28,16,12
2023-12-01,ROU,Sabah,8,5,3
2023-12-01,ROU,Sarawak,10,6,4
2023-12-01,ROU,Selangor,1517,761,756
2023-12-01,ROU,W.P. Labuan,2,1,1
2023-12-01,RUS,Johor,537,255,282
2023-12-01,RUS,Kedah,444,206,238
2023-12-01,RUS,Kelantan,12,7,5
2023-12-01,RUS,Melaka,1,1,0
2023-12-01,RUS,Perak,8,4,4
2023-12-01,RUS,Perlis,39,26,13
2023-12-01,RUS,Pulau Pinang,190,96,94
2023-12-01,RUS,Sabah,69,34,35
2023-12-01,RUS,Sarawak,72,43,29
2023-12-01,RUS,Selangor,9263,4486,4777
2023-12-01,RUS,W.P. Labuan,11,6,5
2023-12-01,RWA,Kedah,1,0,1
2023-12-01,RWA,Selangor,5,1,4
2023-12-01,SAU,Johor,180,100,80
2023-12-01,SAU,Kedah,33,25,8
2023-12-01,SAU,Kelantan,1,1,0
2023-12-01,SAU,Pulau Pinang,29,13,16
2023-12-01,SAU,Sarawak,30,16,14
2023-12-01,SAU,Selangor,3297,1938,1359
2023-12-01,SDN,Johor,25,13,12
2023-12-01,SDN,Kelantan,3,2,1
2023-12-01,SDN,Perlis,1,1,0
2023-12-01,SDN,Pulau Pinang,6,4,2
2023-12-01,SDN,Sabah,2,2,0
2023-12-01,SDN,Sarawak,13,8,5
2023-12-01,SDN,Selangor,1318,723,595
2023-12-01,SEN,Johor,10,5,5
2023-12-01,SEN,Selangor,41,29,12
2023-12-01,SGP,Johor,1414194,776492,637702
2023-12-01,SGP,Kedah,10509,5328,5181
2023-12-01,SGP,Kelantan,87,54,33
2023-12-01,SGP,Melaka,51,40,11
2023-12-01,SGP,Negeri Sembilan,3,2,1
2023-12-01,SGP,Pahang,943,459,484
2023-12-01,SGP,Perak,8880,4055,4825
2023-12-01,SGP,Perlis,698,382,316
2023-12-01,SGP,Pulau Pinang,33751,16522,17229
2023-12-01,SGP,Sabah,4733,2311,2422
2023-12-01,SGP,Sarawak,6550,3388,3162
2023-12-01,SGP,Selangor,75052,37116,37936
2023-12-01,SGP,W.P. Labuan,25,18,7
2023-12-01,SLB,Johor,1,1,0
2023-12-01,SLB,Sabah,3,2,1
2023-12-01,SLB,Sarawak,5,1,4
2023-12-01,SLB,Selangor,2,2,0
2023-12-01,SLE,Johor,11,9,2
2023-12-01,SLE,Perlis,1,1,0
2023-12-01,SLE,Selangor,20,12,8
2023-12-01,SLV,Pulau Pinang,3,2,1
2023-12-01,SLV,Selangor,12,6,6
2023-12-01,SMR,Kedah,2,0,2
2023-12-01,SMR,Selangor,2,0,2
2023-12-01,SOM,Selangor,202,123,79
2023-12-01,SRB,Johor,15,11,4
2023-12-01,SRB,Kedah,9,4,5
2023-12-01,SRB,Pulau Pinang,7,4,3
2023-12-01,SRB,Sabah,4,2,2
2023-12-01,SRB,Sarawak,1,1,0
2023-12-01,SRB,Selangor,108,54,54
2023-12-01,SSD,Johor,1,0,1
2023-12-01,SSD,Sarawak,1,1,0
2023-12-01,SSD,Selangor,33,17,16
2023-12-01,STP,Selangor,3,1,2
2023-12-01,SUR,Johor,4,2,2
2023-12-01,SUR,Selangor,15,8,7
2023-12-01,SVK,Johor,41,23,18
2023-12-01,SVK,Kedah,65,35,30
2023-12-01,SVK,Perlis,5,4,1
2023-12-01,SVK,Pulau Pinang,9,5,4
2023-12-01,SVK,Sabah,6,4,2
2023-12-01,SVK,Selangor,411,222,189
2023-12-01,SVN,Johor,24,13,11
2023-12-01,SVN,Kedah,18,9,9
2023-12-01,SVN,Pulau Pinang,2,2,0
2023-12-01,SVN,Sabah,2,2,0
2023-12-01,SVN,Sarawak,1,0,1
2023-12-01,SVN,Selangor,208,118,90
2023-12-01,SWE,Johor,240,144,96
2023-12-01,SWE,Kedah,295,154,141
2023-12-01,SWE,Kelantan,2,2,0
2023-12-01,SWE,Perak,4,2,2
2023-12-01,SWE,Perlis,20,14,6
2023-12-01,SWE,Pulau Pinang,121,75,46
2023-12-01,SWE,Sabah,24,16,8
2023-12-01,SWE,Sarawak,15,12,3
2023-12-01,SWE,Selangor,2055,1153,902
2023-12-01,SWZ,Johor,4,4,0
2023-12-01,SWZ,Selangor,21,9,12
2023-12-01,SYC,Johor,34,14,20
2023-12-01,SYC,Kedah,2,1,1
2023-12-01,SYC,Sarawak,1,0,1
2023-12-01,SYC,Selangor,207,86,121
2023-12-01,SYR,Johor,24,18,6
2023-12-01,SYR,Kedah,2,2,0
2023-12-01,SYR,Kelantan,2,2,0
2023-12-01,SYR,Melaka,1,1,0
2023-12-01,SYR,Pahang,1,1,0
2023-12-01,SYR,Perlis,1,1,0
2023-12-01,SYR,Pulau Pinang,2,1,1
2023-12-01,SYR,Sarawak,7,6,1
2023-12-01,SYR,Selangor,749,462,287
2023-12-01,TCA,Selangor,1,0,1
2023-12-01,TCD,Johor,5,5,0
2023-12-01,TCD,Selangor,24,21,3
2023-12-01,TGO,Johor,3,1,2
2023-12-01,TGO,Selangor,13,11,2
2023-12-01,THA,Johor,8857,2797,6060
2023-12-01,THA,Kedah,67463,40200,27263
2023-12-01,THA,Kelantan,41287,21144,20143
2023-12-01,THA,Melaka,2,1,1
2023-12-01,THA,Pahang,11,5,6
2023-12-01,THA,Perak,11252,5080,6172
2023-12-01,THA,Perlis,49380,28480,20900
2023-12-01,THA,Pulau Pinang,2619,989,1630
2023-12-01,THA,Sabah,26,7,19
2023-12-01,THA,Sarawak,478,188,290
2023-12-01,THA,Selangor,14102,5309,8793
2023-12-01,THA,W.P. Labuan,8,4,4
2023-12-01,TJK,Johor,6,6,0
2023-12-01,TJK,Kelantan,1,1,0
2023-12-01,TJK,Perlis,2,1,1
2023-12-01,TJK,Sabah,1,0,1
2023-12-01,TJK,Selangor,203,145,58
2023-12-01,TKM,Johor,3,2,1
2023-12-01,TKM,Perlis,1,1,0
2023-12-01,TKM,Sarawak,2,2,0
2023-12-01,TKM,Selangor,117,81,36
2023-12-01,TLS,Johor,9,4,5
2023-12-01,TLS,Kedah,5,1,4
2023-12-01,TLS,Sarawak,3,3,0
2023-12-01,TLS,Selangor,305,167,138
2023-12-01,TON,Pulau Pinang,2,2,0
2023-12-01,TON,Selangor,17,7,10
2023-12-01,TTO,Johor,4,2,2
2023-12-01,TTO,Kedah,1,0,1
2023-12-01,TTO,Sarawak,2,0,2
2023-12-01,TTO,Selangor,32,18,14
2023-12-01,TUN,Johor,9,4,5
2023-12-01,TUN,Kedah,7,2,5
2023-12-01,TUN,Perlis,2,2,0
2023-12-01,TUN,Pulau Pinang,16,11,5
2023-12-01,TUN,Sabah,2,1,1
2023-12-01,TUN,Selangor,837,429,408
2023-12-01,TUR,Johor,254,192,62
2023-12-01,TUR,Kedah,69,42,27
2023-12-01,TUR,Kelantan,2,2,0
2023-12-01,TUR,Pahang,1,1,0
2023-12-01,TUR,Perak,1,1,0
2023-12-01,TUR,Perlis,17,15,2
2023-12-01,TUR,Pulau Pinang,57,34,23
2023-12-01,TUR,Sabah,3,3,0
2023-12-01,TUR,Sarawak,31,22,9
2023-12-01,TUR,Selangor,1614,1082,532
2023-12-01,TWN,Johor,5075,2193,2882
2023-12-01,TWN,Kedah,145,74,71
2023-12-01,TWN,Kelantan,2,1,1
2023-12-01,TWN,Pahang,3,2,1
2023-12-01,TWN,Perak,53,32,21
2023-12-01,TWN,Perlis,22,10,12
2023-12-01,TWN,Pulau Pinang,3595,1795,1800
2023-12-01,TWN,Sabah,1012,480,532
2023-12-01,TWN,Sarawak,327,155,172
2023-12-01,TWN,Selangor,10872,5373,5499
2023-12-01,TWN,W.P. Labuan,6,2,4
2023-12-01,TZA,Johor,44,19,25
2023-12-01,TZA,Kedah,4,0,4
2023-12-01,TZA,Pulau Pinang,1,1,0
2023-12-01,TZA,Selangor,384,190,194
2023-12-01,TZA,W.P. Labuan,1,1,0
2023-12-01,UGA,Johor,32,15,17
2023-12-01,UGA,Kedah,1,0,1
2023-12-01,UGA,Sarawak,2,2,0
2023-12-01,UGA,Selangor,202,100,102
2023-12-01,UKR,Johor,122,59,63
2023-12-01,UKR,Kedah,41,17,24
2023-12-01,UKR,Kelantan,2,1,1
2023-12-01,UKR,Perlis,3,1,2
2023-12-01,UKR,Pulau Pinang,26,12,14
2023-12-01,UKR,Sabah,7,5,2
2023-12-01,UKR,Sarawak,6,3,3
2023-12-01,UKR,Selangor,1188,568,620
2023-12-01,URY,Johor,2,0,2
2023-12-01,URY,Perlis,1,1,0
2023-12-01,URY,Pulau Pinang,2,2,0
2023-12-01,URY,Selangor,46,25,21
2023-12-01,USA,Johor,4742,2712,2030
2023-12-01,USA,Kedah,1579,787,792
2023-12-01,USA,Kelantan,12,8,4
2023-12-01,USA,Melaka,1,1,0
2023-12-01,USA,Pahang,8,6,2
2023-12-01,USA,Perak,142,78,64
2023-12-01,USA,Perlis,110,72,38
2023-12-01,USA,Pulau Pinang,2548,1342,1206
2023-12-01,USA,Sabah,470,268,202
2023-12-01,USA,Sarawak,327,205,122
2023-12-01,USA,Selangor,21722,11794,9928
2023-12-01,USA,W.P. Labuan,9,8,1
2023-12-01,UZB,Johor,137,92,45
2023-12-01,UZB,Kedah,28,17,11
2023-12-01,UZB,Kelantan,4,2,2
2023-12-01,UZB,Pulau Pinang,9,5,4
2023-12-01,UZB,Sabah,7,4,3
2023-12-01,UZB,Sarawak,1,0,1
2023-12-01,UZB,Selangor,1682,979,703
2023-12-01,VAT,Pulau Pinang,1,1,0
2023-12-01,VAT,Sarawak,1,1,0
2023-12-01,VCT,Selangor,3,2,1
2023-12-01,VEN,Johor,23,14,9
2023-12-01,VEN,Kedah,2,1,1
2023-12-01,VEN,Pulau Pinang,1,0,1
2023-12-01,VEN,Sabah,2,1,1
2023-12-01,VEN,Sarawak,1,0,1
2023-12-01,VEN,Selangor,86,40,46
2023-12-01,VNM,Johor,11258,3169,8089
2023-12-01,VNM,Kedah,347,46,301
2023-12-01,VNM,Kelantan,9,3,6
2023-12-01,VNM,Pahang,9,8,1
2023-12-01,VNM,Perak,238,20,218
2023-12-01,VNM,Perlis,186,15,171
2023-12-01,VNM,Pulau Pinang,848,214,634
2023-12-01,VNM,Sabah,30,9,21
2023-12-01,VNM,Sarawak,375,60,315
2023-12-01,VNM,Selangor,11849,3991,7858
2023-12-01,VNM,W.P. Labuan,3,3,0
2023-12-01,VUT,Johor,49,33,16
2023-12-01,VUT,Pulau Pinang,4,4,0
2023-12-01,VUT,Sabah,1,1,0
2023-12-01,VUT,Selangor,111,82,29
2023-12-01,WSM,Johor,1,0,1
2023-12-01,WSM,Selangor,4,2,2
2023-12-01,XXX,Pulau Pinang,2,1,1
2023-12-01,XXX,Selangor,66,41,25
2023-12-01,YEM,Johor,30,21,9
2023-12-01,YEM,Kedah,9,9,0
2023-12-01,YEM,Kelantan,1,1,0
2023-12-01,YEM,Melaka,4,2,2
2023-12-01,YEM,Perlis,3,3,0
2023-12-01,YEM,Pulau Pinang,7,4,3
2023-12-01,YEM,Sarawak,4,2,2
2023-12-01,YEM,Selangor,1283,869,414
2023-12-01,ZAF,Johor,402,229,173
2023-12-01,ZAF,Kedah,123,68,55
2023-12-01,ZAF,Kelantan,1,0,1
2023-12-01,ZAF,Pahang,5,3,2
2023-12-01,ZAF,Perak,3,3,0
2023-12-01,ZAF,Perlis,14,6,8
2023-12-01,ZAF,Pulau Pinang,111,53,58
2023-12-01,ZAF,Sabah,35,16,19
2023-12-01,ZAF,Sarawak,203,98,105
2023-12-01,ZAF,Selangor,2743,1358,1385
2023-12-01,ZAF,W.P. Labuan,8,2,6
2023-12-01,ZAR,Selangor,3,1,2
2023-12-01,ZMB,Johor,18,9,9
2023-12-01,ZMB,Selangor,161,74,87
2023-12-01,ZWE,Johor,28,15,13
2023-12-01,ZWE,Kedah,1,0,1
2023-12-01,ZWE,Pulau Pinang,7,3,4
2023-12-01,ZWE,Sabah,1,1,0
2023-12-01,ZWE,Selangor,274,132,142
2024-01-01,AFG,Selangor,74,62,12
2024-01-01,AGO,Johor,1,1,0
2024-01-01,AGO,Selangor,9,6,3
2024-01-01,ALB,Johor,18,15,3
2024-01-01,ALB,Kedah,7,4,3
2024-01-01,ALB,Pulau Pinang,3,1,2
2024-01-01,ALB,Sabah,2,1,1
2024-01-01,ALB,Selangor,43,26,17
2024-01-01,AND,Selangor,1,1,0
2024-01-01,ANT,Selangor,1,0,1
2024-01-01,ARE,Johor,7,3,4
2024-01-01,ARE,Pulau Pinang,1,1,0
2024-01-01,ARE,Selangor,358,240,118
2024-01-01,ARG,Johor,116,59,57
2024-01-01,ARG,Kedah,209,93,116
2024-01-01,ARG,Kelantan,1,0,1
2024-01-01,ARG,Perlis,7,6,1
2024-01-01,ARG,Pulau Pinang,13,3,10
2024-01-01,ARG,Sabah,8,4,4
2024-01-01,ARG,Sarawak,2,2,0
2024-01-01,ARG,Selangor,855,419,436
2024-01-01,ARM,Johor,3,3,0
2024-01-01,ARM,Kedah,2,0,2
2024-01-01,ARM,Pulau Pinang,1,1,0
2024-01-01,ARM,Sabah,3,3,0
2024-01-01,ARM,Selangor,110,50,60
2024-01-01,ATG,Johor,2,2,0
2024-01-01,ATG,Kedah,3,0,3
2024-01-01,ATG,Selangor,13,8,5
2024-01-01,AUS,Johor,5856,3319,2537
2024-01-01,AUS,Kedah,1431,742,689
2024-01-01,AUS,Kelantan,7,4,3
2024-01-01,AUS,Melaka,3,2,1
2024-01-01,AUS,Pahang,55,32,23
2024-01-01,AUS,Perak,280,142,138
2024-01-01,AUS,Perlis,112,72,40
2024-01-01,AUS,Pulau Pinang,2575,1317,1258
2024-01-01,AUS,Sabah,473,242,231
2024-01-01,AUS,Sarawak,884,476,408
2024-01-01,AUS,Selangor,38688,21461,17227
2024-01-01,AUS,Terengganu,1,1,0
2024-01-01,AUS,W.P. Labuan,9,5,4
2024-01-01,AUT,Johor,205,131,74
2024-01-01,AUT,Kedah,190,100,90
2024-01-01,AUT,Kelantan,2,2,0
2024-01-01,AUT,Perak,1,0,1
2024-01-01,AUT,Perlis,25,15,10
2024-01-01,AUT,Pulau Pinang,94,67,27
2024-01-01,AUT,Sabah,14,6,8
2024-01-01,AUT,Sarawak,14,8,6
2024-01-01,AUT,Selangor,1104,688,416
2024-01-01,AZE,Johor,8,7,1
2024-01-01,AZE,Kedah,5,2,3
2024-01-01,AZE,Pulau Pinang,2,1,1
2024-01-01,AZE,Sabah,1,1,0
2024-01-01,AZE,Selangor,188,107,81
2024-01-01,BDI,Sarawak,2,1,1
2024-01-01,BDI,Selangor,8,8,0
2024-01-01,BEL,Johor,192,120,72
2024-01-01,BEL,Kedah,166,94,72
2024-01-01,BEL,Kelantan,2,2,0
2024-01-01,BEL,Melaka,2,2,0
2024-01-01,BEL,Pahang,1,0,1
2024-01-01,BEL,Perak,4,2,2
2024-01-01,BEL,Perlis,18,11,7
2024-01-01,BEL,Pulau Pinang,88,56,32
2024-01-01,BEL,Sabah,19,10,9
2024-01-01,BEL,Sarawak,21,11,10
2024-01-01,BEL,Selangor,1547,894,653
2024-01-01,BEN,Johor,2,2,0
2024-01-01,BEN,Sarawak,1,0,1
2024-01-01,BEN,Selangor,12,10,2
2024-01-01,BFA,Selangor,9,8,1
2024-01-01,BGD,Johor,2202,1729,473
2024-01-01,BGD,Kedah,129,71,58
2024-01-01,BGD,Kelantan,1,1,0
2024-01-01,BGD,Perak,3,3,0
2024-01-01,BGD,Pulau Pinang,234,208,26
2024-01-01,BGD,Sabah,9,8,1
2024-01-01,BGD,Sarawak,67,51,16
2024-01-01,BGD,Selangor,38752,35941,2811
2024-01-01,BGD,W.P. Labuan,15,14,1
2024-01-01,BGR,Johor,61,36,25
2024-01-01,BGR,Kedah,63,30,33
2024-01-01,BGR,Perak,1,1,0
2024-01-01,BGR,Perlis,1,1,0
2024-01-01,BGR,Pulau Pinang,32,17,15
2024-01-01,BGR,Sabah,4,3,1
2024-01-01,BGR,Sarawak,1,1,0
2024-01-01,BGR,Selangor,515,270,245
2024-01-01,BHR,Kedah,8,5,3
2024-01-01,BHR,Pulau Pinang,1,1,0
2024-01-01,BHR,Selangor,256,134,122
2024-01-01,BHS,Selangor,8,4,4
2024-01-01,BIH,Johor,21,9,12
2024-01-01,BIH,Perlis,1,1,0
2024-01-01,BIH,Pulau Pinang,2,2,0
2024-01-01,BIH,Sabah,2,2,0
2024-01-01,BIH,Selangor,116,69,47
2024-01-01,BLR,Johor,11,4,7
2024-01-01,BLR,Kedah,21,9,12
2024-01-01,BLR,Perlis,1,0,1
2024-01-01,BLR,Pulau Pinang,19,8,11
2024-01-01,BLR,Sabah,4,2,2
2024-01-01,BLR,Sarawak,4,3,1
2024-01-01,BLR,Selangor,570,270,300
2024-01-01,BLZ,Johor,3,3,0
2024-01-01,BLZ,Pulau Pinang,1,1,0
2024-01-01,BLZ,Selangor,9,5,4
2024-01-01,BOL,Johor,6,4,2
2024-01-01,BOL,Kedah,1,1,0
2024-01-01,BOL,Selangor,41,24,17
2024-01-01,BRA,Johor,208,114,94
2024-01-01,BRA,Kedah,198,84,114
2024-01-01,BRA,Kelantan,1,0,1
2024-01-01,BRA,Perlis,5,4,1
2024-01-01,BRA,Pulau Pinang,23,10,13
2024-01-01,BRA,Sabah,5,4,1
2024-01-01,BRA,Sarawak,8,5,3
2024-01-01,BRA,Selangor,1467,766,701
2024-01-01,BRB,Johor,1,0,1
2024-01-01,BRB,Selangor,6,5,1
2024-01-01,BRN,Johor,390,207,183
2024-01-01,BRN,Kedah,34,13,21
2024-01-01,BRN,Pahang,1,0,1
2024-01-01,BRN,Perak,2,0,2
2024-01-01,BRN,Perlis,61,33,28
2024-01-01,BRN,Pulau Pinang,16,6,10
2024-01-01,BRN,Sabah,1269,555,714
2024-01-01,BRN,Sarawak,118380,65041,53339
2024-01-01,BRN,Selangor,4745,2388,2357
2024-01-01,BRN,W.P. Labuan,906,612,294
2024-01-01,BTN,Perak,2,1,1
2024-01-01,BTN,Perlis,2,1,1
2024-01-01,BTN,Selangor,52,28,24
2024-01-01,BWA,Johor,2,1,1
2024-01-01,BWA,Selangor,17,9,8
2024-01-01,CAN,Johor,1512,864,648
2024-01-01,CAN,Kedah,499,272,227
2024-01-01,CAN,Kelantan,4,4,0
2024-01-01,CAN,Melaka,2,1,1
2024-01-01,CAN,Pahang,1,0,1
2024-01-01,CAN,Perak,42,27,15
2024-01-01,CAN,Perlis,81,48,33
2024-01-01,CAN,Pulau Pinang,706,363,343
2024-01-01,CAN,Sabah,175,83,92
2024-01-01,CAN,Sarawak,349,178,171
2024-01-01,CAN,Selangor,6136,3491,2645
2024-01-01,CAN,W.P. Labuan,7,5,2
2024-01-01,CHE,Johor,355,201,154
2024-01-01,CHE,Kedah,327,168,159
2024-01-01,CHE,Kelantan,1,1,0
2024-01-01,CHE,Melaka,1,1,0
2024-01-01,CHE,Negeri Sembilan,2,1,1
2024-01-01,CHE,Pahang,4,2,2
2024-01-01,CHE,Perak,6,3,3
2024-01-01,CHE,Perlis,41,22,19
2024-01-01,CHE,Pulau Pinang,170,115,55
2024-01-01,CHE,Sabah,44,26,18
2024-01-01,CHE,Sarawak,20,11,9
2024-01-01,CHE,Selangor,1824,1104,720
2024-01-01,CHL,Johor,35,16,19
2024-01-01,CHL,Kedah,37,12,25
2024-01-01,CHL,Perlis,4,3,1
2024-01-01,CHL,Pulau Pinang,8,6,2
2024-01-01,CHL,Sabah,4,3,1
2024-01-01,CHL,Sarawak,3,3,0
2024-01-01,CHL,Selangor,439,212,227
2024-01-01,CHN,Johor,59992,25949,34043
2024-01-01,CHN,Kedah,2247,998,1249
2024-01-01,CHN,Kelantan,13,10,3
2024-01-01,CHN,Melaka,6,5,1
2024-01-01,CHN,Pahang,62,39,23
2024-01-01,CHN,Perak,293,145,148
2024-01-01,CHN,Perlis,393,213,180
2024-01-01,CHN,Pulau Pinang,11748,5901,5847
2024-01-01,CHN,Sabah,12533,5464,7069
2024-01-01,CHN,Sarawak,1576,831,745
2024-01-01,CHN,Selangor,139974,68413,71561
2024-01-01,CHN,W.P. Labuan,63,55,8
2024-01-01,CIV,Johor,1,1,0
2024-01-01,CIV,Selangor,17,13,4
2024-01-01,CMR,Sabah,1,1,0
2024-01-01,CMR,Selangor,29,21,8
2024-01-01,COD,Sarawak,1,1,0
2024-01-01,COD,Selangor,29,17,12
2024-01-01,COG,Selangor,4,3,1
2024-01-01,COL,Johor,29,12,17
2024-01-01,COL,Kedah,1,1,0
2024-01-01,COL,Perak,1,1,0
2024-01-01,COL,Pulau Pinang,10,2,8
2024-01-01,COL,Sabah,1,1,0
2024-01-01,COL,Sarawak,2,2,0
2024-01-01,COL,Selangor,281,152,129
2024-01-01,COM,Selangor,16,10,6
2024-01-01,CPV,Selangor,1,0,1
2024-01-01,CRI,Johor,30,20,10
2024-01-01,CRI,Kedah,4,2,2
2024-01-01,CRI,Pulau Pinang,18,10,8
2024-01-01,CRI,Selangor,101,46,55
2024-01-01,CUB,Johor,13,10,3
2024-01-01,CUB,Pulau Pinang,1,1,0
2024-01-01,CUB,Sabah,2,0,2
2024-01-01,CUB,Selangor,28,14,14
2024-01-01,CYP,Johor,4,1,3
2024-01-01,CYP,Kedah,8,5,3
2024-01-01,CYP,Pulau Pinang,2,1,1
2024-01-01,CYP,Sabah,2,2,0
2024-01-01,CYP,Sarawak,2,0,2
2024-01-01,CYP,Selangor,80,48,32
2024-01-01,CZE,Johor,106,54,52
2024-01-01,CZE,Kedah,214,109,105
2024-01-01,CZE,Perlis,18,14,4
2024-01-01,CZE,Pulau Pinang,40,27,13
2024-01-01,CZE,Sabah,17,11,6
2024-01-01,CZE,Sarawak,22,13,9
2024-01-01,CZE,Selangor,1140,644,496
2024-01-01,CZE,W.P. Labuan,4,4,0
2024-01-01,DEU,Johor,2027,1247,780
2024-01-01,DEU,Kedah,1533,791,742
2024-01-01,DEU,Kelantan,9,8,1
2024-01-01,DEU,Melaka,4,4,0
2024-01-01,DEU,Negeri Sembilan,4,2,2
2024-01-01,DEU,Pahang,8,5,3
2024-01-01,DEU,Perak,23,17,6
2024-01-01,DEU,Perlis,185,115,70
2024-01-01,DEU,Pulau Pinang,975,674,301
2024-01-01,DEU,Sabah,144,83,61
2024-01-01,DEU,Sarawak,201,129,72
2024-01-01,DEU,Selangor,8986,5517,3469
2024-01-01,DEU,W.P. Labuan,13,4,9
2024-01-01,DJI,Selangor,12,7,5
2024-01-01,DMA,Johor,5,5,0
2024-01-01,DMA,Kedah,1,1,0
2024-01-01,DMA,Pulau Pinang,2,1,1
2024-01-01,DMA,Selangor,57,47,10
2024-01-01,DNK,Johor,291,209,82
2024-01-01,DNK,Kedah,382,185,197
2024-01-01,DNK,Pahang,21,5,16
2024-01-01,DNK,Perak,13,6,7
2024-01-01,DNK,Perlis,26,17,9
2024-01-01,DNK,Pulau Pinang,100,57,43
2024-01-01,DNK,Sabah,43,25,18
2024-01-01,DNK,Sarawak,22,13,9
2024-01-01,DNK,Selangor,1921,1033,888
2024-01-01,DNK,W.P. Labuan,2,1,1
2024-01-01,DOM,Johor,1,0,1
2024-01-01,DOM,Kedah,1,1,0
2024-01-01,DOM,Perlis,1,1,0
2024-01-01,DOM,Selangor,15,8,7
2024-01-01,DZA,Johor,33,27,6
2024-01-01,DZA,Kedah,10,8,2
2024-01-01,DZA,Kelantan,4,4,0
2024-01-01,DZA,Perlis,5,4,1
2024-01-01,DZA,Sarawak,7,6,1
2024-01-01,DZA,Selangor,958,604,354
2024-01-01,DZA,W.P. Labuan,1,1,0
2024-01-01,ECU,Johor,20,12,8
2024-01-01,ECU,Kedah,4,2,2
2024-01-01,ECU,Pulau Pinang,1,1,0
2024-01-01,ECU,Sabah,1,1,0
2024-01-01,ECU,Selangor,52,28,24
2024-01-01,EGY,Johor,181,133,48
2024-01-01,EGY,Kedah,13,8,5
2024-01-01,EGY,Perak,1,1,0
2024-01-01,EGY,Perlis,2,2,0
2024-01-01,EGY,Pulau Pinang,14,11,3
2024-01-01,EGY,Sabah,6,2,4
2024-01-01,EGY,Sarawak,87,62,25
2024-01-01,EGY,Selangor,2088,1379,709
2024-01-01,ERI,Johor,1,1,0
2024-01-01,ERI,Selangor,16,9,7
2024-01-01,ESP,Johor,435,243,192
2024-01-01,ESP,Kedah,416,184,232
2024-01-01,ESP,Kelantan,1,1,0
2024-01-01,ESP,Pahang,6,4,2
2024-01-01,ESP,Perak,10,2,8
2024-01-01,ESP,Perlis,35,18,17
2024-01-01,ESP,Pulau Pinang,97,56,41
2024-01-01,ESP,Sabah,35,18,17
2024-01-01,ESP,Sarawak,51,35,16
2024-01-01,ESP,Selangor,2866,1619,1247
2024-01-01,ESP,W.P. Labuan,1,1,0
2024-01-01,EST,Johor,54,32,22
2024-01-01,EST,Kedah,106,49,57
2024-01-01,EST,Kelantan,3,1,2
2024-01-01,EST,Perlis,2,1,1
2024-01-01,EST,Pulau Pinang,20,10,10
2024-01-01,EST,Sabah,1,0,1
2024-01-01,EST,Sarawak,1,0,1
2024-01-01,EST,Selangor,440,209,231
2024-01-01,ETH,Johor,1,0,1
2024-01-01,ETH,Sarawak,2,1,1
2024-01-01,ETH,Selangor,67,38,29
2024-01-01,FIN,Johor,267,142,125
2024-01-01,FIN,Kedah,334,167,167
2024-01-01,FIN,Perak,2,1,1
2024-01-01,FIN,Perlis,11,9,2
2024-01-01,FIN,Pulau Pinang,92,60,32
2024-01-01,FIN,Sabah,27,12,15
2024-01-01,FIN,Sarawak,14,5,9
2024-01-01,FIN,Selangor,1139,645,494
2024-01-01,FJI,Johor,125,60,65
2024-01-01,FJI,Perlis,1,0,1
2024-01-01,FJI,Pulau Pinang,7,2,5
2024-01-01,FJI,Selangor,196,98,98
2024-01-01,FRA,Johor,1497,964,533
2024-01-01,FRA,Kedah,1125,586,539
2024-01-01,FRA,Kelantan,16,10,6
2024-01-01,FRA,Melaka,3,2,1
2024-01-01,FRA,Negeri Sembilan,1,0,1
2024-01-01,FRA,Pahang,10,6,4
2024-01-01,FRA,Perak,31,19,12
2024-01-01,FRA,Perlis,132,85,47
2024-01-01,FRA,Pulau Pinang,479,309,170
2024-01-01,FRA,Sabah,93,59,34
2024-01-01,FRA,Sarawak,86,56,30
2024-01-01,FRA,Selangor,10580,6168,4412
2024-01-01,FRA,W.P. Labuan,2,2,0
2024-01-01,FSM,Selangor,2,2,0
2024-01-01,GAB,Johor,1,1,0
2024-01-01,GAB,Selangor,10,5,5
2024-01-01,GBR,Johor,4074,2603,1471
2024-01-01,GBR,Kedah,5649,2811,2838
2024-01-01,GBR,Kelantan,14,11,3
2024-01-01,GBR,Melaka,4,2,2
2024-01-01,GBR,Pahang,10,9,1
2024-01-01,GBR,Perak,113,72,41
2024-01-01,GBR,Perlis,249,166,83
2024-01-01,GBR,Pulau Pinang,1979,1191,788
2024-01-01,GBR,Sabah,430,243,187
2024-01-01,GBR,Sarawak,841,537,304
2024-01-01,GBR,Selangor,22403,13391,9012
2024-01-01,GBR,W.P. Labuan,26,22,4
2024-01-01,GEO,Johor,8,7,1
2024-01-01,GEO,Kedah,4,0,4
2024-01-01,GEO,Pulau Pinang,6,6,0
2024-01-01,GEO,Selangor,88,45,43
2024-01-01,GHA,Johor,6,6,0
2024-01-01,GHA,Pulau Pinang,3,3,0
2024-01-01,GHA,Selangor,70,51,19
2024-01-01,GIN,Johor,5,5,0
2024-01-01,GIN,Kedah,1,1,0
2024-01-01,GIN,Sarawak,1,1,0
2024-01-01,GIN,Selangor,68,40,28
2024-01-01,GMB,Selangor,36,31,5
2024-01-01,GNB,Selangor,1,1,0
2024-01-01,GNQ,Johor,1,1,0
2024-01-01,GNQ,Selangor,1,1,0
2024-01-01,GRC,Johor,53,37,16
2024-01-01,GRC,Kedah,42,28,14
2024-01-01,GRC,Pahang,1,1,0
2024-01-01,GRC,Perak,2,1,1
2024-01-01,GRC,Perlis,5,4,1
2024-01-01,GRC,Pulau Pinang,17,9,8
2024-01-01,GRC,Sabah,3,2,1
2024-01-01,GRC,Sarawak,6,1,5
2024-01-01,GRC,Selangor,406,263,143
2024-01-01,GRD,Johor,6,3,3
2024-01-01,GRD,Selangor,15,12,3
2024-01-01,GTM,Johor,1,0,1
2024-01-01,GTM,Kedah,1,0,1
2024-01-01,GTM,Pulau Pinang,1,1,0
2024-01-01,GTM,Selangor,21,11,10
2024-01-01,GUY,Johor,1,1,0
2024-01-01,GUY,Selangor,7,6,1
2024-01-01,HKG,Johor,2,0,2
2024-01-01,HKG,Kedah,9,5,4
2024-01-01,HKG,Pahang,1,0,1
2024-01-01,HKG,Perak,50,24,26
2024-01-01,HKG,Perlis,1,0,1
2024-01-01,HKG,Sabah,12327,5388,6939
2024-01-01,HKG,Selangor,752,349,403
2024-01-01,HND,Johor,7,6,1
2024-01-01,HND,Kedah,1,1,0
2024-01-01,HND,Selangor,21,14,7
2024-01-01,HRV,Johor,32,22,10
2024-01-01,HRV,Kedah,22,8,14
2024-01-01,HRV,Perlis,1,1,0
2024-01-01,HRV,Pulau Pinang,10,4,6
2024-01-01,HRV,Sabah,4,4,0
2024-01-01,HRV,Sarawak,1,1,0
2024-01-01,HRV,Selangor,417,243,174
2024-01-01,HTI,Johor,4,3,1
2024-01-01,HTI,Selangor,12,9,3
2024-01-01,HUN,Johor,104,68,36
2024-01-01,HUN,Kedah,159,86,73
2024-01-01,HUN,Perak,11,6,5
2024-01-01,HUN,Perlis,10,6,4
2024-01-01,HUN,Pulau Pinang,36,19,17
2024-01-01,HUN,Sabah,42,21,21
2024-01-01,HUN,Sarawak,17,10,7
2024-01-01,HUN,Selangor,1273,671,602
2024-01-01,IDN,Johor,102215,47181,55034
2024-01-01,IDN,Kedah,7243,2820,4423
2024-01-01,IDN,Kelantan,109,59,50
2024-01-01,IDN,Melaka,3401,1596,1805
2024-01-01,IDN,Negeri Sembilan,4818,2786,2032
2024-01-01,IDN,Pahang,8,4,4
2024-01-01,IDN,Perak,138,53,85
2024-01-01,IDN,Perlis,902,259,643
2024-01-01,IDN,Pulau Pinang,45790,17228,28562
2024-01-01,IDN,Sabah,4598,2209,2389
2024-01-01,IDN,Sarawak,42070,21713,20357
2024-01-01,IDN,Selangor,169899,77105,92794
2024-01-01,IDN,W.P. Labuan,60,37,23
2024-01-01,IND,Johor,18984,12989,5995
2024-01-01,IND,Kedah,1224,736,488
2024-01-01,IND,Kelantan,4,4,0
2024-01-01,IND,Melaka,1,1,0
2024-01-01,IND,Pahang,9,8,1
2024-01-01,IND,Perak,245,185,60
2024-01-01,IND,Perlis,90,71,19
2024-01-01,IND,Pulau Pinang,1406,964,442
2024-01-01,IND,Sabah,213,149,64
2024-01-01,IND,Sarawak,2348,1914,434
2024-01-01,IND,Selangor,70540,46989,23551
2024-01-01,IND,W.P. Labuan,52,49,3
2024-01-01,IRL,Johor,242,156,86
2024-01-01,IRL,Kedah,144,72,72
2024-01-01,IRL,Kelantan,2,1,1
2024-01-01,IRL,Perak,7,4,3
2024-01-01,IRL,Perlis,24,16,8
2024-01-01,IRL,Pulau Pinang,168,120,48
2024-01-01,IRL,Sabah,27,12,15
2024-01-01,IRL,Sarawak,21,11,10
2024-01-01,IRL,Selangor,1698,999,699
2024-01-01,IRN,Johor,274,146,128
2024-01-01,IRN,Kedah,9,4,5
2024-01-01,IRN,Perak,1,1,0
2024-01-01,IRN,Perlis,3,3,0
2024-01-01,IRN,Pulau Pinang,17,7,10
2024-01-01,IRN,Sabah,1,0,1
2024-01-01,IRN,Sarawak,2,2,0
2024-01-01,IRN,Selangor,2263,1244,1019
2024-01-01,IRQ,Johor,23,16,7
2024-01-01,IRQ,Kedah,4,2,2
2024-01-01,IRQ,Perlis,1,1,0
2024-01-01,IRQ,Pulau Pinang,11,10,1
2024-01-01,IRQ,Sabah,2,2,0
2024-01-01,IRQ,Selangor,1115,739,376
2024-01-01,ISL,Johor,4,4,0
2024-01-01,ISL,Kedah,7,3,4
2024-01-01,ISL,Perak,2,1,1
2024-01-01,ISL,Pulau Pinang,4,1,3
2024-01-01,ISL,Selangor,51,30,21
2024-01-01,ITA,Johor,528,337,191
2024-01-01,ITA,Kedah,1073,545,528
2024-01-01,ITA,Kelantan,3,3,0
2024-01-01,ITA,Melaka,2,1,1
2024-01-01,ITA,Pahang,2,2,0
2024-01-01,ITA,Perak,12,8,4
2024-01-01,ITA,Perlis,45,31,14
2024-01-01,ITA,Pulau Pinang,172,117,55
2024-01-01,ITA,Sabah,51,33,18
2024-01-01,ITA,Sarawak,25,17,8
2024-01-01,ITA,Selangor,4427,2846,1581
2024-01-01,JAM,Johor,6,3,3
2024-01-01,JAM,Kedah,1,0,1
2024-01-01,JAM,Pulau Pinang,4,3,1
2024-01-01,JAM,Selangor,18,8,10
2024-01-01,JOR,Johor,8,3,5
2024-01-01,JOR,Kedah,1,1,0
2024-01-01,JOR,Perlis,2,2,0
2024-01-01,JOR,Pulau Pinang,4,4,0
2024-01-01,JOR,Sabah,1,1,0
2024-01-01,JOR,Selangor,898,551,347
2024-01-01,JPN,Johor,5512,3508,2004
2024-01-01,JPN,Kedah,576,284,292
2024-01-01,JPN,Kelantan,16,13,3
2024-01-01,JPN,Melaka,2,2,0
2024-01-01,JPN,Pahang,6,4,2
2024-01-01,JPN,Perak,74,44,30
2024-01-01,JPN,Perlis,113,85,28
2024-01-01,JPN,Pulau Pinang,1556,1045,511
2024-01-01,JPN,Sabah,383,187,196
2024-01-01,JPN,Sarawak,229,128,101
2024-01-01,JPN,Selangor,22006,13135,8871
2024-01-01,JPN,W.P. Labuan,16,13,3
2024-01-01,KAZ,Johor,29,10,19
2024-01-01,KAZ,Kedah,26,11,15
2024-01-01,KAZ,Perlis,8,2,6
2024-01-01,KAZ,Pulau Pinang,15,6,9
2024-01-01,KAZ,Sabah,11,5,6
2024-01-01,KAZ,Sarawak,6,4,2
2024-01-01,KAZ,Selangor,1544,636,908
2024-01-01,KEN,Johor,32,14,18
2024-01-01,KEN,Kedah,1,1,0
2024-01-01,KEN,Pulau Pinang,8,4,4
2024-01-01,KEN,Sarawak,1,1,0
2024-01-01,KEN,Selangor,433,214,219
2024-01-01,KGZ,Johor,42,30,12
2024-01-01,KGZ,Kedah,35,15,20
2024-01-01,KGZ,Kelantan,4,4,0
2024-01-01,KGZ,Perlis,1,0,1
2024-01-01,KGZ,Pulau Pinang,8,5,3
2024-01-01,KGZ,Sabah,6,4,2
2024-01-01,KGZ,Selangor,586,262,324
2024-01-01,KHM,Johor,1736,710,1026
2024-01-01,KHM,Kedah,204,143,61
2024-01-01,KHM,Kelantan,740,577,163
2024-01-01,KHM,Melaka,1,1,0
2024-01-01,KHM,Perak,5,3,2
2024-01-01,KHM,Perlis,861,594,267
2024-01-01,KHM,Pulau Pinang,22,10,12
2024-01-01,KHM,Sabah,1,1,0
2024-01-01,KHM,Sarawak,8,4,4
2024-01-01,KHM,Selangor,3311,1600,1711
2024-01-01,KIR,Selangor,5,3,2
2024-01-01,KNA,Johor,18,15,3
2024-01-01,KNA,Selangor,59,46,13
2024-01-01,KOR,Johor,19717,9417,10300
2024-01-01,KOR,Kedah,551,261,290
2024-01-01,KOR,Kelantan,3,2,1
2024-01-01,KOR,Melaka,30,15,15
2024-01-01,KOR,Pahang,8,4,4
2024-01-01,KOR,Perak,32,16,16
2024-01-01,KOR,Perlis,108,79,29
2024-01-01,KOR,Pulau Pinang,1006,510,496
2024-01-01,KOR,Sabah,26519,11123,15396
2024-01-01,KOR,Sarawak,440,219,221
2024-01-01,KOR,Selangor,30481,15121,15360
2024-01-01,KOR,W.P. Labuan,5,4,1
2024-01-01,KWT,Johor,99,42,57
2024-01-01,KWT,Kedah,19,7,12
2024-01-01,KWT,Pulau Pinang,6,4,2
2024-01-01,KWT,Sabah,2,2,0
2024-01-01,KWT,Sarawak,1,1,0
2024-01-01,KWT,Selangor,1242,658,584
2024-01-01,LAO,Johor,169,38,131
2024-01-01,LAO,Kedah,1075,82,993
2024-01-01,LAO,Kelantan,162,17,145
2024-01-01,LAO,Perak,24,1,23
2024-01-01,LAO,Perlis,331,93,238
2024-01-01,LAO,Pulau Pinang,20,6,14
2024-01-01,LAO,Sarawak,13,5,8
2024-01-01,LAO,Selangor,255,81,174
2024-01-01,LBN,Johor,22,12,10
2024-01-01,LBN,Kedah,7,7,0
2024-01-01,LBN,Pulau Pinang,5,4,1
2024-01-01,LBN,Sabah,1,1,0
2024-01-01,LBN,Sarawak,7,7,0
2024-01-01,LBN,Selangor,323,195,128
2024-01-01,LBR,Johor,1,1,0
2024-01-01,LBR,Selangor,4,4,0
2024-01-01,LBY,Johor,2,1,1
2024-01-01,LBY,Perlis,3,3,0
2024-01-01,LBY,Pulau Pinang,1,1,0
2024-01-01,LBY,Sabah,1,0,1
2024-01-01,LBY,Selangor,425,300,125
2024-01-01,LCA,Johor,6,3,3
2024-01-01,LCA,Selangor,10,8,2
2024-01-01,LIE,Johor,1,0,1
2024-01-01,LIE,Kedah,2,1,1
2024-01-01,LIE,Pulau Pinang,2,2,0
2024-01-01,LIE,Selangor,9,9,0
2024-01-01,LKA,Johor,662,427,235
2024-01-01,LKA,Kedah,72,45,27
2024-01-01,LKA,Perak,10,10,0
2024-01-01,LKA,Perlis,2,2,0
2024-01-01,LKA,Pulau Pinang,28,21,7
2024-01-01,LKA,Sabah,10,6,4
2024-01-01,LKA,Sarawak,17,15,2
2024-01-01,LKA,Selangor,4369,2733,1636
2024-01-01,LSO,Selangor,7,0,7
2024-01-01,LTU,Johor,48,19,29
2024-01-01,LTU,Kedah,141,69,72
2024-01-01,LTU,Perlis,9,6,3
2024-01-01,LTU,Pulau Pinang,17,9,8
2024-01-01,LTU,Sabah,9,6,3
2024-01-01,LTU,Sarawak,12,4,8
2024-01-01,LTU,Selangor,792,377,415
2024-01-01,LUX,Johor,5,3,2
2024-01-01,LUX,Kedah,3,2,1
2024-01-01,LUX,Pahang,2,2,0
2024-01-01,LUX,Perlis,2,1,1
2024-01-01,LUX,Pulau Pinang,5,3,2
2024-01-01,LUX,Sarawak,5,3,2
2024-01-01,LUX,Selangor,74,37,37
2024-01-01,LVA,Johor,48,17,31
2024-01-01,LVA,Kedah,24,11,13
2024-01-01,LVA,Perlis,3,3,0
2024-01-01,LVA,Pulau Pinang,10,4,6
2024-01-01,LVA,Sabah,4,2,2
2024-01-01,LVA,Sarawak,5,3,2
2024-01-01,LVA,Selangor,346,167,179
2024-01-01,MAC,Johor,1,1,0
2024-01-01,MAC,Perak,1,1,0
2024-01-01,MAC,Selangor,1,0,1
2024-01-01,MAR,Johor,92,56,36
2024-01-01,MAR,Kedah,11,4,7
2024-01-01,MAR,Perlis,1,0,1
2024-01-01,MAR,Pulau Pinang,15,8,7
2024-01-01,MAR,Sabah,10,5,5
2024-01-01,MAR,Sarawak,8,6,2
2024-01-01,MAR,Selangor,1123,607,516
2024-01-01,MCO,Johor,2,1,1
2024-01-01,MCO,Kedah,2,1,1
2024-01-01,MCO,Selangor,3,3,0
2024-01-01,MDA,Johor,4,4,0
2024-01-01,MDA,Kedah,2,1,1
2024-01-01,MDA,Sabah,2,0,2
2024-01-01,MDA,Selangor,52,24,28
2024-01-01,MDG,Johor,25,12,13
2024-01-01,MDG,Kedah,1,0,1
2024-01-01,MDG,Sabah,1,0,1
2024-01-01,MDG,Sarawak,1,0,1
2024-01-01,MDG,Selangor,47,21,26
2024-01-01,MDV,Johor,133,60,73
2024-01-01,MDV,Kedah,6,2,4
2024-01-01,MDV,Kelantan,1,1,0
2024-01-01,MDV,Pulau Pinang,7,7,0
2024-01-01,MDV,Sabah,1,1,0
2024-01-01,MDV,Selangor,2991,1553,1438
2024-01-01,MEX,Johor,143,76,67
2024-01-01,MEX,Kedah,16,10,6
2024-01-01,MEX,Perak,2,1,1
2024-01-01,MEX,Perlis,2,2,0
2024-01-01,MEX,Pulau Pinang,42,29,13
2024-01-01,MEX,Sabah,9,7,2
2024-01-01,MEX,Sarawak,2,2,0
2024-01-01,MEX,Selangor,624,317,307
2024-01-01,MHL,Selangor,4,2,2
2024-01-01,MKD,Johor,5,4,1
2024-01-01,MKD,Kedah,8,4,4
2024-01-01,MKD,Pulau Pinang,1,1,0
2024-01-01,MKD,Selangor,90,51,39
2024-01-01,MLI,Selangor,9,5,4
2024-01-01,MLT,Johor,4,2,2
2024-01-01,MLT,Kedah,15,8,7
2024-01-01,MLT,Pulau Pinang,2,1,1
2024-01-01,MLT,Selangor,71,45,26
2024-01-01,MMR,Johor,4154,1282,2872
2024-01-01,MMR,Kedah,78,16,62
2024-01-01,MMR,Kelantan,5,2,3
2024-01-01,MMR,Pahang,3,0,3
2024-01-01,MMR,Perak,24,5,19
2024-01-01,MMR,Perlis,3,1,2
2024-01-01,MMR,Pulau Pinang,450,229,221
2024-01-01,MMR,Sabah,21,8,13
2024-01-01,MMR,Sarawak,76,40,36
2024-01-01,MMR,Selangor,6276,4235,2041
2024-01-01,MMR,W.P. Labuan,2,2,0
2024-01-01,MNE,Johor,10,9,1
2024-01-01,MNE,Pulau Pinang,1,1,0
2024-01-01,MNE,Selangor,26,16,10
2024-01-01,MNG,Johor,667,311,356
2024-01-01,MNG,Kedah,37,14,23
2024-01-01,MNG,Perlis,2,2,0
2024-01-01,MNG,Pulau Pinang,40,20,20
2024-01-01,MNG,Sabah,24,9,15
2024-01-01,MNG,Selangor,1327,592,735
2024-01-01,MOZ,Johor,1,0,1
2024-01-01,MOZ,Selangor,96,44,52
2024-01-01,MRT,Johor,3,3,0
2024-01-01,MRT,Selangor,29,20,9
2024-01-01,MUS,Johor,178,95,83
2024-01-01,MUS,Kedah,8,6,2
2024-01-01,MUS,Perak,1,0,1
2024-01-01,MUS,Perlis,1,1,0
2024-01-01,MUS,Pulau Pinang,11,4,7
2024-01-01,MUS,Sabah,3,1,2
2024-01-01,MUS,Selangor,1712,877,835
2024-01-01,MWI,Johor,1,0,1
2024-01-01,MWI,Selangor,23,14,9
2024-01-01,NAM,Johor,1,1,0
2024-01-01,NAM,Selangor,13,6,7
2024-01-01,NER,Selangor,3,3,0
2024-01-01,NGA,Johor,17,17,0
2024-01-01,NGA,Kedah,1,0,1
2024-01-01,NGA,Pulau Pinang,7,7,0
2024-01-01,NGA,Sarawak,5,3,2
2024-01-01,NGA,Selangor,434,335,99
2024-01-01,NIC,Johor,1,1,0
2024-01-01,NIC,Selangor,4,2,2
2024-01-01,NLD,Johor,826,512,314
2024-01-01,NLD,Kedah,582,289,293
2024-01-01,NLD,Kelantan,3,2,1
2024-01-01,NLD,Melaka,1,1,0
2024-01-01,NLD,Pahang,3,3,0
2024-01-01,NLD,Perak,19,13,6
2024-01-01,NLD,Perlis,57,38,19
2024-01-01,NLD,Pulau Pinang,282,185,97
2024-01-01,NLD,Sabah,92,44,48
2024-01-01,NLD,Sarawak,135,87,48
2024-01-01,NLD,Selangor,5119,2981,2138
2024-01-01,NLD,W.P. Labuan,1,1,0
2024-01-01,NOR,Johor,139,82,57
2024-01-01,NOR,Kedah,130,55,75
2024-01-01,NOR,Perlis,8,4,4
2024-01-01,NOR,Pulau Pinang,72,43,29
2024-01-01,NOR,Sabah,14,7,7
2024-01-01,NOR,Sarawak,19,13,6
2024-01-01,NOR,Selangor,1123,657,466
2024-01-01,NPL,Johor,808,586,222
2024-01-01,NPL,Kedah,32,27,5
2024-01-01,NPL,Perlis,1,1,0
2024-01-01,NPL,Pulau Pinang,48,44,4
2024-01-01,NPL,Sabah,5,2,3
2024-01-01,NPL,Sarawak,196,136,60
2024-01-01,NPL,Selangor,9756,9121,635
2024-01-01,NPL,W.P. Labuan,62,59,3
2024-01-01,NRU,Selangor,1,1,0
2024-01-01,NZL,Johor,959,546,413
2024-01-01,NZL,Kedah,234,121,113
2024-01-01,NZL,Kelantan,4,1,3
2024-01-01,NZL,Melaka,3,0,3
2024-01-01,NZL,Perak,26,15,11
2024-01-01,NZL,Perlis,23,9,14
2024-01-01,NZL,Pulau Pinang,278,150,128
2024-01-01,NZL,Sabah,62,32,30
2024-01-01,NZL,Sarawak,162,91,71
2024-01-01,NZL,Selangor,4346,2460,1886
2024-01-01,NZL,W.P. Labuan,1,1,0
2024-01-01,OMN,Johor,24,16,8
2024-01-01,OMN,Kedah,13,9,4
2024-01-01,OMN,Perlis,1,0,1
2024-01-01,OMN,Pulau Pinang,11,7,4
2024-01-01,OMN,Sabah,1,1,0
2024-01-01,OMN,Sarawak,4,3,1
2024-01-01,OMN,Selangor,3378,1770,1608
2024-01-01,PAK,Johor,692,520,172
2024-01-01,PAK,Kedah,97,78,19
2024-01-01,PAK,Kelantan,20,20,0
2024-01-01,PAK,Perak,7,7,0
2024-01-01,PAK,Perlis,28,26,2
2024-01-01,PAK,Pulau Pinang,90,73,17
2024-01-01,PAK,Sabah,21,19,2
2024-01-01,PAK,Sarawak,139,120,19
2024-01-01,PAK,Selangor,10855,8781,2074
2024-01-01,PAK,W.P. Labuan,1,1,0
2024-01-01,PAN,Johor,12,7,5
2024-01-01,PAN,Pulau Pinang,1,1,0
2024-01-01,PAN,Sarawak,2,2,0
2024-01-01,PAN,Selangor,35,20,15
2024-01-01,PER,Johor,32,15,17
2024-01-01,PER,Kedah,9,3,6
2024-01-01,PER,Pulau Pinang,6,5,1
2024-01-01,PER,Selangor,163,83,80
2024-01-01,PHL,Johor,14022,4383,9639
2024-01-01,PHL,Kedah,477,167,310
2024-01-01,PHL,Kelantan,24,11,13
2024-01-01,PHL,Negeri Sembilan,4,4,0
2024-01-01,PHL,Pahang,13,11,2
2024-01-01,PHL,Perak,69,33,36
2024-01-01,PHL,Perlis,213,70,143
2024-01-01,PHL,Pulau Pinang,657,304,353
2024-01-01,PHL,Sabah,1990,835,1155
2024-01-01,PHL,Sarawak,2820,1246,1574
2024-01-01,PHL,Selangor,18073,7354,10719
2024-01-01,PHL,W.P. Labuan,107,34,73
2024-01-01,PLW,Selangor,11,9,2
2024-01-01,PNG,Johor,14,4,10
2024-01-01,PNG,Pulau Pinang,2,0,2
2024-01-01,PNG,Sarawak,18,8,10
2024-01-01,PNG,Selangor,91,48,43
2024-01-01,POL,Johor,684,363,321
2024-01-01,POL,Kedah,530,265,265
2024-01-01,POL,Kelantan,1,1,0
2024-01-01,POL,Melaka,1,1,0
2024-01-01,POL,Perak,3,2,1
2024-01-01,POL,Perlis,42,23,19
2024-01-01,POL,Pulau Pinang,149,67,82
2024-01-01,POL,Sabah,69,36,33
2024-01-01,POL,Sarawak,52,26,26
2024-01-01,POL,Selangor,2850,1510,1340
2024-01-01,POL,W.P. Labuan,22,9,13
2024-01-01,PRT,Johor,136,75,61
2024-01-01,PRT,Kedah,95,48,47
2024-01-01,PRT,Perlis,3,3,0
2024-01-01,PRT,Pulau Pinang,42,12,30
2024-01-01,PRT,Sabah,12,9,3
2024-01-01,PRT,Sarawak,8,6,2
2024-01-01,PRT,Selangor,856,493,363
2024-01-01,PRY,Johor,4,0,4
2024-01-01,PRY,Kedah,4,0,4
2024-01-01,PRY,Perlis,1,1,0
2024-01-01,PRY,Pulau Pinang,1,0,1
2024-01-01,PRY,Sabah,2,1,1
2024-01-01,PRY,Selangor,22,15,7
2024-01-01,PSE,Johor,20,20,0
2024-01-01,PSE,Pulau Pinang,5,5,0
2024-01-01,PSE,Selangor,237,172,65
2024-01-01,QAT,Johor,2,1,1
2024-01-01,QAT,Sarawak,1,1,0
2024-01-01,QAT,Selangor,131,82,49
2024-01-01,ROU,Johor,169,100,69
2024-01-01,ROU,Kedah,200,101,99
2024-01-01,ROU,Kelantan,1,1,0
2024-01-01,ROU,Perlis,9,5,4
2024-01-01,ROU,Pulau Pinang,68,32,36
2024-01-01,ROU,Sabah,6,4,2
2024-01-01,ROU,Sarawak,10,7,3
2024-01-01,ROU,Selangor,1548,804,744
2024-01-01,RUS,Johor,416,221,195
2024-01-01,RUS,Kedah,749,358,391
2024-01-01,RUS,Kelantan,9,5,4
2024-01-01,RUS,Pahang,6,2,4
2024-01-01,RUS,Perak,3,3,0
2024-01-01,RUS,Perlis,84,48,36
2024-01-01,RUS,Pulau Pinang,280,139,141
2024-01-01,RUS,Sabah,165,76,89
2024-01-01,RUS,Sarawak,57,30,27
2024-01-01,RUS,Selangor,13391,6449,6942
2024-01-01,RUS,W.P. Labuan,7,2,5
2024-01-01,RWA,Selangor,11,4,7
2024-01-01,SAU,Johor,151,80,71
2024-01-01,SAU,Kedah,38,18,20
2024-01-01,SAU,Kelantan,4,3,1
2024-01-01,SAU,Perak,2,1,1
2024-01-01,SAU,Perlis,2,1,1
2024-01-01,SAU,Pulau Pinang,45,27,18
2024-01-01,SAU,Sabah,5,4,1
2024-01-01,SAU,Sarawak,8,6,2
2024-01-01,SAU,Selangor,6118,3404,2714
2024-01-01,SDN,Johor,7,6,1
2024-01-01,SDN,Kedah,2,2,0
2024-01-01,SDN,Kelantan,2,2,0
2024-01-01,SDN,Pulau Pinang,1,1,0
2024-01-01,SDN,Sarawak,11,8,3
2024-01-01,SDN,Selangor,1460,797,663
2024-01-01,SEN,Johor,12,8,4
2024-01-01,SEN,Perlis,1,1,0
2024-01-01,SEN,Sabah,1,1,0
2024-01-01,SEN,Selangor,57,44,13
2024-01-01,SGP,Johor,871844,505563,366281
2024-01-01,SGP,Kedah,3673,2000,1673
2024-01-01,SGP,Kelantan,43,29,14
2024-01-01,SGP,Melaka,24,20,4
2024-01-01,SGP,Negeri Sembilan,7,5,2
2024-01-01,SGP,Pahang,290,150,140
2024-01-01,SGP,Perak,4291,2076,2215
2024-01-01,SGP,Perlis,183,122,61
2024-01-01,SGP,Pulau Pinang,14410,7407,7003
2024-01-01,SGP,Sabah,2271,1214,1057
2024-01-01,SGP,Sarawak,3071,1732,1339
2024-01-01,SGP,Selangor,41630,21994,19636
2024-01-01,SGP,W.P. Labuan,11,9,2
2024-01-01,SHN,Johor,1,1,0
2024-01-01,SLB,Pulau Pinang,4,2,2
2024-01-01,SLB,Selangor,7,3,4
2024-01-01,SLE,Johor,4,2,2
2024-01-01,SLE,Kedah,2,1,1
2024-01-01,SLE,Selangor,20,11,9
2024-01-01,SLV,Johor,2,1,1
2024-01-01,SLV,Kedah,15,5,10
2024-01-01,SLV,Selangor,29,13,16
2024-01-01,SMR,Selangor,5,5,0
2024-01-01,SOM,Johor,1,1,0
2024-01-01,SOM,Kedah,1,1,0
2024-01-01,SOM,Selangor,240,119,121
2024-01-01,SPM,Johor,1,0,1
2024-01-01,SRB,Johor,9,6,3
2024-01-01,SRB,Kedah,14,5,9
2024-01-01,SRB,Pulau Pinang,4,2,2
2024-01-01,SRB,Selangor,181,85,96
2024-01-01,SSD,Selangor,46,33,13
2024-01-01,STP,Selangor,1,0,1
2024-01-01,SUR,Johor,1,1,0
2024-01-01,SUR,Pulau Pinang,1,1,0
2024-01-01,SUR,Selangor,12,9,3
2024-01-01,SVK,Johor,49,24,25
2024-01-01,SVK,Kedah,106,49,57
2024-01-01,SVK,Kelantan,2,2,0
2024-01-01,SVK,Perak,2,2,0
2024-01-01,SVK,Perlis,4,3,1
2024-01-01,SVK,Pulau Pinang,36,18,18
2024-01-01,SVK,Sarawak,3,1,2
2024-01-01,SVK,Selangor,559,314,245
2024-01-01,SVN,Johor,17,8,9
2024-01-01,SVN,Kedah,71,39,32
2024-01-01,SVN,Perlis,7,3,4
2024-01-01,SVN,Pulau Pinang,7,2,5
2024-01-01,SVN,Sabah,4,2,2
2024-01-01,SVN,Selangor,318,170,148
2024-01-01,SWE,Johor,311,154,157
2024-01-01,SWE,Kedah,547,271,276
2024-01-01,SWE,Kelantan,6,5,1
2024-01-01,SWE,Perak,5,5,0
2024-01-01,SWE,Perlis,39,29,10
2024-01-01,SWE,Pulau Pinang,119,77,42
2024-01-01,SWE,Sabah,27,12,15
2024-01-01,SWE,Sarawak,18,9,9
2024-01-01,SWE,Selangor,2018,1174,844
2024-01-01,SWZ,Selangor,14,5,9
2024-01-01,SYC,Johor,17,5,12
2024-01-01,SYC,Pulau Pinang,2,2,0
2024-01-01,SYC,Selangor,152,64,88
2024-01-01,SYR,Johor,9,5,4
2024-01-01,SYR,Kedah,4,2,2
2024-01-01,SYR,Pahang,6,6,0
2024-01-01,SYR,Pulau Pinang,1,1,0
2024-01-01,SYR,Sabah,2,2,0
2024-01-01,SYR,Sarawak,1,1,0
2024-01-01,SYR,Selangor,740,467,273
2024-01-01,TCD,Johor,11,10,1
2024-01-01,TCD,Selangor,29,20,9
2024-01-01,TGO,Johor,1,1,0
2024-01-01,TGO,Selangor,10,9,1
2024-01-01,THA,Johor,5582,1486,4096
2024-01-01,THA,Kedah,72272,43955,28317
2024-01-01,THA,Kelantan,52401,27259,25142
2024-01-01,THA,Pahang,3,1,2
2024-01-01,THA,Perak,10688,4919,5769
2024-01-01,THA,Perlis,53832,32478,21354
2024-01-01,THA,Pulau Pinang,2439,988,1451
2024-01-01,THA,Sabah,29,7,22
2024-01-01,THA,Sarawak,407,147,260
2024-01-01,THA,Selangor,13251,5035,8216
2024-01-01,THA,W.P. Labuan,7,4,3
2024-01-01,TJK,Pulau Pinang,1,1,0
2024-01-01,TJK,Sabah,1,1,0
2024-01-01,TJK,Selangor,209,138,71
2024-01-01,TKM,Pulau Pinang,1,1,0
2024-01-01,TKM,Sabah,4,3,1
2024-01-01,TKM,Selangor,180,100,80
2024-01-01,TLS,Johor,20,12,8
2024-01-01,TLS,Pulau Pinang,2,2,0
2024-01-01,TLS,Sabah,1,0,1
2024-01-01,TLS,Selangor,253,117,136
2024-01-01,TON,Johor,12,7,5
2024-01-01,TON,Pulau Pinang,2,0,2
2024-01-01,TON,Selangor,27,15,12
2024-01-01,TTO,Johor,3,2,1
2024-01-01,TTO,Sarawak,3,0,3
2024-01-01,TTO,Selangor,26,15,11
2024-01-01,TTO,W.P. Labuan,1,1,0
2024-01-01,TUN,Johor,15,7,8
2024-01-01,TUN,Kelantan,1,1,0
2024-01-01,TUN,Pulau Pinang,10,10,0
2024-01-01,TUN,Sabah,1,0,1
2024-01-01,TUN,Selangor,833,464,369
2024-01-01,TUR,Johor,280,208,72
2024-01-01,TUR,Kedah,118,67,51
2024-01-01,TUR,Kelantan,2,2,0
2024-01-01,TUR,Melaka,1,1,0
2024-01-01,TUR,Perak,5,4,1
2024-01-01,TUR,Perlis,24,19,5
2024-01-01,TUR,Pulau Pinang,56,40,16
2024-01-01,TUR,Sabah,6,4,2
2024-01-01,TUR,Sarawak,19,13,6
2024-01-01,TUR,Selangor,2017,1281,736
2024-01-01,TUV,Selangor,1,1,0
2024-01-01,TWN,Johor,6749,2907,3842
2024-01-01,TWN,Kedah,239,114,125
2024-01-01,TWN,Melaka,3,3,0
2024-01-01,TWN,Negeri Sembilan,6,3,3
2024-01-01,TWN,Pahang,5,3,2
2024-01-01,TWN,Perak,56,20,36
2024-01-01,TWN,Perlis,37,22,15
2024-01-01,TWN,Pulau Pinang,4522,2074,2448
2024-01-01,TWN,Sabah,2351,1060,1291
2024-01-01,TWN,Sarawak,469,194,275
2024-01-01,TWN,Selangor,19108,8892,10216
2024-01-01,TWN,W.P. Labuan,1,1,0
2024-01-01,TZA,Johor,40,18,22
2024-01-01,TZA,Pulau Pinang,1,0,1
2024-01-01,TZA,Selangor,244,112,132
2024-01-01,UGA,Johor,51,28,23
2024-01-01,UGA,Kedah,2,1,1
2024-01-01,UGA,Perlis,1,0,1
2024-01-01,UGA,Pulau Pinang,3,1,2
2024-01-01,UGA,Sabah,2,2,0
2024-01-01,UGA,Sarawak,4,0,4
2024-01-01,UGA,Selangor,164,81,83
2024-01-01,UKR,Johor,89,43,46
2024-01-01,UKR,Kedah,70,30,40
2024-01-01,UKR,Kelantan,3,1,2
2024-01-01,UKR,Pahang,1,0,1
2024-01-01,UKR,Perak,1,1,0
2024-01-01,UKR,Perlis,7,4,3
2024-01-01,UKR,Pulau Pinang,49,27,22
2024-01-01,UKR,Sabah,13,6,7
2024-01-01,UKR,Sarawak,3,2,1
2024-01-01,UKR,Selangor,1546,691,855
2024-01-01,URY,Johor,18,4,14
2024-01-01,URY,Kedah,8,3,5
2024-01-01,URY,Pulau Pinang,1,0,1
2024-01-01,URY,Selangor,55,28,27
2024-01-01,USA,Johor,4068,2281,1787
2024-01-01,USA,Kedah,1502,749,753
2024-01-01,USA,Kelantan,7,4,3
2024-01-01,USA,Melaka,1,1,0
2024-01-01,USA,Negeri Sembilan,2,1,1
2024-01-01,USA,Pahang,8,8,0
2024-01-01,USA,Perak,98,57,41
2024-01-01,USA,Perlis,114,76,38
2024-01-01,USA,Pulau Pinang,2863,1612,1251
2024-01-01,USA,Sabah,359,199,160
2024-01-01,USA,Sarawak,253,147,106
2024-01-01,USA,Selangor,16734,9807,6927
2024-01-01,USA,W.P. Labuan,5,3,2
2024-01-01,UZB,Johor,89,65,24
2024-01-01,UZB,Kedah,72,41,31
2024-01-01,UZB,Perak,1,1,0
2024-01-01,UZB,Perlis,1,1,0
2024-01-01,UZB,Pulau Pinang,9,6,3
2024-01-01,UZB,Sabah,3,2,1
2024-01-01,UZB,Selangor,3107,1949,1158
2024-01-01,VAT,Pulau Pinang,1,1,0
2024-01-01,VCT,Johor,2,2,0
2024-01-01,VCT,Sabah,1,1,0
2024-01-01,VCT,Selangor,4,4,0
2024-01-01,VEN,Johor,22,8,14
2024-01-01,VEN,Kedah,2,1,1
2024-01-01,VEN,Pulau Pinang,2,1,1
2024-01-01,VEN,Sarawak,1,1,0
2024-01-01,VEN,Selangor,88,51,37
2024-01-01,VNM,Johor,9973,3085,6888
2024-01-01,VNM,Kedah,276,33,243
2024-01-01,VNM,Kelantan,8,3,5
2024-01-01,VNM,Pahang,1,1,0
2024-01-01,VNM,Perak,221,7,214
2024-01-01,VNM,Perlis,216,17,199
2024-01-01,VNM,Pulau Pinang,949,295,654
2024-01-01,VNM,Sabah,59,22,37
2024-01-01,VNM,Sarawak,351,74,277
2024-01-01,VNM,Selangor,12157,4359,7798
2024-01-01,VNM,Terengganu,14,14,0
2024-01-01,VNM,W.P. Labuan,2,2,0
2024-01-01,VUT,Johor,43,36,7
2024-01-01,VUT,Pulau Pinang,2,2,0
2024-01-01,VUT,Sabah,2,2,0
2024-01-01,VUT,Selangor,73,65,8
2024-01-01,WSM,Selangor,3,0,3
2024-01-01,XXX,Johor,5,3,2
2024-01-01,XXX,Sabah,2,2,0
2024-01-01,XXX,Sarawak,1,1,0
2024-01-01,XXX,Selangor,76,50,26
2024-01-01,YEM,Johor,30,20,10
2024-01-01,YEM,Kedah,7,5,2
2024-01-01,YEM,Kelantan,2,1,1
2024-01-01,YEM,Melaka,1,1,0
2024-01-01,YEM,Perak,1,1,0
2024-01-01,YEM,Perlis,3,3,0
2024-01-01,YEM,Pulau Pinang,3,1,2
2024-01-01,YEM,Sarawak,7,6,1
2024-01-01,YEM,Selangor,1487,968,519
2024-01-01,ZAF,Johor,347,196,151
2024-01-01,ZAF,Kedah,68,31,37
2024-01-01,ZAF,Pahang,1,1,0
2024-01-01,ZAF,Perak,2,2,0
2024-01-01,ZAF,Perlis,4,1,3
2024-01-01,ZAF,Pulau Pinang,78,41,37
2024-01-01,ZAF,Sabah,37,20,17
2024-01-01,ZAF,Sarawak,56,30,26
2024-01-01,ZAF,Selangor,1549,814,735
2024-01-01,ZAR,Pulau Pinang,1,0,1
2024-01-01,ZAR,Selangor,1,0,1
2024-01-01,ZMB,Johor,10,5,5
2024-01-01,ZMB,Kedah,1,0,1
2024-01-01,ZMB,Pulau Pinang,5,1,4
2024-01-01,ZMB,Sarawak,2,1,1
2024-01-01,ZMB,Selangor,93,51,42
2024-01-01,ZWE,Johor,13,5,8
2024-01-01,ZWE,Kedah,1,1,0
2024-01-01,ZWE,Pulau Pinang,2,0,2
2024-01-01,ZWE,Sarawak,1,0,1
2024-01-01,ZWE,Selangor,199,103,96
2024-02-01,AFG,Perlis,1,0,1
2024-02-01,AFG,Selangor,53,38,15
2024-02-01,AGO,Selangor,1,1,0
2024-02-01,ALB,Johor,14,10,4
2024-02-01,ALB,Kedah,2,1,1
2024-02-01,ALB,Pulau Pinang,2,1,1
2024-02-01,ALB,Selangor,28,17,11
2024-02-01,AND,Johor,1,0,1
2024-02-01,AND,Selangor,5,2,3
2024-02-01,ARE,Johor,9,6,3
2024-02-01,ARE,Kedah,5,4,1
2024-02-01,ARE,Selangor,378,237,141
2024-02-01,ARG,Johor,92,46,46
2024-02-01,ARG,Kedah,98,47,51
2024-02-01,ARG,Perak,1,1,0
2024-02-01,ARG,Perlis,4,4,0
2024-02-01,ARG,Pulau Pinang,6,4,2
2024-02-01,ARG,Sabah,4,2,2
2024-02-01,ARG,Selangor,576,294,282
2024-02-01,ARG,Terengganu,1,1,0
2024-02-01,ARM,Johor,1,0,1
2024-02-01,ARM,Kedah,5,4,1
2024-02-01,ARM,Pulau Pinang,3,0,3
2024-02-01,ARM,Sabah,1,0,1
2024-02-01,ARM,Selangor,166,61,105
2024-02-01,ATG,Johor,4,2,2
2024-02-01,ATG,Pulau Pinang,1,1,0
2024-02-01,ATG,Selangor,20,13,7
2024-02-01,AUS,Johor,4763,2792,1971
2024-02-01,AUS,Kedah,613,336,277
2024-02-01,AUS,Kelantan,8,6,2
2024-02-01,AUS,Melaka,2,2,0
2024-02-01,AUS,Negeri Sembilan,2,1,1
2024-02-01,AUS,Pahang,14,9,5
2024-02-01,AUS,Perak,274,148,126
2024-02-01,AUS,Perlis,127,78,49
2024-02-01,AUS,Pulau Pinang,1851,1000,851
2024-02-01,AUS,Sabah,370,194,176
2024-02-01,AUS,Sarawak,603,359,244
2024-02-01,AUS,Selangor,21486,12654,8832
2024-02-01,AUS,Terengganu,3,1,2
2024-02-01,AUS,W.P. Labuan,12,5,7
2024-02-01,AUT,Johor,261,175,86
2024-02-01,AUT,Kedah,282,156,126
2024-02-01,AUT,Kelantan,4,3,1
2024-02-01,AUT,Perak,5,3,2
2024-02-01,AUT,Perlis,26,16,10
2024-02-01,AUT,Pulau Pinang,122,79,43
2024-02-01,AUT,Sabah,29,19,10
2024-02-01,AUT,Sarawak,33,20,13
2024-02-01,AUT,Selangor,1402,800,602
2024-02-01,AUT,W.P. Labuan,2,1,1
2024-02-01,AZE,Johor,13,8,5
2024-02-01,AZE,Kedah,5,2,3
2024-02-01,AZE,Kelantan,1,1,0
2024-02-01,AZE,Sabah,1,1,0
2024-02-01,AZE,Sarawak,3,1,2
2024-02-01,AZE,Selangor,118,65,53
2024-02-01,BDI,Selangor,4,0,4
2024-02-01,BEL,Johor,209,128,81
2024-02-01,BEL,Kedah,186,93,93
2024-02-01,BEL,Kelantan,2,1,1
2024-02-01,BEL,Melaka,1,1,0
2024-02-01,BEL,Pahang,2,0,2
2024-02-01,BEL,Perak,1,1,0
2024-02-01,BEL,Perlis,17,15,2
2024-02-01,BEL,Pulau Pinang,92,60,32
2024-02-01,BEL,Sabah,34,19,15
2024-02-01,BEL,Sarawak,26,15,11
2024-02-01,BEL,Selangor,1553,945,608
2024-02-01,BEL,Terengganu,1,1,0
2024-02-01,BEL,W.P. Labuan,5,2,3
2024-02-01,BEN,Selangor,10,9,1
2024-02-01,BFA,Johor,2,1,1
2024-02-01,BFA,Selangor,7,5,2
2024-02-01,BGD,Johor,4241,3702,539
2024-02-01,BGD,Kedah,130,78,52
2024-02-01,BGD,Kelantan,4,4,0
2024-02-01,BGD,Pahang,3,1,2
2024-02-01,BGD,Perak,6,4,2
2024-02-01,BGD,Perlis,3,3,0
2024-02-01,BGD,Pulau Pinang,83,76,7
2024-02-01,BGD,Sabah,4,3,1
2024-02-01,BGD,Sarawak,111,76,35
2024-02-01,BGD,Selangor,27189,25198,1991
2024-02-01,BGD,Terengganu,1,1,0
2024-02-01,BGD,W.P. Labuan,18,18,0
2024-02-01,BGR,Johor,85,43,42
2024-02-01,BGR,Kedah,17,8,9
2024-02-01,BGR,Kelantan,1,1,0
2024-02-01,BGR,Perak,1,1,0
2024-02-01,BGR,Perlis,1,1,0
2024-02-01,BGR,Pulau Pinang,17,12,5
2024-02-01,BGR,Sabah,2,1,1
2024-02-01,BGR,Sarawak,2,2,0
2024-02-01,BGR,Selangor,474,223,251
2024-02-01,BHR,Johor,9,6,3
2024-02-01,BHR,Kedah,2,2,0
2024-02-01,BHR,Pulau Pinang,2,2,0
2024-02-01,BHR,Selangor,140,76,64
2024-02-01,BHS,Johor,2,2,0
2024-02-01,BHS,Pulau Pinang,1,0,1
2024-02-01,BHS,Selangor,8,2,6
2024-02-01,BIH,Johor,8,5,3
2024-02-01,BIH,Kedah,2,1,1
2024-02-01,BIH,Pulau Pinang,1,1,0
2024-02-01,BIH,Sabah,1,1,0
2024-02-01,BIH,Sarawak,2,2,0
2024-02-01,BIH,Selangor,76,49,27
2024-02-01,BLR,Johor,19,9,10
2024-02-01,BLR,Kedah,66,29,37
2024-02-01,BLR,Kelantan,2,1,1
2024-02-01,BLR,Perak,1,1,0
2024-02-01,BLR,Pulau Pinang,14,8,6
2024-02-01,BLR,Sabah,5,2,3
2024-02-01,BLR,Sarawak,1,1,0
2024-02-01,BLR,Selangor,592,282,310
2024-02-01,BLZ,Johor,3,2,1
2024-02-01,BLZ,Selangor,11,3,8
2024-02-01,BOL,Pulau Pinang,2,2,0
2024-02-01,BOL,Selangor,15,8,7
2024-02-01,BRA,Johor,365,208,157
2024-02-01,BRA,Kedah,98,49,49
2024-02-01,BRA,Perak,5,3,2
2024-02-01,BRA,Perlis,10,3,7
2024-02-01,BRA,Pulau Pinang,48,22,26
2024-02-01,BRA,Sabah,13,6,7
2024-02-01,BRA,Sarawak,7,4,3
2024-02-01,BRA,Selangor,929,530,399
2024-02-01,BRB,Johor,2,2,0
2024-02-01,BRB,Pulau Pinang,3,0,3
2024-02-01,BRB,Selangor,8,2,6
2024-02-01,BRN,Johor,389,206,183
2024-02-01,BRN,Kedah,32,12,20
2024-02-01,BRN,Kelantan,6,2,4
2024-02-01,BRN,Perak,7,3,4
2024-02-01,BRN,Perlis,47,20,27
2024-02-01,BRN,Pulau Pinang,20,10,10
2024-02-01,BRN,Sabah,1109,460,649
2024-02-01,BRN,Sarawak,131382,70633,60749
2024-02-01,BRN,Selangor,5785,2764,3021
2024-02-01,BRN,W.P. Labuan,1729,1058,671
2024-02-01,BTN,Johor,3,3,0
2024-02-01,BTN,Kedah,1,1,0
2024-02-01,BTN,Perlis,3,1,2
2024-02-01,BTN,Pulau Pinang,1,1,0
2024-02-01,BTN,Sarawak,3,3,0
2024-02-01,BTN,Selangor,74,38,36
2024-02-01,BWA,Johor,1,1,0
2024-02-01,BWA,Selangor,16,7,9
2024-02-01,CAN,Johor,1764,958,806
2024-02-01,CAN,Kedah,418,217,201
2024-02-01,CAN,Kelantan,12,8,4
2024-02-01,CAN,Negeri Sembilan,7,5,2
2024-02-01,CAN,Pahang,2,2,0
2024-02-01,CAN,Perak,33,18,15
2024-02-01,CAN,Perlis,83,48,35
2024-02-01,CAN,Pulau Pinang,642,358,284
2024-02-01,CAN,Sabah,257,118,139
2024-02-01,CAN,Sarawak,368,190,178
2024-02-01,CAN,Selangor,6300,3539,2761
2024-02-01,CAN,W.P. Labuan,11,9,2
2024-02-01,CHE,Johor,491,285,206
2024-02-01,CHE,Kedah,316,169,147
2024-02-01,CHE,Kelantan,1,0,1
2024-02-01,CHE,Negeri Sembilan,1,1,0
2024-02-01,CHE,Pahang,1,1,0
2024-02-01,CHE,Perak,19,13,6
2024-02-01,CHE,Perlis,26,18,8
2024-02-01,CHE,Pulau Pinang,178,104,74
2024-02-01,CHE,Sabah,47,25,22
2024-02-01,CHE,Sarawak,40,18,22
2024-02-01,CHE,Selangor,1798,1037,761
2024-02-01,CHE,W.P. Labuan,1,1,0
2024-02-01,CHL,Johor,65,37,28
2024-02-01,CHL,Kedah,28,11,17
2024-02-01,CHL,Kelantan,1,1,0
2024-02-01,CHL,Perlis,5,4,1
2024-02-01,CHL,Pulau Pinang,11,5,6
2024-02-01,CHL,Sabah,6,3,3
2024-02-01,CHL,Sarawak,2,2,0
2024-02-01,CHL,Selangor,501,232,269
2024-02-01,CHN,Johor,78786,34787,43999
2024-02-01,CHN,Kedah,6529,2856,3673
2024-02-01,CHN,Kelantan,56,32,24
2024-02-01,CHN,Melaka,8,4,4
2024-02-01,CHN,Pahang,58,36,22
2024-02-01,CHN,Perak,288,122,166
2024-02-01,CHN,Perlis,620,336,284
2024-02-01,CHN,Pulau Pinang,13500,6614,6886
2024-02-01,CHN,Sabah,34953,15397,19556
2024-02-01,CHN,Sarawak,1919,885,1034
2024-02-01,CHN,Selangor,205226,97688,107538
2024-02-01,CHN,W.P. Labuan,60,46,14
2024-02-01,CIV,Selangor,34,24,10
2024-02-01,CMR,Kedah,3,1,2
2024-02-01,CMR,Pulau Pinang,3,1,2
2024-02-01,CMR,Selangor,18,15,3
2024-02-01,COD,Johor,2,2,0
2024-02-01,COD,Selangor,17,13,4
2024-02-01,COG,Selangor,6,5,1
2024-02-01,COL,Johor,29,17,12
2024-02-01,COL,Kedah,5,0,5
2024-02-01,COL,Perak,1,1,0
2024-02-01,COL,Pulau Pinang,5,4,1
2024-02-01,COL,Sabah,4,2,2
2024-02-01,COL,Selangor,160,89,71
2024-02-01,COM,Johor,1,1,0
2024-02-01,COM,Selangor,11,10,1
2024-02-01,CPV,Johor,1,0,1
2024-02-01,CPV,Selangor,6,4,2
2024-02-01,CRI,Johor,10,6,4
2024-02-01,CRI,Kedah,1,0,1
2024-02-01,CRI,Pulau Pinang,7,2,5
2024-02-01,CRI,Sabah,3,2,1
2024-02-01,CRI,Selangor,69,40,29
2024-02-01,CUB,Johor,6,4,2
2024-02-01,CUB,Pulau Pinang,1,1,0
2024-02-01,CUB,Sabah,1,1,0
2024-02-01,CUB,Selangor,24,8,16
2024-02-01,CYP,Johor,4,3,1
2024-02-01,CYP,Pulau Pinang,1,1,0
2024-02-01,CYP,Selangor,90,57,33
2024-02-01,CZE,Johor,201,90,111
2024-02-01,CZE,Kedah,326,153,173
2024-02-01,CZE,Perlis,18,9,9
2024-02-01,CZE,Pulau Pinang,62,31,31
2024-02-01,CZE,Sabah,22,12,10
2024-02-01,CZE,Sarawak,18,12,6
2024-02-01,CZE,Selangor,1244,692,552
2024-02-01,DEU,Johor,2768,1641,1127
2024-02-01,DEU,Kedah,3358,1657,1701
2024-02-01,DEU,Kelantan,19,14,5
2024-02-01,DEU,Melaka,3,2,1
2024-02-01,DEU,Negeri Sembilan,3,2,1
2024-02-01,DEU,Pahang,9,6,3
2024-02-01,DEU,Perak,30,21,9
2024-02-01,DEU,Perlis,229,140,89
2024-02-01,DEU,Pulau Pinang,889,605,284
2024-02-01,DEU,Sabah,139,92,47
2024-02-01,DEU,Sarawak,270,145,125
2024-02-01,DEU,Selangor,15593,8534,7059
2024-02-01,DEU,W.P. Labuan,16,11,5
2024-02-01,DJI,Kedah,2,1,1
2024-02-01,DJI,Selangor,6,2,4
2024-02-01,DMA,Johor,3,2,1
2024-02-01,DMA,Pulau Pinang,4,4,0
2024-02-01,DMA,Sarawak,1,0,1
2024-02-01,DMA,Selangor,45,34,11
2024-02-01,DNK,Johor,354,230,124
2024-02-01,DNK,Kedah,427,194,233
2024-02-01,DNK,Kelantan,7,7,0
2024-02-01,DNK,Perak,6,4,2
2024-02-01,DNK,Perlis,16,9,7
2024-02-01,DNK,Pulau Pinang,106,65,41
2024-02-01,DNK,Sabah,38,19,19
2024-02-01,DNK,Sarawak,20,11,9
2024-02-01,DNK,Selangor,1627,917,710
2024-02-01,DNK,W.P. Labuan,3,1,2
2024-02-01,DOM,Johor,2,0,2
2024-02-01,DOM,Sabah,1,0,1
2024-02-01,DOM,Selangor,15,10,5
2024-02-01,DZA,Johor,37,30,7
2024-02-01,DZA,Kedah,9,7,2
2024-02-01,DZA,Kelantan,1,1,0
2024-02-01,DZA,Perlis,1,0,1
2024-02-01,DZA,Pulau Pinang,1,1,0
2024-02-01,DZA,Sabah,2,1,1
2024-02-01,DZA,Sarawak,3,3,0
2024-02-01,DZA,Selangor,811,522,289
2024-02-01,ECU,Johor,10,5,5
2024-02-01,ECU,Pulau Pinang,1,0,1
2024-02-01,ECU,Selangor,75,42,33
2024-02-01,EGY,Johor,167,142,25
2024-02-01,EGY,Kedah,23,14,9
2024-02-01,EGY,Kelantan,2,0,2
2024-02-01,EGY,Perlis,1,1,0
2024-02-01,EGY,Pulau Pinang,20,12,8
2024-02-01,EGY,Sabah,5,4,1
2024-02-01,EGY,Sarawak,139,78,61
2024-02-01,EGY,Selangor,2355,1499,856
2024-02-01,ERI,Selangor,22,12,10
2024-02-01,ESP,Johor,547,340,207
2024-02-01,ESP,Kedah,279,140,139
2024-02-01,ESP,Kelantan,3,2,1
2024-02-01,ESP,Melaka,1,1,0
2024-02-01,ESP,Perak,2,1,1
2024-02-01,ESP,Perlis,31,18,13
2024-02-01,ESP,Pulau Pinang,170,99,71
2024-02-01,ESP,Sabah,81,50,31
2024-02-01,ESP,Sarawak,59,39,20
2024-02-01,ESP,Selangor,2441,1420,1021
2024-02-01,ESP,W.P. Labuan,5,3,2
2024-02-01,EST,Johor,91,47,44
2024-02-01,EST,Kedah,158,77,81
2024-02-01,EST,Perlis,2,1,1
2024-02-01,EST,Pulau Pinang,34,17,17
2024-02-01,EST,Sabah,6,2,4
2024-02-01,EST,Selangor,525,247,278
2024-02-01,ETH,Johor,6,4,2
2024-02-01,ETH,Pulau Pinang,1,1,0
2024-02-01,ETH,Selangor,51,43,8
2024-02-01,FIN,Johor,324,181,143
2024-02-01,FIN,Kedah,291,125,166
2024-02-01,FIN,Kelantan,1,0,1
2024-02-01,FIN,Perak,6,3,3
2024-02-01,FIN,Perlis,25,15,10
2024-02-01,FIN,Pulau Pinang,63,36,27
2024-02-01,FIN,Sabah,35,17,18
2024-02-01,FIN,Sarawak,8,4,4
2024-02-01,FIN,Selangor,936,513,423
2024-02-01,FJI,Johor,43,24,19
2024-02-01,FJI,Kedah,2,1,1
2024-02-01,FJI,Pulau Pinang,2,0,2
2024-02-01,FJI,Selangor,69,34,35
2024-02-01,FJI,Terengganu,1,1,0
2024-02-01,FRA,Johor,2574,1459,1115
2024-02-01,FRA,Kedah,1729,889,840
2024-02-01,FRA,Kelantan,28,17,11
2024-02-01,FRA,Melaka,8,5,3
2024-02-01,FRA,Pahang,18,7,11
2024-02-01,FRA,Perak,26,18,8
2024-02-01,FRA,Perlis,145,89,56
2024-02-01,FRA,Pulau Pinang,527,307,220
2024-02-01,FRA,Sabah,207,111,96
2024-02-01,FRA,Sarawak,96,68,28
2024-02-01,FRA,Selangor,12007,6802,5205
2024-02-01,FRA,W.P. Labuan,5,5,0
2024-02-01,FSM,Johor,1,0,1
2024-02-01,GAB,Sabah,1,0,1
2024-02-01,GAB,Selangor,12,9,3
2024-02-01,GBR,Johor,5087,3143,1944
2024-02-01,GBR,Kedah,3642,1813,1829
2024-02-01,GBR,Kelantan,29,16,13
2024-02-01,GBR,Melaka,10,5,5
2024-02-01,GBR,Negeri Sembilan,1,1,0
2024-02-01,GBR,Pahang,18,13,5
2024-02-01,GBR,Perak,137,85,52
2024-02-01,GBR,Perlis,268,170,98
2024-02-01,GBR,Pulau Pinang,2040,1194,846
2024-02-01,GBR,Sabah,553,301,252
2024-02-01,GBR,Sarawak,1250,748,502
2024-02-01,GBR,Selangor,26155,15188,10967
2024-02-01,GBR,W.P. Labuan,116,73,43
2024-02-01,GEO,Johor,4,3,1
2024-02-01,GEO,Kedah,7,3,4
2024-02-01,GEO,Pulau Pinang,1,1,0
2024-02-01,GEO,Sabah,2,0,2
2024-02-01,GEO,Selangor,73,37,36
2024-02-01,GHA,Johor,7,6,1
2024-02-01,GHA,Pulau Pinang,1,1,0
2024-02-01,GHA,Sabah,2,1,1
2024-02-01,GHA,Selangor,86,60,26
2024-02-01,GIN,Johor,7,4,3
2024-02-01,GIN,Selangor,71,52,19
2024-02-01,GMB,Johor,3,2,1
2024-02-01,GMB,Sabah,1,1,0
2024-02-01,GMB,Selangor,24,16,8
2024-02-01,GNQ,Selangor,2,1,1
2024-02-01,GRC,Johor,55,35,20
2024-02-01,GRC,Kedah,38,19,19
2024-02-01,GRC,Perak,2,2,0
2024-02-01,GRC,Perlis,5,4,1
2024-02-01,GRC,Pulau Pinang,19,8,11
2024-02-01,GRC,Sabah,8,5,3
2024-02-01,GRC,Sarawak,4,1,3
2024-02-01,GRC,Selangor,331,212,119
2024-02-01,GRD,Johor,7,4,3
2024-02-01,GRD,Pulau Pinang,1,1,0
2024-02-01,GRD,Selangor,3,2,1
2024-02-01,GRL,Johor,1,0,1
2024-02-01,GTM,Johor,9,7,2
2024-02-01,GTM,Pulau Pinang,2,0,2
2024-02-01,GTM,Selangor,18,11,7
2024-02-01,GUY,Johor,4,3,1
2024-02-01,GUY,Sabah,1,1,0
2024-02-01,GUY,Selangor,8,4,4
2024-02-01,HKG,Johor,17,11,6
2024-02-01,HKG,Pahang,1,0,1
2024-02-01,HKG,Perak,20,12,8
2024-02-01,HKG,Pulau Pinang,2,2,0
2024-02-01,HKG,Sabah,1141,504,637
2024-02-01,HKG,Selangor,380,188,192
2024-02-01,HND,Johor,6,4,2
2024-02-01,HND,Sabah,2,0,2
2024-02-01,HND,Selangor,17,8,9
2024-02-01,HRV,Johor,29,22,7
2024-02-01,HRV,Kedah,9,7,2
2024-02-01,HRV,Perlis,2,1,1
2024-02-01,HRV,Pulau Pinang,7,5,2
2024-02-01,HRV,Sabah,6,4,2
2024-02-01,HRV,Selangor,257,139,118
2024-02-01,HTI,Sabah,1,1,0
2024-02-01,HTI,Selangor,8,7,1
2024-02-01,HUN,Johor,142,82,60
2024-02-01,HUN,Kedah,157,77,80
2024-02-01,HUN,Kelantan,1,1,0
2024-02-01,HUN,Perak,1,1,0
2024-02-01,HUN,Perlis,18,10,8
2024-02-01,HUN,Pulau Pinang,49,22,27
2024-02-01,HUN,Sabah,40,19,21
2024-02-01,HUN,Sarawak,55,25,30
2024-02-01,HUN,Selangor,1051,581,470
2024-02-01,HUN,W.P. Labuan,1,0,1
2024-02-01,IDN,Johor,94247,42469,51778
2024-02-01,IDN,Kedah,6860,2604,4256
2024-02-01,IDN,Kelantan,180,101,79
2024-02-01,IDN,Melaka,3199,1425,1774
2024-02-01,IDN,Negeri Sembilan,4386,2547,1839
2024-02-01,IDN,Pahang,17,4,13
2024-02-01,IDN,Perak,242,63,179
2024-02-01,IDN,Perlis,806,248,558
2024-02-01,IDN,Pulau Pinang,35586,14042,21544
2024-02-01,IDN,Sabah,4787,2293,2494
2024-02-01,IDN,Sarawak,40468,20489,19979
2024-02-01,IDN,Selangor,142789,65413,77376
2024-02-01,IDN,Terengganu,1,1,0
2024-02-01,IDN,W.P. Labuan,57,27,30
2024-02-01,IND,Johor,30844,22017,8827
2024-02-01,IND,Kedah,1229,747,482
2024-02-01,IND,Kelantan,14,10,4
2024-02-01,IND,Melaka,2,2,0
2024-02-01,IND,Negeri Sembilan,2,2,0
2024-02-01,IND,Pahang,5,3,2
2024-02-01,IND,Perak,190,140,50
2024-02-01,IND,Perlis,93,76,17
2024-02-01,IND,Pulau Pinang,964,683,281
2024-02-01,IND,Sabah,186,123,63
2024-02-01,IND,Sarawak,2755,2150,605
2024-02-01,IND,Selangor,53318,36675,16643
2024-02-01,IND,Terengganu,2,1,1
2024-02-01,IND,W.P. Labuan,141,101,40
2024-02-01,IOT,Selangor,1,0,1
2024-02-01,IRL,Johor,287,173,114
2024-02-01,IRL,Kedah,127,66,61
2024-02-01,IRL,Kelantan,1,1,0
2024-02-01,IRL,Perak,9,3,6
2024-02-01,IRL,Perlis,19,12,7
2024-02-01,IRL,Pulau Pinang,163,111,52
2024-02-01,IRL,Sabah,27,16,11
2024-02-01,IRL,Sarawak,36,17,19
2024-02-01,IRL,Selangor,1532,894,638
2024-02-01,IRL,W.P. Labuan,6,5,1
2024-02-01,IRN,Johor,362,164,198
2024-02-01,IRN,Kedah,6,2,4
2024-02-01,IRN,Kelantan,4,3,1
2024-02-01,IRN,Pulau Pinang,10,6,4
2024-02-01,IRN,Sabah,5,2,3
2024-02-01,IRN,Sarawak,1,1,0
2024-02-01,IRN,Selangor,1754,896,858
2024-02-01,IRQ,Johor,45,25,20
2024-02-01,IRQ,Kelantan,2,1,1
2024-02-01,IRQ,Perlis,2,2,0
2024-02-01,IRQ,Pulau Pinang,2,1,1
2024-02-01,IRQ,Sarawak,10,6,4
2024-02-01,IRQ,Selangor,1755,1117,638
2024-02-01,ISL,Johor,2,2,0
2024-02-01,ISL,Kedah,6,4,2
2024-02-01,ISL,Pulau Pinang,3,2,1
2024-02-01,ISL,Sabah,3,2,1
2024-02-01,ISL,Selangor,41,22,19
2024-02-01,ISR,Selangor,1,1,0
2024-02-01,ITA,Johor,580,373,207
2024-02-01,ITA,Kedah,838,450,388
2024-02-01,ITA,Kelantan,4,3,1
2024-02-01,ITA,Melaka,3,2,1
2024-02-01,ITA,Negeri Sembilan,1,1,0
2024-02-01,ITA,Pahang,2,2,0
2024-02-01,ITA,Perak,5,5,0
2024-02-01,ITA,Perlis,58,43,15
2024-02-01,ITA,Pulau Pinang,149,107,42
2024-02-01,ITA,Sabah,63,45,18
2024-02-01,ITA,Sarawak,61,41,20
2024-02-01,ITA,Selangor,3972,2480,1492
2024-02-01,ITA,Terengganu,2,1,1
2024-02-01,ITA,W.P. Labuan,3,2,1
2024-02-01,JAM,Johor,10,3,7
2024-02-01,JAM,Kedah,1,1,0
2024-02-01,JAM,Pulau Pinang,2,0,2
2024-02-01,JAM,Sabah,1,0,1
2024-02-01,JAM,Selangor,50,18,32
2024-02-01,JOR,Johor,29,23,6
2024-02-01,JOR,Kedah,12,6,6
2024-02-01,JOR,Perak,1,0,1
2024-02-01,JOR,Pulau Pinang,10,5,5
2024-02-01,JOR,Sabah,2,2,0
2024-02-01,JOR,Selangor,761,475,286
2024-02-01,JPN,Johor,5913,3749,2164
2024-02-01,JPN,Kedah,509,259,250
2024-02-01,JPN,Kelantan,17,12,5
2024-02-01,JPN,Pahang,8,4,4
2024-02-01,JPN,Perak,64,37,27
2024-02-01,JPN,Perlis,166,123,43
2024-02-01,JPN,Pulau Pinang,1607,1020,587
2024-02-01,JPN,Sabah,632,328,304
2024-02-01,JPN,Sarawak,210,129,81
2024-02-01,JPN,Selangor,22366,13330,9036
2024-02-01,JPN,Terengganu,3,3,0
2024-02-01,JPN,W.P. Labuan,23,12,11
2024-02-01,KAZ,Johor,53,17,36
2024-02-01,KAZ,Kedah,32,11,21
2024-02-01,KAZ,Kelantan,1,1,0
2024-02-01,KAZ,Perlis,6,4,2
2024-02-01,KAZ,Pulau Pinang,14,7,7
2024-02-01,KAZ,Sabah,5,3,2
2024-02-01,KAZ,Sarawak,15,10,5
2024-02-01,KAZ,Selangor,1524,654,870
2024-02-01,KAZ,W.P. Labuan,1,1,0
2024-02-01,KEN,Johor,28,14,14
2024-02-01,KEN,Kedah,4,4,0
2024-02-01,KEN,Perlis,2,0,2
2024-02-01,KEN,Pulau Pinang,24,9,15
2024-02-01,KEN,Sabah,6,2,4
2024-02-01,KEN,Sarawak,3,2,1
2024-02-01,KEN,Selangor,343,202,141
2024-02-01,KGZ,Johor,40,27,13
2024-02-01,KGZ,Kedah,4,3,1
2024-02-01,KGZ,Pulau Pinang,3,0,3
2024-02-01,KGZ,Sabah,2,1,1
2024-02-01,KGZ,Selangor,374,176,198
2024-02-01,KHM,Johor,1442,614,828
2024-02-01,KHM,Kedah,299,235,64
2024-02-01,KHM,Kelantan,1379,1223,156
2024-02-01,KHM,Perak,7,6,1
2024-02-01,KHM,Perlis,1021,753,268
2024-02-01,KHM,Pulau Pinang,30,5,25
2024-02-01,KHM,Sabah,2,0,2
2024-02-01,KHM,Sarawak,4,1,3
2024-02-01,KHM,Selangor,3187,1500,1687
2024-02-01,KIR,Johor,5,2,3
2024-02-01,KNA,Johor,18,11,7
2024-02-01,KNA,Kedah,4,2,2
2024-02-01,KNA,Pulau Pinang,1,1,0
2024-02-01,KNA,Sarawak,1,1,0
2024-02-01,KNA,Selangor,62,43,19
2024-02-01,KOR,Johor,14699,7432,7267
2024-02-01,KOR,Kedah,412,178,234
2024-02-01,KOR,Kelantan,7,5,2
2024-02-01,KOR,Melaka,2,1,1
2024-02-01,KOR,Negeri Sembilan,1,0,1
2024-02-01,KOR,Pahang,2,0,2
2024-02-01,KOR,Perak,31,11,20
2024-02-01,KOR,Perlis,62,49,13
2024-02-01,KOR,Pulau Pinang,614,341,273
2024-02-01,KOR,Sabah,16079,6940,9139
2024-02-01,KOR,Sarawak,305,164,141
2024-02-01,KOR,Selangor,18849,10064,8785
2024-02-01,KOR,W.P. Labuan,23,18,5
2024-02-01,KWT,Johor,6,2,4
2024-02-01,KWT,Kedah,4,2,2
2024-02-01,KWT,Kelantan,1,1,0
2024-02-01,KWT,Perlis,1,1,0
2024-02-01,KWT,Pulau Pinang,4,2,2
2024-02-01,KWT,Sarawak,1,1,0
2024-02-01,KWT,Selangor,393,253,140
2024-02-01,KWT,W.P. Labuan,1,1,0
2024-02-01,LAO,Johor,133,28,105
2024-02-01,LAO,Kedah,1228,96,1132
2024-02-01,LAO,Kelantan,1075,971,104
2024-02-01,LAO,Perak,37,1,36
2024-02-01,LAO,Perlis,522,83,439
2024-02-01,LAO,Pulau Pinang,18,2,16
2024-02-01,LAO,Sarawak,16,7,9
2024-02-01,LAO,Selangor,259,98,161
2024-02-01,LBN,Johor,27,21,6
2024-02-01,LBN,Kedah,7,3,4
2024-02-01,LBN,Pulau Pinang,4,3,1
2024-02-01,LBN,Sabah,4,4,0
2024-02-01,LBN,Sarawak,7,7,0
2024-02-01,LBN,Selangor,324,203,121
2024-02-01,LBR,Selangor,6,5,1
2024-02-01,LBY,Johor,9,6,3
2024-02-01,LBY,Kedah,3,3,0
2024-02-01,LBY,Pulau Pinang,1,1,0
2024-02-01,LBY,Selangor,264,190,74
2024-02-01,LCA,Johor,2,2,0
2024-02-01,LCA,Pulau Pinang,1,1,0
2024-02-01,LCA,Selangor,16,11,5
2024-02-01,LIE,Johor,2,1,1
2024-02-01,LIE,Selangor,2,2,0
2024-02-01,LKA,Johor,688,442,246
2024-02-01,LKA,Kedah,16,14,2
2024-02-01,LKA,Melaka,1,1,0
2024-02-01,LKA,Perak,5,3,2
2024-02-01,LKA,Perlis,1,1,0
2024-02-01,LKA,Pulau Pinang,31,20,11
2024-02-01,LKA,Sabah,5,3,2
2024-02-01,LKA,Sarawak,24,15,9
2024-02-01,LKA,Selangor,3784,2425,1359
2024-02-01,LSO,Selangor,7,4,3
2024-02-01,LTU,Johor,123,55,68
2024-02-01,LTU,Kedah,194,90,104
2024-02-01,LTU,Kelantan,1,1,0
2024-02-01,LTU,Perlis,14,6,8
2024-02-01,LTU,Pulau Pinang,35,14,21
2024-02-01,LTU,Sabah,19,10,9
2024-02-01,LTU,Sarawak,10,4,6
2024-02-01,LTU,Selangor,1510,697,813
2024-02-01,LTU,W.P. Labuan,31,11,20
2024-02-01,LUX,Johor,19,13,6
2024-02-01,LUX,Kedah,9,5,4
2024-02-01,LUX,Pulau Pinang,4,4,0
2024-02-01,LUX,Sabah,5,2,3
2024-02-01,LUX,Sarawak,3,2,1
2024-02-01,LUX,Selangor,56,31,25
2024-02-01,LVA,Johor,60,25,35
2024-02-01,LVA,Kedah,62,25,37
2024-02-01,LVA,Perlis,2,1,1
2024-02-01,LVA,Pulau Pinang,6,3,3
2024-02-01,LVA,Sabah,36,7,29
2024-02-01,LVA,Sarawak,53,19,34
2024-02-01,LVA,Selangor,346,172,174
2024-02-01,MAC,Johor,1,0,1
2024-02-01,MAC,Perak,2,2,0
2024-02-01,MAC,Selangor,18,7,11
2024-02-01,MAR,Johor,69,42,27
2024-02-01,MAR,Kedah,17,10,7
2024-02-01,MAR,Kelantan,1,1,0
2024-02-01,MAR,Perlis,1,1,0
2024-02-01,MAR,Pulau Pinang,11,7,4
2024-02-01,MAR,Sabah,2,2,0
2024-02-01,MAR,Sarawak,9,6,3
2024-02-01,MAR,Selangor,1079,615,464
2024-02-01,MCO,Pulau Pinang,1,1,0
2024-02-01,MCO,Selangor,7,4,3
2024-02-01,MDA,Johor,5,2,3
2024-02-01,MDA,Kedah,5,1,4
2024-02-01,MDA,Sarawak,2,0,2
2024-02-01,MDA,Selangor,37,15,22
2024-02-01,MDG,Johor,14,6,8
2024-02-01,MDG,Kedah,1,1,0
2024-02-01,MDG,Selangor,48,24,24
2024-02-01,MDV,Johor,153,70,83
2024-02-01,MDV,Kedah,2,2,0
2024-02-01,MDV,Sabah,1,1,0
2024-02-01,MDV,Sarawak,5,1,4
2024-02-01,MDV,Selangor,2466,1338,1128
2024-02-01,MEX,Johor,153,76,77
2024-02-01,MEX,Kedah,8,2,6
2024-02-01,MEX,Kelantan,1,0,1
2024-02-01,MEX,Perlis,2,1,1
2024-02-01,MEX,Pulau Pinang,24,23,1
2024-02-01,MEX,Sabah,11,6,5
2024-02-01,MEX,Sarawak,4,3,1
2024-02-01,MEX,Selangor,650,319,331
2024-02-01,MHL,Johor,1,1,0
2024-02-01,MHL,Selangor,7,6,1
2024-02-01,MKD,Johor,9,6,3
2024-02-01,MKD,Kedah,7,4,3
2024-02-01,MKD,Selangor,61,25,36
2024-02-01,MLI,Selangor,22,16,6
2024-02-01,MLT,Johor,3,1,2
2024-02-01,MLT,Kedah,2,1,1
2024-02-01,MLT,Perlis,1,1,0
2024-02-01,MLT,Selangor,51,31,20
2024-02-01,MMR,Johor,6855,2155,4700
2024-02-01,MMR,Kedah,107,24,83
2024-02-01,MMR,Kelantan,4,2,2
2024-02-01,MMR,Melaka,1,0,1
2024-02-01,MMR,Negeri Sembilan,1,1,0
2024-02-01,MMR,Pahang,3,2,1
2024-02-01,MMR,Perak,32,5,27
2024-02-01,MMR,Perlis,14,1,13
2024-02-01,MMR,Pulau Pinang,379,184,195
2024-02-01,MMR,Sabah,26,5,21
2024-02-01,MMR,Sarawak,107,44,63
2024-02-01,MMR,Selangor,5438,3506,1932
2024-02-01,MMR,W.P. Labuan,7,1,6
2024-02-01,MNE,Pulau Pinang,1,1,0
2024-02-01,MNE,Selangor,19,14,5
2024-02-01,MNG,Johor,282,118,164
2024-02-01,MNG,Kedah,6,3,3
2024-02-01,MNG,Perak,1,0,1
2024-02-01,MNG,Perlis,2,0,2
2024-02-01,MNG,Pulau Pinang,3,1,2
2024-02-01,MNG,Sabah,5,0,5
2024-02-01,MNG,Selangor,407,179,228
2024-02-01,MOZ,Selangor,23,9,14
2024-02-01,MRT,Johor,3,2,1
2024-02-01,MRT,Sabah,1,1,0
2024-02-01,MRT,Selangor,28,19,9
2024-02-01,MUS,Johor,115,59,56
2024-02-01,MUS,Kedah,5,4,1
2024-02-01,MUS,Kelantan,3,2,1
2024-02-01,MUS,Pulau Pinang,3,1,2
2024-02-01,MUS,Sarawak,3,1,2
2024-02-01,MUS,Selangor,1476,732,744
2024-02-01,MWI,Pulau Pinang,1,0,1
2024-02-01,MWI,Sabah,1,1,0
2024-02-01,MWI,Sarawak,1,0,1
2024-02-01,MWI,Selangor,18,9,9
2024-02-01,NAM,Selangor,12,7,5
2024-02-01,NCL,Selangor,1,1,0
2024-02-01,NER,Johor,4,4,0
2024-02-01,NER,Selangor,3,3,0
2024-02-01,NGA,Johor,23,19,4
2024-02-01,NGA,Kedah,2,2,0
2024-02-01,NGA,Kelantan,3,2,1
2024-02-01,NGA,Pulau Pinang,4,3,1
2024-02-01,NGA,Sabah,1,1,0
2024-02-01,NGA,Sarawak,18,14,4
2024-02-01,NGA,Selangor,363,294,69
2024-02-01,NIC,Johor,2,1,1
2024-02-01,NIC,Selangor,11,4,7
2024-02-01,NLD,Johor,1028,687,341
2024-02-01,NLD,Kedah,548,297,251
2024-02-01,NLD,Kelantan,9,6,3
2024-02-01,NLD,Melaka,1,1,0
2024-02-01,NLD,Negeri Sembilan,1,1,0
2024-02-01,NLD,Perak,17,10,7
2024-02-01,NLD,Perlis,70,46,24
2024-02-01,NLD,Pulau Pinang,329,206,123
2024-02-01,NLD,Sabah,76,43,33
2024-02-01,NLD,Sarawak,139,86,53
2024-02-01,NLD,Selangor,4942,2834,2108
2024-02-01,NLD,W.P. Labuan,10,7,3
2024-02-01,NOR,Johor,199,117,82
2024-02-01,NOR,Kedah,193,77,116
2024-02-01,NOR,Perak,2,0,2
2024-02-01,NOR,Perlis,23,11,12
2024-02-01,NOR,Pulau Pinang,62,34,28
2024-02-01,NOR,Sabah,8,6,2
2024-02-01,NOR,Sarawak,17,13,4
2024-02-01,NOR,Selangor,1112,608,504
2024-02-01,NOR,W.P. Labuan,1,1,0
2024-02-01,NPL,Johor,1336,1028,308
2024-02-01,NPL,Kedah,16,14,2
2024-02-01,NPL,Kelantan,1,1,0
2024-02-01,NPL,Perlis,2,2,0
2024-02-01,NPL,Pulau Pinang,44,41,3
2024-02-01,NPL,Sabah,1,1,0
2024-02-01,NPL,Sarawak,196,134,62
2024-02-01,NPL,Selangor,7542,6998,544
2024-02-01,NPL,W.P. Labuan,91,77,14
2024-02-01,NRU,Selangor,1,1,0
2024-02-01,NZL,Johor,809,468,341
2024-02-01,NZL,Kedah,79,46,33
2024-02-01,NZL,Kelantan,4,3,1
2024-02-01,NZL,Melaka,2,1,1
2024-02-01,NZL,Perak,17,10,7
2024-02-01,NZL,Perlis,17,9,8
2024-02-01,NZL,Pulau Pinang,184,101,83
2024-02-01,NZL,Sabah,75,44,31
2024-02-01,NZL,Sarawak,110,62,48
2024-02-01,NZL,Selangor,2534,1536,998
2024-02-01,NZL,Terengganu,2,1,1
2024-02-01,NZL,W.P. Labuan,6,3,3
2024-02-01,OMN,Johor,30,20,10
2024-02-01,OMN,Kedah,9,7,2
2024-02-01,OMN,Perak,2,1,1
2024-02-01,OMN,Perlis,7,5,2
2024-02-01,OMN,Sarawak,16,9,7
2024-02-01,OMN,Selangor,1168,709,459
2024-02-01,PAK,Johor,721,558,163
2024-02-01,PAK,Kedah,122,101,21
2024-02-01,PAK,Kelantan,25,24,1
2024-02-01,PAK,Perak,3,1,2
2024-02-01,PAK,Perlis,25,22,3
2024-02-01,PAK,Pulau Pinang,107,101,6
2024-02-01,PAK,Sabah,18,15,3
2024-02-01,PAK,Sarawak,116,90,26
2024-02-01,PAK,Selangor,10478,8760,1718
2024-02-01,PAK,W.P. Labuan,4,3,1
2024-02-01,PAN,Johor,8,5,3
2024-02-01,PAN,Kedah,2,1,1
2024-02-01,PAN,Pulau Pinang,3,2,1
2024-02-01,PAN,Selangor,45,15,30
2024-02-01,PER,Johor,42,22,20
2024-02-01,PER,Kedah,3,3,0
2024-02-01,PER,Perlis,4,3,1
2024-02-01,PER,Pulau Pinang,3,2,1
2024-02-01,PER,Sarawak,3,1,2
2024-02-01,PER,Selangor,139,65,74
2024-02-01,PHL,Johor,20285,5943,14342
2024-02-01,PHL,Kedah,448,122,326
2024-02-01,PHL,Kelantan,16,7,9
2024-02-01,PHL,Melaka,1,0,1
2024-02-01,PHL,Negeri Sembilan,2,2,0
2024-02-01,PHL,Pahang,19,16,3
2024-02-01,PHL,Perak,49,10,39
2024-02-01,PHL,Perlis,283,86,197
2024-02-01,PHL,Pulau Pinang,633,242,391
2024-02-01,PHL,Sabah,1445,584,861
2024-02-01,PHL,Sarawak,3229,1334,1895
2024-02-01,PHL,Selangor,14564,5668,8896
2024-02-01,PHL,Terengganu,2,0,2
2024-02-01,PHL,W.P. Labuan,111,47,64
2024-02-01,PNG,Johor,17,5,12
2024-02-01,PNG,Perak,1,1,0
2024-02-01,PNG,Pulau Pinang,1,1,0
2024-02-01,PNG,Sarawak,10,5,5
2024-02-01,PNG,Selangor,88,51,37
2024-02-01,POL,Johor,943,486,457
2024-02-01,POL,Kedah,601,299,302
2024-02-01,POL,Kelantan,11,6,5
2024-02-01,POL,Melaka,1,1,0
2024-02-01,POL,Perak,1,0,1
2024-02-01,POL,Perlis,49,28,21
2024-02-01,POL,Pulau Pinang,110,56,54
2024-02-01,POL,Sabah,110,49,61
2024-02-01,POL,Sarawak,47,27,20
2024-02-01,POL,Selangor,2980,1499,1481
2024-02-01,POL,W.P. Labuan,3,3,0
2024-02-01,PRT,Johor,281,152,129
2024-02-01,PRT,Kedah,124,63,61
2024-02-01,PRT,Kelantan,1,1,0
2024-02-01,PRT,Perak,1,1,0
2024-02-01,PRT,Perlis,6,3,3
2024-02-01,PRT,Pulau Pinang,55,29,26
2024-02-01,PRT,Sabah,20,11,9
2024-02-01,PRT,Sarawak,9,6,3
2024-02-01,PRT,Selangor,811,435,376
2024-02-01,PRY,Johor,5,1,4
2024-02-01,PRY,Perlis,1,0,1
2024-02-01,PRY,Pulau Pinang,2,1,1
2024-02-01,PRY,Selangor,12,5,7
2024-02-01,PSE,Johor,14,14,0
2024-02-01,PSE,Kedah,2,1,1
2024-02-01,PSE,Sarawak,2,2,0
2024-02-01,PSE,Selangor,272,193,79
2024-02-01,QAT,Johor,5,5,0
2024-02-01,QAT,Kedah,1,1,0
2024-02-01,QAT,Selangor,150,121,29
2024-02-01,ROU,Johor,145,94,51
2024-02-01,ROU,Kedah,92,42,50
2024-02-01,ROU,Perak,1,0,1
2024-02-01,ROU,Perlis,4,3,1
2024-02-01,ROU,Pulau Pinang,36,19,17
2024-02-01,ROU,Sabah,16,13,3
2024-02-01,ROU,Sarawak,10,8,2
2024-02-01,ROU,Selangor,1226,603,623
2024-02-01,RUS,Johor,409,201,208
2024-02-01,RUS,Kedah,690,329,361
2024-02-01,RUS,Kelantan,29,11,18
2024-02-01,RUS,Melaka,1,1,0
2024-02-01,RUS,Perak,3,1,2
2024-02-01,RUS,Perlis,114,64,50
2024-02-01,RUS,Pulau Pinang,204,101,103
2024-02-01,RUS,Sabah,76,40,36
2024-02-01,RUS,Sarawak,75,40,35
2024-02-01,RUS,Selangor,12209,5796,6413
2024-02-01,RUS,W.P. Labuan,5,3,2
2024-02-01,RWA,Selangor,6,3,3
2024-02-01,SAU,Johor,202,124,78
2024-02-01,SAU,Kedah,57,32,25
2024-02-01,SAU,Kelantan,3,2,1
2024-02-01,SAU,Perlis,8,4,4
2024-02-01,SAU,Pulau Pinang,37,23,14
2024-02-01,SAU,Sarawak,24,14,10
2024-02-01,SAU,Selangor,4286,2428,1858
2024-02-01,SDN,Johor,11,5,6
2024-02-01,SDN,Kedah,6,3,3
2024-02-01,SDN,Pulau Pinang,12,4,8
2024-02-01,SDN,Sabah,2,2,0
2024-02-01,SDN,Sarawak,1,1,0
2024-02-01,SDN,Selangor,1077,607,470
2024-02-01,SDN,W.P. Labuan,1,1,0
2024-02-01,SEN,Johor,6,5,1
2024-02-01,SEN,Sabah,1,1,0
2024-02-01,SEN,Selangor,73,51,22
2024-02-01,SGP,Johor,1069298,614417,454881
2024-02-01,SGP,Kedah,3712,2013,1699
2024-02-01,SGP,Kelantan,155,80,75
2024-02-01,SGP,Melaka,25,14,11
2024-02-01,SGP,Negeri Sembilan,1,1,0
2024-02-01,SGP,Pahang,511,250,261
2024-02-01,SGP,Perak,5490,2694,2796
2024-02-01,SGP,Perlis,266,166,100
2024-02-01,SGP,Pulau Pinang,15992,8254,7738
2024-02-01,SGP,Sabah,2383,1215,1168
2024-02-01,SGP,Sarawak,4161,2212,1949
2024-02-01,SGP,Selangor,44117,23037,21080
2024-02-01,SGP,W.P. Labuan,14,10,4
2024-02-01,SLB,Johor,3,2,1
2024-02-01,SLB,Pulau Pinang,1,0,1
2024-02-01,SLB,Sarawak,6,1,5
2024-02-01,SLB,Selangor,10,6,4
2024-02-01,SLE,Johor,4,3,1
2024-02-01,SLE,Kedah,1,1,0
2024-02-01,SLE,Selangor,15,13,2
2024-02-01,SLV,Johor,8,5,3
2024-02-01,SLV,Sarawak,1,1,0
2024-02-01,SLV,Selangor,12,9,3
2024-02-01,SMR,Selangor,6,4,2
2024-02-01,SOM,Johor,3,3,0
2024-02-01,SOM,Kelantan,1,1,0
2024-02-01,SOM,Selangor,265,145,120
2024-02-01,SRB,Johor,13,9,4
2024-02-01,SRB,Kedah,10,4,6
2024-02-01,SRB,Perlis,1,0,1
2024-02-01,SRB,Pulau Pinang,14,13,1
2024-02-01,SRB,Sabah,2,1,1
2024-02-01,SRB,Selangor,181,87,94
2024-02-01,SSD,Sarawak,3,1,2
2024-02-01,SSD,Selangor,40,29,11
2024-02-01,SUR,Pulau Pinang,1,1,0
2024-02-01,SUR,Selangor,13,7,6
2024-02-01,SVK,Johor,51,33,18
2024-02-01,SVK,Kedah,185,92,93
2024-02-01,SVK,Pahang,1,0,1
2024-02-01,SVK,Perlis,2,1,1
2024-02-01,SVK,Pulau Pinang,28,20,8
2024-02-01,SVK,Sabah,12,5,7
2024-02-01,SVK,Sarawak,4,2,2
2024-02-01,SVK,Selangor,641,350,291
2024-02-01,SVK,W.P. Labuan,1,1,0
2024-02-01,SVN,Johor,26,15,11
2024-02-01,SVN,Kedah,75,40,35
2024-02-01,SVN,Perlis,1,1,0
2024-02-01,SVN,Pulau Pinang,7,5,2
2024-02-01,SVN,Sabah,3,1,2
2024-02-01,SVN,Selangor,387,215,172
2024-02-01,SWE,Johor,336,184,152
2024-02-01,SWE,Kedah,539,235,304
2024-02-01,SWE,Kelantan,12,10,2
2024-02-01,SWE,Melaka,1,0,1
2024-02-01,SWE,Perak,4,2,2
2024-02-01,SWE,Perlis,28,19,9
2024-02-01,SWE,Pulau Pinang,110,67,43
2024-02-01,SWE,Sabah,46,30,16
2024-02-01,SWE,Sarawak,8,7,1
2024-02-01,SWE,Selangor,1928,1050,878
2024-02-01,SWZ,Johor,3,1,2
2024-02-01,SWZ,Selangor,13,5,8
2024-02-01,SYC,Johor,13,2,11
2024-02-01,SYC,Selangor,88,32,56
2024-02-01,SYR,Johor,22,14,8
2024-02-01,SYR,Kedah,8,5,3
2024-02-01,SYR,Pulau Pinang,15,12,3
2024-02-01,SYR,Sabah,1,1,0
2024-02-01,SYR,Sarawak,1,1,0
2024-02-01,SYR,Selangor,737,472,265
2024-02-01,TCA,Selangor,1,0,1
2024-02-01,TCD,Johor,5,4,1
2024-02-01,TCD,Selangor,30,23,7
2024-02-01,TGO,Selangor,5,2,3
2024-02-01,THA,Johor,6228,1632,4596
2024-02-01,THA,Kedah,63910,37844,26066
2024-02-01,THA,Kelantan,52876,26261,26615
2024-02-01,THA,Pahang,2,0,2
2024-02-01,THA,Perak,11982,5506,6476
2024-02-01,THA,Perlis,52916,30639,22277
2024-02-01,THA,Pulau Pinang,2123,735,1388
2024-02-01,THA,Sabah,58,16,42
2024-02-01,THA,Sarawak,479,148,331
2024-02-01,THA,Selangor,12217,4642,7575
2024-02-01,THA,W.P. Labuan,8,4,4
2024-02-01,TJK,Johor,2,1,1
2024-02-01,TJK,Kedah,4,2,2
2024-02-01,TJK,Pulau Pinang,1,1,0
2024-02-01,TJK,Sabah,5,3,2
2024-02-01,TJK,Selangor,218,149,69
2024-02-01,TKM,Johor,5,5,0
2024-02-01,TKM,Kedah,1,0,1
2024-02-01,TKM,Sarawak,1,1,0
2024-02-01,TKM,Selangor,541,322,219
2024-02-01,TLS,Johor,13,6,7
2024-02-01,TLS,Pulau Pinang,5,3,2
2024-02-01,TLS,Sarawak,1,0,1
2024-02-01,TLS,Selangor,186,110,76
2024-02-01,TON,Johor,1,1,0
2024-02-01,TON,Pulau Pinang,1,1,0
2024-02-01,TON,Sabah,1,0,1
2024-02-01,TON,Selangor,18,14,4
2024-02-01,TTO,Johor,2,1,1
2024-02-01,TTO,Kedah,3,0,3
2024-02-01,TTO,Pulau Pinang,3,1,2
2024-02-01,TTO,Selangor,46,28,18
2024-02-01,TUN,Johor,12,7,5
2024-02-01,TUN,Kedah,9,8,1
2024-02-01,TUN,Melaka,2,0,2
2024-02-01,TUN,Pulau Pinang,13,8,5
2024-02-01,TUN,Sabah,1,1,0
2024-02-01,TUN,Sarawak,1,1,0
2024-02-01,TUN,Selangor,723,380,343
2024-02-01,TUR,Johor,349,235,114
2024-02-01,TUR,Kedah,70,44,26
2024-02-01,TUR,Kelantan,5,3,2
2024-02-01,TUR,Pahang,2,2,0
2024-02-01,TUR,Perak,1,1,0
2024-02-01,TUR,Perlis,27,21,6
2024-02-01,TUR,Pulau Pinang,34,26,8
2024-02-01,TUR,Sabah,8,6,2
2024-02-01,TUR,Sarawak,29,24,5
2024-02-01,TUR,Selangor,2033,1392,641
2024-02-01,TUR,Terengganu,1,1,0
2024-02-01,TWN,Johor,7987,3561,4426
2024-02-01,TWN,Kedah,350,160,190
2024-02-01,TWN,Kelantan,4,0,4
2024-02-01,TWN,Melaka,5,2,3
2024-02-01,TWN,Pahang,7,2,5
2024-02-01,TWN,Perak,97,57,40
2024-02-01,TWN,Perlis,50,22,28
2024-02-01,TWN,Pulau Pinang,4226,2064,2162
2024-02-01,TWN,Sabah,2958,1358,1600
2024-02-01,TWN,Sarawak,512,198,314
2024-02-01,TWN,Selangor,18869,9041,9828
2024-02-01,TWN,W.P. Labuan,3,2,1
2024-02-01,TZA,Johor,30,9,21
2024-02-01,TZA,Kedah,1,0,1
2024-02-01,TZA,Sabah,3,3,0
2024-02-01,TZA,Sarawak,2,2,0
2024-02-01,TZA,Selangor,201,104,97
2024-02-01,UGA,Johor,22,11,11
2024-02-01,UGA,Pahang,1,0,1
2024-02-01,UGA,Perlis,1,1,0
2024-02-01,UGA,Pulau Pinang,1,0,1
2024-02-01,UGA,Sarawak,2,1,1
2024-02-01,UGA,Selangor,99,38,61
2024-02-01,UKR,Johor,124,52,72
2024-02-01,UKR,Kedah,75,30,45
2024-02-01,UKR,Kelantan,29,14,15
2024-02-01,UKR,Pahang,3,3,0
2024-02-01,UKR,Perlis,21,9,12
2024-02-01,UKR,Pulau Pinang,50,20,30
2024-02-01,UKR,Sabah,15,8,7
2024-02-01,UKR,Sarawak,1,1,0
2024-02-01,UKR,Selangor,1411,604,807
2024-02-01,UKR,W.P. Labuan,1,0,1
2024-02-01,URY,Johor,10,7,3
2024-02-01,URY,Kedah,4,3,1
2024-02-01,URY,Perlis,1,0,1
2024-02-01,URY,Sarawak,1,0,1
2024-02-01,URY,Selangor,43,23,20
2024-02-01,USA,Johor,4880,2780,2100
2024-02-01,USA,Kedah,712,397,315
2024-02-01,USA,Kelantan,34,12,22
2024-02-01,USA,Melaka,6,5,1
2024-02-01,USA,Negeri Sembilan,2,2,0
2024-02-01,USA,Pahang,4,4,0
2024-02-01,USA,Perak,146,77,69
2024-02-01,USA,Perlis,157,108,49
2024-02-01,USA,Pulau Pinang,2250,1383,867
2024-02-01,USA,Sabah,505,293,212
2024-02-01,USA,Sarawak,333,161,172
2024-02-01,USA,Selangor,16666,9622,7044
2024-02-01,USA,Terengganu,3,1,2
2024-02-01,USA,W.P. Labuan,12,6,6
2024-02-01,UZB,Johor,68,52,16
2024-02-01,UZB,Kedah,29,18,11
2024-02-01,UZB,Perlis,1,0,1
2024-02-01,UZB,Pulau Pinang,8,5,3
2024-02-01,UZB,Sabah,4,3,1
2024-02-01,UZB,Sarawak,1,0,1
2024-02-01,UZB,Selangor,2049,1304,745
2024-02-01,VAT,Selangor,1,1,0
2024-02-01,VCT,Pulau Pinang,1,1,0
2024-02-01,VCT,Selangor,1,1,0
2024-02-01,VEN,Johor,17,11,6
2024-02-01,VEN,Kedah,2,1,1
2024-02-01,VEN,Pulau Pinang,2,1,1
2024-02-01,VEN,Sabah,2,0,2
2024-02-01,VEN,Sarawak,2,1,1
2024-02-01,VEN,Selangor,98,56,42
2024-02-01,VNM,Johor,11772,3810,7962
2024-02-01,VNM,Kedah,336,56,280
2024-02-01,VNM,Kelantan,18,7,11
2024-02-01,VNM,Pahang,1,0,1
2024-02-01,VNM,Perak,215,8,207
2024-02-01,VNM,Perlis,224,21,203
2024-02-01,VNM,Pulau Pinang,1151,266,885
2024-02-01,VNM,Sabah,25,12,13
2024-02-01,VNM,Sarawak,367,76,291
2024-02-01,VNM,Selangor,18917,6545,12372
2024-02-01,VNM,W.P. Labuan,7,4,3
2024-02-01,VUT,Johor,36,28,8
2024-02-01,VUT,Kedah,2,2,0
2024-02-01,VUT,Pulau Pinang,4,4,0
2024-02-01,VUT,Sabah,1,1,0
2024-02-01,VUT,Sarawak,1,1,0
2024-02-01,VUT,Selangor,106,92,14
2024-02-01,WSM,Selangor,2,1,1
2024-02-01,XXX,Johor,4,3,1
2024-02-01,XXX,Kedah,2,0,2
2024-02-01,XXX,Selangor,62,39,23
2024-02-01,YEM,Johor,39,31,8
2024-02-01,YEM,Kedah,10,8,2
2024-02-01,YEM,Kelantan,1,1,0
2024-02-01,YEM,Melaka,5,3,2
2024-02-01,YEM,Pulau Pinang,12,8,4
2024-02-01,YEM,Sabah,4,3,1
2024-02-01,YEM,Sarawak,9,7,2
2024-02-01,YEM,Selangor,1339,952,387
2024-02-01,ZAF,Johor,221,140,81
2024-02-01,ZAF,Kedah,24,14,10
2024-02-01,ZAF,Kelantan,3,2,1
2024-02-01,ZAF,Perak,3,2,1
2024-02-01,ZAF,Perlis,16,10,6
2024-02-01,ZAF,Pulau Pinang,57,33,24
2024-02-01,ZAF,Sabah,23,11,12
2024-02-01,ZAF,Sarawak,134,62,72
2024-02-01,ZAF,Selangor,1010,571,439
2024-02-01,ZAF,Terengganu,1,1,0
2024-02-01,ZAF,W.P. Labuan,21,6,15
2024-02-01,ZAR,Selangor,2,1,1
2024-02-01,ZMB,Johor,1,1,0
2024-02-01,ZMB,Selangor,42,13,29
2024-02-01,ZWE,Johor,21,2,19
2024-02-01,ZWE,Kedah,3,2,1
2024-02-01,ZWE,Pulau Pinang,9,4,5
2024-02-01,ZWE,Selangor,153,77,76
2024-03-01,AFG,Perlis,2,2,0
2024-03-01,AFG,Pulau Pinang,1,1,0
2024-03-01,AFG,Selangor,44,39,5
2024-03-01,AGO,Selangor,10,4,6
2024-03-01,AIA,Selangor,1,0,1
2024-03-01,ALB,Johor,12,8,4
2024-03-01,ALB,Perak,1,1,0
2024-03-01,ALB,Pulau Pinang,48,14,34
2024-03-01,ALB,Sabah,1,1,0
2024-03-01,ALB,Selangor,40,25,15
2024-03-01,AND,Pulau Pinang,1,1,0
2024-03-01,AND,Selangor,13,7,6
2024-03-01,ARE,Johor,11,5,6
2024-03-01,ARE,Kedah,7,4,3
2024-03-01,ARE,Pulau Pinang,4,3,1
2024-03-01,ARE,Selangor,154,98,56
2024-03-01,ARG,Johor,100,52,48
2024-03-01,ARG,Kedah,85,42,43
2024-03-01,ARG,Kelantan,1,1,0
2024-03-01,ARG,Perlis,7,4,3
2024-03-01,ARG,Pulau Pinang,23,13,10
2024-03-01,ARG,Sabah,9,3,6
2024-03-01,ARG,Sarawak,4,4,0
2024-03-01,ARG,Selangor,538,286,252
2024-03-01,ARM,Johor,2,1,1
2024-03-01,ARM,Kedah,1,0,1
2024-03-01,ARM,Pulau Pinang,2,1,1
2024-03-01,ARM,Sabah,2,0,2
2024-03-01,ARM,Selangor,60,21,39
2024-03-01,ATA,Selangor,1,1,0
2024-03-01,ATG,Johor,1,1,0
2024-03-01,ATG,Pulau Pinang,1,1,0
2024-03-01,ATG,Selangor,10,4,6
2024-03-01,AUS,Johor,5612,3252,2360
2024-03-01,AUS,Kedah,687,380,307
2024-03-01,AUS,Kelantan,10,5,5
2024-03-01,AUS,Melaka,2,2,0
2024-03-01,AUS,Negeri Sembilan,4,3,1
2024-03-01,AUS,Pahang,33,15,18
2024-03-01,AUS,Perak,309,155,154
2024-03-01,AUS,Perlis,78,43,35
2024-03-01,AUS,Pulau Pinang,2709,1374,1335
2024-03-01,AUS,Sabah,518,280,238
2024-03-01,AUS,Sarawak,631,345,286
2024-03-01,AUS,Selangor,23682,13755,9927
2024-03-01,AUS,Terengganu,7,3,4
2024-03-01,AUS,W.P. Labuan,6,4,2
2024-03-01,AUT,Johor,264,182,82
2024-03-01,AUT,Kedah,161,73,88
2024-03-01,AUT,Kelantan,3,3,0
2024-03-01,AUT,Perak,5,3,2
2024-03-01,AUT,Perlis,9,5,4
2024-03-01,AUT,Pulau Pinang,108,79,29
2024-03-01,AUT,Sabah,26,13,13
2024-03-01,AUT,Sarawak,15,10,5
2024-03-01,AUT,Selangor,1013,586,427
2024-03-01,AUT,W.P. Labuan,3,2,1
2024-03-01,AZE,Johor,44,16,28
2024-03-01,AZE,Kedah,20,9,11
2024-03-01,AZE,Pulau Pinang,14,10,4
2024-03-01,AZE,Sarawak,1,0,1
2024-03-01,AZE,Selangor,317,144,173
2024-03-01,AZE,W.P. Labuan,1,0,1
2024-03-01,BDI,Pulau Pinang,1,1,0
2024-03-01,BDI,Selangor,4,4,0
2024-03-01,BEL,Johor,308,170,138
2024-03-01,BEL,Kedah,165,83,82
2024-03-01,BEL,Kelantan,5,0,5
2024-03-01,BEL,Pahang,2,2,0
2024-03-01,BEL,Perak,4,3,1
2024-03-01,BEL,Perlis,19,9,10
2024-03-01,BEL,Pulau Pinang,113,71,42
2024-03-01,BEL,Sabah,24,13,11
2024-03-01,BEL,Sarawak,26,19,7
2024-03-01,BEL,Selangor,1513,923,590
2024-03-01,BEN,Johor,3,2,1
2024-03-01,BEN,Selangor,13,8,5
2024-03-01,BFA,Selangor,1,0,1
2024-03-01,BGD,Johor,1999,1565,434
2024-03-01,BGD,Kedah,69,48,21
2024-03-01,BGD,Kelantan,3,3,0
2024-03-01,BGD,Negeri Sembilan,2,2,0
2024-03-01,BGD,Perak,4,4,0
2024-03-01,BGD,Perlis,2,2,0
2024-03-01,BGD,Pulau Pinang,73,60,13
2024-03-01,BGD,Sabah,3,3,0
2024-03-01,BGD,Sarawak,114,92,22
2024-03-01,BGD,Selangor,24350,22705,1645
2024-03-01,BGD,W.P. Labuan,6,6,0
2024-03-01,BGR,Johor,56,34,22
2024-03-01,BGR,Kedah,20,9,11
2024-03-01,BGR,Kelantan,1,1,0
2024-03-01,BGR,Perlis,1,1,0
2024-03-01,BGR,Pulau Pinang,30,25,5
2024-03-01,BGR,Sabah,1,1,0
2024-03-01,BGR,Sarawak,4,3,1
2024-03-01,BGR,Selangor,476,238,238
2024-03-01,BHR,Johor,6,3,3
2024-03-01,BHR,Kedah,1,1,0
2024-03-01,BHR,Perlis,1,1,0
2024-03-01,BHR,Selangor,29,19,10
2024-03-01,BHS,Selangor,11,7,4
2024-03-01,BIH,Johor,7,4,3
2024-03-01,BIH,Kedah,1,1,0
2024-03-01,BIH,Selangor,51,32,19
2024-03-01,BLR,Johor,10,2,8
2024-03-01,BLR,Kedah,39,17,22
2024-03-01,BLR,Kelantan,3,2,1
2024-03-01,BLR,Pulau Pinang,22,7,15
2024-03-01,BLR,Sabah,9,4,5
2024-03-01,BLR,Selangor,674,323,351
2024-03-01,BLR,W.P. Labuan,1,1,0
2024-03-01,BLZ,Johor,2,2,0
2024-03-01,BLZ,Selangor,9,4,5
2024-03-01,BOL,Johor,1,0,1
2024-03-01,BOL,Sarawak,1,1,0
2024-03-01,BOL,Selangor,18,12,6
2024-03-01,BRA,Johor,287,165,122
2024-03-01,BRA,Kedah,150,76,74
2024-03-01,BRA,Kelantan,1,1,0
2024-03-01,BRA,Pahang,1,0,1
2024-03-01,BRA,Perak,3,1,2
2024-03-01,BRA,Perlis,10,4,6
2024-03-01,BRA,Pulau Pinang,51,29,22
2024-03-01,BRA,Sabah,18,9,9
2024-03-01,BRA,Sarawak,8,5,3
2024-03-01,BRA,Selangor,1148,667,481
2024-03-01,BRB,Selangor,6,2,4
2024-03-01,BRN,Johor,445,210,235
2024-03-01,BRN,Kedah,39,28,11
2024-03-01,BRN,Kelantan,14,7,7
2024-03-01,BRN,Perak,5,2,3
2024-03-01,BRN,Perlis,27,13,14
2024-03-01,BRN,Pulau Pinang,41,15,26
2024-03-01,BRN,Sabah,1043,439,604
2024-03-01,BRN,Sarawak,157523,82638,74885
2024-03-01,BRN,Selangor,6365,2912,3453
2024-03-01,BRN,W.P. Labuan,988,659,329
2024-03-01,BTN,Johor,7,7,0
2024-03-01,BTN,Kedah,3,3,0
2024-03-01,BTN,Pulau Pinang,4,4,0
2024-03-01,BTN,Selangor,53,35,18
2024-03-01,BWA,Selangor,25,11,14
2024-03-01,CAF,Selangor,1,1,0
2024-03-01,CAN,Johor,1949,1046,903
2024-03-01,CAN,Kedah,366,196,170
2024-03-01,CAN,Kelantan,7,5,2
2024-03-01,CAN,Pahang,7,4,3
2024-03-01,CAN,Perak,30,15,15
2024-03-01,CAN,Perlis,47,30,17
2024-03-01,CAN,Pulau Pinang,887,465,422
2024-03-01,CAN,Sabah,253,131,122
2024-03-01,CAN,Sarawak,445,238,207
2024-03-01,CAN,Selangor,5842,3335,2507
2024-03-01,CAN,Terengganu,1,1,0
2024-03-01,CAN,W.P. Labuan,6,3,3
2024-03-01,CHE,Johor,508,316,192
2024-03-01,CHE,Kedah,282,154,128
2024-03-01,CHE,Kelantan,4,1,3
2024-03-01,CHE,Negeri Sembilan,2,1,1
2024-03-01,CHE,Pahang,2,1,1
2024-03-01,CHE,Perak,10,7,3
2024-03-01,CHE,Perlis,31,20,11
2024-03-01,CHE,Pulau Pinang,186,102,84
2024-03-01,CHE,Sabah,69,36,33
2024-03-01,CHE,Sarawak,59,27,32
2024-03-01,CHE,Selangor,1795,1040,755
2024-03-01,CHL,Johor,48,24,24
2024-03-01,CHL,Kedah,23,12,11
2024-03-01,CHL,Kelantan,1,1,0
2024-03-01,CHL,Perlis,2,1,1
2024-03-01,CHL,Pulau Pinang,14,8,6
2024-03-01,CHL,Sabah,4,2,2
2024-03-01,CHL,Selangor,384,168,216
2024-03-01,CHN,Johor,91075,39596,51479
2024-03-01,CHN,Kedah,2101,927,1174
2024-03-01,CHN,Kelantan,12,8,4
2024-03-01,CHN,Melaka,5,5,0
2024-03-01,CHN,Negeri Sembilan,5,5,0
2024-03-01,CHN,Pahang,54,35,19
2024-03-01,CHN,Perak,344,131,213
2024-03-01,CHN,Perlis,444,243,201
2024-03-01,CHN,Pulau Pinang,13137,6529,6608
2024-03-01,CHN,Sabah,18833,7888,10945
2024-03-01,CHN,Sarawak,1693,878,815
2024-03-01,CHN,Selangor,135069,68396,66673
2024-03-01,CHN,W.P. Labuan,54,46,8
2024-03-01,CIV,Johor,2,1,1
2024-03-01,CIV,Pulau Pinang,1,0,1
2024-03-01,CIV,Sabah,1,0,1
2024-03-01,CIV,Selangor,9,5,4
2024-03-01,CMR,Kedah,1,0,1
2024-03-01,CMR,Selangor,27,16,11
2024-03-01,COD,Johor,3,3,0
2024-03-01,COD,Sabah,2,2,0
2024-03-01,COD,Selangor,19,17,2
2024-03-01,COL,Johor,52,21,31
2024-03-01,COL,Kedah,10,4,6
2024-03-01,COL,Pulau Pinang,15,7,8
2024-03-01,COL,Sabah,4,2,2
2024-03-01,COL,Sarawak,1,1,0
2024-03-01,COL,Selangor,225,123,102
2024-03-01,COM,Selangor,6,2,4
2024-03-01,CPV,Selangor,1,0,1
2024-03-01,CRI,Johor,17,11,6
2024-03-01,CRI,Pulau Pinang,26,21,5
2024-03-01,CRI,Sabah,2,1,1
2024-03-01,CRI,Selangor,87,40,47
2024-03-01,CUB,Johor,9,6,3
2024-03-01,CUB,Selangor,25,13,12
2024-03-01,CYP,Johor,10,8,2
2024-03-01,CYP,Kedah,1,1,0
2024-03-01,CYP,Sabah,2,1,1
2024-03-01,CYP,Sarawak,1,1,0
2024-03-01,CYP,Selangor,87,56,31
2024-03-01,CZE,Johor,181,103,78
2024-03-01,CZE,Kedah,322,147,175
2024-03-01,CZE,Kelantan,3,3,0
2024-03-01,CZE,Perlis,10,5,5
2024-03-01,CZE,Pulau Pinang,45,26,19
2024-03-01,CZE,Sabah,11,4,7
2024-03-01,CZE,Sarawak,13,10,3
2024-03-01,CZE,Selangor,987,562,425
2024-03-01,CZE,W.P. Labuan,15,4,11
2024-03-01,DEU,Johor,3173,1876,1297
2024-03-01,DEU,Kedah,1907,975,932
2024-03-01,DEU,Kelantan,11,6,5
2024-03-01,DEU,Melaka,8,6,2
2024-03-01,DEU,Pahang,15,8,7
2024-03-01,DEU,Perak,34,25,9
2024-03-01,DEU,Perlis,178,104,74
2024-03-01,DEU,Pulau Pinang,1156,784,372
2024-03-01,DEU,Sabah,203,108,95
2024-03-01,DEU,Sarawak,278,160,118
2024-03-01,DEU,Selangor,11716,6773,4943
2024-03-01,DEU,W.P. Labuan,11,7,4
2024-03-01,DJI,Johor,4,2,2
2024-03-01,DJI,Selangor,22,15,7
2024-03-01,DMA,Johor,10,6,4
2024-03-01,DMA,Kedah,8,3,5
2024-03-01,DMA,Pulau Pinang,1,1,0
2024-03-01,DMA,Selangor,55,41,14
2024-03-01,DNK,Johor,359,236,123
2024-03-01,DNK,Kedah,403,184,219
2024-03-01,DNK,Kelantan,4,2,2
2024-03-01,DNK,Perak,2,2,0
2024-03-01,DNK,Perlis,9,6,3
2024-03-01,DNK,Pulau Pinang,106,68,38
2024-03-01,DNK,Sabah,67,29,38
2024-03-01,DNK,Sarawak,17,10,7
2024-03-01,DNK,Selangor,1588,917,671
2024-03-01,DOM,Johor,7,0,7
2024-03-01,DOM,Pulau Pinang,2,0,2
2024-03-01,DOM,Selangor,17,11,6
2024-03-01,DZA,Johor,24,16,8
2024-03-01,DZA,Kedah,4,1,3
2024-03-01,DZA,Kelantan,1,1,0
2024-03-01,DZA,Pulau Pinang,4,2,2
2024-03-01,DZA,Sabah,2,0,2
2024-03-01,DZA,Sarawak,5,4,1
2024-03-01,DZA,Selangor,355,270,85
2024-03-01,ECU,Johor,6,3,3
2024-03-01,ECU,Kedah,1,0,1
2024-03-01,ECU,Pulau Pinang,5,0,5
2024-03-01,ECU,Sabah,1,0,1
2024-03-01,ECU,Selangor,77,29,48
2024-03-01,EGY,Johor,194,173,21
2024-03-01,EGY,Kedah,18,12,6
2024-03-01,EGY,Melaka,1,1,0
2024-03-01,EGY,Pulau Pinang,28,23,5
2024-03-01,EGY,Sabah,2,2,0
2024-03-01,EGY,Sarawak,83,55,28
2024-03-01,EGY,Selangor,1124,857,267
2024-03-01,ERI,Johor,1,1,0
2024-03-01,ERI,Selangor,20,5,15
2024-03-01,ESP,Johor,619,371,248
2024-03-01,ESP,Kedah,289,148,141
2024-03-01,ESP,Kelantan,8,6,2
2024-03-01,ESP,Negeri Sembilan,6,3,3
2024-03-01,ESP,Pahang,3,3,0
2024-03-01,ESP,Perak,11,7,4
2024-03-01,ESP,Perlis,17,8,9
2024-03-01,ESP,Pulau Pinang,180,90,90
2024-03-01,ESP,Sabah,73,38,35
2024-03-01,ESP,Sarawak,32,18,14
2024-03-01,ESP,Selangor,3257,1785,1472
2024-03-01,ESP,W.P. Labuan,4,1,3
2024-03-01,EST,Johor,47,24,23
2024-03-01,EST,Kedah,87,40,47
2024-03-01,EST,Perlis,4,3,1
2024-03-01,EST,Pulau Pinang,10,6,4
2024-03-01,EST,Sabah,6,4,2
2024-03-01,EST,Sarawak,3,2,1
2024-03-01,EST,Selangor,390,202,188
2024-03-01,EST,W.P. Labuan,3,1,2
2024-03-01,ETH,Johor,5,5,0
2024-03-01,ETH,Pulau Pinang,2,1,1
2024-03-01,ETH,Selangor,24,10,14
2024-03-01,FIN,Johor,340,178,162
2024-03-01,FIN,Kedah,217,98,119
2024-03-01,FIN,Kelantan,2,2,0
2024-03-01,FIN,Perak,1,0,1
2024-03-01,FIN,Perlis,13,11,2
2024-03-01,FIN,Pulau Pinang,87,59,28
2024-03-01,FIN,Sabah,17,11,6
2024-03-01,FIN,Sarawak,20,9,11
2024-03-01,FIN,Selangor,744,400,344
2024-03-01,FIN,W.P. Labuan,3,2,1
2024-03-01,FJI,Johor,53,27,26
2024-03-01,FJI,Pulau Pinang,4,3,1
2024-03-01,FJI,Selangor,102,44,58
2024-03-01,FRA,Johor,2690,1620,1070
2024-03-01,FRA,Kedah,1383,697,686
2024-03-01,FRA,Kelantan,43,25,18
2024-03-01,FRA,Melaka,1,0,1
2024-03-01,FRA,Negeri Sembilan,2,1,1
2024-03-01,FRA,Pahang,43,26,17
2024-03-01,FRA,Perak,32,20,12
2024-03-01,FRA,Perlis,114,75,39
2024-03-01,FRA,Pulau Pinang,552,318,234
2024-03-01,FRA,Sabah,193,104,89
2024-03-01,FRA,Sarawak,131,79,52
2024-03-01,FRA,Selangor,9820,5816,4004
2024-03-01,FRA,Terengganu,1,1,0
2024-03-01,FRA,W.P. Labuan,4,3,1
2024-03-01,FSM,Selangor,3,3,0
2024-03-01,GAB,Johor,1,1,0
2024-03-01,GAB,Selangor,5,3,2
2024-03-01,GBR,Johor,6084,3807,2277
2024-03-01,GBR,Kedah,2514,1295,1219
2024-03-01,GBR,Kelantan,30,25,5
2024-03-01,GBR,Melaka,5,2,3
2024-03-01,GBR,Negeri Sembilan,4,4,0
2024-03-01,GBR,Pahang,34,19,15
2024-03-01,GBR,Perak,123,70,53
2024-03-01,GBR,Perlis,221,145,76
2024-03-01,GBR,Pulau Pinang,5327,2756,2571
2024-03-01,GBR,Sabah,913,472,441
2024-03-01,GBR,Sarawak,1589,958,631
2024-03-01,GBR,Selangor,27149,15609,11540
2024-03-01,GBR,Terengganu,1,1,0
2024-03-01,GBR,W.P. Labuan,46,30,16
2024-03-01,GEO,Johor,6,3,3
2024-03-01,GEO,Kedah,3,1,2
2024-03-01,GEO,Pulau Pinang,2,1,1
2024-03-01,GEO,Sabah,3,1,2
2024-03-01,GEO,Sarawak,1,0,1
2024-03-01,GEO,Selangor,63,30,33
2024-03-01,GHA,Johor,8,8,0
2024-03-01,GHA,Kedah,3,3,0
2024-03-01,GHA,Perak,1,1,0
2024-03-01,GHA,Pulau Pinang,21,16,5
2024-03-01,GHA,Sarawak,1,1,0
2024-03-01,GHA,Selangor,83,58,25
2024-03-01,GIN,Johor,6,5,1
2024-03-01,GIN,Kedah,2,2,0
2024-03-01,GIN,Pulau Pinang,2,1,1
2024-03-01,GIN,Selangor,43,32,11
2024-03-01,GMB,Johor,1,1,0
2024-03-01,GMB,Selangor,23,19,4
2024-03-01,GNB,Selangor,1,1,0
2024-03-01,GNQ,Selangor,3,1,2
2024-03-01,GRC,Johor,83,62,21
2024-03-01,GRC,Kedah,18,12,6
2024-03-01,GRC,Negeri Sembilan,1,1,0
2024-03-01,GRC,Perak,1,1,0
2024-03-01,GRC,Perlis,1,0,1
2024-03-01,GRC,Pulau Pinang,15,7,8
2024-03-01,GRC,Sabah,5,4,1
2024-03-01,GRC,Sarawak,3,1,2
2024-03-01,GRC,Selangor,334,228,106
2024-03-01,GRC,W.P. Labuan,2,2,0
2024-03-01,GRD,Johor,3,3,0
2024-03-01,GRD,Selangor,9,8,1
2024-03-01,GRL,Selangor,1,1,0
2024-03-01,GTM,Johor,4,3,1
2024-03-01,GTM,Kedah,1,1,0
2024-03-01,GTM,Pulau Pinang,1,1,0
2024-03-01,GTM,Sabah,1,1,0
2024-03-01,GTM,Selangor,29,17,12
2024-03-01,GUY,Johor,1,1,0
2024-03-01,GUY,Pulau Pinang,4,0,4
2024-03-01,GUY,Selangor,10,7,3
2024-03-01,HKG,Johor,8,4,4
2024-03-01,HKG,Kedah,1,0,1
2024-03-01,HKG,Pahang,3,2,1
2024-03-01,HKG,Perak,37,15,22
2024-03-01,HKG,Pulau Pinang,133,56,77
2024-03-01,HKG,Sabah,170,75,95
2024-03-01,HKG,Selangor,79,41,38
2024-03-01,HKG,W.P. Labuan,2,2,0
2024-03-01,HND,Johor,9,4,5
2024-03-01,HND,Selangor,16,11,5
2024-03-01,HRV,Johor,42,33,9
2024-03-01,HRV,Kedah,9,4,5
2024-03-01,HRV,Perlis,1,0,1
2024-03-01,HRV,Pulau Pinang,14,10,4
2024-03-01,HRV,Sabah,1,1,0
2024-03-01,HRV,Sarawak,1,1,0
2024-03-01,HRV,Selangor,266,152,114
2024-03-01,HTI,Selangor,14,9,5
2024-03-01,HUN,Johor,146,83,63
2024-03-01,HUN,Kedah,101,47,54
2024-03-01,HUN,Kelantan,3,3,0
2024-03-01,HUN,Perlis,5,4,1
2024-03-01,HUN,Pulau Pinang,50,30,20
2024-03-01,HUN,Sabah,9,6,3
2024-03-01,HUN,Sarawak,25,14,11
2024-03-01,HUN,Selangor,1048,540,508
2024-03-01,IDN,Johor,93412,40044,53368
2024-03-01,IDN,Kedah,3830,1463,2367
2024-03-01,IDN,Kelantan,151,104,47
2024-03-01,IDN,Melaka,2994,1357,1637
2024-03-01,IDN,Negeri Sembilan,4894,2767,2127
2024-03-01,IDN,Pahang,20,13,7
2024-03-01,IDN,Perak,161,50,111
2024-03-01,IDN,Perlis,508,199,309
2024-03-01,IDN,Pulau Pinang,43542,17443,26099
2024-03-01,IDN,Sabah,4945,2485,2460
2024-03-01,IDN,Sarawak,38775,19579,19196
2024-03-01,IDN,Selangor,122614,57603,65011
2024-03-01,IDN,W.P. Labuan,39,22,17
2024-03-01,IND,Johor,37284,23812,13472
2024-03-01,IND,Kedah,2083,1110,973
2024-03-01,IND,Kelantan,13,10,3
2024-03-01,IND,Melaka,4,3,1
2024-03-01,IND,Negeri Sembilan,9,9,0
2024-03-01,IND,Pahang,15,13,2
2024-03-01,IND,Perak,253,178,75
2024-03-01,IND,Perlis,68,60,8
2024-03-01,IND,Pulau Pinang,3357,2000,1357
2024-03-01,IND,Sabah,314,198,116
2024-03-01,IND,Sarawak,2378,1947,431
2024-03-01,IND,Selangor,66629,44197,22432
2024-03-01,IND,Terengganu,2,1,1
2024-03-01,IND,W.P. Labuan,33,30,3
2024-03-01,IOT,Selangor,1,1,0
2024-03-01,IRL,Johor,352,212,140
2024-03-01,IRL,Kedah,147,71,76
2024-03-01,IRL,Kelantan,2,1,1
2024-03-01,IRL,Perak,7,5,2
2024-03-01,IRL,Perlis,26,20,6
2024-03-01,IRL,Pulau Pinang,226,123,103
2024-03-01,IRL,Sabah,44,23,21
2024-03-01,IRL,Sarawak,30,15,15
2024-03-01,IRL,Selangor,1626,951,675
2024-03-01,IRN,Johor,765,362,403
2024-03-01,IRN,Kedah,38,19,19
2024-03-01,IRN,Perlis,4,4,0
2024-03-01,IRN,Pulau Pinang,39,19,20
2024-03-01,IRN,Sabah,4,0,4
2024-03-01,IRN,Sarawak,2,2,0
2024-03-01,IRN,Selangor,5497,2702,2795
2024-03-01,IRQ,Johor,39,33,6
2024-03-01,IRQ,Kedah,2,2,0
2024-03-01,IRQ,Pulau Pinang,1,1,0
2024-03-01,IRQ,Sarawak,6,4,2
2024-03-01,IRQ,Selangor,802,555,247
2024-03-01,ISL,Johor,3,1,2
2024-03-01,ISL,Kedah,6,1,5
2024-03-01,ISL,Negeri Sembilan,1,0,1
2024-03-01,ISL,Perlis,1,0,1
2024-03-01,ISL,Pulau Pinang,5,3,2
2024-03-01,ISL,Selangor,46,25,21
2024-03-01,ITA,Johor,747,520,227
2024-03-01,ITA,Kedah,598,323,275
2024-03-01,ITA,Kelantan,6,6,0
2024-03-01,ITA,Pahang,1,1,0
2024-03-01,ITA,Perak,9,5,4
2024-03-01,ITA,Perlis,35,22,13
2024-03-01,ITA,Pulau Pinang,198,148,50
2024-03-01,ITA,Sabah,66,40,26
2024-03-01,ITA,Sarawak,43,28,15
2024-03-01,ITA,Selangor,3641,2371,1270
2024-03-01,ITA,W.P. Labuan,4,4,0
2024-03-01,JAM,Johor,4,0,4
2024-03-01,JAM,Selangor,16,11,5
2024-03-01,JOR,Johor,18,14,4
2024-03-01,JOR,Kedah,4,4,0
2024-03-01,JOR,Pulau Pinang,4,4,0
2024-03-01,JOR,Selangor,414,310,104
2024-03-01,JPN,Johor,8379,5268,3111
2024-03-01,JPN,Kedah,498,255,243
2024-03-01,JPN,Kelantan,11,10,1
2024-03-01,JPN,Melaka,1,1,0
2024-03-01,JPN,Negeri Sembilan,12,10,2
2024-03-01,JPN,Pahang,24,15,9
2024-03-01,JPN,Perak,64,39,25
2024-03-01,JPN,Perlis,137,115,22
2024-03-01,JPN,Pulau Pinang,3232,1783,1449
2024-03-01,JPN,Sabah,780,394,386
2024-03-01,JPN,Sarawak,210,127,83
2024-03-01,JPN,Selangor,23771,14159,9612
2024-03-01,JPN,W.P. Labuan,11,7,4
2024-03-01,KAZ,Johor,62,21,41
2024-03-01,KAZ,Kedah,51,27,24
2024-03-01,KAZ,Kelantan,5,2,3
2024-03-01,KAZ,Perlis,11,5,6
2024-03-01,KAZ,Pulau Pinang,15,7,8
2024-03-01,KAZ,Sabah,6,1,5
2024-03-01,KAZ,Sarawak,8,1,7
2024-03-01,KAZ,Selangor,3044,1253,1791
2024-03-01,KEN,Johor,31,11,20
2024-03-01,KEN,Kedah,4,1,3
2024-03-01,KEN,Pulau Pinang,17,7,10
2024-03-01,KEN,Selangor,337,194,143
2024-03-01,KGZ,Johor,37,27,10
2024-03-01,KGZ,Kedah,5,3,2
2024-03-01,KGZ,Kelantan,2,2,0
2024-03-01,KGZ,Pulau Pinang,3,0,3
2024-03-01,KGZ,Sabah,1,1,0
2024-03-01,KGZ,Selangor,490,205,285
2024-03-01,KHM,Johor,1921,830,1091
2024-03-01,KHM,Kedah,147,77,70
2024-03-01,KHM,Kelantan,624,463,161
2024-03-01,KHM,Melaka,3,2,1
2024-03-01,KHM,Perak,5,1,4
2024-03-01,KHM,Perlis,725,411,314
2024-03-01,KHM,Pulau Pinang,42,15,27
2024-03-01,KHM,Sabah,2,1,1
2024-03-01,KHM,Sarawak,10,7,3
2024-03-01,KHM,Selangor,3361,1630,1731
2024-03-01,KNA,Johor,11,8,3
2024-03-01,KNA,Kedah,4,3,1
2024-03-01,KNA,Pulau Pinang,2,2,0
2024-03-01,KNA,Sabah,1,0,1
2024-03-01,KNA,Selangor,60,47,13
2024-03-01,KOR,Johor,10615,5810,4805
2024-03-01,KOR,Kedah,293,132,161
2024-03-01,KOR,Kelantan,1,0,1
2024-03-01,KOR,Negeri Sembilan,1,1,0
2024-03-01,KOR,Perak,24,11,13
2024-03-01,KOR,Perlis,79,52,27
2024-03-01,KOR,Pulau Pinang,1421,680,741
2024-03-01,KOR,Sabah,13537,5160,8377
2024-03-01,KOR,Sarawak,175,101,74
2024-03-01,KOR,Selangor,12886,7246,5640
2024-03-01,KOR,W.P. Labuan,17,11,6
2024-03-01,KWT,Johor,13,9,4
2024-03-01,KWT,Kedah,1,1,0
2024-03-01,KWT,Kelantan,1,0,1
2024-03-01,KWT,Pulau Pinang,1,0,1
2024-03-01,KWT,Selangor,109,79,30
2024-03-01,LAO,Johor,156,33,123
2024-03-01,LAO,Kedah,1302,107,1195
2024-03-01,LAO,Kelantan,508,391,117
2024-03-01,LAO,Perak,26,3,23
2024-03-01,LAO,Perlis,406,65,341
2024-03-01,LAO,Pulau Pinang,31,11,20
2024-03-01,LAO,Sarawak,14,10,4
2024-03-01,LAO,Selangor,271,95,176
2024-03-01,LBN,Johor,36,23,13
2024-03-01,LBN,Kedah,9,5,4
2024-03-01,LBN,Pulau Pinang,8,4,4
2024-03-01,LBN,Sabah,2,2,0
2024-03-01,LBN,Sarawak,7,7,0
2024-03-01,LBN,Selangor,210,140,70
2024-03-01,LBR,Johor,2,2,0
2024-03-01,LBR,Selangor,10,7,3
2024-03-01,LBY,Perlis,1,1,0
2024-03-01,LBY,Pulau Pinang,1,1,0
2024-03-01,LBY,Selangor,197,146,51
2024-03-01,LCA,Johor,4,3,1
2024-03-01,LCA,Kedah,1,1,0
2024-03-01,LCA,Pulau Pinang,4,4,0
2024-03-01,LCA,Selangor,14,8,6
2024-03-01,LIE,Pulau Pinang,2,1,1
2024-03-01,LIE,Selangor,5,4,1
2024-03-01,LKA,Johor,674,427,247
2024-03-01,LKA,Kedah,47,29,18
2024-03-01,LKA,Melaka,1,1,0
2024-03-01,LKA,Perak,4,1,3
2024-03-01,LKA,Perlis,8,6,2
2024-03-01,LKA,Pulau Pinang,45,22,23
2024-03-01,LKA,Sabah,5,3,2
2024-03-01,LKA,Sarawak,36,28,8
2024-03-01,LKA,Selangor,3380,2117,1263
2024-03-01,LSO,Johor,1,0,1
2024-03-01,LSO,Selangor,4,3,1
2024-03-01,LTU,Johor,83,32,51
2024-03-01,LTU,Kedah,153,66,87
2024-03-01,LTU,Pahang,1,1,0
2024-03-01,LTU,Perlis,2,2,0
2024-03-01,LTU,Pulau Pinang,18,9,9
2024-03-01,LTU,Sabah,7,1,6
2024-03-01,LTU,Sarawak,15,7,8
2024-03-01,LTU,Selangor,1102,527,575
2024-03-01,LTU,W.P. Labuan,12,3,9
2024-03-01,LUX,Johor,11,8,3
2024-03-01,LUX,Kedah,5,2,3
2024-03-01,LUX,Pulau Pinang,3,1,2
2024-03-01,LUX,Sabah,3,2,1
2024-03-01,LUX,Sarawak,2,1,1
2024-03-01,LUX,Selangor,68,37,31
2024-03-01,LVA,Johor,69,32,37
2024-03-01,LVA,Kedah,33,15,18
2024-03-01,LVA,Perak,2,1,1
2024-03-01,LVA,Perlis,3,2,1
2024-03-01,LVA,Pulau Pinang,11,6,5
2024-03-01,LVA,Sabah,5,3,2
2024-03-01,LVA,Sarawak,2,0,2
2024-03-01,LVA,Selangor,327,178,149
2024-03-01,LVA,W.P. Labuan,18,7,11
2024-03-01,MAC,Pulau Pinang,1,0,1
2024-03-01,MAR,Johor,84,47,37
2024-03-01,MAR,Kedah,15,11,4
2024-03-01,MAR,Kelantan,5,4,1
2024-03-01,MAR,Perlis,2,2,0
2024-03-01,MAR,Pulau Pinang,13,6,7
2024-03-01,MAR,Sabah,3,0,3
2024-03-01,MAR,Sarawak,5,4,1
2024-03-01,MAR,Selangor,516,324,192
2024-03-01,MCO,Johor,1,1,0
2024-03-01,MCO,Selangor,2,2,0
2024-03-01,MDA,Johor,9,1,8
2024-03-01,MDA,Kedah,1,0,1
2024-03-01,MDA,Kelantan,1,1,0
2024-03-01,MDA,Sarawak,1,1,0
2024-03-01,MDA,Selangor,59,24,35
2024-03-01,MDG,Johor,8,6,2
2024-03-01,MDG,Selangor,111,55,56
2024-03-01,MDV,Johor,108,47,61
2024-03-01,MDV,Pulau Pinang,24,21,3
2024-03-01,MDV,Sabah,1,1,0
2024-03-01,MDV,Selangor,1618,916,702
2024-03-01,MEX,Johor,260,124,136
2024-03-01,MEX,Kedah,11,5,6
2024-03-01,MEX,Kelantan,1,0,1
2024-03-01,MEX,Perak,1,1,0
2024-03-01,MEX,Perlis,3,2,1
2024-03-01,MEX,Pulau Pinang,75,42,33
2024-03-01,MEX,Sabah,10,5,5
2024-03-01,MEX,Sarawak,1,0,1
2024-03-01,MEX,Selangor,1021,498,523
2024-03-01,MHL,Sabah,1,1,0
2024-03-01,MKD,Johor,10,7,3
2024-03-01,MKD,Kedah,1,0,1
2024-03-01,MKD,Pulau Pinang,1,0,1
2024-03-01,MKD,Sabah,1,1,0
2024-03-01,MKD,Sarawak,2,1,1
2024-03-01,MKD,Selangor,32,15,17
2024-03-01,MLI,Selangor,5,4,1
2024-03-01,MLT,Johor,17,8,9
2024-03-01,MLT,Kedah,14,10,4
2024-03-01,MLT,Perlis,2,0,2
2024-03-01,MLT,Pulau Pinang,9,6,3
2024-03-01,MLT,Sarawak,1,0,1
2024-03-01,MLT,Selangor,50,30,20
2024-03-01,MMR,Johor,8072,2349,5723
2024-03-01,MMR,Kedah,128,26,102
2024-03-01,MMR,Kelantan,4,2,2
2024-03-01,MMR,Pahang,4,2,2
2024-03-01,MMR,Perak,33,7,26
2024-03-01,MMR,Perlis,9,1,8
2024-03-01,MMR,Pulau Pinang,453,162,291
2024-03-01,MMR,Sabah,18,6,12
2024-03-01,MMR,Sarawak,95,48,47
2024-03-01,MMR,Selangor,8089,5371,2718
2024-03-01,MNE,Johor,3,3,0
2024-03-01,MNE,Pulau Pinang,1,0,1
2024-03-01,MNE,Selangor,18,12,6
2024-03-01,MNG,Johor,153,60,93
2024-03-01,MNG,Kedah,7,5,2
2024-03-01,MNG,Perlis,6,2,4
2024-03-01,MNG,Pulau Pinang,22,12,10
2024-03-01,MNG,Sabah,2,0,2
2024-03-01,MNG,Sarawak,1,0,1
2024-03-01,MNG,Selangor,443,201,242
2024-03-01,MOZ,Selangor,26,14,12
2024-03-01,MRT,Johor,5,4,1
2024-03-01,MRT,Selangor,21,18,3
2024-03-01,MUS,Johor,130,62,68
2024-03-01,MUS,Kedah,5,2,3
2024-03-01,MUS,Pahang,6,2,4
2024-03-01,MUS,Perlis,1,0,1
2024-03-01,MUS,Pulau Pinang,16,10,6
2024-03-01,MUS,Sabah,3,2,1
2024-03-01,MUS,Selangor,1376,726,650
2024-03-01,MWI,Pulau Pinang,3,2,1
2024-03-01,MWI,Selangor,20,14,6
2024-03-01,NAM,Johor,3,2,1
2024-03-01,NAM,Selangor,12,8,4
2024-03-01,NER,Selangor,2,1,1
2024-03-01,NGA,Johor,30,27,3
2024-03-01,NGA,Kedah,1,1,0
2024-03-01,NGA,Pulau Pinang,18,11,7
2024-03-01,NGA,Sarawak,7,7,0
2024-03-01,NGA,Selangor,473,392,81
2024-03-01,NIC,Johor,5,3,2
2024-03-01,NIC,Kedah,2,1,1
2024-03-01,NIC,Selangor,9,5,4
2024-03-01,NLD,Johor,1120,746,374
2024-03-01,NLD,Kedah,515,256,259
2024-03-01,NLD,Kelantan,7,6,1
2024-03-01,NLD,Melaka,1,1,0
2024-03-01,NLD,Pahang,5,3,2
2024-03-01,NLD,Perak,21,11,10
2024-03-01,NLD,Perlis,56,28,28
2024-03-01,NLD,Pulau Pinang,382,223,159
2024-03-01,NLD,Sabah,70,38,32
2024-03-01,NLD,Sarawak,125,84,41
2024-03-01,NLD,Selangor,4284,2507,1777
2024-03-01,NLD,W.P. Labuan,4,2,2
2024-03-01,NOR,Johor,218,130,88
2024-03-01,NOR,Kedah,181,78,103
2024-03-01,NOR,Kelantan,1,1,0
2024-03-01,NOR,Perak,3,3,0
2024-03-01,NOR,Perlis,12,6,6
2024-03-01,NOR,Pulau Pinang,53,28,25
2024-03-01,NOR,Sabah,26,14,12
2024-03-01,NOR,Sarawak,16,13,3
2024-03-01,NOR,Selangor,1053,541,512
2024-03-01,NPL,Johor,697,458,239
2024-03-01,NPL,Kedah,24,12,12
2024-03-01,NPL,Perlis,1,1,0
2024-03-01,NPL,Pulau Pinang,34,25,9
2024-03-01,NPL,Sabah,4,2,2
2024-03-01,NPL,Sarawak,296,203,93
2024-03-01,NPL,Selangor,10524,9813,711
2024-03-01,NPL,W.P. Labuan,74,70,4
2024-03-01,NZL,Johor,800,484,316
2024-03-01,NZL,Kedah,109,53,56
2024-03-01,NZL,Kelantan,2,2,0
2024-03-01,NZL,Pahang,3,3,0
2024-03-01,NZL,Perak,24,13,11
2024-03-01,NZL,Perlis,28,16,12
2024-03-01,NZL,Pulau Pinang,284,149,135
2024-03-01,NZL,Sabah,62,36,26
2024-03-01,NZL,Sarawak,113,62,51
2024-03-01,NZL,Selangor,2673,1645,1028
2024-03-01,NZL,W.P. Labuan,1,1,0
2024-03-01,OMN,Johor,2,1,1
2024-03-01,OMN,Perlis,1,1,0
2024-03-01,OMN,Pulau Pinang,3,1,2
2024-03-01,OMN,Sabah,1,1,0
2024-03-01,OMN,Sarawak,6,4,2
2024-03-01,OMN,Selangor,232,163,69
2024-03-01,PAK,Johor,574,453,121
2024-03-01,PAK,Kedah,88,72,16
2024-03-01,PAK,Kelantan,20,20,0
2024-03-01,PAK,Perak,5,5,0
2024-03-01,PAK,Perlis,14,14,0
2024-03-01,PAK,Pulau Pinang,73,69,4
2024-03-01,PAK,Sabah,7,6,1
2024-03-01,PAK,Sarawak,154,134,20
2024-03-01,PAK,Selangor,7606,6586,1020
2024-03-01,PAK,W.P. Labuan,4,2,2
2024-03-01,PAN,Johor,7,4,3
2024-03-01,PAN,Kedah,4,3,1
2024-03-01,PAN,Sabah,3,0,3
2024-03-01,PAN,Selangor,27,12,15
2024-03-01,PER,Johor,30,21,9
2024-03-01,PER,Kedah,12,7,5
2024-03-01,PER,Kelantan,2,1,1
2024-03-01,PER,Pulau Pinang,4,2,2
2024-03-01,PER,Sabah,1,1,0
2024-03-01,PER,Sarawak,1,1,0
2024-03-01,PER,Selangor,132,74,58
2024-03-01,PHL,Johor,33147,10008,23139
2024-03-01,PHL,Kedah,587,170,417
2024-03-01,PHL,Kelantan,31,13,18
2024-03-01,PHL,Melaka,1,0,1
2024-03-01,PHL,Pahang,14,12,2
2024-03-01,PHL,Perak,83,21,62
2024-03-01,PHL,Perlis,177,67,110
2024-03-01,PHL,Pulau Pinang,1846,772,1074
2024-03-01,PHL,Sabah,2848,1111,1737
2024-03-01,PHL,Sarawak,3224,1321,1903
2024-03-01,PHL,Selangor,19596,7329,12267
2024-03-01,PHL,W.P. Labuan,117,47,70
2024-03-01,PNG,Johor,13,4,9
2024-03-01,PNG,Perak,3,2,1
2024-03-01,PNG,Pulau Pinang,1,0,1
2024-03-01,PNG,Selangor,85,57,28
2024-03-01,POL,Johor,555,319,236
2024-03-01,POL,Kedah,349,174,175
2024-03-01,POL,Kelantan,2,0,2
2024-03-01,POL,Melaka,1,1,0
2024-03-01,POL,Pahang,2,1,1
2024-03-01,POL,Perak,3,1,2
2024-03-01,POL,Perlis,48,24,24
2024-03-01,POL,Pulau Pinang,115,60,55
2024-03-01,POL,Sabah,33,16,17
2024-03-01,POL,Sarawak,70,33,37
2024-03-01,POL,Selangor,2549,1353,1196
2024-03-01,POL,W.P. Labuan,1,1,0
2024-03-01,PRT,Johor,211,119,92
2024-03-01,PRT,Kedah,110,58,52
2024-03-01,PRT,Melaka,3,2,1
2024-03-01,PRT,Pahang,2,1,1
2024-03-01,PRT,Perak,3,2,1
2024-03-01,PRT,Perlis,9,8,1
2024-03-01,PRT,Pulau Pinang,60,32,28
2024-03-01,PRT,Sabah,32,15,17
2024-03-01,PRT,Sarawak,14,10,4
2024-03-01,PRT,Selangor,1072,576,496
2024-03-01,PRY,Johor,6,5,1
2024-03-01,PRY,Pulau Pinang,1,0,1
2024-03-01,PRY,Selangor,12,5,7
2024-03-01,PSE,Johor,23,21,2
2024-03-01,PSE,Kedah,3,3,0
2024-03-01,PSE,Pulau Pinang,1,1,0
2024-03-01,PSE,Selangor,187,133,54
2024-03-01,QAT,Sarawak,2,1,1
2024-03-01,QAT,Selangor,27,25,2
2024-03-01,ROU,Johor,184,102,82
2024-03-01,ROU,Kedah,106,48,58
2024-03-01,ROU,Kelantan,1,1,0
2024-03-01,ROU,Perak,3,3,0
2024-03-01,ROU,Perlis,1,1,0
2024-03-01,ROU,Pulau Pinang,38,19,19
2024-03-01,ROU,Sabah,23,12,11
2024-03-01,ROU,Sarawak,6,5,1
2024-03-01,ROU,Selangor,982,501,481
2024-03-01,RUS,Johor,531,251,280
2024-03-01,RUS,Kedah,736,350,386
2024-03-01,RUS,Kelantan,47,24,23
2024-03-01,RUS,Melaka,2,2,0
2024-03-01,RUS,Perak,17,8,9
2024-03-01,RUS,Perlis,94,61,33
2024-03-01,RUS,Pulau Pinang,181,84,97
2024-03-01,RUS,Sabah,75,36,39
2024-03-01,RUS,Sarawak,45,24,21
2024-03-01,RUS,Selangor,13160,6212,6948
2024-03-01,RUS,W.P. Labuan,14,5,9
2024-03-01,RWA,Johor,1,0,1
2024-03-01,RWA,Selangor,12,9,3
2024-03-01,SAU,Johor,141,79,62
2024-03-01,SAU,Kedah,6,5,1
2024-03-01,SAU,Kelantan,2,2,0
2024-03-01,SAU,Pulau Pinang,13,11,2
2024-03-01,SAU,Sarawak,23,14,9
2024-03-01,SAU,Selangor,954,647,307
2024-03-01,SDN,Johor,14,11,3
2024-03-01,SDN,Kedah,5,2,3
2024-03-01,SDN,Pulau Pinang,6,2,4
2024-03-01,SDN,Sarawak,7,4,3
2024-03-01,SDN,Selangor,856,554,302
2024-03-01,SEN,Johor,5,5,0
2024-03-01,SEN,Selangor,44,30,14
2024-03-01,SGP,Johor,1526600,847751,678849
2024-03-01,SGP,Kedah,4647,2479,2168
2024-03-01,SGP,Kelantan,79,53,26
2024-03-01,SGP,Melaka,16,12,4
2024-03-01,SGP,Negeri Sembilan,7,5,2
2024-03-01,SGP,Pahang,773,399,374
2024-03-01,SGP,Perak,7501,3513,3988
2024-03-01,SGP,Perlis,214,123,91
2024-03-01,SGP,Pulau Pinang,29565,14270,15295
2024-03-01,SGP,Sabah,2587,1296,1291
2024-03-01,SGP,Sarawak,4245,2244,2001
2024-03-01,SGP,Selangor,50305,26052,24253
2024-03-01,SGP,W.P. Labuan,13,12,1
2024-03-01,SLB,Johor,1,1,0
2024-03-01,SLB,Pulau Pinang,1,1,0
2024-03-01,SLB,Sarawak,20,2,18
2024-03-01,SLB,Selangor,10,7,3
2024-03-01,SLE,Johor,2,2,0
2024-03-01,SLE,Selangor,28,24,4
2024-03-01,SLV,Johor,1,1,0
2024-03-01,SLV,Pulau Pinang,1,0,1
2024-03-01,SLV,Sarawak,1,1,0
2024-03-01,SLV,Selangor,13,9,4
2024-03-01,SMR,Kedah,2,1,1
2024-03-01,SMR,Selangor,3,2,1
2024-03-01,SOM,Selangor,230,135,95
2024-03-01,SRB,Johor,15,12,3
2024-03-01,SRB,Kedah,7,5,2
2024-03-01,SRB,Pulau Pinang,4,2,2
2024-03-01,SRB,Sabah,1,0,1
2024-03-01,SRB,Sarawak,2,0,2
2024-03-01,SRB,Selangor,124,62,62
2024-03-01,SSD,Sabah,1,1,0
2024-03-01,SSD,Sarawak,3,1,2
2024-03-01,SSD,Selangor,27,17,10
2024-03-01,SUR,Johor,1,1,0
2024-03-01,SUR,Kedah,4,1,3
2024-03-01,SUR,Pulau Pinang,2,2,0
2024-03-01,SUR,Selangor,16,15,1
2024-03-01,SVK,Johor,49,29,20
2024-03-01,SVK,Kedah,266,146,120
2024-03-01,SVK,Kelantan,3,2,1
2024-03-01,SVK,Perak,2,1,1
2024-03-01,SVK,Perlis,1,1,0
2024-03-01,SVK,Pulau Pinang,30,15,15
2024-03-01,SVK,Sabah,17,7,10
2024-03-01,SVK,Sarawak,4,3,1
2024-03-01,SVK,Selangor,671,336,335
2024-03-01,SVK,W.P. Labuan,12,8,4
2024-03-01,SVN,Johor,31,16,15
2024-03-01,SVN,Kedah,60,30,30
2024-03-01,SVN,Perak,2,1,1
2024-03-01,SVN,Perlis,3,2,1
2024-03-01,SVN,Pulau Pinang,3,2,1
2024-03-01,SVN,Sabah,5,3,2
2024-03-01,SVN,Sarawak,1,0,1
2024-03-01,SVN,Selangor,269,137,132
2024-03-01,SVN,W.P. Labuan,2,1,1
2024-03-01,SWE,Johor,296,172,124
2024-03-01,SWE,Kedah,429,190,239
2024-03-01,SWE,Perak,7,6,1
2024-03-01,SWE,Perlis,18,13,5
2024-03-01,SWE,Pulau Pinang,109,72,37
2024-03-01,SWE,Sabah,41,19,22
2024-03-01,SWE,Sarawak,16,11,5
2024-03-01,SWE,Selangor,1518,862,656
2024-03-01,SWE,W.P. Labuan,2,2,0
2024-03-01,SWZ,Johor,1,1,0
2024-03-01,SWZ,Pulau Pinang,1,1,0
2024-03-01,SWZ,Selangor,22,10,12
2024-03-01,SYC,Johor,3,2,1
2024-03-01,SYC,Selangor,56,19,37
2024-03-01,SYR,Johor,22,19,3
2024-03-01,SYR,Kedah,9,6,3
2024-03-01,SYR,Kelantan,1,0,1
2024-03-01,SYR,Pahang,1,1,0
2024-03-01,SYR,Pulau Pinang,8,4,4
2024-03-01,SYR,Sabah,4,4,0
2024-03-01,SYR,Sarawak,4,4,0
2024-03-01,SYR,Selangor,414,283,131
2024-03-01,TCD,Johor,3,2,1
2024-03-01,TCD,Selangor,26,20,6
2024-03-01,TGO,Pulau Pinang,1,1,0
2024-03-01,TGO,Selangor,10,9,1
2024-03-01,THA,Johor,7453,1938,5515
2024-03-01,THA,Kedah,70841,41721,29120
2024-03-01,THA,Kelantan,59952,29221,30731
2024-03-01,THA,Melaka,1,1,0
2024-03-01,THA,Negeri Sembilan,2,2,0
2024-03-01,THA,Pahang,10,10,0
2024-03-01,THA,Perak,12720,5999,6721
2024-03-01,THA,Perlis,55102,32181,22921
2024-03-01,THA,Pulau Pinang,3414,1357,2057
2024-03-01,THA,Sabah,46,20,26
2024-03-01,THA,Sarawak,457,152,305
2024-03-01,THA,Selangor,15000,5812,9188
2024-03-01,THA,Terengganu,2,2,0
2024-03-01,THA,W.P. Labuan,12,6,6
2024-03-01,TJK,Johor,2,2,0
2024-03-01,TJK,Sabah,2,2,0
2024-03-01,TJK,Selangor,104,60,44
2024-03-01,TKM,Johor,11,5,6
2024-03-01,TKM,Kelantan,1,1,0
2024-03-01,TKM,Selangor,1093,456,637
2024-03-01,TLS,Johor,3,3,0
2024-03-01,TLS,Kedah,6,1,5
2024-03-01,TLS,Pulau Pinang,1,1,0
2024-03-01,TLS,Sabah,1,0,1
2024-03-01,TLS,Sarawak,7,7,0
2024-03-01,TLS,Selangor,288,142,146
2024-03-01,TON,Pulau Pinang,2,0,2
2024-03-01,TON,Selangor,12,6,6
2024-03-01,TTO,Johor,4,2,2
2024-03-01,TTO,Pulau Pinang,2,1,1
2024-03-01,TTO,Sabah,2,0,2
2024-03-01,TTO,Selangor,30,17,13
2024-03-01,TUN,Johor,17,9,8
2024-03-01,TUN,Kedah,13,7,6
2024-03-01,TUN,Perlis,2,0,2
2024-03-01,TUN,Pulau Pinang,4,2,2
2024-03-01,TUN,Sabah,4,3,1
2024-03-01,TUN,Sarawak,1,1,0
2024-03-01,TUN,Selangor,332,202,130
2024-03-01,TUR,Johor,324,249,75
2024-03-01,TUR,Kedah,64,43,21
2024-03-01,TUR,Kelantan,8,7,1
2024-03-01,TUR,Melaka,1,1,0
2024-03-01,TUR,Pahang,3,2,1
2024-03-01,TUR,Perak,2,1,1
2024-03-01,TUR,Perlis,21,15,6
2024-03-01,TUR,Pulau Pinang,45,32,13
2024-03-01,TUR,Sabah,6,3,3
2024-03-01,TUR,Sarawak,26,19,7
2024-03-01,TUR,Selangor,1769,1281,488
2024-03-01,TUV,Selangor,2,1,1
2024-03-01,TWN,Johor,7056,3014,4042
2024-03-01,TWN,Kedah,204,103,101
2024-03-01,TWN,Kelantan,2,1,1
2024-03-01,TWN,Melaka,8,5,3
2024-03-01,TWN,Pahang,6,6,0
2024-03-01,TWN,Perak,63,23,40
2024-03-01,TWN,Perlis,27,14,13
2024-03-01,TWN,Pulau Pinang,4309,2023,2286
2024-03-01,TWN,Sabah,2173,992,1181
2024-03-01,TWN,Sarawak,473,200,273
2024-03-01,TWN,Selangor,16818,7775,9043
2024-03-01,TWN,W.P. Labuan,2,1,1
2024-03-01,TZA,Johor,25,12,13
2024-03-01,TZA,Kedah,3,1,2
2024-03-01,TZA,Pulau Pinang,4,3,1
2024-03-01,TZA,Sarawak,1,1,0
2024-03-01,TZA,Selangor,168,93,75
2024-03-01,UGA,Johor,44,29,15
2024-03-01,UGA,Kedah,2,0,2
2024-03-01,UGA,Pulau Pinang,9,7,2
2024-03-01,UGA,Sarawak,1,1,0
2024-03-01,UGA,Selangor,123,50,73
2024-03-01,UKR,Johor,134,56,78
2024-03-01,UKR,Kedah,63,26,37
2024-03-01,UKR,Kelantan,21,9,12
2024-03-01,UKR,Pahang,2,2,0
2024-03-01,UKR,Perak,1,0,1
2024-03-01,UKR,Perlis,9,2,7
2024-03-01,UKR,Pulau Pinang,36,17,19
2024-03-01,UKR,Sabah,7,2,5
2024-03-01,UKR,Selangor,1528,685,843
2024-03-01,URY,Johor,85,39,46
2024-03-01,URY,Kedah,4,3,1
2024-03-01,URY,Pulau Pinang,1,0,1
2024-03-01,URY,Selangor,81,43,38
2024-03-01,USA,Johor,5854,3228,2626
2024-03-01,USA,Kedah,645,331,314
2024-03-01,USA,Kelantan,18,13,5
2024-03-01,USA,Melaka,9,5,4
2024-03-01,USA,Negeri Sembilan,2,2,0
2024-03-01,USA,Pahang,20,12,8
2024-03-01,USA,Perak,122,73,49
2024-03-01,USA,Perlis,134,85,49
2024-03-01,USA,Pulau Pinang,3836,2089,1747
2024-03-01,USA,Sabah,535,278,257
2024-03-01,USA,Sarawak,344,205,139
2024-03-01,USA,Selangor,17483,10097,7386
2024-03-01,USA,Terengganu,2,1,1
2024-03-01,USA,W.P. Labuan,1,0,1
2024-03-01,UZB,Johor,106,83,23
2024-03-01,UZB,Kedah,15,8,7
2024-03-01,UZB,Kelantan,6,5,1
2024-03-01,UZB,Perlis,1,0,1
2024-03-01,UZB,Pulau Pinang,4,3,1
2024-03-01,UZB,Sabah,6,2,4
2024-03-01,UZB,Sarawak,1,0,1
2024-03-01,UZB,Selangor,1092,602,490
2024-03-01,VAT,Johor,1,1,0
2024-03-01,VCT,Selangor,5,3,2
2024-03-01,VEN,Johor,17,5,12
2024-03-01,VEN,Kedah,1,1,0
2024-03-01,VEN,Kelantan,1,0,1
2024-03-01,VEN,Pulau Pinang,1,1,0
2024-03-01,VEN,Sabah,2,0,2
2024-03-01,VEN,Sarawak,2,2,0
2024-03-01,VEN,Selangor,112,60,52
2024-03-01,VNM,Johor,14980,4606,10374
2024-03-01,VNM,Kedah,346,45,301
2024-03-01,VNM,Kelantan,10,7,3
2024-03-01,VNM,Melaka,3,1,2
2024-03-01,VNM,Pahang,2,0,2
2024-03-01,VNM,Perak,113,2,111
2024-03-01,VNM,Perlis,231,19,212
2024-03-01,VNM,Pulau Pinang,1509,462,1047
2024-03-01,VNM,Sabah,39,9,30
2024-03-01,VNM,Sarawak,369,57,312
2024-03-01,VNM,Selangor,18672,6372,12300
2024-03-01,VNM,W.P. Labuan,4,4,0
2024-03-01,VUT,Johor,32,21,11
2024-03-01,VUT,Kedah,1,1,0
2024-03-01,VUT,Perlis,1,1,0
2024-03-01,VUT,Pulau Pinang,6,4,2
2024-03-01,VUT,Sabah,5,4,1
2024-03-01,VUT,Selangor,84,72,12
2024-03-01,WSM,Sarawak,1,0,1
2024-03-01,WSM,Selangor,2,1,1
2024-03-01,XXX,Johor,2,2,0
2024-03-01,XXX,Pulau Pinang,3,2,1
2024-03-01,XXX,Selangor,59,35,24
2024-03-01,YEM,Johor,24,19,5
2024-03-01,YEM,Kedah,3,2,1
2024-03-01,YEM,Kelantan,1,0,1
2024-03-01,YEM,Melaka,3,2,1
2024-03-01,YEM,Pulau Pinang,7,7,0
2024-03-01,YEM,Selangor,801,626,175
2024-03-01,ZAF,Johor,245,150,95
2024-03-01,ZAF,Kedah,68,40,28
2024-03-01,ZAF,Perak,2,2,0
2024-03-01,ZAF,Perlis,18,9,9
2024-03-01,ZAF,Pulau Pinang,111,54,57
2024-03-01,ZAF,Sabah,33,16,17
2024-03-01,ZAF,Sarawak,142,60,82
2024-03-01,ZAF,Selangor,1020,588,432
2024-03-01,ZAF,W.P. Labuan,38,21,17
2024-03-01,ZAR,Selangor,1,1,0
2024-03-01,ZMB,Johor,3,1,2
2024-03-01,ZMB,Pulau Pinang,2,0,2
2024-03-01,ZMB,Selangor,69,39,30
2024-03-01,ZWE,Johor,21,11,10
2024-03-01,ZWE,Kelantan,1,0,1
2024-03-01,ZWE,Pulau Pinang,4,1,3
2024-03-01,ZWE,Selangor,114,57,57
2024-04-01,AFG,Pulau Pinang,1,1,0
2024-04-01,AFG,Sarawak,1,1,0
2024-04-01,AFG,Selangor,75,54,21
2024-04-01,AGO,Selangor,2,1,1
2024-04-01,ALB,Johor,14,9,5
2024-04-01,ALB,Perlis,1,0,1
2024-04-01,ALB,Selangor,36,19,17
2024-04-01,AND,Selangor,5,3,2
2024-04-01,ARE,Johor,20,8,12
2024-04-01,ARE,Kedah,14,9,5
2024-04-01,ARE,Pulau Pinang,5,5,0
2024-04-01,ARE,Sabah,3,3,0
2024-04-01,ARE,Selangor,486,278,208
2024-04-01,ARG,Johor,91,51,40
2024-04-01,ARG,Kedah,75,35,40
2024-04-01,ARG,Perak,1,0,1
2024-04-01,ARG,Perlis,5,2,3
2024-04-01,ARG,Pulau Pinang,9,4,5
2024-04-01,ARG,Sarawak,6,3,3
2024-04-01,ARG,Selangor,470,228,242
2024-04-01,ARM,Johor,32,9,23
2024-04-01,ARM,Kedah,1,0,1
2024-04-01,ARM,Pulau Pinang,1,1,0
2024-04-01,ARM,Sabah,1,0,1
2024-04-01,ARM,Selangor,74,24,50
2024-04-01,ATG,Johor,2,1,1
2024-04-01,ATG,Pulau Pinang,1,1,0
2024-04-01,ATG,Selangor,11,6,5
2024-04-01,AUS,Johor,6363,3674,2689
2024-04-01,AUS,Kedah,872,436,436
2024-04-01,AUS,Kelantan,37,30,7
2024-04-01,AUS,Negeri Sembilan,3,3,0
2024-04-01,AUS,Pahang,38,19,19
2024-04-01,AUS,Perak,198,102,96
2024-04-01,AUS,Perlis,98,67,31
2024-04-01,AUS,Pulau Pinang,1762,940,822
2024-04-01,AUS,Sabah,440,213,227
2024-04-01,AUS,Sarawak,541,318,223
2024-04-01,AUS,Selangor,22503,12906,9597
2024-04-01,AUS,W.P. Labuan,13,7,6
2024-04-01,AUT,Johor,178,122,56
2024-04-01,AUT,Kedah,73,39,34
2024-04-01,AUT,Kelantan,3,3,0
2024-04-01,AUT,Perak,2,1,1
2024-04-01,AUT,Perlis,3,2,1
2024-04-01,AUT,Pulau Pinang,58,37,21
2024-04-01,AUT,Sabah,11,7,4
2024-04-01,AUT,Sarawak,44,25,19
2024-04-01,AUT,Selangor,790,472,318
2024-04-01,AZE,Johor,14,9,5
2024-04-01,AZE,Kedah,3,2,1
2024-04-01,AZE,Pulau Pinang,1,0,1
2024-04-01,AZE,Sarawak,2,2,0
2024-04-01,AZE,Selangor,145,88,57
2024-04-01,BDI,Selangor,4,2,2
2024-04-01,BEL,Johor,285,167,118
2024-04-01,BEL,Kedah,133,71,62
2024-04-01,BEL,Kelantan,2,2,0
2024-04-01,BEL,Melaka,2,0,2
2024-04-01,BEL,Perak,3,2,1
2024-04-01,BEL,Perlis,12,10,2
2024-04-01,BEL,Pulau Pinang,79,45,34
2024-04-01,BEL,Sabah,27,16,11
2024-04-01,BEL,Sarawak,32,20,12
2024-04-01,BEL,Selangor,1378,813,565
2024-04-01,BEN,Johor,1,1,0
2024-04-01,BEN,Selangor,11,5,6
2024-04-01,BFA,Selangor,6,5,1
2024-04-01,BGD,Johor,2893,2245,648
2024-04-01,BGD,Kedah,132,77,55
2024-04-01,BGD,Kelantan,2,2,0
2024-04-01,BGD,Perak,4,4,0
2024-04-01,BGD,Perlis,3,3,0
2024-04-01,BGD,Pulau Pinang,124,95,29
2024-04-01,BGD,Sabah,2,2,0
2024-04-01,BGD,Sarawak,115,81,34
2024-04-01,BGD,Selangor,25169,22729,2440
2024-04-01,BGD,W.P. Labuan,5,2,3
2024-04-01,BGR,Johor,76,42,34
2024-04-01,BGR,Kedah,23,13,10
2024-04-01,BGR,Kelantan,1,1,0
2024-04-01,BGR,Perak,4,3,1
2024-04-01,BGR,Pulau Pinang,1,1,0
2024-04-01,BGR,Sabah,1,1,0
2024-04-01,BGR,Sarawak,1,0,1
2024-04-01,BGR,Selangor,302,158,144
2024-04-01,BHR,Johor,15,10,5
2024-04-01,BHR,Kedah,12,4,8
2024-04-01,BHR,Pulau Pinang,2,1,1
2024-04-01,BHR,Selangor,79,48,31
2024-04-01,BHS,Johor,1,0,1
2024-04-01,BHS,Selangor,12,7,5
2024-04-01,BIH,Johor,11,6,5
2024-04-01,BIH,Kedah,3,0,3
2024-04-01,BIH,Pulau Pinang,3,1,2
2024-04-01,BIH,Sabah,1,1,0
2024-04-01,BIH,Sarawak,3,3,0
2024-04-01,BIH,Selangor,50,30,20
2024-04-01,BLR,Johor,11,5,6
2024-04-01,BLR,Kedah,19,8,11
2024-04-01,BLR,Kelantan,2,1,1
2024-04-01,BLR,Perlis,1,1,0
2024-04-01,BLR,Pulau Pinang,9,4,5
2024-04-01,BLR,Sabah,3,1,2
2024-04-01,BLR,Sarawak,5,2,3
2024-04-01,BLR,Selangor,493,218,275
2024-04-01,BLZ,Johor,3,2,1
2024-04-01,BLZ,Selangor,3,2,1
2024-04-01,BMU,Selangor,3,0,3
2024-04-01,BOL,Johor,1,1,0
2024-04-01,BOL,Pulau Pinang,3,1,2
2024-04-01,BOL,Sarawak,5,3,2
2024-04-01,BOL,Selangor,22,10,12
2024-04-01,BRA,Johor,281,142,139
2024-04-01,BRA,Kedah,105,47,58
2024-04-01,BRA,Pahang,3,1,2
2024-04-01,BRA,Perak,3,1,2
2024-04-01,BRA,Perlis,5,1,4
2024-04-01,BRA,Pulau Pinang,25,20,5
2024-04-01,BRA,Sabah,11,4,7
2024-04-01,BRA,Sarawak,9,6,3
2024-04-01,BRA,Selangor,1077,592,485
2024-04-01,BRB,Johor,1,0,1
2024-04-01,BRB,Kedah,1,1,0
2024-04-01,BRB,Selangor,8,5,3
2024-04-01,BRN,Johor,389,200,189
2024-04-01,BRN,Kedah,24,16,8
2024-04-01,BRN,Kelantan,23,9,14
2024-04-01,BRN,Melaka,5,2,3
2024-04-01,BRN,Perak,2,2,0
2024-04-01,BRN,Perlis,10,6,4
2024-04-01,BRN,Pulau Pinang,15,7,8
2024-04-01,BRN,Sabah,1126,473,653
2024-04-01,BRN,Sarawak,160441,84838,75603
2024-04-01,BRN,Selangor,5530,2753,2777
2024-04-01,BRN,W.P. Labuan,1402,840,562
2024-04-01,BTN,Johor,15,12,3
2024-04-01,BTN,Pulau Pinang,1,1,0
2024-04-01,BTN,Selangor,38,22,16
2024-04-01,BWA,Johor,1,1,0
2024-04-01,BWA,Pulau Pinang,1,0,1
2024-04-01,BWA,Selangor,11,3,8
2024-04-01,CAN,Johor,1586,887,699
2024-04-01,CAN,Kedah,253,132,121
2024-04-01,CAN,Kelantan,7,5,2
2024-04-01,CAN,Negeri Sembilan,6,3,3
2024-04-01,CAN,Pahang,7,3,4
2024-04-01,CAN,Perak,33,17,16
2024-04-01,CAN,Perlis,50,34,16
2024-04-01,CAN,Pulau Pinang,485,259,226
2024-04-01,CAN,Sabah,159,87,72
2024-04-01,CAN,Sarawak,415,242,173
2024-04-01,CAN,Selangor,4897,2741,2156
2024-04-01,CAN,W.P. Labuan,9,3,6
2024-04-01,CHE,Johor,539,303,236
2024-04-01,CHE,Kedah,241,115,126
2024-04-01,CHE,Kelantan,3,2,1
2024-04-01,CHE,Negeri Sembilan,2,1,1
2024-04-01,CHE,Pahang,9,4,5
2024-04-01,CHE,Perak,10,8,2
2024-04-01,CHE,Perlis,47,23,24
2024-04-01,CHE,Pulau Pinang,155,94,61
2024-04-01,CHE,Sabah,41,24,17
2024-04-01,CHE,Sarawak,42,22,20
2024-04-01,CHE,Selangor,1589,909,680
2024-04-01,CHL,Johor,35,17,18
2024-04-01,CHL,Kedah,28,11,17
2024-04-01,CHL,Kelantan,2,0,2
2024-04-01,CHL,Perlis,1,0,1
2024-04-01,CHL,Pulau Pinang,10,6,4
2024-04-01,CHL,Sabah,6,3,3
2024-04-01,CHL,Selangor,307,157,150
2024-04-01,CHN,Johor,76729,33387,43342
2024-04-01,CHN,Kedah,2005,843,1162
2024-04-01,CHN,Kelantan,38,21,17
2024-04-01,CHN,Melaka,6,6,0
2024-04-01,CHN,Negeri Sembilan,1,1,0
2024-04-01,CHN,Pahang,31,16,15
2024-04-01,CHN,Perak,402,190,212
2024-04-01,CHN,Perlis,443,241,202
2024-04-01,CHN,Pulau Pinang,9358,4725,4633
2024-04-01,CHN,Sabah,12460,5379,7081
2024-04-01,CHN,Sarawak,1634,825,809
2024-04-01,CHN,Selangor,125281,62052,63229
2024-04-01,CHN,W.P. Labuan,38,33,5
2024-04-01,CIV,Johor,3,3,0
2024-04-01,CIV,Sabah,1,0,1
2024-04-01,CIV,Sarawak,1,0,1
2024-04-01,CIV,Selangor,21,12,9
2024-04-01,CMR,Pulau Pinang,1,1,0
2024-04-01,CMR,Selangor,38,15,23
2024-04-01,COD,Johor,2,2,0
2024-04-01,COD,Selangor,32,14,18
2024-04-01,COG,Selangor,1,0,1
2024-04-01,COL,Johor,33,15,18
2024-04-01,COL,Kedah,9,6,3
2024-04-01,COL,Perak,2,2,0
2024-04-01,COL,Pulau Pinang,3,2,1
2024-04-01,COL,Sabah,1,0,1
2024-04-01,COL,Sarawak,7,3,4
2024-04-01,COL,Selangor,246,120,126
2024-04-01,COM,Johor,5,2,3
2024-04-01,COM,Selangor,21,15,6
2024-04-01,CRI,Johor,13,7,6
2024-04-01,CRI,Kedah,2,1,1
2024-04-01,CRI,Pulau Pinang,10,6,4
2024-04-01,CRI,Sabah,1,1,0
2024-04-01,CRI,Selangor,66,37,29
2024-04-01,CUB,Johor,9,5,4
2024-04-01,CUB,Sabah,1,0,1
2024-04-01,CUB,Selangor,17,14,3
2024-04-01,CYP,Johor,9,4,5
2024-04-01,CYP,Kedah,2,1,1
2024-04-01,CYP,Pulau Pinang,4,4,0
2024-04-01,CYP,Selangor,63,38,25
2024-04-01,CZE,Johor,110,66,44
2024-04-01,CZE,Kedah,49,23,26
2024-04-01,CZE,Perak,2,1,1
2024-04-01,CZE,Perlis,9,6,3
2024-04-01,CZE,Pulau Pinang,33,19,14
2024-04-01,CZE,Sabah,17,10,7
2024-04-01,CZE,Sarawak,10,7,3
2024-04-01,CZE,Selangor,576,319,257
2024-04-01,DEU,Johor,2634,1573,1061
2024-04-01,DEU,Kedah,1076,556,520
2024-04-01,DEU,Kelantan,12,8,4
2024-04-01,DEU,Pahang,8,4,4
2024-04-01,DEU,Perak,30,20,10
2024-04-01,DEU,Perlis,105,58,47
2024-04-01,DEU,Pulau Pinang,627,430,197
2024-04-01,DEU,Sabah,150,83,67
2024-04-01,DEU,Sarawak,236,133,103
2024-04-01,DEU,Selangor,9864,5527,4337
2024-04-01,DEU,W.P. Labuan,7,6,1
2024-04-01,DJI,Selangor,9,6,3
2024-04-01,DMA,Johor,2,2,0
2024-04-01,DMA,Kedah,2,1,1
2024-04-01,DMA,Pulau Pinang,1,1,0
2024-04-01,DMA,Sarawak,2,1,1
2024-04-01,DMA,Selangor,64,44,20
2024-04-01,DNK,Johor,293,216,77
2024-04-01,DNK,Kedah,166,81,85
2024-04-01,DNK,Kelantan,3,1,2
2024-04-01,DNK,Perak,2,1,1
2024-04-01,DNK,Perlis,6,3,3
2024-04-01,DNK,Pulau Pinang,51,32,19
2024-04-01,DNK,Sabah,16,9,7
2024-04-01,DNK,Sarawak,8,6,2
2024-04-01,DNK,Selangor,1167,639,528
2024-04-01,DNK,Terengganu,19,4,15
2024-04-01,DOM,Johor,1,0,1
2024-04-01,DOM,Pulau Pinang,1,1,0
2024-04-01,DOM,Sabah,1,0,1
2024-04-01,DOM,Selangor,11,4,7
2024-04-01,DZA,Johor,28,19,9
2024-04-01,DZA,Kedah,3,1,2
2024-04-01,DZA,Sabah,1,1,0
2024-04-01,DZA,Sarawak,2,2,0
2024-04-01,DZA,Selangor,479,313,166
2024-04-01,ECU,Johor,12,7,5
2024-04-01,ECU,Kedah,1,0,1
2024-04-01,ECU,Pulau Pinang,6,2,4
2024-04-01,ECU,Selangor,118,49,69
2024-04-01,EGY,Johor,262,221,41
2024-04-01,EGY,Kedah,39,22,17
2024-04-01,EGY,Kelantan,4,2,2
2024-04-01,EGY,Perlis,1,1,0
2024-04-01,EGY,Pulau Pinang,18,13,5
2024-04-01,EGY,Sabah,3,3,0
2024-04-01,EGY,Sarawak,162,105,57
2024-04-01,EGY,Selangor,1469,967,502
2024-04-01,ERI,Selangor,15,10,5
2024-04-01,ESP,Johor,511,323,188
2024-04-01,ESP,Kedah,175,84,91
2024-04-01,ESP,Kelantan,8,5,3
2024-04-01,ESP,Melaka,1,0,1
2024-04-01,ESP,Pahang,1,1,0
2024-04-01,ESP,Perak,3,1,2
2024-04-01,ESP,Perlis,21,12,9
2024-04-01,ESP,Pulau Pinang,84,52,32
2024-04-01,ESP,Sabah,35,22,13
2024-04-01,ESP,Sarawak,42,31,11
2024-04-01,ESP,Selangor,2749,1556,1193
2024-04-01,ESP,W.P. Labuan,1,1,0
2024-04-01,EST,Johor,24,13,11
2024-04-01,EST,Kedah,19,8,11
2024-04-01,EST,Perlis,2,2,0
2024-04-01,EST,Pulau Pinang,11,7,4
2024-04-01,EST,Sabah,4,2,2
2024-04-01,EST,Sarawak,9,4,5
2024-04-01,EST,Selangor,135,80,55
2024-04-01,EST,W.P. Labuan,1,0,1
2024-04-01,ETH,Johor,5,3,2
2024-04-01,ETH,Selangor,26,20,6
2024-04-01,FIN,Johor,238,134,104
2024-04-01,FIN,Kedah,69,29,40
2024-04-01,FIN,Perak,9,4,5
2024-04-01,FIN,Perlis,2,2,0
2024-04-01,FIN,Pulau Pinang,34,21,13
2024-04-01,FIN,Sabah,8,5,3
2024-04-01,FIN,Sarawak,2,0,2
2024-04-01,FIN,Selangor,434,222,212
2024-04-01,FJI,Johor,71,30,41
2024-04-01,FJI,Kedah,2,2,0
2024-04-01,FJI,Perlis,1,0,1
2024-04-01,FJI,Pulau Pinang,5,4,1
2024-04-01,FJI,Selangor,149,70,79
2024-04-01,FRA,Johor,2567,1498,1069
2024-04-01,FRA,Kedah,942,474,468
2024-04-01,FRA,Kelantan,20,11,9
2024-04-01,FRA,Melaka,9,5,4
2024-04-01,FRA,Negeri Sembilan,2,1,1
2024-04-01,FRA,Pahang,56,28,28
2024-04-01,FRA,Perak,28,16,12
2024-04-01,FRA,Perlis,91,59,32
2024-04-01,FRA,Pulau Pinang,342,198,144
2024-04-01,FRA,Sabah,166,96,70
2024-04-01,FRA,Sarawak,141,86,55
2024-04-01,FRA,Selangor,10465,5753,4712
2024-04-01,FRA,W.P. Labuan,9,4,5
2024-04-01,GAB,Johor,3,1,2
2024-04-01,GAB,Selangor,9,4,5
2024-04-01,GBR,Johor,5383,3339,2044
2024-04-01,GBR,Kedah,2112,1118,994
2024-04-01,GBR,Kelantan,9,8,1
2024-04-01,GBR,Melaka,2,1,1
2024-04-01,GBR,Pahang,10,9,1
2024-04-01,GBR,Perak,114,68,46
2024-04-01,GBR,Perlis,173,112,61
2024-04-01,GBR,Pulau Pinang,5968,2945,3023
2024-04-01,GBR,Sabah,654,349,305
2024-04-01,GBR,Sarawak,1134,676,458
2024-04-01,GBR,Selangor,19008,11101,7907
2024-04-01,GBR,W.P. Labuan,39,31,8
2024-04-01,GEO,Johor,22,17,5
2024-04-01,GEO,Kelantan,1,1,0
2024-04-01,GEO,Perlis,1,1,0
2024-04-01,GEO,Pulau Pinang,2,1,1
2024-04-01,GEO,Sabah,2,1,1
2024-04-01,GEO,Sarawak,1,0,1
2024-04-01,GEO,Selangor,45,29,16
2024-04-01,GHA,Johor,4,3,1
2024-04-01,GHA,Kedah,1,1,0
2024-04-01,GHA,Pulau Pinang,1,0,1
2024-04-01,GHA,Selangor,95,59,36
2024-04-01,GIN,Johor,4,3,1
2024-04-01,GIN,Selangor,34,28,6
2024-04-01,GMB,Selangor,20,16,4
2024-04-01,GNB,Selangor,2,1,1
2024-04-01,GNQ,Johor,1,1,0
2024-04-01,GNQ,Selangor,2,1,1
2024-04-01,GRC,Johor,53,36,17
2024-04-01,GRC,Kedah,11,10,1
2024-04-01,GRC,Perak,1,1,0
2024-04-01,GRC,Perlis,2,2,0
2024-04-01,GRC,Pulau Pinang,8,4,4
2024-04-01,GRC,Sabah,4,3,1
2024-04-01,GRC,Sarawak,4,3,1
2024-04-01,GRC,Selangor,298,190,108
2024-04-01,GRD,Johor,6,2,4
2024-04-01,GRD,Kedah,4,2,2
2024-04-01,GRD,Selangor,7,5,2
2024-04-01,GTM,Johor,2,1,1
2024-04-01,GTM,Kedah,1,1,0
2024-04-01,GTM,Pulau Pinang,1,0,1
2024-04-01,GTM,Sabah,1,1,0
2024-04-01,GTM,Selangor,25,13,12
2024-04-01,GUY,Selangor,8,5,3
2024-04-01,HKG,Johor,6,4,2
2024-04-01,HKG,Pahang,1,1,0
2024-04-01,HKG,Perak,44,21,23
2024-04-01,HKG,Perlis,3,2,1
2024-04-01,HKG,Pulau Pinang,3,0,3
2024-04-01,HKG,Sabah,22,13,9
2024-04-01,HKG,Selangor,52,23,29
2024-04-01,HND,Johor,3,3,0
2024-04-01,HND,Selangor,22,15,7
2024-04-01,HRV,Johor,32,24,8
2024-04-01,HRV,Kedah,9,4,5
2024-04-01,HRV,Perlis,1,1,0
2024-04-01,HRV,Pulau Pinang,7,7,0
2024-04-01,HRV,Sabah,7,6,1
2024-04-01,HRV,Sarawak,4,2,2
2024-04-01,HRV,Selangor,215,129,86
2024-04-01,HTI,Sabah,1,1,0
2024-04-01,HTI,Selangor,11,5,6
2024-04-01,HUN,Johor,128,74,54
2024-04-01,HUN,Kedah,35,15,20
2024-04-01,HUN,Perlis,4,2,2
2024-04-01,HUN,Pulau Pinang,13,9,4
2024-04-01,HUN,Sabah,2,1,1
2024-04-01,HUN,Sarawak,29,15,14
2024-04-01,HUN,Selangor,549,301,248
2024-04-01,IDN,Johor,100989,46197,54792
2024-04-01,IDN,Kedah,2583,962,1621
2024-04-01,IDN,Kelantan,167,80,87
2024-04-01,IDN,Melaka,4697,2070,2627
2024-04-01,IDN,Negeri Sembilan,5176,3149,2027
2024-04-01,IDN,Pahang,19,14,5
2024-04-01,IDN,Perak,217,77,140
2024-04-01,IDN,Perlis,707,263,444
2024-04-01,IDN,Pulau Pinang,36706,15143,21563
2024-04-01,IDN,Sabah,6268,3121,3147
2024-04-01,IDN,Sarawak,54088,28166,25922
2024-04-01,IDN,Selangor,166132,77610,88522
2024-04-01,IDN,W.P. Labuan,66,24,42
2024-04-01,IND,Johor,32493,20972,11521
2024-04-01,IND,Kedah,1701,942,759
2024-04-01,IND,Kelantan,4,4,0
2024-04-01,IND,Melaka,3,3,0
2024-04-01,IND,Negeri Sembilan,1,1,0
2024-04-01,IND,Pahang,11,9,2
2024-04-01,IND,Perak,200,119,81
2024-04-01,IND,Perlis,79,61,18
2024-04-01,IND,Pulau Pinang,1870,1186,684
2024-04-01,IND,Sabah,234,139,95
2024-04-01,IND,Sarawak,2593,1994,599
2024-04-01,IND,Selangor,75329,48165,27164
2024-04-01,IND,W.P. Labuan,75,63,12
2024-04-01,IOT,Selangor,1,0,1
2024-04-01,IRL,Johor,315,197,118
2024-04-01,IRL,Kedah,142,70,72
2024-04-01,IRL,Kelantan,4,3,1
2024-04-01,IRL,Perak,7,6,1
2024-04-01,IRL,Perlis,12,5,7
2024-04-01,IRL,Pulau Pinang,134,74,60
2024-04-01,IRL,Sabah,27,12,15
2024-04-01,IRL,Sarawak,31,14,17
2024-04-01,IRL,Selangor,1409,804,605
2024-04-01,IRL,W.P. Labuan,1,0,1
2024-04-01,IRN,Johor,336,166,170
2024-04-01,IRN,Kedah,15,2,13
2024-04-01,IRN,Melaka,1,1,0
2024-04-01,IRN,Perak,1,0,1
2024-04-01,IRN,Perlis,10,6,4
2024-04-01,IRN,Pulau Pinang,11,5,6
2024-04-01,IRN,Sabah,2,1,1
2024-04-01,IRN,Sarawak,7,7,0
2024-04-01,IRN,Selangor,1965,1060,905
2024-04-01,IRQ,Johor,32,27,5
2024-04-01,IRQ,Kedah,10,8,2
2024-04-01,IRQ,Pulau Pinang,6,4,2
2024-04-01,IRQ,Sabah,1,0,1
2024-04-01,IRQ,Sarawak,3,1,2
2024-04-01,IRQ,Selangor,1193,839,354
2024-04-01,ISL,Johor,6,2,4
2024-04-01,ISL,Perak,2,1,1
2024-04-01,ISL,Pulau Pinang,4,2,2
2024-04-01,ISL,Selangor,31,14,17
2024-04-01,ISR,Selangor,6,6,0
2024-04-01,ITA,Johor,639,421,218
2024-04-01,ITA,Kedah,240,135,105
2024-04-01,ITA,Kelantan,3,2,1
2024-04-01,ITA,Melaka,1,1,0
2024-04-01,ITA,Negeri Sembilan,3,3,0
2024-04-01,ITA,Pahang,1,1,0
2024-04-01,ITA,Perak,17,6,11
2024-04-01,ITA,Perlis,21,14,7
2024-04-01,ITA,Pulau Pinang,83,57,26
2024-04-01,ITA,Sabah,57,35,22
2024-04-01,ITA,Sarawak,57,35,22
2024-04-01,ITA,Selangor,3403,2022,1381
2024-04-01,ITA,W.P. Labuan,2,0,2
2024-04-01,JAM,Johor,4,2,2
2024-04-01,JAM,Kedah,5,1,4
2024-04-01,JAM,Pulau Pinang,1,0,1
2024-04-01,JAM,Selangor,20,8,12
2024-04-01,JOR,Johor,13,6,7
2024-04-01,JOR,Kedah,12,8,4
2024-04-01,JOR,Kelantan,1,1,0
2024-04-01,JOR,Pahang,1,1,0
2024-04-01,JOR,Perlis,1,0,1
2024-04-01,JOR,Pulau Pinang,12,7,5
2024-04-01,JOR,Sarawak,5,3,2
2024-04-01,JOR,Selangor,862,530,332
2024-04-01,JPN,Johor,5777,3801,1976
2024-04-01,JPN,Kedah,463,234,229
2024-04-01,JPN,Kelantan,9,8,1
2024-04-01,JPN,Pahang,12,7,5
2024-04-01,JPN,Perak,60,35,25
2024-04-01,JPN,Perlis,85,57,28
2024-04-01,JPN,Pulau Pinang,1143,753,390
2024-04-01,JPN,Sabah,581,291,290
2024-04-01,JPN,Sarawak,144,84,60
2024-04-01,JPN,Selangor,18647,10830,7817
2024-04-01,JPN,W.P. Labuan,13,10,3
2024-04-01,KAZ,Johor,48,16,32
2024-04-01,KAZ,Kedah,55,21,34
2024-04-01,KAZ,Kelantan,2,0,2
2024-04-01,KAZ,Perlis,11,2,9
2024-04-01,KAZ,Pulau Pinang,8,3,5
2024-04-01,KAZ,Sabah,4,2,2
2024-04-01,KAZ,Sarawak,18,9,9
2024-04-01,KAZ,Selangor,3521,1378,2143
2024-04-01,KEN,Johor,56,21,35
2024-04-01,KEN,Kedah,9,4,5
2024-04-01,KEN,Melaka,1,0,1
2024-04-01,KEN,Pulau Pinang,5,2,3
2024-04-01,KEN,Sarawak,1,1,0
2024-04-01,KEN,Selangor,344,162,182
2024-04-01,KGZ,Johor,33,22,11
2024-04-01,KGZ,Kedah,13,5,8
2024-04-01,KGZ,Perlis,1,1,0
2024-04-01,KGZ,Pulau Pinang,8,0,8
2024-04-01,KGZ,Sarawak,2,2,0
2024-04-01,KGZ,Selangor,467,205,262
2024-04-01,KHM,Johor,2424,1048,1376
2024-04-01,KHM,Kedah,194,162,32
2024-04-01,KHM,Kelantan,357,200,157
2024-04-01,KHM,Perak,6,1,5
2024-04-01,KHM,Perlis,822,531,291
2024-04-01,KHM,Pulau Pinang,25,5,20
2024-04-01,KHM,Sarawak,5,3,2
2024-04-01,KHM,Selangor,4428,2115,2313
2024-04-01,KIR,Johor,2,0,2
2024-04-01,KNA,Johor,25,14,11
2024-04-01,KNA,Kedah,9,3,6
2024-04-01,KNA,Pulau Pinang,1,1,0
2024-04-01,KNA,Selangor,53,38,15
2024-04-01,KOR,Johor,9475,5211,4264
2024-04-01,KOR,Kedah,269,109,160
2024-04-01,KOR,Kelantan,5,2,3
2024-04-01,KOR,Melaka,1,1,0
2024-04-01,KOR,Perak,25,13,12
2024-04-01,KOR,Perlis,65,43,22
2024-04-01,KOR,Pulau Pinang,557,300,257
2024-04-01,KOR,Sabah,11009,4304,6705
2024-04-01,KOR,Sarawak,216,123,93
2024-04-01,KOR,Selangor,12860,6999,5861
2024-04-01,KOR,W.P. Labuan,3,2,1
2024-04-01,KWT,Johor,14,5,9
2024-04-01,KWT,Kedah,11,7,4
2024-04-01,KWT,Pulau Pinang,4,3,1
2024-04-01,KWT,Selangor,201,127,74
2024-04-01,LAO,Johor,214,62,152
2024-04-01,LAO,Kedah,676,51,625
2024-04-01,LAO,Kelantan,177,44,133
2024-04-01,LAO,Perak,33,5,28
2024-04-01,LAO,Perlis,264,45,219
2024-04-01,LAO,Pulau Pinang,20,4,16
2024-04-01,LAO,Sarawak,17,9,8
2024-04-01,LAO,Selangor,310,125,185
2024-04-01,LBN,Johor,28,18,10
2024-04-01,LBN,Kedah,16,10,6
2024-04-01,LBN,Pulau Pinang,14,7,7
2024-04-01,LBN,Sabah,2,1,1
2024-04-01,LBN,Sarawak,4,3,1
2024-04-01,LBN,Selangor,352,223,129
2024-04-01,LBR,Johor,2,2,0
2024-04-01,LBR,Selangor,4,3,1
2024-04-01,LBY,Johor,6,6,0
2024-04-01,LBY,Kedah,2,2,0
2024-04-01,LBY,Sabah,1,0,1
2024-04-01,LBY,Selangor,283,204,79
2024-04-01,LCA,Johor,3,1,2
2024-04-01,LCA,Pulau Pinang,4,1,3
2024-04-01,LCA,Selangor,7,4,3
2024-04-01,LIE,Kedah,7,1,6
2024-04-01,LIE,Perak,1,1,0
2024-04-01,LIE,Selangor,12,7,5
2024-04-01,LKA,Johor,721,427,294
2024-04-01,LKA,Kedah,6,6,0
2024-04-01,LKA,Perlis,1,1,0
2024-04-01,LKA,Pulau Pinang,30,18,12
2024-04-01,LKA,Sabah,7,6,1
2024-04-01,LKA,Sarawak,37,27,10
2024-04-01,LKA,Selangor,4904,2875,2029
2024-04-01,LKA,W.P. Labuan,1,1,0
2024-04-01,LSO,Selangor,12,5,7
2024-04-01,LTU,Johor,92,49,43
2024-04-01,LTU,Kedah,41,18,23
2024-04-01,LTU,Perlis,4,2,2
2024-04-01,LTU,Pulau Pinang,15,7,8
2024-04-01,LTU,Sabah,4,3,1
2024-04-01,LTU,Sarawak,2,1,1
2024-04-01,LTU,Selangor,357,186,171
2024-04-01,LTU,Terengganu,1,1,0
2024-04-01,LTU,W.P. Labuan,6,1,5
2024-04-01,LUX,Johor,11,8,3
2024-04-01,LUX,Kedah,13,7,6
2024-04-01,LUX,Perlis,1,1,0
2024-04-01,LUX,Pulau Pinang,3,3,0
2024-04-01,LUX,Sabah,1,1,0
2024-04-01,LUX,Selangor,75,40,35
2024-04-01,LVA,Johor,52,24,28
2024-04-01,LVA,Kedah,10,5,5
2024-04-01,LVA,Perlis,4,3,1
2024-04-01,LVA,Pulau Pinang,10,5,5
2024-04-01,LVA,Sabah,1,0,1
2024-04-01,LVA,Sarawak,1,1,0
2024-04-01,LVA,Selangor,186,78,108
2024-04-01,LVA,W.P. Labuan,5,2,3
2024-04-01,MAC,Perak,1,1,0
2024-04-01,MAC,Selangor,2,1,1
2024-04-01,MAR,Johor,111,70,41
2024-04-01,MAR,Kedah,16,10,6
2024-04-01,MAR,Kelantan,2,0,2
2024-04-01,MAR,Perlis,4,2,2
2024-04-01,MAR,Pulau Pinang,12,7,5
2024-04-01,MAR,Sabah,2,1,1
2024-04-01,MAR,Sarawak,7,3,4
2024-04-01,MAR,Selangor,978,526,452
2024-04-01,MCO,Selangor,6,4,2
2024-04-01,MDA,Johor,6,2,4
2024-04-01,MDA,Sabah,1,1,0
2024-04-01,MDA,Selangor,34,16,18
2024-04-01,MDG,Johor,7,2,5
2024-04-01,MDG,Selangor,133,58,75
2024-04-01,MDV,Johor,134,67,67
2024-04-01,MDV,Sabah,4,3,1
2024-04-01,MDV,Sarawak,6,4,2
2024-04-01,MDV,Selangor,3206,1725,1481
2024-04-01,MEX,Johor,233,95,138
2024-04-01,MEX,Kedah,15,7,8
2024-04-01,MEX,Perlis,5,3,2
2024-04-01,MEX,Pulau Pinang,31,23,8
2024-04-01,MEX,Sabah,5,3,2
2024-04-01,MEX,Selangor,841,391,450
2024-04-01,MHL,Selangor,2,2,0
2024-04-01,MKD,Johor,8,3,5
2024-04-01,MKD,Kedah,3,2,1
2024-04-01,MKD,Perlis,2,2,0
2024-04-01,MKD,Pulau Pinang,4,1,3
2024-04-01,MKD,Sarawak,3,2,1
2024-04-01,MKD,Selangor,49,20,29
2024-04-01,MLI,Pulau Pinang,1,0,1
2024-04-01,MLI,Selangor,9,8,1
2024-04-01,MLT,Johor,9,5,4
2024-04-01,MLT,Sabah,1,1,0
2024-04-01,MLT,Selangor,55,35,20
2024-04-01,MMR,Johor,6833,2245,4588
2024-04-01,MMR,Kedah,79,21,58
2024-04-01,MMR,Kelantan,5,2,3
2024-04-01,MMR,Melaka,1,0,1
2024-04-01,MMR,Pahang,4,0,4
2024-04-01,MMR,Perak,27,7,20
2024-04-01,MMR,Perlis,15,2,13
2024-04-01,MMR,Pulau Pinang,215,89,126
2024-04-01,MMR,Sabah,9,4,5
2024-04-01,MMR,Sarawak,65,35,30
2024-04-01,MMR,Selangor,6877,4522,2355
2024-04-01,MNE,Johor,3,3,0
2024-04-01,MNE,Pulau Pinang,3,2,1
2024-04-01,MNE,Selangor,19,14,5
2024-04-01,MNG,Johor,170,72,98
2024-04-01,MNG,Kedah,11,7,4
2024-04-01,MNG,Perak,4,1,3
2024-04-01,MNG,Pulau Pinang,3,1,2
2024-04-01,MNG,Sabah,3,1,2
2024-04-01,MNG,Sarawak,1,0,1
2024-04-01,MNG,Selangor,354,147,207
2024-04-01,MOZ,Johor,1,0,1
2024-04-01,MOZ,Selangor,20,10,10
2024-04-01,MRT,Johor,1,1,0
2024-04-01,MRT,Selangor,14,12,2
2024-04-01,MUS,Johor,290,139,151
2024-04-01,MUS,Kedah,13,7,6
2024-04-01,MUS,Perlis,3,3,0
2024-04-01,MUS,Pulau Pinang,10,5,5
2024-04-01,MUS,Sabah,1,1,0
2024-04-01,MUS,Sarawak,1,0,1
2024-04-01,MUS,Selangor,2205,1094,1111
2024-04-01,MWI,Pulau Pinang,3,2,1
2024-04-01,MWI,Selangor,22,12,10
2024-04-01,NAM,Johor,1,1,0
2024-04-01,NAM,Selangor,8,3,5
2024-04-01,NER,Selangor,4,0,4
2024-04-01,NGA,Johor,19,17,2
2024-04-01,NGA,Pulau Pinang,8,8,0
2024-04-01,NGA,Sabah,2,2,0
2024-04-01,NGA,Sarawak,6,5,1
2024-04-01,NGA,Selangor,428,332,96
2024-04-01,NIC,Johor,3,2,1
2024-04-01,NIC,Kedah,1,0,1
2024-04-01,NIC,Pulau Pinang,2,1,1
2024-04-01,NIC,Selangor,3,2,1
2024-04-01,NLD,Johor,1123,694,429
2024-04-01,NLD,Kedah,428,210,218
2024-04-01,NLD,Kelantan,4,3,1
2024-04-01,NLD,Melaka,2,2,0
2024-04-01,NLD,Negeri Sembilan,1,1,0
2024-04-01,NLD,Pahang,5,3,2
2024-04-01,NLD,Perak,12,6,6
2024-04-01,NLD,Perlis,41,20,21
2024-04-01,NLD,Pulau Pinang,247,143,104
2024-04-01,NLD,Sabah,96,55,41
2024-04-01,NLD,Sarawak,146,90,56
2024-04-01,NLD,Selangor,4591,2597,1994
2024-04-01,NLD,W.P. Labuan,1,1,0
2024-04-01,NOR,Johor,173,110,63
2024-04-01,NOR,Kedah,66,20,46
2024-04-01,NOR,Kelantan,1,1,0
2024-04-01,NOR,Perak,1,1,0
2024-04-01,NOR,Perlis,17,8,9
2024-04-01,NOR,Pulau Pinang,35,27,8
2024-04-01,NOR,Sabah,7,4,3
2024-04-01,NOR,Sarawak,18,13,5
2024-04-01,NOR,Selangor,630,371,259
2024-04-01,NOR,W.P. Labuan,1,1,0
2024-04-01,NPL,Johor,1077,835,242
2024-04-01,NPL,Kedah,17,10,7
2024-04-01,NPL,Perak,1,1,0
2024-04-01,NPL,Perlis,10,10,0
2024-04-01,NPL,Pulau Pinang,9,8,1
2024-04-01,NPL,Sabah,2,2,0
2024-04-01,NPL,Sarawak,306,206,100
2024-04-01,NPL,Selangor,10072,9561,511
2024-04-01,NPL,W.P. Labuan,56,50,6
2024-04-01,NRU,Selangor,4,3,1
2024-04-01,NZL,Johor,915,559,356
2024-04-01,NZL,Kedah,149,81,68
2024-04-01,NZL,Kelantan,1,1,0
2024-04-01,NZL,Negeri Sembilan,1,1,0
2024-04-01,NZL,Pahang,11,5,6
2024-04-01,NZL,Perak,26,18,8
2024-04-01,NZL,Perlis,20,11,9
2024-04-01,NZL,Pulau Pinang,196,104,92
2024-04-01,NZL,Sabah,72,32,40
2024-04-01,NZL,Sarawak,130,73,57
2024-04-01,NZL,Selangor,2802,1640,1162
2024-04-01,NZL,Terengganu,1,0,1
2024-04-01,NZL,W.P. Labuan,6,3,3
2024-04-01,OMN,Johor,18,9,9
2024-04-01,OMN,Kedah,5,3,2
2024-04-01,OMN,Kelantan,1,1,0
2024-04-01,OMN,Perak,1,1,0
2024-04-01,OMN,Pulau Pinang,2,2,0
2024-04-01,OMN,Sarawak,10,3,7
2024-04-01,OMN,Selangor,682,427,255
2024-04-01,PAK,Johor,602,463,139
2024-04-01,PAK,Kedah,90,59,31
2024-04-01,PAK,Kelantan,16,15,1
2024-04-01,PAK,Pahang,2,2,0
2024-04-01,PAK,Perak,3,3,0
2024-04-01,PAK,Perlis,18,17,1
2024-04-01,PAK,Pulau Pinang,74,60,14
2024-04-01,PAK,Sabah,23,18,5
2024-04-01,PAK,Sarawak,218,177,41
2024-04-01,PAK,Selangor,6853,5607,1246
2024-04-01,PAK,W.P. Labuan,3,3,0
2024-04-01,PAN,Johor,10,4,6
2024-04-01,PAN,Sabah,2,0,2
2024-04-01,PAN,Sarawak,1,0,1
2024-04-01,PAN,Selangor,28,15,13
2024-04-01,PER,Johor,24,13,11
2024-04-01,PER,Kedah,7,3,4
2024-04-01,PER,Perak,2,1,1
2024-04-01,PER,Perlis,1,0,1
2024-04-01,PER,Pulau Pinang,1,1,0
2024-04-01,PER,Sabah,1,0,1
2024-04-01,PER,Selangor,148,78,70
2024-04-01,PHL,Johor,23651,7539,16112
2024-04-01,PHL,Kedah,410,121,289
2024-04-01,PHL,Kelantan,49,24,25
2024-04-01,PHL,Negeri Sembilan,6,5,1
2024-04-01,PHL,Pahang,17,9,8
2024-04-01,PHL,Perak,63,22,41
2024-04-01,PHL,Perlis,180,49,131
2024-04-01,PHL,Pulau Pinang,670,278,392
2024-04-01,PHL,Sabah,1084,560,524
2024-04-01,PHL,Sarawak,3189,1262,1927
2024-04-01,PHL,Selangor,15292,6063,9229
2024-04-01,PHL,W.P. Labuan,146,46,100
2024-04-01,PNG,Johor,13,6,7
2024-04-01,PNG,Sabah,4,2,2
2024-04-01,PNG,Sarawak,3,2,1
2024-04-01,PNG,Selangor,81,48,33
2024-04-01,POL,Johor,377,223,154
2024-04-01,POL,Kedah,194,94,100
2024-04-01,POL,Kelantan,3,3,0
2024-04-01,POL,Pahang,1,0,1
2024-04-01,POL,Perak,4,1,3
2024-04-01,POL,Perlis,13,9,4
2024-04-01,POL,Pulau Pinang,88,47,41
2024-04-01,POL,Sabah,59,27,32
2024-04-01,POL,Sarawak,67,38,29
2024-04-01,POL,Selangor,1570,807,763
2024-04-01,POL,W.P. Labuan,3,2,1
2024-04-01,PRI,Sabah,1,0,1
2024-04-01,PRT,Johor,208,117,91
2024-04-01,PRT,Kedah,128,62,66
2024-04-01,PRT,Kelantan,1,0,1
2024-04-01,PRT,Pahang,1,1,0
2024-04-01,PRT,Perak,2,1,1
2024-04-01,PRT,Perlis,10,3,7
2024-04-01,PRT,Pulau Pinang,46,30,16
2024-04-01,PRT,Sabah,97,54,43
2024-04-01,PRT,Sarawak,14,8,6
2024-04-01,PRT,Selangor,961,557,404
2024-04-01,PRY,Johor,3,2,1
2024-04-01,PRY,Sabah,3,2,1
2024-04-01,PRY,Selangor,9,5,4
2024-04-01,PSE,Johor,29,28,1
2024-04-01,PSE,Kedah,2,1,1
2024-04-01,PSE,Pulau Pinang,2,2,0
2024-04-01,PSE,Sabah,1,1,0
2024-04-01,PSE,Sarawak,1,1,0
2024-04-01,PSE,Selangor,270,205,65
2024-04-01,QAT,Johor,2,2,0
2024-04-01,QAT,Kedah,2,1,1
2024-04-01,QAT,Selangor,137,86,51
2024-04-01,ROU,Johor,215,110,105
2024-04-01,ROU,Kedah,27,12,15
2024-04-01,ROU,Pahang,2,2,0
2024-04-01,ROU,Perak,3,1,2
2024-04-01,ROU,Perlis,2,2,0
2024-04-01,ROU,Pulau Pinang,14,9,5
2024-04-01,ROU,Sabah,9,6,3
2024-04-01,ROU,Sarawak,8,7,1
2024-04-01,ROU,Selangor,765,365,400
2024-04-01,RUS,Johor,465,222,243
2024-04-01,RUS,Kedah,454,214,240
2024-04-01,RUS,Kelantan,29,16,13
2024-04-01,RUS,Melaka,1,0,1
2024-04-01,RUS,Pahang,3,1,2
2024-04-01,RUS,Perak,6,3,3
2024-04-01,RUS,Perlis,86,51,35
2024-04-01,RUS,Pulau Pinang,147,83,64
2024-04-01,RUS,Sabah,54,27,27
2024-04-01,RUS,Sarawak,49,28,21
2024-04-01,RUS,Selangor,10143,4933,5210
2024-04-01,RUS,W.P. Labuan,7,3,4
2024-04-01,RWA,Johor,5,1,4
2024-04-01,RWA,Selangor,9,6,3
2024-04-01,SAU,Johor,157,79,78
2024-04-01,SAU,Kedah,21,16,5
2024-04-01,SAU,Kelantan,2,2,0
2024-04-01,SAU,Perlis,2,2,0
2024-04-01,SAU,Pulau Pinang,12,8,4
2024-04-01,SAU,Sabah,4,2,2
2024-04-01,SAU,Sarawak,12,7,5
2024-04-01,SAU,Selangor,2426,1444,982
2024-04-01,SDN,Johor,18,13,5
2024-04-01,SDN,Kedah,6,2,4
2024-04-01,SDN,Pulau Pinang,3,2,1
2024-04-01,SDN,Sarawak,7,5,2
2024-04-01,SDN,Selangor,819,499,320
2024-04-01,SDN,W.P. Labuan,2,2,0
2024-04-01,SEN,Johor,2,2,0
2024-04-01,SEN,Selangor,82,50,32
2024-04-01,SGP,Johor,1306727,756435,550292
2024-04-01,SGP,Kedah,2536,1314,1222
2024-04-01,SGP,Kelantan,49,33,16
2024-04-01,SGP,Melaka,39,27,12
2024-04-01,SGP,Negeri Sembilan,1,0,1
2024-04-01,SGP,Pahang,423,224,199
2024-04-01,SGP,Perak,5174,2415,2759
2024-04-01,SGP,Perlis,159,107,52
2024-04-01,SGP,Pulau Pinang,14246,7028,7218
2024-04-01,SGP,Sabah,1504,788,716
2024-04-01,SGP,Sarawak,3293,1867,1426
2024-04-01,SGP,Selangor,45315,23122,22193
2024-04-01,SGP,W.P. Labuan,3,3,0
2024-04-01,SLB,Johor,3,3,0
2024-04-01,SLB,Pulau Pinang,1,0,1
2024-04-01,SLB,Sarawak,10,2,8
2024-04-01,SLB,Selangor,5,4,1
2024-04-01,SLE,Johor,2,1,1
2024-04-01,SLE,Selangor,10,6,4
2024-04-01,SLV,Kedah,1,0,1
2024-04-01,SLV,Selangor,15,11,4
2024-04-01,SMR,Selangor,7,5,2
2024-04-01,SOM,Kelantan,2,0,2
2024-04-01,SOM,Pulau Pinang,5,1,4
2024-04-01,SOM,Selangor,194,107,87
2024-04-01,SRB,Johor,15,11,4
2024-04-01,SRB,Kedah,1,1,0
2024-04-01,SRB,Pahang,1,1,0
2024-04-01,SRB,Perak,1,1,0
2024-04-01,SRB,Perlis,1,0,1
2024-04-01,SRB,Pulau Pinang,2,2,0
2024-04-01,SRB,Sabah,1,1,0
2024-04-01,SRB,Sarawak,4,2,2
2024-04-01,SRB,Selangor,87,51,36
2024-04-01,SSD,Sarawak,3,1,2
2024-04-01,SSD,Selangor,29,13,16
2024-04-01,SSD,W.P. Labuan,3,1,2
2024-04-01,STP,Selangor,1,0,1
2024-04-01,SUR,Johor,3,2,1
2024-04-01,SUR,Pulau Pinang,3,2,1
2024-04-01,SUR,Selangor,23,14,9
2024-04-01,SVK,Johor,56,31,25
2024-04-01,SVK,Kedah,77,41,36
2024-04-01,SVK,Perlis,2,1,1
2024-04-01,SVK,Pulau Pinang,20,14,6
2024-04-01,SVK,Sabah,3,3,0
2024-04-01,SVK,Sarawak,6,3,3
2024-04-01,SVK,Selangor,327,163,164
2024-04-01,SVN,Johor,38,16,22
2024-04-01,SVN,Kedah,14,6,8
2024-04-01,SVN,Sabah,1,0,1
2024-04-01,SVN,Sarawak,2,0,2
2024-04-01,SVN,Selangor,205,110,95
2024-04-01,SWE,Johor,243,147,96
2024-04-01,SWE,Kedah,160,61,99
2024-04-01,SWE,Kelantan,5,5,0
2024-04-01,SWE,Perak,6,3,3
2024-04-01,SWE,Perlis,5,4,1
2024-04-01,SWE,Pulau Pinang,64,42,22
2024-04-01,SWE,Sabah,14,10,4
2024-04-01,SWE,Sarawak,18,13,5
2024-04-01,SWE,Selangor,965,558,407
2024-04-01,SWE,W.P. Labuan,1,1,0
2024-04-01,SWZ,Johor,1,1,0
2024-04-01,SWZ,Selangor,21,8,13
2024-04-01,SYC,Johor,10,4,6
2024-04-01,SYC,Selangor,132,57,75
2024-04-01,SYR,Johor,27,20,7
2024-04-01,SYR,Kedah,24,9,15
2024-04-01,SYR,Perlis,1,1,0
2024-04-01,SYR,Pulau Pinang,7,6,1
2024-04-01,SYR,Sabah,1,1,0
2024-04-01,SYR,Sarawak,2,2,0
2024-04-01,SYR,Selangor,529,345,184
2024-04-01,TCD,Selangor,22,18,4
2024-04-01,TGO,Johor,1,1,0
2024-04-01,TGO,Sarawak,1,0,1
2024-04-01,TGO,Selangor,7,3,4
2024-04-01,THA,Johor,10451,3285,7166
2024-04-01,THA,Kedah,46961,26232,20729
2024-04-01,THA,Kelantan,54643,27067,27576
2024-04-01,THA,Negeri Sembilan,1,0,1
2024-04-01,THA,Pahang,7,4,3
2024-04-01,THA,Perak,11918,5467,6451
2024-04-01,THA,Perlis,51523,29059,22464
2024-04-01,THA,Pulau Pinang,2627,977,1650
2024-04-01,THA,Sabah,32,13,19
2024-04-01,THA,Sarawak,405,123,282
2024-04-01,THA,Selangor,15232,5653,9579
2024-04-01,THA,W.P. Labuan,11,5,6
2024-04-01,TJK,Johor,1,0,1
2024-04-01,TJK,Kedah,3,3,0
2024-04-01,TJK,Sabah,5,4,1
2024-04-01,TJK,Selangor,108,70,38
2024-04-01,TKM,Johor,6,3,3
2024-04-01,TKM,Kedah,8,4,4
2024-04-01,TKM,Sarawak,1,1,0
2024-04-01,TKM,Selangor,325,173,152
2024-04-01,TLS,Johor,5,4,1
2024-04-01,TLS,Pulau Pinang,6,3,3
2024-04-01,TLS,Sarawak,6,5,1
2024-04-01,TLS,Selangor,178,101,77
2024-04-01,TON,Johor,1,1,0
2024-04-01,TON,Kedah,1,0,1
2024-04-01,TON,Pulau Pinang,2,0,2
2024-04-01,TON,Selangor,21,8,13
2024-04-01,TTO,Johor,8,3,5
2024-04-01,TTO,Sarawak,1,1,0
2024-04-01,TTO,Selangor,28,14,14
2024-04-01,TUN,Johor,17,11,6
2024-04-01,TUN,Kedah,4,2,2
2024-04-01,TUN,Pulau Pinang,6,1,5
2024-04-01,TUN,Sabah,1,1,0
2024-04-01,TUN,Sarawak,1,1,0
2024-04-01,TUN,Selangor,655,338,317
2024-04-01,TUR,Johor,404,238,166
2024-04-01,TUR,Kedah,61,39,22
2024-04-01,TUR,Kelantan,2,2,0
2024-04-01,TUR,Melaka,1,1,0
2024-04-01,TUR,Perak,3,3,0
2024-04-01,TUR,Perlis,22,17,5
2024-04-01,TUR,Pulau Pinang,41,31,10
2024-04-01,TUR,Sabah,4,2,2
2024-04-01,TUR,Sarawak,30,22,8
2024-04-01,TUR,Selangor,2000,1280,720
2024-04-01,TUV,Johor,1,1,0
2024-04-01,TWN,Johor,7988,3317,4671
2024-04-01,TWN,Kedah,232,96,136
2024-04-01,TWN,Kelantan,11,10,1
2024-04-01,TWN,Pahang,3,3,0
2024-04-01,TWN,Perak,89,38,51
2024-04-01,TWN,Perlis,36,21,15
2024-04-01,TWN,Pulau Pinang,3454,1741,1713
2024-04-01,TWN,Sabah,2136,1016,1120
2024-04-01,TWN,Sarawak,328,125,203
2024-04-01,TWN,Selangor,14443,6867,7576
2024-04-01,TWN,W.P. Labuan,2,1,1
2024-04-01,TZA,Johor,16,9,7
2024-04-01,TZA,Perak,1,1,0
2024-04-01,TZA,Selangor,148,81,67
2024-04-01,UGA,Johor,11,6,5
2024-04-01,UGA,Kedah,1,1,0
2024-04-01,UGA,Sarawak,2,2,0
2024-04-01,UGA,Selangor,109,41,68
2024-04-01,UKR,Johor,114,50,64
2024-04-01,UKR,Kedah,46,24,22
2024-04-01,UKR,Kelantan,6,3,3
2024-04-01,UKR,Pahang,1,1,0
2024-04-01,UKR,Perak,2,2,0
2024-04-01,UKR,Perlis,11,7,4
2024-04-01,UKR,Pulau Pinang,18,8,10
2024-04-01,UKR,Sabah,8,5,3
2024-04-01,UKR,Sarawak,5,4,1
2024-04-01,UKR,Selangor,1165,568,597
2024-04-01,UKR,W.P. Labuan,1,1,0
2024-04-01,URY,Johor,62,25,37
2024-04-01,URY,Kedah,4,3,1
2024-04-01,URY,Selangor,112,37,75
2024-04-01,USA,Johor,4625,2661,1964
2024-04-01,USA,Kedah,490,271,219
2024-04-01,USA,Kelantan,16,16,0
2024-04-01,USA,Melaka,1,1,0
2024-04-01,USA,Pahang,6,3,3
2024-04-01,USA,Perak,125,72,53
2024-04-01,USA,Perlis,117,82,35
2024-04-01,USA,Pulau Pinang,1890,1121,769
2024-04-01,USA,Sabah,441,226,215
2024-04-01,USA,Sarawak,263,151,112
2024-04-01,USA,Selangor,15326,8680,6646
2024-04-01,USA,W.P. Labuan,4,3,1
2024-04-01,UZB,Johor,77,63,14
2024-04-01,UZB,Kedah,12,4,8
2024-04-01,UZB,Kelantan,2,1,1
2024-04-01,UZB,Perlis,1,1,0
2024-04-01,UZB,Sabah,6,5,1
2024-04-01,UZB,Sarawak,1,0,1
2024-04-01,UZB,Selangor,1006,633,373
2024-04-01,VAT,Johor,2,2,0
2024-04-01,VAT,Selangor,1,1,0
2024-04-01,VCT,Selangor,2,2,0
2024-04-01,VEN,Johor,19,11,8
2024-04-01,VEN,Kedah,8,6,2
2024-04-01,VEN,Pulau Pinang,1,1,0
2024-04-01,VEN,Sarawak,5,2,3
2024-04-01,VEN,Selangor,99,51,48
2024-04-01,VNM,Johor,13689,4083,9606
2024-04-01,VNM,Kedah,289,52,237
2024-04-01,VNM,Kelantan,10,5,5
2024-04-01,VNM,Perak,117,7,110
2024-04-01,VNM,Perlis,188,18,170
2024-04-01,VNM,Pulau Pinang,1295,367,928
2024-04-01,VNM,Sabah,27,7,20
2024-04-01,VNM,Sarawak,428,72,356
2024-04-01,VNM,Selangor,16746,5613,11133
2024-04-01,VNM,W.P. Labuan,1,0,1
2024-04-01,VUT,Johor,24,20,4
2024-04-01,VUT,Kedah,1,1,0
2024-04-01,VUT,Perlis,1,1,0
2024-04-01,VUT,Pulau Pinang,6,5,1
2024-04-01,VUT,Selangor,92,80,12
2024-04-01,WSM,Selangor,3,0,3
2024-04-01,XXX,Johor,4,3,1
2024-04-01,XXX,Pulau Pinang,1,1,0
2024-04-01,XXX,Selangor,58,35,23
2024-04-01,YEM,Johor,30,25,5
2024-04-01,YEM,Kedah,4,3,1
2024-04-01,YEM,Melaka,2,1,1
2024-04-01,YEM,Perlis,1,1,0
2024-04-01,YEM,Pulau Pinang,2,1,1
2024-04-01,YEM,Sarawak,4,4,0
2024-04-01,YEM,Selangor,1081,746,335
2024-04-01,ZAF,Johor,248,153,95
2024-04-01,ZAF,Kedah,38,24,14
2024-04-01,ZAF,Kelantan,1,0,1
2024-04-01,ZAF,Perlis,6,4,2
2024-04-01,ZAF,Pulau Pinang,55,27,28
2024-04-01,ZAF,Sabah,28,15,13
2024-04-01,ZAF,Sarawak,95,38,57
2024-04-01,ZAF,Selangor,943,516,427
2024-04-01,ZAF,W.P. Labuan,15,5,10
2024-04-01,ZAR,Selangor,2,1,1
2024-04-01,ZMB,Johor,4,3,1
2024-04-01,ZMB,Kedah,2,1,1
2024-04-01,ZMB,Perak,1,0,1
2024-04-01,ZMB,Pulau Pinang,2,1,1
2024-04-01,ZMB,Selangor,56,25,31
2024-04-01,ZWE,Johor,20,7,13
2024-04-01,ZWE,Kedah,2,0,2
2024-04-01,ZWE,Pulau Pinang,1,0,1
2024-04-01,ZWE,Selangor,144,63,81
2024-05-01,AFG,Johor,1,1,0
2024-05-01,AFG,Pulau Pinang,2,2,0
2024-05-01,AFG,Selangor,42,26,16
2024-05-01,AGO,Selangor,2,2,0
2024-05-01,ALB,Johor,14,12,2
2024-05-01,ALB,Pulau Pinang,1,1,0
2024-05-01,ALB,Sabah,1,1,0
2024-05-01,ALB,Selangor,26,11,15
2024-05-01,AND,Perlis,1,1,0
2024-05-01,AND,Pulau Pinang,1,1,0
2024-05-01,AND,Selangor,13,11,2
2024-05-01,ARE,Johor,20,7,13
2024-05-01,ARE,Kedah,6,5,1
2024-05-01,ARE,Perak,1,1,0
2024-05-01,ARE,Pulau Pinang,7,5,2
2024-05-01,ARE,Sabah,2,1,1
2024-05-01,ARE,Selangor,284,182,102
2024-05-01,ARG,Johor,85,51,34
2024-05-01,ARG,Kedah,48,27,21
2024-05-01,ARG,Kelantan,1,0,1
2024-05-01,ARG,Perak,1,1,0
2024-05-01,ARG,Perlis,1,0,1
2024-05-01,ARG,Pulau Pinang,8,6,2
2024-05-01,ARG,Sarawak,5,5,0
2024-05-01,ARG,Selangor,422,217,205
2024-05-01,ARM,Johor,1,1,0
2024-05-01,ARM,Kedah,3,0,3
2024-05-01,ARM,Pulau Pinang,1,0,1
2024-05-01,ARM,Selangor,63,36,27
2024-05-01,ATG,Johor,7,6,1
2024-05-01,ATG,Pulau Pinang,1,1,0
2024-05-01,ATG,Sabah,1,0,1
2024-05-01,ATG,Selangor,11,10,1
2024-05-01,AUS,Johor,4697,2892,1805
2024-05-01,AUS,Kedah,566,328,238
2024-05-01,AUS,Kelantan,5,4,1
2024-05-01,AUS,Melaka,4,3,1
2024-05-01,AUS,Pahang,55,25,30
2024-05-01,AUS,Perak,170,90,80
2024-05-01,AUS,Perlis,60,40,20
2024-05-01,AUS,Pulau Pinang,1719,915,804
2024-05-01,AUS,Sabah,310,165,145
2024-05-01,AUS,Sarawak,575,341,234
2024-05-01,AUS,Selangor,18706,11064,7642
2024-05-01,AUS,W.P. Labuan,3,3,0
2024-05-01,AUT,Johor,196,136,60
2024-05-01,AUT,Kedah,49,27,22
2024-05-01,AUT,Kelantan,9,7,2
2024-05-01,AUT,Pahang,1,0,1
2024-05-01,AUT,Perak,2,2,0
2024-05-01,AUT,Perlis,8,5,3
2024-05-01,AUT,Pulau Pinang,66,46,20
2024-05-01,AUT,Sabah,13,5,8
2024-05-01,AUT,Sarawak,17,12,5
2024-05-01,AUT,Selangor,736,453,283
2024-05-01,AZE,Johor,7,5,2
2024-05-01,AZE,Kedah,4,1,3
2024-05-01,AZE,Perlis,1,1,0
2024-05-01,AZE,Pulau Pinang,1,1,0
2024-05-01,AZE,Selangor,68,33,35
2024-05-01,BDI,Pulau Pinang,1,1,0
2024-05-01,BDI,Selangor,2,2,0
2024-05-01,BEL,Johor,302,185,117
2024-05-01,BEL,Kedah,64,30,34
2024-05-01,BEL,Kelantan,2,1,1
2024-05-01,BEL,Pahang,1,0,1
2024-05-01,BEL,Perak,3,2,1
2024-05-01,BEL,Perlis,11,5,6
2024-05-01,BEL,Pulau Pinang,75,55,20
2024-05-01,BEL,Sabah,31,15,16
2024-05-01,BEL,Sarawak,31,16,15
2024-05-01,BEL,Selangor,1470,839,631
2024-05-01,BEN,Johor,3,1,2
2024-05-01,BEN,Pulau Pinang,1,1,0
2024-05-01,BEN,Selangor,13,10,3
2024-05-01,BFA,Selangor,5,5,0
2024-05-01,BGD,Johor,2612,2060,552
2024-05-01,BGD,Kedah,82,52,30
2024-05-01,BGD,Kelantan,1,1,0
2024-05-01,BGD,Perak,2,2,0
2024-05-01,BGD,Perlis,5,1,4
2024-05-01,BGD,Pulau Pinang,590,556,34
2024-05-01,BGD,Sabah,9,8,1
2024-05-01,BGD,Sarawak,144,116,28
2024-05-01,BGD,Selangor,63866,62404,1462
2024-05-01,BGD,W.P. Labuan,5,4,1
2024-05-01,BGR,Johor,51,29,22
2024-05-01,BGR,Kedah,7,3,4
2024-05-01,BGR,Perak,2,1,1
2024-05-01,BGR,Sabah,3,1,2
2024-05-01,BGR,Sarawak,1,1,0
2024-05-01,BGR,Selangor,253,132,121
2024-05-01,BHR,Johor,3,2,1
2024-05-01,BHR,Kedah,2,2,0
2024-05-01,BHR,Sarawak,1,1,0
2024-05-01,BHR,Selangor,101,76,25
2024-05-01,BHS,Johor,2,1,1
2024-05-01,BHS,Selangor,8,4,4
2024-05-01,BIH,Johor,9,7,2
2024-05-01,BIH,Kedah,1,0,1
2024-05-01,BIH,Pulau Pinang,2,2,0
2024-05-01,BIH,Sarawak,1,1,0
2024-05-01,BIH,Selangor,86,40,46
2024-05-01,BLR,Johor,18,10,8
2024-05-01,BLR,Kedah,9,2,7
2024-05-01,BLR,Kelantan,6,4,2
2024-05-01,BLR,Perlis,1,0,1
2024-05-01,BLR,Pulau Pinang,2,1,1
2024-05-01,BLR,Sabah,4,2,2
2024-05-01,BLR,Selangor,349,162,187
2024-05-01,BLZ,Johor,2,2,0
2024-05-01,BLZ,Selangor,4,1,3
2024-05-01,BOL,Johor,6,2,4
2024-05-01,BOL,Selangor,21,11,10
2024-05-01,BRA,Johor,307,155,152
2024-05-01,BRA,Kedah,68,36,32
2024-05-01,BRA,Kelantan,1,1,0
2024-05-01,BRA,Perak,5,2,3
2024-05-01,BRA,Perlis,10,3,7
2024-05-01,BRA,Pulau Pinang,22,14,8
2024-05-01,BRA,Sabah,7,1,6
2024-05-01,BRA,Sarawak,3,3,0
2024-05-01,BRA,Selangor,958,560,398
2024-05-01,BRB,Johor,2,0,2
2024-05-01,BRB,Selangor,11,5,6
2024-05-01,BRN,Johor,369,190,179
2024-05-01,BRN,Kedah,41,25,16
2024-05-01,BRN,Kelantan,15,7,8
2024-05-01,BRN,Perak,7,4,3
2024-05-01,BRN,Perlis,17,7,10
2024-05-01,BRN,Pulau Pinang,9,3,6
2024-05-01,BRN,Sabah,1066,488,578
2024-05-01,BRN,Sarawak,136931,74214,62717
2024-05-01,BRN,Selangor,4778,2312,2466
2024-05-01,BRN,W.P. Labuan,1549,907,642
2024-05-01,BTN,Johor,13,9,4
2024-05-01,BTN,Perak,2,1,1
2024-05-01,BTN,Pulau Pinang,78,38,40
2024-05-01,BTN,Sabah,1,0,1
2024-05-01,BTN,Selangor,155,104,51
2024-05-01,BWA,Selangor,7,5,2
2024-05-01,CAN,Johor,1608,908,700
2024-05-01,CAN,Kedah,149,78,71
2024-05-01,CAN,Kelantan,8,7,1
2024-05-01,CAN,Pahang,5,4,1
2024-05-01,CAN,Perak,26,12,14
2024-05-01,CAN,Perlis,19,9,10
2024-05-01,CAN,Pulau Pinang,466,259,207
2024-05-01,CAN,Sabah,151,73,78
2024-05-01,CAN,Sarawak,413,234,179
2024-05-01,CAN,Selangor,4131,2351,1780
2024-05-01,CAN,W.P. Labuan,3,1,2
2024-05-01,CCK,Selangor,1,0,1
2024-05-01,CHE,Johor,426,264,162
2024-05-01,CHE,Kedah,107,58,49
2024-05-01,CHE,Kelantan,5,3,2
2024-05-01,CHE,Perak,12,6,6
2024-05-01,CHE,Perlis,14,5,9
2024-05-01,CHE,Pulau Pinang,150,112,38
2024-05-01,CHE,Sabah,26,11,15
2024-05-01,CHE,Sarawak,34,18,16
2024-05-01,CHE,Selangor,1244,777,467
2024-05-01,CHL,Johor,30,13,17
2024-05-01,CHL,Kedah,18,10,8
2024-05-01,CHL,Kelantan,1,1,0
2024-05-01,CHL,Perlis,4,3,1
2024-05-01,CHL,Pulau Pinang,5,3,2
2024-05-01,CHL,Sabah,4,1,3
2024-05-01,CHL,Sarawak,3,2,1
2024-05-01,CHL,Selangor,295,160,135
2024-05-01,CHN,Johor,80957,35666,45291
2024-05-01,CHN,Kedah,2085,907,1178
2024-05-01,CHN,Kelantan,36,18,18
2024-05-01,CHN,Melaka,15,12,3
2024-05-01,CHN,Negeri Sembilan,2,2,0
2024-05-01,CHN,Pahang,70,49,21
2024-05-01,CHN,Perak,457,211,246
2024-05-01,CHN,Perlis,375,200,175
2024-05-01,CHN,Pulau Pinang,12562,6366,6196
2024-05-01,CHN,Sabah,19901,8484,11417
2024-05-01,CHN,Sarawak,1718,924,794
2024-05-01,CHN,Selangor,151040,75790,75250
2024-05-01,CHN,W.P. Labuan,38,33,5
2024-05-01,CIV,Sarawak,1,1,0
2024-05-01,CIV,Selangor,29,17,12
2024-05-01,CMR,Johor,1,0,1
2024-05-01,CMR,Selangor,36,23,13
2024-05-01,COD,Johor,2,1,1
2024-05-01,COD,Selangor,14,11,3
2024-05-01,COG,Selangor,5,4,1
2024-05-01,COL,Johor,32,14,18
2024-05-01,COL,Kedah,2,0,2
2024-05-01,COL,Pulau Pinang,6,5,1
2024-05-01,COL,Sabah,3,1,2
2024-05-01,COL,Sarawak,1,1,0
2024-05-01,COL,Selangor,185,100,85
2024-05-01,COM,Kedah,1,0,1
2024-05-01,COM,Pulau Pinang,1,1,0
2024-05-01,COM,Selangor,18,10,8
2024-05-01,CPV,Selangor,2,1,1
2024-05-01,CRI,Johor,17,9,8
2024-05-01,CRI,Pulau Pinang,4,4,0
2024-05-01,CRI,Sarawak,2,2,0
2024-05-01,CRI,Selangor,57,29,28
2024-05-01,CUB,Johor,12,9,3
2024-05-01,CUB,Kedah,1,0,1
2024-05-01,CUB,Pulau Pinang,3,0,3
2024-05-01,CUB,Selangor,20,10,10
2024-05-01,CYP,Johor,6,5,1
2024-05-01,CYP,Pulau Pinang,4,0,4
2024-05-01,CYP,Sabah,1,0,1
2024-05-01,CYP,Selangor,83,59,24
2024-05-01,CZE,Johor,82,37,45
2024-05-01,CZE,Kedah,55,24,31
2024-05-01,CZE,Perak,2,1,1
2024-05-01,CZE,Perlis,4,3,1
2024-05-01,CZE,Pulau Pinang,26,12,14
2024-05-01,CZE,Sabah,9,4,5
2024-05-01,CZE,Sarawak,18,11,7
2024-05-01,CZE,Selangor,385,239,146
2024-05-01,DEU,Johor,2233,1349,884
2024-05-01,DEU,Kedah,659,346,313
2024-05-01,DEU,Kelantan,11,9,2
2024-05-01,DEU,Pahang,19,10,9
2024-05-01,DEU,Perak,28,19,9
2024-05-01,DEU,Perlis,68,42,26
2024-05-01,DEU,Pulau Pinang,618,422,196
2024-05-01,DEU,Sabah,129,69,60
2024-05-01,DEU,Sarawak,226,138,88
2024-05-01,DEU,Selangor,9314,5358,3956
2024-05-01,DEU,W.P. Labuan,4,2,2
2024-05-01,DJI,Selangor,15,5,10
2024-05-01,DMA,Johor,10,5,5
2024-05-01,DMA,Kedah,1,1,0
2024-05-01,DMA,Perak,1,1,0
2024-05-01,DMA,Pulau Pinang,5,3,2
2024-05-01,DMA,Sabah,2,1,1
2024-05-01,DMA,Selangor,43,31,12
2024-05-01,DNK,Johor,274,216,58
2024-05-01,DNK,Kedah,66,31,35
2024-05-01,DNK,Kelantan,2,2,0
2024-05-01,DNK,Melaka,1,1,0
2024-05-01,DNK,Pahang,1,1,0
2024-05-01,DNK,Perak,1,1,0
2024-05-01,DNK,Perlis,6,1,5
2024-05-01,DNK,Pulau Pinang,61,40,21
2024-05-01,DNK,Sabah,12,9,3
2024-05-01,DNK,Sarawak,7,5,2
2024-05-01,DNK,Selangor,678,430,248
2024-05-01,DOM,Johor,1,0,1
2024-05-01,DOM,Pulau Pinang,2,0,2
2024-05-01,DOM,Sabah,2,2,0
2024-05-01,DOM,Selangor,24,10,14
2024-05-01,DZA,Johor,36,30,6
2024-05-01,DZA,Kedah,8,5,3
2024-05-01,DZA,Kelantan,1,1,0
2024-05-01,DZA,Pulau Pinang,3,3,0
2024-05-01,DZA,Sabah,4,2,2
2024-05-01,DZA,Sarawak,4,3,1
2024-05-01,DZA,Selangor,906,582,324
2024-05-01,ECU,Johor,7,3,4
2024-05-01,ECU,Pulau Pinang,1,1,0
2024-05-01,ECU,Selangor,87,45,42
2024-05-01,EGY,Johor,233,196,37
2024-05-01,EGY,Kedah,12,8,4
2024-05-01,EGY,Kelantan,2,1,1
2024-05-01,EGY,Pulau Pinang,9,8,1
2024-05-01,EGY,Sabah,2,2,0
2024-05-01,EGY,Sarawak,134,96,38
2024-05-01,EGY,Selangor,1639,1141,498
2024-05-01,ERI,Selangor,19,12,7
2024-05-01,ESP,Johor,493,317,176
2024-05-01,ESP,Kedah,88,49,39
2024-05-01,ESP,Kelantan,6,4,2
2024-05-01,ESP,Pahang,2,1,1
2024-05-01,ESP,Perak,5,5,0
2024-05-01,ESP,Perlis,18,11,7
2024-05-01,ESP,Pulau Pinang,137,89,48
2024-05-01,ESP,Sabah,32,17,15
2024-05-01,ESP,Sarawak,59,37,22
2024-05-01,ESP,Selangor,2548,1456,1092
2024-05-01,ESP,W.P. Labuan,4,2,2
2024-05-01,EST,Johor,33,14,19
2024-05-01,EST,Kedah,5,1,4
2024-05-01,EST,Kelantan,3,3,0
2024-05-01,EST,Perlis,1,1,0
2024-05-01,EST,Pulau Pinang,2,2,0
2024-05-01,EST,Sabah,3,1,2
2024-05-01,EST,Sarawak,1,0,1
2024-05-01,EST,Selangor,85,58,27
2024-05-01,ETH,Johor,8,7,1
2024-05-01,ETH,Pulau Pinang,4,1,3
2024-05-01,ETH,Selangor,30,24,6
2024-05-01,FIN,Johor,226,133,93
2024-05-01,FIN,Kedah,39,19,20
2024-05-01,FIN,Perak,3,2,1
2024-05-01,FIN,Perlis,1,1,0
2024-05-01,FIN,Pulau Pinang,30,20,10
2024-05-01,FIN,Sabah,10,8,2
2024-05-01,FIN,Sarawak,11,5,6
2024-05-01,FIN,Selangor,379,223,156
2024-05-01,FJI,Johor,217,93,124
2024-05-01,FJI,Kedah,1,1,0
2024-05-01,FJI,Pulau Pinang,2,0,2
2024-05-01,FJI,Sarawak,2,2,0
2024-05-01,FJI,Selangor,147,72,75
2024-05-01,FRA,Johor,2476,1490,986
2024-05-01,FRA,Kedah,743,385,358
2024-05-01,FRA,Kelantan,32,18,14
2024-05-01,FRA,Melaka,2,1,1
2024-05-01,FRA,Negeri Sembilan,2,1,1
2024-05-01,FRA,Pahang,32,13,19
2024-05-01,FRA,Perak,36,25,11
2024-05-01,FRA,Perlis,74,53,21
2024-05-01,FRA,Pulau Pinang,391,270,121
2024-05-01,FRA,Sabah,114,66,48
2024-05-01,FRA,Sarawak,117,69,48
2024-05-01,FRA,Selangor,9455,5310,4145
2024-05-01,FRA,W.P. Labuan,1,1,0
2024-05-01,FSM,Johor,1,0,1
2024-05-01,FSM,Selangor,1,0,1
2024-05-01,GAB,Johor,7,4,3
2024-05-01,GAB,Selangor,7,5,2
2024-05-01,GBR,Johor,5541,3574,1967
2024-05-01,GBR,Kedah,1144,577,567
2024-05-01,GBR,Kelantan,13,8,5
2024-05-01,GBR,Melaka,2,1,1
2024-05-01,GBR,Pahang,29,19,10
2024-05-01,GBR,Perak,96,54,42
2024-05-01,GBR,Perlis,138,90,48
2024-05-01,GBR,Pulau Pinang,1367,814,553
2024-05-01,GBR,Sabah,482,243,239
2024-05-01,GBR,Sarawak,1621,1018,603
2024-05-01,GBR,Selangor,17493,10538,6955
2024-05-01,GBR,W.P. Labuan,47,26,21
2024-05-01,GEO,Johor,19,3,16
2024-05-01,GEO,Selangor,71,37,34
2024-05-01,GHA,Johor,5,5,0
2024-05-01,GHA,Pulau Pinang,29,11,18
2024-05-01,GHA,Sarawak,1,1,0
2024-05-01,GHA,Selangor,166,105,61
2024-05-01,GIN,Johor,3,2,1
2024-05-01,GIN,Selangor,65,49,16
2024-05-01,GMB,Johor,4,2,2
2024-05-01,GMB,Sabah,1,1,0
2024-05-01,GMB,Selangor,26,20,6
2024-05-01,GNB,Selangor,1,1,0
2024-05-01,GNQ,Selangor,2,1,1
2024-05-01,GRC,Johor,58,43,15
2024-05-01,GRC,Kedah,10,6,4
2024-05-01,GRC,Perak,2,1,1
2024-05-01,GRC,Pulau Pinang,10,7,3
2024-05-01,GRC,Sabah,2,1,1
2024-05-01,GRC,Sarawak,3,2,1
2024-05-01,GRC,Selangor,262,178,84
2024-05-01,GRD,Johor,8,5,3
2024-05-01,GRD,Selangor,12,12,0
2024-05-01,GTM,Johor,3,2,1
2024-05-01,GTM,Kedah,1,1,0
2024-05-01,GTM,Pulau Pinang,1,1,0
2024-05-01,GTM,Selangor,26,16,10
2024-05-01,GUY,Johor,2,1,1
2024-05-01,GUY,Selangor,10,6,4
2024-05-01,HKG,Johor,3,2,1
2024-05-01,HKG,Pahang,2,2,0
2024-05-01,HKG,Perak,71,31,40
2024-05-01,HKG,Perlis,1,1,0
2024-05-01,HKG,Pulau Pinang,5,2,3
2024-05-01,HKG,Sabah,108,58,50
2024-05-01,HKG,Selangor,17,9,8
2024-05-01,HND,Johor,2,2,0
2024-05-01,HND,Kedah,1,1,0
2024-05-01,HND,Pulau Pinang,1,1,0
2024-05-01,HND,Selangor,18,9,9
2024-05-01,HRV,Johor,32,28,4
2024-05-01,HRV,Kedah,2,1,1
2024-05-01,HRV,Kelantan,1,1,0
2024-05-01,HRV,Perlis,2,1,1
2024-05-01,HRV,Pulau Pinang,7,5,2
2024-05-01,HRV,Sabah,4,4,0
2024-05-01,HRV,Sarawak,2,2,0
2024-05-01,HRV,Selangor,154,110,44
2024-05-01,HTI,Johor,2,1,1
2024-05-01,HTI,Selangor,17,12,5
2024-05-01,HUN,Johor,84,55,29
2024-05-01,HUN,Kedah,24,8,16
2024-05-01,HUN,Kelantan,2,1,1
2024-05-01,HUN,Perlis,2,2,0
2024-05-01,HUN,Pulau Pinang,51,30,21
2024-05-01,HUN,Sabah,8,4,4
2024-05-01,HUN,Sarawak,6,2,4
2024-05-01,HUN,Selangor,332,190,142
2024-05-01,IDN,Johor,107867,50906,56961
2024-05-01,IDN,Kedah,4552,1554,2998
2024-05-01,IDN,Kelantan,122,61,61
2024-05-01,IDN,Melaka,3906,1716,2190
2024-05-01,IDN,Negeri Sembilan,9682,6421,3261
2024-05-01,IDN,Pahang,69,45,24
2024-05-01,IDN,Perak,213,81,132
2024-05-01,IDN,Perlis,636,218,418
2024-05-01,IDN,Pulau Pinang,38621,15442,23179
2024-05-01,IDN,Sabah,6524,3401,3123
2024-05-01,IDN,Sarawak,52364,29522,22842
2024-05-01,IDN,Selangor,150031,71800,78231
2024-05-01,IDN,W.P. Labuan,66,31,35
2024-05-01,IND,Johor,51512,30254,21258
2024-05-01,IND,Kedah,3071,1676,1395
2024-05-01,IND,Kelantan,7,6,1
2024-05-01,IND,Melaka,3,2,1
2024-05-01,IND,Pahang,26,20,6
2024-05-01,IND,Perak,225,140,85
2024-05-01,IND,Perlis,66,50,16
2024-05-01,IND,Pulau Pinang,4192,2575,1617
2024-05-01,IND,Sabah,201,148,53
2024-05-01,IND,Sarawak,2653,2025,628
2024-05-01,IND,Selangor,104981,66299,38682
2024-05-01,IND,W.P. Labuan,50,37,13
2024-05-01,IRL,Johor,302,200,102
2024-05-01,IRL,Kedah,74,38,36
2024-05-01,IRL,Pahang,2,1,1
2024-05-01,IRL,Perak,6,5,1
2024-05-01,IRL,Perlis,10,10,0
2024-05-01,IRL,Pulau Pinang,119,71,48
2024-05-01,IRL,Sabah,22,14,8
2024-05-01,IRL,Sarawak,29,15,14
2024-05-01,IRL,Selangor,1326,796,530
2024-05-01,IRL,W.P. Labuan,4,2,2
2024-05-01,IRN,Johor,163,93,70
2024-05-01,IRN,Kedah,14,6,8
2024-05-01,IRN,Perak,1,1,0
2024-05-01,IRN,Perlis,3,2,1
2024-05-01,IRN,Pulau Pinang,22,16,6
2024-05-01,IRN,Sabah,1,1,0
2024-05-01,IRN,Sarawak,7,5,2
2024-05-01,IRN,Selangor,1193,670,523
2024-05-01,IRQ,Johor,34,22,12
2024-05-01,IRQ,Pulau Pinang,11,7,4
2024-05-01,IRQ,Sabah,1,1,0
2024-05-01,IRQ,Sarawak,6,3,3
2024-05-01,IRQ,Selangor,967,635,332
2024-05-01,ISL,Johor,4,2,2
2024-05-01,ISL,Kedah,1,1,0
2024-05-01,ISL,Pulau Pinang,4,1,3
2024-05-01,ISL,Selangor,28,17,11
2024-05-01,ITA,Johor,587,368,219
2024-05-01,ITA,Kedah,127,61,66
2024-05-01,ITA,Perak,11,8,3
2024-05-01,ITA,Perlis,13,9,4
2024-05-01,ITA,Pulau Pinang,111,82,29
2024-05-01,ITA,Sabah,24,14,10
2024-05-01,ITA,Sarawak,67,39,28
2024-05-01,ITA,Selangor,2738,1771,967
2024-05-01,ITA,W.P. Labuan,4,3,1
2024-05-01,JAM,Johor,12,3,9
2024-05-01,JAM,Pulau Pinang,1,0,1
2024-05-01,JAM,Sarawak,3,1,2
2024-05-01,JAM,Selangor,26,16,10
2024-05-01,JOR,Johor,8,4,4
2024-05-01,JOR,Kedah,10,6,4
2024-05-01,JOR,Pahang,4,3,1
2024-05-01,JOR,Perlis,1,1,0
2024-05-01,JOR,Pulau Pinang,15,8,7
2024-05-01,JOR,Sarawak,1,1,0
2024-05-01,JOR,Selangor,765,485,280
2024-05-01,JPN,Johor,6543,4368,2175
2024-05-01,JPN,Kedah,302,157,145
2024-05-01,JPN,Kelantan,6,6,0
2024-05-01,JPN,Pahang,16,12,4
2024-05-01,JPN,Perak,78,51,27
2024-05-01,JPN,Perlis,77,52,25
2024-05-01,JPN,Pulau Pinang,1382,1017,365
2024-05-01,JPN,Sabah,328,168,160
2024-05-01,JPN,Sarawak,249,156,93
2024-05-01,JPN,Selangor,18766,11453,7313
2024-05-01,JPN,W.P. Labuan,18,14,4
2024-05-01,KAZ,Johor,46,16,30
2024-05-01,KAZ,Kedah,24,6,18
2024-05-01,KAZ,Kelantan,1,1,0
2024-05-01,KAZ,Perlis,3,3,0
2024-05-01,KAZ,Pulau Pinang,9,5,4
2024-05-01,KAZ,Sabah,2,1,1
2024-05-01,KAZ,Sarawak,7,1,6
2024-05-01,KAZ,Selangor,3198,1234,1964
2024-05-01,KEN,Johor,221,77,144
2024-05-01,KEN,Kedah,3,1,2
2024-05-01,KEN,Pulau Pinang,11,6,5
2024-05-01,KEN,Sarawak,2,2,0
2024-05-01,KEN,Selangor,546,247,299
2024-05-01,KGZ,Johor,37,24,13
2024-05-01,KGZ,Kedah,10,6,4
2024-05-01,KGZ,Pulau Pinang,5,3,2
2024-05-01,KGZ,Selangor,468,221,247
2024-05-01,KHM,Johor,1719,798,921
2024-05-01,KHM,Kedah,228,143,85
2024-05-01,KHM,Kelantan,594,371,223
2024-05-01,KHM,Perak,13,6,7
2024-05-01,KHM,Perlis,666,382,284
2024-05-01,KHM,Pulau Pinang,63,27,36
2024-05-01,KHM,Sabah,1,0,1
2024-05-01,KHM,Sarawak,8,4,4
2024-05-01,KHM,Selangor,3651,1794,1857
2024-05-01,KHM,W.P. Labuan,2,2,0
2024-05-01,KNA,Johor,35,25,10
2024-05-01,KNA,Pulau Pinang,1,1,0
2024-05-01,KNA,Sabah,1,0,1
2024-05-01,KNA,Selangor,41,36,5
2024-05-01,KOR,Johor,9188,5165,4023
2024-05-01,KOR,Kedah,229,118,111
2024-05-01,KOR,Kelantan,3,3,0
2024-05-01,KOR,Melaka,2,1,1
2024-05-01,KOR,Negeri Sembilan,14,5,9
2024-05-01,KOR,Perak,17,8,9
2024-05-01,KOR,Perlis,34,19,15
2024-05-01,KOR,Pulau Pinang,505,294,211
2024-05-01,KOR,Sabah,11551,4754,6797
2024-05-01,KOR,Sarawak,229,123,106
2024-05-01,KOR,Selangor,11944,7122,4822
2024-05-01,KOR,W.P. Labuan,5,5,0
2024-05-01,KWT,Johor,14,7,7
2024-05-01,KWT,Kedah,1,1,0
2024-05-01,KWT,Pulau Pinang,6,5,1
2024-05-01,KWT,Selangor,312,197,115
2024-05-01,LAO,Johor,142,29,113
2024-05-01,LAO,Kedah,1240,98,1142
2024-05-01,LAO,Kelantan,238,63,175
2024-05-01,LAO,Perak,38,4,34
2024-05-01,LAO,Perlis,285,81,204
2024-05-01,LAO,Pulau Pinang,30,8,22
2024-05-01,LAO,Sabah,1,0,1
2024-05-01,LAO,Sarawak,20,11,9
2024-05-01,LAO,Selangor,272,108,164
2024-05-01,LBN,Johor,16,9,7
2024-05-01,LBN,Kedah,4,1,3
2024-05-01,LBN,Pulau Pinang,7,6,1
2024-05-01,LBN,Sabah,2,2,0
2024-05-01,LBN,Sarawak,3,3,0
2024-05-01,LBN,Selangor,283,185,98
2024-05-01,LBR,Johor,1,1,0
2024-05-01,LBR,Sarawak,1,1,0
2024-05-01,LBR,Selangor,10,6,4
2024-05-01,LBY,Johor,1,1,0
2024-05-01,LBY,Selangor,438,286,152
2024-05-01,LCA,Johor,3,1,2
2024-05-01,LCA,Pulau Pinang,2,2,0
2024-05-01,LCA,Sarawak,1,0,1
2024-05-01,LCA,Selangor,16,11,5
2024-05-01,LIE,Johor,2,0,2
2024-05-01,LIE,Kedah,2,0,2
2024-05-01,LIE,Pulau Pinang,4,4,0
2024-05-01,LIE,Selangor,6,5,1
2024-05-01,LKA,Johor,637,419,218
2024-05-01,LKA,Kedah,62,35,27
2024-05-01,LKA,Pahang,2,2,0
2024-05-01,LKA,Perak,9,4,5
2024-05-01,LKA,Pulau Pinang,49,32,17
2024-05-01,LKA,Sabah,11,5,6
2024-05-01,LKA,Sarawak,21,13,8
2024-05-01,LKA,Selangor,5307,3292,2015
2024-05-01,LKA,W.P. Labuan,4,3,1
2024-05-01,LSO,Kedah,1,0,1
2024-05-01,LSO,Selangor,5,3,2
2024-05-01,LTU,Johor,56,37,19
2024-05-01,LTU,Kedah,19,6,13
2024-05-01,LTU,Perak,1,1,0
2024-05-01,LTU,Perlis,2,1,1
2024-05-01,LTU,Pulau Pinang,7,5,2
2024-05-01,LTU,Sabah,22,10,12
2024-05-01,LTU,Sarawak,4,3,1
2024-05-01,LTU,Selangor,266,138,128
2024-05-01,LUX,Johor,3,2,1
2024-05-01,LUX,Kedah,4,2,2
2024-05-01,LUX,Kelantan,1,1,0
2024-05-01,LUX,Pulau Pinang,2,1,1
2024-05-01,LUX,Sabah,1,1,0
2024-05-01,LUX,Sarawak,2,1,1
2024-05-01,LUX,Selangor,50,29,21
2024-05-01,LVA,Johor,12,5,7
2024-05-01,LVA,Kedah,7,4,3
2024-05-01,LVA,Pulau Pinang,7,7,0
2024-05-01,LVA,Sabah,2,1,1
2024-05-01,LVA,Sarawak,4,1,3
2024-05-01,LVA,Selangor,165,101,64
2024-05-01,MAC,Pulau Pinang,1,0,1
2024-05-01,MAC,Selangor,1,0,1
2024-05-01,MAR,Johor,116,63,53
2024-05-01,MAR,Kedah,10,5,5
2024-05-01,MAR,Kelantan,1,1,0
2024-05-01,MAR,Pahang,1,1,0
2024-05-01,MAR,Perlis,2,1,1
2024-05-01,MAR,Pulau Pinang,8,3,5
2024-05-01,MAR,Sabah,2,0,2
2024-05-01,MAR,Sarawak,7,3,4
2024-05-01,MAR,Selangor,1652,843,809
2024-05-01,MCO,Johor,4,4,0
2024-05-01,MCO,Perlis,1,0,1
2024-05-01,MCO,Selangor,2,2,0
2024-05-01,MDA,Johor,5,1,4
2024-05-01,MDA,Selangor,37,15,22
2024-05-01,MDG,Johor,13,3,10
2024-05-01,MDG,Pulau Pinang,2,1,1
2024-05-01,MDG,Sabah,1,0,1
2024-05-01,MDG,Selangor,99,41,58
2024-05-01,MDV,Johor,437,210,227
2024-05-01,MDV,Kedah,6,2,4
2024-05-01,MDV,Perak,5,0,5
2024-05-01,MDV,Pulau Pinang,3,1,2
2024-05-01,MDV,Sabah,1,0,1
2024-05-01,MDV,Selangor,5278,2653,2625
2024-05-01,MEX,Johor,152,78,74
2024-05-01,MEX,Kedah,21,12,9
2024-05-01,MEX,Pulau Pinang,37,29,8
2024-05-01,MEX,Sabah,7,2,5
2024-05-01,MEX,Sarawak,6,4,2
2024-05-01,MEX,Selangor,660,312,348
2024-05-01,MHL,Johor,2,2,0
2024-05-01,MHL,Pulau Pinang,2,1,1
2024-05-01,MHL,Selangor,1,1,0
2024-05-01,MKD,Johor,7,5,2
2024-05-01,MKD,Sarawak,5,2,3
2024-05-01,MKD,Selangor,56,25,31
2024-05-01,MLI,Johor,1,1,0
2024-05-01,MLI,Sarawak,1,1,0
2024-05-01,MLI,Selangor,12,7,5
2024-05-01,MLT,Johor,2,1,1
2024-05-01,MLT,Pulau Pinang,3,3,0
2024-05-01,MLT,Selangor,45,23,22
2024-05-01,MMR,Johor,7267,2050,5217
2024-05-01,MMR,Kedah,87,15,72
2024-05-01,MMR,Kelantan,3,1,2
2024-05-01,MMR,Pahang,3,1,2
2024-05-01,MMR,Perak,37,6,31
2024-05-01,MMR,Perlis,9,1,8
2024-05-01,MMR,Pulau Pinang,349,153,196
2024-05-01,MMR,Sabah,17,2,15
2024-05-01,MMR,Sarawak,81,39,42
2024-05-01,MMR,Selangor,11520,8112,3408
2024-05-01,MMR,W.P. Labuan,1,1,0
2024-05-01,MNE,Johor,4,4,0
2024-05-01,MNE,Selangor,17,16,1
2024-05-01,MNG,Johor,128,39,89
2024-05-01,MNG,Kedah,7,3,4
2024-05-01,MNG,Perak,1,1,0
2024-05-01,MNG,Perlis,2,2,0
2024-05-01,MNG,Pulau Pinang,7,6,1
2024-05-01,MNG,Sarawak,2,2,0
2024-05-01,MNG,Selangor,353,138,215
2024-05-01,MOZ,Selangor,58,38,20
2024-05-01,MRT,Johor,1,1,0
2024-05-01,MRT,Kedah,2,1,1
2024-05-01,MRT,Selangor,20,14,6
2024-05-01,MUS,Johor,182,90,92
2024-05-01,MUS,Kedah,9,5,4
2024-05-01,MUS,Pahang,1,1,0
2024-05-01,MUS,Perlis,4,3,1
2024-05-01,MUS,Pulau Pinang,16,6,10
2024-05-01,MUS,Sabah,2,2,0
2024-05-01,MUS,Selangor,921,501,420
2024-05-01,MWI,Johor,1,1,0
2024-05-01,MWI,Pulau Pinang,1,0,1
2024-05-01,MWI,Selangor,18,15,3
2024-05-01,NAM,Selangor,18,10,8
2024-05-01,NER,Selangor,1,1,0
2024-05-01,NGA,Johor,14,13,1
2024-05-01,NGA,Kedah,2,2,0
2024-05-01,NGA,Pulau Pinang,10,7,3
2024-05-01,NGA,Sarawak,13,12,1
2024-05-01,NGA,Selangor,505,407,98
2024-05-01,NIC,Johor,2,1,1
2024-05-01,NIC,Selangor,4,2,2
2024-05-01,NLD,Johor,1239,755,484
2024-05-01,NLD,Kedah,376,188,188
2024-05-01,NLD,Kelantan,11,7,4
2024-05-01,NLD,Melaka,1,1,0
2024-05-01,NLD,Pahang,6,4,2
2024-05-01,NLD,Perak,19,10,9
2024-05-01,NLD,Perlis,43,26,17
2024-05-01,NLD,Pulau Pinang,266,175,91
2024-05-01,NLD,Sabah,93,57,36
2024-05-01,NLD,Sarawak,169,99,70
2024-05-01,NLD,Selangor,4230,2455,1775
2024-05-01,NLD,W.P. Labuan,2,1,1
2024-05-01,NOR,Johor,136,84,52
2024-05-01,NOR,Kedah,36,16,20
2024-05-01,NOR,Kelantan,1,1,0
2024-05-01,NOR,Perak,1,0,1
2024-05-01,NOR,Perlis,6,1,5
2024-05-01,NOR,Pulau Pinang,20,13,7
2024-05-01,NOR,Sabah,8,5,3
2024-05-01,NOR,Sarawak,32,20,12
2024-05-01,NOR,Selangor,529,331,198
2024-05-01,NPL,Johor,665,421,244
2024-05-01,NPL,Kedah,24,14,10
2024-05-01,NPL,Perak,5,3,2
2024-05-01,NPL,Pulau Pinang,29,22,7
2024-05-01,NPL,Sabah,3,1,2
2024-05-01,NPL,Sarawak,268,189,79
2024-05-01,NPL,Selangor,20680,19936,744
2024-05-01,NPL,W.P. Labuan,77,77,0
2024-05-01,NRU,Selangor,2,2,0
2024-05-01,NZL,Johor,763,467,296
2024-05-01,NZL,Kedah,87,52,35
2024-05-01,NZL,Kelantan,4,2,2
2024-05-01,NZL,Melaka,1,0,1
2024-05-01,NZL,Pahang,5,5,0
2024-05-01,NZL,Perak,19,9,10
2024-05-01,NZL,Perlis,22,14,8
2024-05-01,NZL,Pulau Pinang,241,133,108
2024-05-01,NZL,Sabah,55,28,27
2024-05-01,NZL,Sarawak,141,89,52
2024-05-01,NZL,Selangor,2485,1487,998
2024-05-01,OMN,Johor,24,23,1
2024-05-01,OMN,Perak,4,3,1
2024-05-01,OMN,Pulau Pinang,4,4,0
2024-05-01,OMN,Sarawak,8,7,1
2024-05-01,OMN,Selangor,965,607,358
2024-05-01,PAK,Johor,617,455,162
2024-05-01,PAK,Kedah,129,96,33
2024-05-01,PAK,Kelantan,15,15,0
2024-05-01,PAK,Pahang,2,2,0
2024-05-01,PAK,Perak,1,0,1
2024-05-01,PAK,Perlis,18,17,1
2024-05-01,PAK,Pulau Pinang,278,240,38
2024-05-01,PAK,Sabah,13,12,1
2024-05-01,PAK,Sarawak,182,148,34
2024-05-01,PAK,Selangor,13638,12047,1591
2024-05-01,PAK,W.P. Labuan,2,2,0
2024-05-01,PAN,Johor,5,4,1
2024-05-01,PAN,Kedah,1,0,1
2024-05-01,PAN,Selangor,14,7,7
2024-05-01,PER,Johor,29,14,15
2024-05-01,PER,Kedah,4,3,1
2024-05-01,PER,Perlis,3,2,1
2024-05-01,PER,Pulau Pinang,10,6,4
2024-05-01,PER,Sarawak,3,3,0
2024-05-01,PER,Selangor,191,104,87
2024-05-01,PHL,Johor,25289,7974,17315
2024-05-01,PHL,Kedah,498,146,352
2024-05-01,PHL,Kelantan,65,31,34
2024-05-01,PHL,Pahang,22,14,8
2024-05-01,PHL,Perak,88,31,57
2024-05-01,PHL,Perlis,125,45,80
2024-05-01,PHL,Pulau Pinang,1024,392,632
2024-05-01,PHL,Sabah,1422,718,704
2024-05-01,PHL,Sarawak,2747,1046,1701
2024-05-01,PHL,Selangor,16032,6565,9467
2024-05-01,PHL,W.P. Labuan,112,27,85
2024-05-01,PLW,Johor,2,2,0
2024-05-01,PNG,Johor,17,10,7
2024-05-01,PNG,Kedah,1,1,0
2024-05-01,PNG,Sarawak,6,6,0
2024-05-01,PNG,Selangor,54,30,24
2024-05-01,POL,Johor,283,159,124
2024-05-01,POL,Kedah,85,44,41
2024-05-01,POL,Kelantan,1,1,0
2024-05-01,POL,Perak,6,5,1
2024-05-01,POL,Perlis,16,12,4
2024-05-01,POL,Pulau Pinang,55,27,28
2024-05-01,POL,Sabah,34,16,18
2024-05-01,POL,Sarawak,53,29,24
2024-05-01,POL,Selangor,1270,654,616
2024-05-01,POL,W.P. Labuan,2,2,0
2024-05-01,PRT,Johor,145,89,56
2024-05-01,PRT,Kedah,55,26,29
2024-05-01,PRT,Pahang,1,1,0
2024-05-01,PRT,Perak,2,1,1
2024-05-01,PRT,Perlis,1,1,0
2024-05-01,PRT,Pulau Pinang,41,25,16
2024-05-01,PRT,Sabah,12,8,4
2024-05-01,PRT,Sarawak,9,6,3
2024-05-01,PRT,Selangor,861,516,345
2024-05-01,PRY,Johor,4,1,3
2024-05-01,PRY,Sabah,1,1,0
2024-05-01,PRY,Selangor,14,2,12
2024-05-01,PSE,Johor,30,20,10
2024-05-01,PSE,Kedah,4,2,2
2024-05-01,PSE,Perak,1,1,0
2024-05-01,PSE,Pulau Pinang,3,3,0
2024-05-01,PSE,Selangor,352,230,122
2024-05-01,QAT,Johor,6,6,0
2024-05-01,QAT,Selangor,112,83,29
2024-05-01,ROU,Johor,128,69,59
2024-05-01,ROU,Kedah,21,9,12
2024-05-01,ROU,Kelantan,4,2,2
2024-05-01,ROU,Melaka,1,1,0
2024-05-01,ROU,Perak,1,0,1
2024-05-01,ROU,Perlis,1,0,1
2024-05-01,ROU,Pulau Pinang,34,17,17
2024-05-01,ROU,Sabah,5,3,2
2024-05-01,ROU,Sarawak,9,5,4
2024-05-01,ROU,Selangor,628,337,291
2024-05-01,RUS,Johor,437,226,211
2024-05-01,RUS,Kedah,250,114,136
2024-05-01,RUS,Kelantan,36,21,15
2024-05-01,RUS,Pahang,1,0,1
2024-05-01,RUS,Perak,5,2,3
2024-05-01,RUS,Perlis,53,37,16
2024-05-01,RUS,Pulau Pinang,109,63,46
2024-05-01,RUS,Sabah,38,19,19
2024-05-01,RUS,Sarawak,47,24,23
2024-05-01,RUS,Selangor,7876,3930,3946
2024-05-01,RUS,W.P. Labuan,3,2,1
2024-05-01,RWA,Pulau Pinang,1,1,0
2024-05-01,RWA,Selangor,6,6,0
2024-05-01,SAU,Johor,164,93,71
2024-05-01,SAU,Kedah,28,21,7
2024-05-01,SAU,Kelantan,1,1,0
2024-05-01,SAU,Perak,8,8,0
2024-05-01,SAU,Perlis,1,1,0
2024-05-01,SAU,Pulau Pinang,22,13,9
2024-05-01,SAU,Sarawak,16,7,9
2024-05-01,SAU,Selangor,3984,2474,1510
2024-05-01,SDN,Johor,11,8,3
2024-05-01,SDN,Kedah,2,1,1
2024-05-01,SDN,Pulau Pinang,2,1,1
2024-05-01,SDN,Sarawak,8,2,6
2024-05-01,SDN,Selangor,811,482,329
2024-05-01,SDN,W.P. Labuan,1,1,0
2024-05-01,SEN,Johor,14,12,2
2024-05-01,SEN,Selangor,90,63,27
2024-05-01,SGP,Johor,1432787,817386,615401
2024-05-01,SGP,Kedah,5368,2742,2626
2024-05-01,SGP,Kelantan,99,64,35
2024-05-01,SGP,Melaka,22,18,4
2024-05-01,SGP,Pahang,696,363,333
2024-05-01,SGP,Perak,6096,2748,3348
2024-05-01,SGP,Perlis,240,144,96
2024-05-01,SGP,Pulau Pinang,21664,10285,11379
2024-05-01,SGP,Sabah,2770,1356,1414
2024-05-01,SGP,Sarawak,4386,2597,1789
2024-05-01,SGP,Selangor,52931,27341,25590
2024-05-01,SGP,W.P. Labuan,6,4,2
2024-05-01,SLB,Johor,5,5,0
2024-05-01,SLB,Pulau Pinang,1,1,0
2024-05-01,SLB,Sarawak,10,3,7
2024-05-01,SLB,Selangor,8,5,3
2024-05-01,SLE,Johor,7,5,2
2024-05-01,SLE,Kedah,1,1,0
2024-05-01,SLE,Pulau Pinang,5,1,4
2024-05-01,SLE,Selangor,25,12,13
2024-05-01,SLV,Johor,2,2,0
2024-05-01,SLV,Selangor,13,6,7
2024-05-01,SMR,Selangor,3,2,1
2024-05-01,SOM,Selangor,208,116,92
2024-05-01,SRB,Johor,5,5,0
2024-05-01,SRB,Kedah,2,0,2
2024-05-01,SRB,Perak,1,1,0
2024-05-01,SRB,Pulau Pinang,5,5,0
2024-05-01,SRB,Selangor,180,82,98
2024-05-01,SSD,Johor,1,1,0
2024-05-01,SSD,Sarawak,4,2,2
2024-05-01,SSD,Selangor,29,14,15
2024-05-01,STP,Selangor,2,0,2
2024-05-01,SUR,Johor,4,3,1
2024-05-01,SUR,Pulau Pinang,2,1,1
2024-05-01,SUR,Selangor,27,13,14
2024-05-01,SVK,Johor,53,29,24
2024-05-01,SVK,Kedah,47,22,25
2024-05-01,SVK,Perlis,2,1,1
2024-05-01,SVK,Pulau Pinang,15,13,2
2024-05-01,SVK,Sabah,10,4,6
2024-05-01,SVK,Sarawak,9,8,1
2024-05-01,SVK,Selangor,256,146,110
2024-05-01,SVN,Johor,13,9,4
2024-05-01,SVN,Kedah,8,3,5
2024-05-01,SVN,Perak,1,1,0
2024-05-01,SVN,Pulau Pinang,1,1,0
2024-05-01,SVN,Sabah,3,2,1
2024-05-01,SVN,Sarawak,4,0,4
2024-05-01,SVN,Selangor,129,72,57
2024-05-01,SWE,Johor,184,114,70
2024-05-01,SWE,Kedah,64,36,28
2024-05-01,SWE,Kelantan,1,1,0
2024-05-01,SWE,Perak,1,1,0
2024-05-01,SWE,Perlis,5,3,2
2024-05-01,SWE,Pulau Pinang,81,59,22
2024-05-01,SWE,Sabah,20,13,7
2024-05-01,SWE,Sarawak,30,23,7
2024-05-01,SWE,Selangor,704,455,249
2024-05-01,SWE,W.P. Labuan,2,1,1
2024-05-01,SWZ,Johor,2,2,0
2024-05-01,SWZ,Selangor,28,12,16
2024-05-01,SYC,Johor,3,1,2
2024-05-01,SYC,Pahang,1,1,0
2024-05-01,SYC,Selangor,59,27,32
2024-05-01,SYR,Johor,37,32,5
2024-05-01,SYR,Kedah,6,4,2
2024-05-01,SYR,Pulau Pinang,11,10,1
2024-05-01,SYR,Sarawak,11,9,2
2024-05-01,SYR,Selangor,618,398,220
2024-05-01,TCD,Johor,4,3,1
2024-05-01,TCD,Selangor,32,26,6
2024-05-01,TGO,Kedah,1,1,0
2024-05-01,TGO,Selangor,12,9,3
2024-05-01,THA,Johor,8267,2210,6057
2024-05-01,THA,Kedah,64267,35657,28610
2024-05-01,THA,Kelantan,55889,28354,27535
2024-05-01,THA,Melaka,4,1,3
2024-05-01,THA,Pahang,21,11,10
2024-05-01,THA,Perak,8614,4017,4597
2024-05-01,THA,Perlis,47853,27639,20214
2024-05-01,THA,Pulau Pinang,3045,1105,1940
2024-05-01,THA,Sabah,23,5,18
2024-05-01,THA,Sarawak,500,180,320
2024-05-01,THA,Selangor,14834,5812,9022
2024-05-01,THA,Terengganu,1,1,0
2024-05-01,THA,W.P. Labuan,14,6,8
2024-05-01,TJK,Johor,7,5,2
2024-05-01,TJK,Kedah,2,1,1
2024-05-01,TJK,Sabah,1,1,0
2024-05-01,TJK,Selangor,140,110,30
2024-05-01,TKM,Johor,4,3,1
2024-05-01,TKM,Kedah,6,1,5
2024-05-01,TKM,Pulau Pinang,2,2,0
2024-05-01,TKM,Sarawak,1,1,0
2024-05-01,TKM,Selangor,333,205,128
2024-05-01,TLS,Johor,15,7,8
2024-05-01,TLS,Kedah,1,0,1
2024-05-01,TLS,Perak,3,0,3
2024-05-01,TLS,Pulau Pinang,10,5,5
2024-05-01,TLS,Sabah,1,0,1
2024-05-01,TLS,Selangor,197,105,92
2024-05-01,TON,Johor,1,1,0
2024-05-01,TON,Kedah,1,1,0
2024-05-01,TON,Pulau Pinang,1,0,1
2024-05-01,TON,Sarawak,1,1,0
2024-05-01,TON,Selangor,12,6,6
2024-05-01,TTO,Johor,7,4,3
2024-05-01,TTO,Kedah,1,0,1
2024-05-01,TTO,Perak,1,1,0
2024-05-01,TTO,Sarawak,2,0,2
2024-05-01,TTO,Selangor,34,17,17
2024-05-01,TUN,Johor,26,15,11
2024-05-01,TUN,Kedah,2,0,2
2024-05-01,TUN,Kelantan,1,1,0
2024-05-01,TUN,Pulau Pinang,12,5,7
2024-05-01,TUN,Sarawak,1,1,0
2024-05-01,TUN,Selangor,816,435,381
2024-05-01,TUR,Johor,327,228,99
2024-05-01,TUR,Kedah,38,23,15
2024-05-01,TUR,Kelantan,11,9,2
2024-05-01,TUR,Perak,3,1,2
2024-05-01,TUR,Perlis,15,13,2
2024-05-01,TUR,Pulau Pinang,35,29,6
2024-05-01,TUR,Sabah,7,6,1
2024-05-01,TUR,Sarawak,25,16,9
2024-05-01,TUR,Selangor,1772,1302,470
2024-05-01,TUR,W.P. Labuan,1,0,1
2024-05-01,TUV,Pulau Pinang,2,0,2
2024-05-01,TUV,Selangor,2,1,1
2024-05-01,TWN,Johor,8338,3582,4756
2024-05-01,TWN,Kedah,168,87,81
2024-05-01,TWN,Kelantan,4,3,1
2024-05-01,TWN,Melaka,13,9,4
2024-05-01,TWN,Pahang,5,3,2
2024-05-01,TWN,Perak,60,25,35
2024-05-01,TWN,Perlis,23,16,7
2024-05-01,TWN,Pulau Pinang,4147,2036,2111
2024-05-01,TWN,Sabah,1517,706,811
2024-05-01,TWN,Sarawak,269,132,137
2024-05-01,TWN,Selangor,14570,7068,7502
2024-05-01,TWN,W.P. Labuan,4,3,1
2024-05-01,TZA,Johor,12,9,3
2024-05-01,TZA,Pulau Pinang,2,1,1
2024-05-01,TZA,Sarawak,4,3,1
2024-05-01,TZA,Selangor,167,75,92
2024-05-01,UGA,Johor,308,127,181
2024-05-01,UGA,Kedah,1,0,1
2024-05-01,UGA,Sarawak,2,2,0
2024-05-01,UGA,Selangor,390,148,242
2024-05-01,UKR,Johor,120,61,59
2024-05-01,UKR,Kedah,36,16,20
2024-05-01,UKR,Kelantan,12,5,7
2024-05-01,UKR,Pahang,3,2,1
2024-05-01,UKR,Perlis,6,3,3
2024-05-01,UKR,Pulau Pinang,19,7,12
2024-05-01,UKR,Sabah,5,3,2
2024-05-01,UKR,Sarawak,4,2,2
2024-05-01,UKR,Selangor,1101,530,571
2024-05-01,URY,Johor,14,6,8
2024-05-01,URY,Kedah,2,1,1
2024-05-01,URY,Sabah,2,1,1
2024-05-01,URY,Selangor,51,21,30
2024-05-01,USA,Johor,5196,2974,2222
2024-05-01,USA,Kedah,522,279,243
2024-05-01,USA,Kelantan,24,17,7
2024-05-01,USA,Melaka,5,3,2
2024-05-01,USA,Pahang,9,7,2
2024-05-01,USA,Perak,143,84,59
2024-05-01,USA,Perlis,107,56,51
2024-05-01,USA,Pulau Pinang,2332,1419,913
2024-05-01,USA,Sabah,320,164,156
2024-05-01,USA,Sarawak,313,206,107
2024-05-01,USA,Selangor,14291,8418,5873
2024-05-01,USA,W.P. Labuan,5,4,1
2024-05-01,UZB,Johor,82,58,24
2024-05-01,UZB,Kedah,8,7,1
2024-05-01,UZB,Kelantan,2,2,0
2024-05-01,UZB,Perlis,1,1,0
2024-05-01,UZB,Pulau Pinang,13,11,2
2024-05-01,UZB,Sabah,6,4,2
2024-05-01,UZB,Selangor,924,580,344
2024-05-01,VAT,Selangor,1,1,0
2024-05-01,VCT,Selangor,1,1,0
2024-05-01,VEN,Johor,12,8,4
2024-05-01,VEN,Kedah,1,0,1
2024-05-01,VEN,Pulau Pinang,1,1,0
2024-05-01,VEN,Sabah,2,1,1
2024-05-01,VEN,Sarawak,4,1,3
2024-05-01,VEN,Selangor,106,56,50
2024-05-01,VNM,Johor,15481,4745,10736
2024-05-01,VNM,Kedah,372,43,329
2024-05-01,VNM,Kelantan,29,14,15
2024-05-01,VNM,Pahang,10,9,1
2024-05-01,VNM,Perak,142,34,108
2024-05-01,VNM,Perlis,220,14,206
2024-05-01,VNM,Pulau Pinang,1837,482,1355
2024-05-01,VNM,Sabah,16,2,14
2024-05-01,VNM,Sarawak,361,47,314
2024-05-01,VNM,Selangor,14207,4898,9309
2024-05-01,VNM,W.P. Labuan,4,2,2
2024-05-01,VUT,Johor,19,11,8
2024-05-01,VUT,Pulau Pinang,5,5,0
2024-05-01,VUT,Sabah,1,1,0
2024-05-01,VUT,Selangor,102,89,13
2024-05-01,WSM,Johor,1,0,1
2024-05-01,WSM,Pulau Pinang,1,0,1
2024-05-01,XXX,Johor,1,1,0
2024-05-01,XXX,Pulau Pinang,1,1,0
2024-05-01,XXX,Sarawak,3,2,1
2024-05-01,XXX,Selangor,68,38,30
2024-05-01,YEM,Johor,39,29,10
2024-05-01,YEM,Kedah,6,4,2
2024-05-01,YEM,Kelantan,3,3,0
2024-05-01,YEM,Perlis,1,1,0
2024-05-01,YEM,Pulau Pinang,4,3,1
2024-05-01,YEM,Sarawak,3,2,1
2024-05-01,YEM,Selangor,1203,832,371
2024-05-01,ZAF,Johor,293,187,106
2024-05-01,ZAF,Kedah,46,26,20
2024-05-01,ZAF,Kelantan,2,2,0
2024-05-01,ZAF,Perak,3,2,1
2024-05-01,ZAF,Perlis,4,2,2
2024-05-01,ZAF,Pulau Pinang,71,41,30
2024-05-01,ZAF,Sabah,19,11,8
2024-05-01,ZAF,Sarawak,101,41,60
2024-05-01,ZAF,Selangor,814,489,325
2024-05-01,ZAR,Selangor,4,2,2
2024-05-01,ZMB,Johor,7,4,3
2024-05-01,ZMB,Kedah,1,1,0
2024-05-01,ZMB,Pulau Pinang,1,0,1
2024-05-01,ZMB,Selangor,44,28,16
2024-05-01,ZWE,Johor,14,8,6
2024-05-01,ZWE,Kedah,2,0,2
2024-05-01,ZWE,Pulau Pinang,6,4,2
2024-05-01,ZWE,Sabah,2,1,1
2024-05-01,ZWE,Selangor,139,70,69
2024-06-01,AFG,Sarawak,2,2,0
2024-06-01,AFG,Selangor,34,25,9
2024-06-01,AGO,Selangor,9,7,2
2024-06-01,AIA,Selangor,1,1,0
2024-06-01,ALB,Johor,11,7,4
2024-06-01,ALB,Kedah,1,1,0
2024-06-01,ALB,Pulau Pinang,1,1,0
2024-06-01,ALB,Sarawak,1,1,0
2024-06-01,ALB,Selangor,32,18,14
2024-06-01,AND,Pulau Pinang,1,1,0
2024-06-01,AND,Selangor,13,9,4
2024-06-01,ARE,Johor,36,17,19
2024-06-01,ARE,Kedah,19,13,6
2024-06-01,ARE,Kelantan,1,0,1
2024-06-01,ARE,Pulau Pinang,11,9,2
2024-06-01,ARE,Selangor,659,371,288
2024-06-01,ARG,Johor,93,46,47
2024-06-01,ARG,Kedah,11,5,6
2024-06-01,ARG,Kelantan,1,0,1
2024-06-01,ARG,Perlis,7,3,4
2024-06-01,ARG,Pulau Pinang,6,2,4
2024-06-01,ARG,Sabah,3,2,1
2024-06-01,ARG,Sarawak,11,9,2
2024-06-01,ARG,Selangor,417,225,192
2024-06-01,ARM,Johor,2,1,1
2024-06-01,ARM,Kedah,3,2,1
2024-06-01,ARM,Pulau Pinang,2,1,1
2024-06-01,ARM,Selangor,63,33,30
2024-06-01,ATG,Johor,5,2,3
2024-06-01,ATG,Sabah,1,0,1
2024-06-01,ATG,Selangor,16,8,8
2024-06-01,AUS,Johor,5362,3141,2221
2024-06-01,AUS,Kedah,505,277,228
2024-06-01,AUS,Kelantan,13,8,5
2024-06-01,AUS,Melaka,2,1,1
2024-06-01,AUS,Pahang,62,34,28
2024-06-01,AUS,Perak,212,110,102
2024-06-01,AUS,Perlis,75,43,32
2024-06-01,AUS,Pulau Pinang,2182,1125,1057
2024-06-01,AUS,Sabah,583,303,280
2024-06-01,AUS,Sarawak,631,360,271
2024-06-01,AUS,Selangor,29383,16434,12949
2024-06-01,AUS,W.P. Labuan,12,10,2
2024-06-01,AUT,Johor,136,98,38
2024-06-01,AUT,Kedah,12,6,6
2024-06-01,AUT,Kelantan,7,7,0
2024-06-01,AUT,Negeri Sembilan,2,1,1
2024-06-01,AUT,Perak,2,2,0
2024-06-01,AUT,Perlis,2,2,0
2024-06-01,AUT,Pulau Pinang,48,35,13
2024-06-01,AUT,Sabah,9,5,4
2024-06-01,AUT,Sarawak,11,5,6
2024-06-01,AUT,Selangor,568,369,199
2024-06-01,AZE,Johor,7,4,3
2024-06-01,AZE,Kedah,11,3,8
2024-06-01,AZE,Selangor,203,100,103
2024-06-01,BDI,Johor,1,1,0
2024-06-01,BDI,Selangor,1,0,1
2024-06-01,BEL,Johor,288,174,114
2024-06-01,BEL,Kedah,150,80,70
2024-06-01,BEL,Kelantan,2,1,1
2024-06-01,BEL,Pahang,1,0,1
2024-06-01,BEL,Perak,1,1,0
2024-06-01,BEL,Perlis,13,8,5
2024-06-01,BEL,Pulau Pinang,80,56,24
2024-06-01,BEL,Sabah,29,14,15
2024-06-01,BEL,Sarawak,42,20,22
2024-06-01,BEL,Selangor,1754,1006,748
2024-06-01,BEL,W.P. Labuan,1,1,0
2024-06-01,BEN,Selangor,8,6,2
2024-06-01,BFA,Pulau Pinang,1,1,0
2024-06-01,BFA,Selangor,29,26,3
2024-06-01,BGD,Johor,3628,2861,767
2024-06-01,BGD,Kedah,162,104,58
2024-06-01,BGD,Kelantan,3,3,0
2024-06-01,BGD,Perak,2,2,0
2024-06-01,BGD,Perlis,1,1,0
2024-06-01,BGD,Pulau Pinang,227,187,40
2024-06-01,BGD,Sabah,2,1,1
2024-06-01,BGD,Sarawak,140,101,39
2024-06-01,BGD,Selangor,25217,21920,3297
2024-06-01,BGD,W.P. Labuan,5,5,0
2024-06-01,BGR,Johor,44,22,22
2024-06-01,BGR,Pulau Pinang,4,3,1
2024-06-01,BGR,Sabah,4,2,2
2024-06-01,BGR,Sarawak,5,5,0
2024-06-01,BGR,Selangor,173,101,72
2024-06-01,BHR,Johor,43,22,21
2024-06-01,BHR,Kedah,2,1,1
2024-06-01,BHR,Pulau Pinang,20,5,15
2024-06-01,BHR,Sabah,1,0,1
2024-06-01,BHR,Selangor,427,211,216
2024-06-01,BHS,Perlis,1,1,0
2024-06-01,BHS,Selangor,3,1,2
2024-06-01,BIH,Johor,6,4,2
2024-06-01,BIH,Pulau Pinang,1,1,0
2024-06-01,BIH,Selangor,67,42,25
2024-06-01,BLR,Johor,10,6,4
2024-06-01,BLR,Kedah,11,4,7
2024-06-01,BLR,Kelantan,4,1,3
2024-06-01,BLR,Pulau Pinang,2,0,2
2024-06-01,BLR,Sarawak,1,1,0
2024-06-01,BLR,Selangor,343,147,196
2024-06-01,BLZ,Johor,4,4,0
2024-06-01,BLZ,Selangor,5,4,1
2024-06-01,BOL,Johor,7,2,5
2024-06-01,BOL,Pulau Pinang,2,1,1
2024-06-01,BOL,Sarawak,4,1,3
2024-06-01,BOL,Selangor,19,8,11
2024-06-01,BRA,Johor,316,182,134
2024-06-01,BRA,Kedah,31,19,12
2024-06-01,BRA,Kelantan,1,1,0
2024-06-01,BRA,Perlis,8,3,5
2024-06-01,BRA,Pulau Pinang,21,17,4
2024-06-01,BRA,Sabah,5,4,1
2024-06-01,BRA,Sarawak,5,3,2
2024-06-01,BRA,Selangor,966,581,385
2024-06-01,BRB,Johor,10,2,8
2024-06-01,BRB,Kedah,1,1,0
2024-06-01,BRB,Selangor,5,2,3
2024-06-01,BRN,Johor,367,191,176
2024-06-01,BRN,Kedah,12,7,5
2024-06-01,BRN,Kelantan,5,2,3
2024-06-01,BRN,Perak,4,2,2
2024-06-01,BRN,Perlis,29,14,15
2024-06-01,BRN,Pulau Pinang,18,7,11
2024-06-01,BRN,Sabah,1087,454,633
2024-06-01,BRN,Sarawak,131317,71327,59990
2024-06-01,BRN,Selangor,4831,2452,2379
2024-06-01,BRN,W.P. Labuan,1059,701,358
2024-06-01,BTN,Johor,11,6,5
2024-06-01,BTN,Selangor,50,39,11
2024-06-01,BWA,Kedah,3,1,2
2024-06-01,BWA,Sarawak,1,1,0
2024-06-01,BWA,Selangor,15,5,10
2024-06-01,CAN,Johor,1461,830,631
2024-06-01,CAN,Kedah,125,68,57
2024-06-01,CAN,Kelantan,3,3,0
2024-06-01,CAN,Melaka,2,2,0
2024-06-01,CAN,Pahang,9,5,4
2024-06-01,CAN,Perak,25,13,12
2024-06-01,CAN,Perlis,22,13,9
2024-06-01,CAN,Pulau Pinang,459,259,200
2024-06-01,CAN,Sabah,175,90,85
2024-06-01,CAN,Sarawak,281,151,130
2024-06-01,CAN,Selangor,3855,2232,1623
2024-06-01,CAN,W.P. Labuan,7,4,3
2024-06-01,CHE,Johor,366,217,149
2024-06-01,CHE,Kedah,41,23,18
2024-06-01,CHE,Negeri Sembilan,3,2,1
2024-06-01,CHE,Pahang,5,3,2
2024-06-01,CHE,Perak,5,2,3
2024-06-01,CHE,Perlis,29,17,12
2024-06-01,CHE,Pulau Pinang,113,80,33
2024-06-01,CHE,Sabah,39,18,21
2024-06-01,CHE,Sarawak,47,23,24
2024-06-01,CHE,Selangor,1340,796,544
2024-06-01,CHL,Johor,59,24,35
2024-06-01,CHL,Kedah,8,3,5
2024-06-01,CHL,Kelantan,2,1,1
2024-06-01,CHL,Pahang,1,1,0
2024-06-01,CHL,Perlis,9,7,2
2024-06-01,CHL,Pulau Pinang,8,6,2
2024-06-01,CHL,Sabah,2,1,1
2024-06-01,CHL,Selangor,318,178,140
2024-06-01,CHN,Johor,81971,35785,46186
2024-06-01,CHN,Kedah,1450,647,803
2024-06-01,CHN,Kelantan,36,26,10
2024-06-01,CHN,Melaka,12,11,1
2024-06-01,CHN,Negeri Sembilan,2,2,0
2024-06-01,CHN,Pahang,45,21,24
2024-06-01,CHN,Perak,380,187,193
2024-06-01,CHN,Perlis,504,243,261
2024-06-01,CHN,Pulau Pinang,15103,7353,7750
2024-06-01,CHN,Sabah,24694,10340,14354
2024-06-01,CHN,Sarawak,1706,891,815
2024-06-01,CHN,Selangor,184267,87650,96617
2024-06-01,CHN,W.P. Labuan,34,25,9
2024-06-01,CIV,Selangor,5,4,1
2024-06-01,CMR,Johor,3,1,2
2024-06-01,CMR,Selangor,24,20,4
2024-06-01,COD,Johor,6,5,1
2024-06-01,COD,Selangor,14,11,3
2024-06-01,COG,Selangor,1,1,0
2024-06-01,COL,Johor,27,13,14
2024-06-01,COL,Kedah,15,7,8
2024-06-01,COL,Perak,1,1,0
2024-06-01,COL,Pulau Pinang,5,3,2
2024-06-01,COL,Sabah,3,2,1
2024-06-01,COL,Sarawak,1,0,1
2024-06-01,COL,Selangor,227,118,109
2024-06-01,COL,W.P. Labuan,1,1,0
2024-06-01,COM,Kedah,1,0,1
2024-06-01,COM,Selangor,38,16,22
2024-06-01,CPV,Johor,2,1,1
2024-06-01,CPV,Selangor,5,3,2
2024-06-01,CRI,Johor,13,10,3
2024-06-01,CRI,Kedah,1,0,1
2024-06-01,CRI,Pulau Pinang,10,9,1
2024-06-01,CRI,Sabah,1,0,1
2024-06-01,CRI,Sarawak,2,2,0
2024-06-01,CRI,Selangor,41,19,22
2024-06-01,CUB,Johor,12,7,5
2024-06-01,CUB,Pulau Pinang,3,3,0
2024-06-01,CUB,Selangor,22,12,10
2024-06-01,CYP,Johor,6,3,3
2024-06-01,CYP,Kedah,1,0,1
2024-06-01,CYP,Pulau Pinang,5,2,3
2024-06-01,CYP,Selangor,79,60,19
2024-06-01,CZE,Johor,86,50,36
2024-06-01,CZE,Kedah,39,20,19
2024-06-01,CZE,Kelantan,2,2,0
2024-06-01,CZE,Perlis,1,0,1
2024-06-01,CZE,Pulau Pinang,13,9,4
2024-06-01,CZE,Sabah,3,2,1
2024-06-01,CZE,Sarawak,17,12,5
2024-06-01,CZE,Selangor,484,281,203
2024-06-01,DEU,Johor,2004,1255,749
2024-06-01,DEU,Kedah,295,166,129
2024-06-01,DEU,Kelantan,10,7,3
2024-06-01,DEU,Melaka,3,0,3
2024-06-01,DEU,Negeri Sembilan,6,2,4
2024-06-01,DEU,Pahang,11,9,2
2024-06-01,DEU,Perak,36,25,11
2024-06-01,DEU,Perlis,84,49,35
2024-06-01,DEU,Pulau Pinang,527,370,157
2024-06-01,DEU,Sabah,158,85,73
2024-06-01,DEU,Sarawak,217,132,85
2024-06-01,DEU,Selangor,6228,3790,2438
2024-06-01,DEU,W.P. Labuan,1,0,1
2024-06-01,DJI,Selangor,14,11,3
2024-06-01,DMA,Johor,4,2,2
2024-06-01,DMA,Kedah,1,1,0
2024-06-01,DMA,Pulau Pinang,2,2,0
2024-06-01,DMA,Selangor,44,34,10
2024-06-01,DNK,Johor,271,209,62
2024-06-01,DNK,Kedah,24,15,9
2024-06-01,DNK,Kelantan,4,3,1
2024-06-01,DNK,Pahang,3,2,1
2024-06-01,DNK,Perlis,12,9,3
2024-06-01,DNK,Pulau Pinang,61,42,19
2024-06-01,DNK,Sabah,18,13,5
2024-06-01,DNK,Sarawak,19,9,10
2024-06-01,DNK,Selangor,897,535,362
2024-06-01,DOM,Johor,7,1,6
2024-06-01,DOM,Pulau Pinang,1,0,1
2024-06-01,DOM,Sabah,1,0,1
2024-06-01,DOM,Selangor,12,8,4
2024-06-01,DZA,Johor,31,24,7
2024-06-01,DZA,Kedah,10,6,4
2024-06-01,DZA,Perlis,1,0,1
2024-06-01,DZA,Pulau Pinang,3,3,0
2024-06-01,DZA,Selangor,770,488,282
2024-06-01,ECU,Johor,32,14,18
2024-06-01,ECU,Kedah,1,1,0
2024-06-01,ECU,Perlis,1,0,1
2024-06-01,ECU,Pulau Pinang,3,2,1
2024-06-01,ECU,Sabah,1,0,1
2024-06-01,ECU,Sarawak,2,2,0
2024-06-01,ECU,Selangor,81,46,35
2024-06-01,EGY,Johor,255,216,39
2024-06-01,EGY,Kedah,15,7,8
2024-06-01,EGY,Kelantan,1,1,0
2024-06-01,EGY,Perlis,1,1,0
2024-06-01,EGY,Pulau Pinang,37,22,15
2024-06-01,EGY,Sabah,4,2,2
2024-06-01,EGY,Sarawak,96,70,26
2024-06-01,EGY,Selangor,2160,1291,869
2024-06-01,ERI,Selangor,34,20,14
2024-06-01,ESP,Johor,541,321,220
2024-06-01,ESP,Kedah,71,35,36
2024-06-01,ESP,Kelantan,5,3,2
2024-06-01,ESP,Perak,5,2,3
2024-06-01,ESP,Perlis,12,5,7
2024-06-01,ESP,Pulau Pinang,120,59,61
2024-06-01,ESP,Sabah,50,24,26
2024-06-01,ESP,Sarawak,79,39,40
2024-06-01,ESP,Selangor,3625,1959,1666
2024-06-01,ESP,W.P. Labuan,10,7,3
2024-06-01,EST,Johor,22,13,9
2024-06-01,EST,Kelantan,1,0,1
2024-06-01,EST,Pulau Pinang,5,2,3
2024-06-01,EST,Sabah,4,2,2
2024-06-01,EST,Sarawak,1,0,1
2024-06-01,EST,Selangor,106,65,41
2024-06-01,ETH,Pulau Pinang,2,1,1
2024-06-01,ETH,Selangor,37,21,16
2024-06-01,FIN,Johor,180,107,73
2024-06-01,FIN,Kedah,29,13,16
2024-06-01,FIN,Kelantan,3,1,2
2024-06-01,FIN,Perak,2,2,0
2024-06-01,FIN,Perlis,5,4,1
2024-06-01,FIN,Pulau Pinang,46,30,16
2024-06-01,FIN,Sabah,5,2,3
2024-06-01,FIN,Sarawak,8,4,4
2024-06-01,FIN,Selangor,349,200,149
2024-06-01,FJI,Johor,60,26,34
2024-06-01,FJI,Pulau Pinang,4,1,3
2024-06-01,FJI,Sabah,4,3,1
2024-06-01,FJI,Sarawak,4,4,0
2024-06-01,FJI,Selangor,94,54,40
2024-06-01,FJI,W.P. Labuan,1,1,0
2024-06-01,FRA,Johor,2395,1439,956
2024-06-01,FRA,Kedah,267,141,126
2024-06-01,FRA,Kelantan,36,26,10
2024-06-01,FRA,Melaka,7,4,3
2024-06-01,FRA,Negeri Sembilan,1,0,1
2024-06-01,FRA,Pahang,10,4,6
2024-06-01,FRA,Perak,23,16,7
2024-06-01,FRA,Perlis,94,49,45
2024-06-01,FRA,Pulau Pinang,406,246,160
2024-06-01,FRA,Sabah,121,66,55
2024-06-01,FRA,Sarawak,144,77,67
2024-06-01,FRA,Selangor,9921,5520,4401
2024-06-01,FRA,Terengganu,1,1,0
2024-06-01,FRA,W.P. Labuan,3,2,1
2024-06-01,FSM,Selangor,1,0,1
2024-06-01,GAB,Johor,5,2,3
2024-06-01,GBR,Johor,4939,3195,1744
2024-06-01,GBR,Kedah,764,414,350
2024-06-01,GBR,Kelantan,22,14,8
2024-06-01,GBR,Melaka,6,5,1
2024-06-01,GBR,Negeri Sembilan,2,2,0
2024-06-01,GBR,Pahang,23,21,2
2024-06-01,GBR,Perak,104,61,43
2024-06-01,GBR,Perlis,190,118,72
2024-06-01,GBR,Pulau Pinang,1403,836,567
2024-06-01,GBR,Sabah,563,309,254
2024-06-01,GBR,Sarawak,1145,773,372
2024-06-01,GBR,Selangor,19486,11397,8089
2024-06-01,GBR,Terengganu,1,1,0
2024-06-01,GBR,W.P. Labuan,20,17,3
2024-06-01,GEO,Johor,12,3,9
2024-06-01,GEO,Sarawak,3,1,2
2024-06-01,GEO,Selangor,57,36,21
2024-06-01,GHA,Johor,10,8,2
2024-06-01,GHA,Pulau Pinang,2,1,1
2024-06-01,GHA,Selangor,105,68,37
2024-06-01,GIN,Johor,10,9,1
2024-06-01,GIN,Kedah,1,1,0
2024-06-01,GIN,Kelantan,1,1,0
2024-06-01,GIN,Selangor,54,40,14
2024-06-01,GMB,Johor,5,0,5
2024-06-01,GMB,Selangor,27,14,13
2024-06-01,GNB,Selangor,1,1,0
2024-06-01,GNQ,Selangor,2,1,1
2024-06-01,GRC,Johor,97,78,19
2024-06-01,GRC,Kedah,4,3,1
2024-06-01,GRC,Kelantan,1,1,0
2024-06-01,GRC,Pulau Pinang,6,4,2
2024-06-01,GRC,Sabah,4,2,2
2024-06-01,GRC,Sarawak,5,5,0
2024-06-01,GRC,Selangor,199,137,62
2024-06-01,GRD,Johor,7,5,2
2024-06-01,GRD,Selangor,9,6,3
2024-06-01,GTM,Johor,8,6,2
2024-06-01,GTM,Pulau Pinang,2,1,1
2024-06-01,GTM,Sabah,1,0,1
2024-06-01,GTM,Selangor,23,16,7
2024-06-01,GUY,Johor,1,1,0
2024-06-01,GUY,Selangor,3,2,1
2024-06-01,HKG,Johor,6,4,2
2024-06-01,HKG,Perak,61,20,41
2024-06-01,HKG,Perlis,1,1,0
2024-06-01,HKG,Pulau Pinang,6,1,5
2024-06-01,HKG,Sarawak,1,1,0
2024-06-01,HKG,Selangor,93,70,23
2024-06-01,HND,Johor,3,2,1
2024-06-01,HND,Pulau Pinang,2,1,1
2024-06-01,HND,Selangor,14,7,7
2024-06-01,HRV,Johor,29,27,2
2024-06-01,HRV,Kedah,2,2,0
2024-06-01,HRV,Kelantan,1,1,0
2024-06-01,HRV,Sabah,2,2,0
2024-06-01,HRV,Sarawak,2,1,1
2024-06-01,HRV,Selangor,150,102,48
2024-06-01,HTI,Johor,1,1,0
2024-06-01,HTI,Selangor,16,13,3
2024-06-01,HUN,Johor,76,51,25
2024-06-01,HUN,Kedah,7,3,4
2024-06-01,HUN,Perlis,1,1,0
2024-06-01,HUN,Pulau Pinang,30,19,11
2024-06-01,HUN,Sabah,7,5,2
2024-06-01,HUN,Sarawak,7,3,4
2024-06-01,HUN,Selangor,430,230,200
2024-06-01,IDN,Johor,117386,51562,65824
2024-06-01,IDN,Kedah,5316,1843,3473
2024-06-01,IDN,Kelantan,213,112,101
2024-06-01,IDN,Melaka,5262,2356,2906
2024-06-01,IDN,Negeri Sembilan,7155,4291,2864
2024-06-01,IDN,Pahang,25,13,12
2024-06-01,IDN,Perak,202,38,164
2024-06-01,IDN,Perlis,702,188,514
2024-06-01,IDN,Pulau Pinang,42689,17075,25614
2024-06-01,IDN,Sabah,6036,2910,3126
2024-06-01,IDN,Sarawak,54953,27092,27861
2024-06-01,IDN,Selangor,165487,74754,90733
2024-06-01,IDN,W.P. Labuan,63,39,24
2024-06-01,IND,Johor,50758,31531,19227
2024-06-01,IND,Kedah,1905,1059,846
2024-06-01,IND,Kelantan,5,4,1
2024-06-01,IND,Melaka,2,2,0
2024-06-01,IND,Pahang,18,17,1
2024-06-01,IND,Perak,284,155,129
2024-06-01,IND,Perlis,114,90,24
2024-06-01,IND,Pulau Pinang,1854,1091,763
2024-06-01,IND,Sabah,219,135,84
2024-06-01,IND,Sarawak,2493,1907,586
2024-06-01,IND,Selangor,89482,56049,33433
2024-06-01,IND,W.P. Labuan,79,57,22
2024-06-01,IRL,Johor,304,197,107
2024-06-01,IRL,Kedah,54,31,23
2024-06-01,IRL,Kelantan,1,1,0
2024-06-01,IRL,Pahang,1,0,1
2024-06-01,IRL,Perak,7,4,3
2024-06-01,IRL,Perlis,24,15,9
2024-06-01,IRL,Pulau Pinang,166,93,73
2024-06-01,IRL,Sabah,28,17,11
2024-06-01,IRL,Sarawak,31,23,8
2024-06-01,IRL,Selangor,1755,986,769
2024-06-01,IRL,W.P. Labuan,1,0,1
2024-06-01,IRN,Johor,200,115,85
2024-06-01,IRN,Kedah,14,4,10
2024-06-01,IRN,Perlis,8,7,1
2024-06-01,IRN,Pulau Pinang,12,8,4
2024-06-01,IRN,Sabah,1,1,0
2024-06-01,IRN,Sarawak,3,1,2
2024-06-01,IRN,Selangor,1672,899,773
2024-06-01,IRQ,Johor,39,30,9
2024-06-01,IRQ,Kedah,14,5,9
2024-06-01,IRQ,Pulau Pinang,2,1,1
2024-06-01,IRQ,Selangor,2478,1560,918
2024-06-01,ISL,Johor,3,2,1
2024-06-01,ISL,Selangor,42,22,20
2024-06-01,ITA,Johor,643,408,235
2024-06-01,ITA,Kedah,57,35,22
2024-06-01,ITA,Kelantan,3,2,1
2024-06-01,ITA,Melaka,2,2,0
2024-06-01,ITA,Pahang,2,2,0
2024-06-01,ITA,Perak,5,2,3
2024-06-01,ITA,Perlis,15,11,4
2024-06-01,ITA,Pulau Pinang,103,73,30
2024-06-01,ITA,Sabah,57,32,25
2024-06-01,ITA,Sarawak,54,30,24
2024-06-01,ITA,Selangor,3628,2215,1413
2024-06-01,ITA,W.P. Labuan,2,1,1
2024-06-01,JAM,Johor,3,1,2
2024-06-01,JAM,Pulau Pinang,1,1,0
2024-06-01,JAM,Selangor,13,8,5
2024-06-01,JOR,Johor,25,18,7
2024-06-01,JOR,Kedah,24,14,10
2024-06-01,JOR,Kelantan,1,1,0
2024-06-01,JOR,Pahang,1,1,0
2024-06-01,JOR,Pulau Pinang,15,7,8
2024-06-01,JOR,Sarawak,1,1,0
2024-06-01,JOR,Selangor,1600,870,730
2024-06-01,JPN,Johor,6192,4164,2028
2024-06-01,JPN,Kedah,142,76,66
2024-06-01,JPN,Kelantan,7,4,3
2024-06-01,JPN,Melaka,2,2,0
2024-06-01,JPN,Pahang,16,12,4
2024-06-01,JPN,Perak,63,43,20
2024-06-01,JPN,Perlis,83,61,22
2024-06-01,JPN,Pulau Pinang,1259,924,335
2024-06-01,JPN,Sabah,347,163,184
2024-06-01,JPN,Sarawak,192,111,81
2024-06-01,JPN,Selangor,20914,12345,8569
2024-06-01,JPN,W.P. Labuan,10,6,4
2024-06-01,KAZ,Johor,74,37,37
2024-06-01,KAZ,Kedah,13,6,7
2024-06-01,KAZ,Kelantan,2,0,2
2024-06-01,KAZ,Perlis,5,2,3
2024-06-01,KAZ,Pulau Pinang,10,6,4
2024-06-01,KAZ,Sabah,3,2,1
2024-06-01,KAZ,Sarawak,4,1,3
2024-06-01,KAZ,Selangor,3717,1485,2232
2024-06-01,KAZ,W.P. Labuan,1,1,0
2024-06-01,KEN,Johor,56,27,29
2024-06-01,KEN,Kedah,7,2,5
2024-06-01,KEN,Pulau Pinang,10,5,5
2024-06-01,KEN,Sabah,2,0,2
2024-06-01,KEN,Sarawak,2,2,0
2024-06-01,KEN,Selangor,872,423,449
2024-06-01,KGZ,Johor,34,25,9
2024-06-01,KGZ,Kedah,6,3,3
2024-06-01,KGZ,Kelantan,1,0,1
2024-06-01,KGZ,Pulau Pinang,9,5,4
2024-06-01,KGZ,Sabah,4,2,2
2024-06-01,KGZ,Selangor,371,180,191
2024-06-01,KHM,Johor,1562,659,903
2024-06-01,KHM,Kedah,152,97,55
2024-06-01,KHM,Kelantan,431,229,202
2024-06-01,KHM,Perak,11,4,7
2024-06-01,KHM,Perlis,727,419,308
2024-06-01,KHM,Pulau Pinang,42,15,27
2024-06-01,KHM,Sabah,4,0,4
2024-06-01,KHM,Sarawak,18,10,8
2024-06-01,KHM,Selangor,3813,1852,1961
2024-06-01,KNA,Johor,22,14,8
2024-06-01,KNA,Kedah,2,0,2
2024-06-01,KNA,Pulau Pinang,1,1,0
2024-06-01,KNA,Selangor,59,48,11
2024-06-01,KOR,Johor,9723,5374,4349
2024-06-01,KOR,Kedah,116,67,49
2024-06-01,KOR,Kelantan,7,4,3
2024-06-01,KOR,Pahang,2,2,0
2024-06-01,KOR,Perak,14,10,4
2024-06-01,KOR,Perlis,66,47,19
2024-06-01,KOR,Pulau Pinang,580,348,232
2024-06-01,KOR,Sabah,15562,6116,9446
2024-06-01,KOR,Sarawak,262,159,103
2024-06-01,KOR,Selangor,15547,8567,6980
2024-06-01,KOR,W.P. Labuan,3,0,3
2024-06-01,KWT,Johor,88,45,43
2024-06-01,KWT,Kedah,21,10,11
2024-06-01,KWT,Perlis,1,1,0
2024-06-01,KWT,Pulau Pinang,26,16,10
2024-06-01,KWT,Selangor,1117,608,509
2024-06-01,LAO,Johor,185,61,124
2024-06-01,LAO,Kedah,1041,84,957
2024-06-01,LAO,Kelantan,168,18,150
2024-06-01,LAO,Perak,43,5,38
2024-06-01,LAO,Perlis,458,94,364
2024-06-01,LAO,Pulau Pinang,66,30,36
2024-06-01,LAO,Sabah,1,0,1
2024-06-01,LAO,Sarawak,25,17,8
2024-06-01,LAO,Selangor,361,115,246
2024-06-01,LBN,Johor,21,12,9
2024-06-01,LBN,Kedah,7,2,5
2024-06-01,LBN,Pulau Pinang,5,2,3
2024-06-01,LBN,Sabah,1,1,0
2024-06-01,LBN,Sarawak,2,2,0
2024-06-01,LBN,Selangor,402,234,168
2024-06-01,LBR,Johor,2,2,0
2024-06-01,LBR,Sarawak,1,1,0
2024-06-01,LBR,Selangor,5,4,1
2024-06-01,LBY,Johor,4,2,2
2024-06-01,LBY,Kedah,1,1,0
2024-06-01,LBY,Selangor,363,254,109
2024-06-01,LCA,Johor,4,4,0
2024-06-01,LCA,Pulau Pinang,3,3,0
2024-06-01,LCA,Sarawak,4,2,2
2024-06-01,LCA,Selangor,13,9,4
2024-06-01,LIE,Johor,1,1,0
2024-06-01,LIE,Sabah,1,0,1
2024-06-01,LIE,Selangor,2,1,1
2024-06-01,LKA,Johor,804,494,310
2024-06-01,LKA,Kedah,37,21,16
2024-06-01,LKA,Kelantan,1,1,0
2024-06-01,LKA,Melaka,1,1,0
2024-06-01,LKA,Pahang,1,0,1
2024-06-01,LKA,Perlis,7,3,4
2024-06-01,LKA,Pulau Pinang,114,73,41
2024-06-01,LKA,Sabah,5,1,4
2024-06-01,LKA,Sarawak,31,22,9
2024-06-01,LKA,Selangor,4448,2720,1728
2024-06-01,LKA,W.P. Labuan,1,1,0
2024-06-01,LSO,Selangor,7,5,2
2024-06-01,LTU,Johor,40,24,16
2024-06-01,LTU,Kedah,10,4,6
2024-06-01,LTU,Pahang,1,1,0
2024-06-01,LTU,Perlis,2,1,1
2024-06-01,LTU,Pulau Pinang,9,4,5
2024-06-01,LTU,Sabah,2,2,0
2024-06-01,LTU,Sarawak,2,2,0
2024-06-01,LTU,Selangor,267,125,142
2024-06-01,LUX,Johor,5,4,1
2024-06-01,LUX,Kedah,2,0,2
2024-06-01,LUX,Kelantan,1,1,0
2024-06-01,LUX,Perlis,1,1,0
2024-06-01,LUX,Pulau Pinang,1,0,1
2024-06-01,LUX,Sabah,3,2,1
2024-06-01,LUX,Sarawak,2,2,0
2024-06-01,LUX,Selangor,52,28,24
2024-06-01,LVA,Johor,9,7,2
2024-06-01,LVA,Perak,1,0,1
2024-06-01,LVA,Pulau Pinang,2,1,1
2024-06-01,LVA,Sabah,3,1,2
2024-06-01,LVA,Sarawak,5,4,1
2024-06-01,LVA,Selangor,141,62,79
2024-06-01,LVA,W.P. Labuan,3,2,1
2024-06-01,MAC,Perak,1,0,1
2024-06-01,MAC,Pulau Pinang,1,0,1
2024-06-01,MAC,Selangor,1,0,1
2024-06-01,MAR,Johor,92,54,38
2024-06-01,MAR,Kedah,12,7,5
2024-06-01,MAR,Pulau Pinang,16,11,5
2024-06-01,MAR,Sabah,4,1,3
2024-06-01,MAR,Sarawak,11,6,5
2024-06-01,MAR,Selangor,1226,694,532
2024-06-01,MCO,Johor,1,1,0
2024-06-01,MCO,Selangor,1,1,0
2024-06-01,MDA,Johor,11,4,7
2024-06-01,MDA,Kedah,2,1,1
2024-06-01,MDA,Pahang,1,1,0
2024-06-01,MDA,Pulau Pinang,1,0,1
2024-06-01,MDA,Sabah,1,1,0
2024-06-01,MDA,Selangor,26,16,10
2024-06-01,MDG,Johor,18,7,11
2024-06-01,MDG,Selangor,120,45,75
2024-06-01,MDV,Johor,142,85,57
2024-06-01,MDV,Kedah,1,1,0
2024-06-01,MDV,Kelantan,1,1,0
2024-06-01,MDV,Perlis,1,1,0
2024-06-01,MDV,Pulau Pinang,6,3,3
2024-06-01,MDV,Sarawak,1,1,0
2024-06-01,MDV,Selangor,4053,2193,1860
2024-06-01,MEX,Johor,148,73,75
2024-06-01,MEX,Kedah,20,12,8
2024-06-01,MEX,Kelantan,2,1,1
2024-06-01,MEX,Perak,3,3,0
2024-06-01,MEX,Perlis,3,2,1
2024-06-01,MEX,Pulau Pinang,27,17,10
2024-06-01,MEX,Sabah,3,2,1
2024-06-01,MEX,Sarawak,2,2,0
2024-06-01,MEX,Selangor,639,323,316
2024-06-01,MHL,Selangor,6,3,3
2024-06-01,MKD,Johor,11,9,2
2024-06-01,MKD,Kedah,3,2,1
2024-06-01,MKD,Pulau Pinang,1,0,1
2024-06-01,MKD,Sarawak,3,2,1
2024-06-01,MKD,Selangor,25,14,11
2024-06-01,MLI,Johor,3,3,0
2024-06-01,MLI,Selangor,7,4,3
2024-06-01,MLT,Johor,12,5,7
2024-06-01,MLT,Kedah,5,3,2
2024-06-01,MLT,Pulau Pinang,2,2,0
2024-06-01,MLT,Sabah,1,1,0
2024-06-01,MLT,Sarawak,3,3,0
2024-06-01,MLT,Selangor,50,29,21
2024-06-01,MMR,Johor,10838,3120,7718
2024-06-01,MMR,Kedah,105,27,78
2024-06-01,MMR,Kelantan,1,0,1
2024-06-01,MMR,Pahang,4,3,1
2024-06-01,MMR,Perak,44,7,37
2024-06-01,MMR,Perlis,8,3,5
2024-06-01,MMR,Pulau Pinang,355,134,221
2024-06-01,MMR,Sabah,36,15,21
2024-06-01,MMR,Sarawak,115,52,63
2024-06-01,MMR,Selangor,4861,2798,2063
2024-06-01,MNE,Johor,4,3,1
2024-06-01,MNE,Selangor,7,2,5
2024-06-01,MNG,Johor,211,73,138
2024-06-01,MNG,Kedah,9,6,3
2024-06-01,MNG,Pulau Pinang,4,2,2
2024-06-01,MNG,Selangor,407,151,256
2024-06-01,MOZ,Selangor,21,8,13
2024-06-01,MRT,Selangor,26,22,4
2024-06-01,MUS,Johor,126,71,55
2024-06-01,MUS,Kedah,7,4,3
2024-06-01,MUS,Kelantan,2,1,1
2024-06-01,MUS,Pahang,1,1,0
2024-06-01,MUS,Perlis,4,2,2
2024-06-01,MUS,Pulau Pinang,3,1,2
2024-06-01,MUS,Sabah,1,1,0
2024-06-01,MUS,Sarawak,1,1,0
2024-06-01,MUS,Selangor,1223,656,567
2024-06-01,MWI,Johor,1,1,0
2024-06-01,MWI,Selangor,19,12,7
2024-06-01,NAM,Johor,4,2,2
2024-06-01,NAM,Pulau Pinang,1,1,0
2024-06-01,NAM,Selangor,19,11,8
2024-06-01,NGA,Johor,37,27,10
2024-06-01,NGA,Pulau Pinang,3,2,1
2024-06-01,NGA,Sarawak,8,7,1
2024-06-01,NGA,Selangor,429,331,98
2024-06-01,NIC,Johor,3,2,1
2024-06-01,NIC,Kedah,4,1,3
2024-06-01,NIC,Sabah,1,1,0
2024-06-01,NIC,Selangor,7,2,5
2024-06-01,NLD,Johor,948,620,328
2024-06-01,NLD,Kedah,165,94,71
2024-06-01,NLD,Kelantan,4,3,1
2024-06-01,NLD,Melaka,1,1,0
2024-06-01,NLD,Negeri Sembilan,2,0,2
2024-06-01,NLD,Pahang,1,0,1
2024-06-01,NLD,Perak,14,9,5
2024-06-01,NLD,Perlis,38,19,19
2024-06-01,NLD,Pulau Pinang,193,117,76
2024-06-01,NLD,Sabah,86,49,37
2024-06-01,NLD,Sarawak,92,63,29
2024-06-01,NLD,Selangor,4142,2424,1718
2024-06-01,NOR,Johor,218,132,86
2024-06-01,NOR,Kedah,18,12,6
2024-06-01,NOR,Pahang,1,1,0
2024-06-01,NOR,Perak,5,3,2
2024-06-01,NOR,Perlis,3,3,0
2024-06-01,NOR,Pulau Pinang,48,30,18
2024-06-01,NOR,Sabah,10,8,2
2024-06-01,NOR,Sarawak,18,14,4
2024-06-01,NOR,Selangor,974,573,401
2024-06-01,NPL,Johor,1126,789,337
2024-06-01,NPL,Kedah,24,13,11
2024-06-01,NPL,Perlis,1,1,0
2024-06-01,NPL,Pulau Pinang,25,22,3
2024-06-01,NPL,Sabah,3,1,2
2024-06-01,NPL,Sarawak,143,91,52
2024-06-01,NPL,Selangor,2965,2593,372
2024-06-01,NPL,W.P. Labuan,78,75,3
2024-06-01,NRU,Selangor,4,3,1
2024-06-01,NZL,Johor,870,512,358
2024-06-01,NZL,Kedah,68,39,29
2024-06-01,NZL,Kelantan,1,0,1
2024-06-01,NZL,Pahang,4,2,2
2024-06-01,NZL,Perak,25,16,9
2024-06-01,NZL,Perlis,12,8,4
2024-06-01,NZL,Pulau Pinang,301,151,150
2024-06-01,NZL,Sabah,77,36,41
2024-06-01,NZL,Sarawak,144,87,57
2024-06-01,NZL,Selangor,3262,1904,1358
2024-06-01,NZL,Terengganu,1,1,0
2024-06-01,NZL,W.P. Labuan,5,3,2
2024-06-01,OMN,Johor,87,59,28
2024-06-01,OMN,Kedah,21,10,11
2024-06-01,OMN,Perlis,6,2,4
2024-06-01,OMN,Pulau Pinang,50,47,3
2024-06-01,OMN,Sabah,1,0,1
2024-06-01,OMN,Sarawak,20,19,1
2024-06-01,OMN,Selangor,2375,1303,1072
2024-06-01,PAK,Johor,711,484,227
2024-06-01,PAK,Kedah,189,114,75
2024-06-01,PAK,Kelantan,9,8,1
2024-06-01,PAK,Melaka,1,1,0
2024-06-01,PAK,Perak,4,4,0
2024-06-01,PAK,Perlis,11,10,1
2024-06-01,PAK,Pulau Pinang,101,69,32
2024-06-01,PAK,Sabah,15,9,6
2024-06-01,PAK,Sarawak,185,161,24
2024-06-01,PAK,Selangor,11403,8760,2643
2024-06-01,PAK,W.P. Labuan,3,3,0
2024-06-01,PAN,Johor,10,4,6
2024-06-01,PAN,Pulau Pinang,4,3,1
2024-06-01,PAN,Selangor,23,9,14
2024-06-01,PER,Johor,26,15,11
2024-06-01,PER,Kedah,3,2,1
2024-06-01,PER,Perak,1,0,1
2024-06-01,PER,Perlis,2,2,0
2024-06-01,PER,Pulau Pinang,3,3,0
2024-06-01,PER,Sabah,3,1,2
2024-06-01,PER,Selangor,131,71,60
2024-06-01,PHL,Johor,36097,11682,24415
2024-06-01,PHL,Kedah,563,181,382
2024-06-01,PHL,Kelantan,89,45,44
2024-06-01,PHL,Melaka,2,1,1
2024-06-01,PHL,Pahang,30,22,8
2024-06-01,PHL,Perak,127,46,81
2024-06-01,PHL,Perlis,282,101,181
2024-06-01,PHL,Pulau Pinang,958,364,594
2024-06-01,PHL,Sabah,1453,688,765
2024-06-01,PHL,Sarawak,3054,1232,1822
2024-06-01,PHL,Selangor,21674,8398,13276
2024-06-01,PHL,W.P. Labuan,138,56,82
2024-06-01,PLW,Johor,3,3,0
2024-06-01,PLW,Pulau Pinang,1,1,0
2024-06-01,PLW,Selangor,1,0,1
2024-06-01,PNG,Johor,47,7,40
2024-06-01,PNG,Pulau Pinang,1,0,1
2024-06-01,PNG,Sabah,1,1,0
2024-06-01,PNG,Sarawak,3,1,2
2024-06-01,PNG,Selangor,142,67,75
2024-06-01,POL,Johor,342,201,141
2024-06-01,POL,Kedah,60,31,29
2024-06-01,POL,Kelantan,1,1,0
2024-06-01,POL,Pahang,2,2,0
2024-06-01,POL,Perak,4,2,2
2024-06-01,POL,Perlis,3,2,1
2024-06-01,POL,Pulau Pinang,45,23,22
2024-06-01,POL,Sabah,30,16,14
2024-06-01,POL,Sarawak,46,27,19
2024-06-01,POL,Selangor,1529,772,757
2024-06-01,PRT,Johor,184,105,79
2024-06-01,PRT,Kedah,17,8,9
2024-06-01,PRT,Kelantan,1,1,0
2024-06-01,PRT,Perlis,2,0,2
2024-06-01,PRT,Pulau Pinang,30,17,13
2024-06-01,PRT,Sabah,26,12,14
2024-06-01,PRT,Sarawak,12,6,6
2024-06-01,PRT,Selangor,782,447,335
2024-06-01,PRT,W.P. Labuan,3,1,2
2024-06-01,PRY,Johor,1,1,0
2024-06-01,PRY,Selangor,21,12,9
2024-06-01,PSE,Johor,12,11,1
2024-06-01,PSE,Kedah,13,9,4
2024-06-01,PSE,Pulau Pinang,3,2,1
2024-06-01,PSE,Selangor,491,293,198
2024-06-01,QAT,Johor,24,8,16
2024-06-01,QAT,Kedah,7,3,4
2024-06-01,QAT,Perlis,2,2,0
2024-06-01,QAT,Pulau Pinang,6,4,2
2024-06-01,QAT,Sarawak,1,1,0
2024-06-01,QAT,Selangor,389,230,159
2024-06-01,ROU,Johor,115,69,46
2024-06-01,ROU,Kedah,13,5,8
2024-06-01,ROU,Pahang,1,1,0
2024-06-01,ROU,Perak,1,0,1
2024-06-01,ROU,Perlis,3,2,1
2024-06-01,ROU,Pulau Pinang,23,12,11
2024-06-01,ROU,Sabah,7,1,6
2024-06-01,ROU,Sarawak,2,0,2
2024-06-01,ROU,Selangor,480,272,208
2024-06-01,RUS,Johor,473,216,257
2024-06-01,RUS,Kedah,129,72,57
2024-06-01,RUS,Kelantan,34,19,15
2024-06-01,RUS,Melaka,1,1,0
2024-06-01,RUS,Pahang,1,0,1
2024-06-01,RUS,Perak,5,3,2
2024-06-01,RUS,Perlis,57,39,18
2024-06-01,RUS,Pulau Pinang,80,34,46
2024-06-01,RUS,Sabah,62,30,32
2024-06-01,RUS,Sarawak,42,19,23
2024-06-01,RUS,Selangor,7576,3710,3866
2024-06-01,RUS,W.P. Labuan,9,4,5
2024-06-01,RWA,Johor,1,1,0
2024-06-01,RWA,Selangor,6,4,2
2024-06-01,SAU,Johor,394,209,185
2024-06-01,SAU,Kedah,158,82,76
2024-06-01,SAU,Kelantan,4,3,1
2024-06-01,SAU,Perak,4,1,3
2024-06-01,SAU,Perlis,2,1,1
2024-06-01,SAU,Pulau Pinang,135,58,77
2024-06-01,SAU,Sabah,3,2,1
2024-06-01,SAU,Sarawak,4,3,1
2024-06-01,SAU,Selangor,10757,5812,4945
2024-06-01,SDN,Johor,15,13,2
2024-06-01,SDN,Kedah,4,3,1
2024-06-01,SDN,Perlis,1,1,0
2024-06-01,SDN,Pulau Pinang,3,1,2
2024-06-01,SDN,Sarawak,2,0,2
2024-06-01,SDN,Selangor,1506,838,668
2024-06-01,SDN,W.P. Labuan,2,2,0
2024-06-01,SEN,Johor,6,5,1
2024-06-01,SEN,Kedah,1,1,0
2024-06-01,SEN,Pulau Pinang,1,0,1
2024-06-01,SEN,Selangor,54,39,15
2024-06-01,SGP,Johor,1684536,931196,753340
2024-06-01,SGP,Kedah,8231,4175,4056
2024-06-01,SGP,Kelantan,212,124,88
2024-06-01,SGP,Melaka,49,35,14
2024-06-01,SGP,Negeri Sembilan,3,0,3
2024-06-01,SGP,Pahang,882,439,443
2024-06-01,SGP,Perak,8977,4127,4850
2024-06-01,SGP,Perlis,522,286,236
2024-06-01,SGP,Pulau Pinang,28598,13835,14763
2024-06-01,SGP,Sabah,4053,2008,2045
2024-06-01,SGP,Sarawak,5684,3078,2606
2024-06-01,SGP,Selangor,63733,32034,31699
2024-06-01,SGP,W.P. Labuan,12,11,1
2024-06-01,SLB,Johor,8,2,6
2024-06-01,SLB,Pulau Pinang,1,1,0
2024-06-01,SLB,Sarawak,4,1,3
2024-06-01,SLB,Selangor,13,5,8
2024-06-01,SLE,Johor,3,1,2
2024-06-01,SLE,Kedah,1,1,0
2024-06-01,SLE,Kelantan,1,1,0
2024-06-01,SLE,Selangor,34,18,16
2024-06-01,SLV,Johor,1,1,0
2024-06-01,SLV,Pulau Pinang,2,2,0
2024-06-01,SLV,Sabah,1,0,1
2024-06-01,SLV,Selangor,13,4,9
2024-06-01,SMR,Selangor,1,1,0
2024-06-01,SOM,Selangor,232,144,88
2024-06-01,SRB,Johor,5,4,1
2024-06-01,SRB,Perlis,1,1,0
2024-06-01,SRB,Selangor,101,50,51
2024-06-01,SSD,Kedah,1,1,0
2024-06-01,SSD,Pulau Pinang,2,0,2
2024-06-01,SSD,Sarawak,2,2,0
2024-06-01,SSD,Selangor,33,16,17
2024-06-01,STP,Selangor,1,1,0
2024-06-01,SUR,Johor,5,3,2
2024-06-01,SUR,Sabah,2,2,0
2024-06-01,SUR,Selangor,14,11,3
2024-06-01,SVK,Johor,56,34,22
2024-06-01,SVK,Kedah,29,13,16
2024-06-01,SVK,Perlis,1,0,1
2024-06-01,SVK,Pulau Pinang,10,5,5
2024-06-01,SVK,Sabah,2,1,1
2024-06-01,SVK,Sarawak,5,3,2
2024-06-01,SVK,Selangor,285,156,129
2024-06-01,SVN,Johor,10,6,4
2024-06-01,SVN,Kedah,4,1,3
2024-06-01,SVN,Pulau Pinang,7,3,4
2024-06-01,SVN,Sarawak,2,1,1
2024-06-01,SVN,Selangor,194,97,97
2024-06-01,SWE,Johor,313,195,118
2024-06-01,SWE,Kedah,33,12,21
2024-06-01,SWE,Kelantan,17,8,9
2024-06-01,SWE,Pahang,2,2,0
2024-06-01,SWE,Perak,5,1,4
2024-06-01,SWE,Perlis,7,6,1
2024-06-01,SWE,Pulau Pinang,133,87,46
2024-06-01,SWE,Sabah,16,8,8
2024-06-01,SWE,Sarawak,28,17,11
2024-06-01,SWE,Selangor,1018,593,425
2024-06-01,SWE,W.P. Labuan,5,2,3
2024-06-01,SWZ,Johor,3,2,1
2024-06-01,SWZ,Selangor,53,28,25
2024-06-01,SYC,Johor,3,2,1
2024-06-01,SYC,Pulau Pinang,1,1,0
2024-06-01,SYC,Selangor,92,33,59
2024-06-01,SYR,Johor,23,16,7
2024-06-01,SYR,Kedah,32,17,15
2024-06-01,SYR,Pulau Pinang,4,3,1
2024-06-01,SYR,Sabah,4,1,3
2024-06-01,SYR,Sarawak,8,6,2
2024-06-01,SYR,Selangor,912,514,398
2024-06-01,TCD,Johor,9,7,2
2024-06-01,TCD,Pulau Pinang,1,1,0
2024-06-01,TCD,Selangor,31,26,5
2024-06-01,TGO,Johor,2,2,0
2024-06-01,TGO,Sabah,1,1,0
2024-06-01,TGO,Selangor,5,4,1
2024-06-01,THA,Johor,7062,1622,5440
2024-06-01,THA,Kedah,47857,26418,21439
2024-06-01,THA,Kelantan,50235,25102,25133
2024-06-01,THA,Melaka,6,4,2
2024-06-01,THA,Pahang,29,23,6
2024-06-01,THA,Perak,9023,4335,4688
2024-06-01,THA,Perlis,47503,26921,20582
2024-06-01,THA,Pulau Pinang,3132,1231,1901
2024-06-01,THA,Sabah,25,6,19
2024-06-01,THA,Sarawak,418,128,290
2024-06-01,THA,Selangor,13695,5023,8672
2024-06-01,THA,W.P. Labuan,11,4,7
2024-06-01,TJK,Selangor,201,139,62
2024-06-01,TKM,Johor,1,0,1
2024-06-01,TKM,Pulau Pinang,2,2,0
2024-06-01,TKM,Sarawak,1,1,0
2024-06-01,TKM,Selangor,580,318,262
2024-06-01,TLS,Johor,12,6,6
2024-06-01,TLS,Perak,6,2,4
2024-06-01,TLS,Pulau Pinang,12,2,10
2024-06-01,TLS,Selangor,296,171,125
2024-06-01,TON,Johor,1,1,0
2024-06-01,TON,Pulau Pinang,1,0,1
2024-06-01,TON,Selangor,15,8,7
2024-06-01,TTO,Johor,6,5,1
2024-06-01,TTO,Kedah,1,1,0
2024-06-01,TTO,Pulau Pinang,1,1,0
2024-06-01,TTO,Sabah,1,1,0
2024-06-01,TTO,Sarawak,1,0,1
2024-06-01,TTO,Selangor,29,13,16
2024-06-01,TUN,Johor,20,12,8
2024-06-01,TUN,Kedah,6,3,3
2024-06-01,TUN,Kelantan,1,1,0
2024-06-01,TUN,Pulau Pinang,5,1,4
2024-06-01,TUN,Sarawak,1,1,0
2024-06-01,TUN,Selangor,476,244,232
2024-06-01,TUR,Johor,357,243,114
2024-06-01,TUR,Kedah,51,34,17
2024-06-01,TUR,Kelantan,6,5,1
2024-06-01,TUR,Melaka,1,1,0
2024-06-01,TUR,Perak,3,2,1
2024-06-01,TUR,Perlis,7,6,1
2024-06-01,TUR,Pulau Pinang,35,25,10
2024-06-01,TUR,Sabah,2,2,0
2024-06-01,TUR,Sarawak,26,19,7
2024-06-01,TUR,Selangor,2549,1509,1040
2024-06-01,TUV,Selangor,1,0,1
2024-06-01,TWN,Johor,9187,3913,5274
2024-06-01,TWN,Kedah,224,112,112
2024-06-01,TWN,Kelantan,3,3,0
2024-06-01,TWN,Melaka,3,1,2
2024-06-01,TWN,Pahang,6,5,1
2024-06-01,TWN,Perak,77,38,39
2024-06-01,TWN,Perlis,45,22,23
2024-06-01,TWN,Pulau Pinang,5005,2385,2620
2024-06-01,TWN,Sabah,3056,1431,1625
2024-06-01,TWN,Sarawak,307,125,182
2024-06-01,TWN,Selangor,22555,10704,11851
2024-06-01,TWN,W.P. Labuan,1,1,0
2024-06-01,TZA,Johor,36,17,19
2024-06-01,TZA,Pulau Pinang,1,0,1
2024-06-01,TZA,Sarawak,4,4,0
2024-06-01,TZA,Selangor,225,112,113
2024-06-01,UGA,Johor,16,6,10
2024-06-01,UGA,Kedah,1,0,1
2024-06-01,UGA,Pahang,1,1,0
2024-06-01,UGA,Pulau Pinang,1,0,1
2024-06-01,UGA,Sabah,1,0,1
2024-06-01,UGA,Selangor,154,62,92
2024-06-01,UKR,Johor,106,50,56
2024-06-01,UKR,Kedah,8,4,4
2024-06-01,UKR,Kelantan,18,7,11
2024-06-01,UKR,Perak,1,0,1
2024-06-01,UKR,Perlis,1,0,1
2024-06-01,UKR,Pulau Pinang,38,18,20
2024-06-01,UKR,Sabah,9,3,6
2024-06-01,UKR,Sarawak,2,1,1
2024-06-01,UKR,Selangor,921,460,461
2024-06-01,URY,Johor,7,1,6
2024-06-01,URY,Kedah,2,0,2
2024-06-01,URY,Pulau Pinang,1,1,0
2024-06-01,URY,Selangor,61,30,31
2024-06-01,USA,Johor,5886,3360,2526
2024-06-01,USA,Kedah,431,212,219
2024-06-01,USA,Kelantan,20,15,5
2024-06-01,USA,Pahang,13,10,3
2024-06-01,USA,Perak,180,105,75
2024-06-01,USA,Perlis,148,103,45
2024-06-01,USA,Pulau Pinang,2644,1547,1097
2024-06-01,USA,Sabah,787,502,285
2024-06-01,USA,Sarawak,402,198,204
2024-06-01,USA,Selangor,18228,10175,8053
2024-06-01,USA,Terengganu,2,2,0
2024-06-01,USA,W.P. Labuan,5,5,0
2024-06-01,UZB,Johor,83,62,21
2024-06-01,UZB,Kedah,3,2,1
2024-06-01,UZB,Kelantan,2,2,0
2024-06-01,UZB,Pulau Pinang,1,1,0
2024-06-01,UZB,Sabah,5,2,3
2024-06-01,UZB,Selangor,1225,673,552
2024-06-01,VAT,Selangor,1,0,1
2024-06-01,VCT,Selangor,1,1,0
2024-06-01,VEN,Johor,11,9,2
2024-06-01,VEN,Kedah,2,2,0
2024-06-01,VEN,Perlis,1,0,1
2024-06-01,VEN,Pulau Pinang,4,3,1
2024-06-01,VEN,Sabah,1,1,0
2024-06-01,VEN,Sarawak,4,3,1
2024-06-01,VEN,Selangor,76,40,36
2024-06-01,VNM,Johor,22007,7263,14744
2024-06-01,VNM,Kedah,421,51,370
2024-06-01,VNM,Kelantan,15,7,8
2024-06-01,VNM,Melaka,1,1,0
2024-06-01,VNM,Pahang,1,0,1
2024-06-01,VNM,Perak,83,7,76
2024-06-01,VNM,Perlis,301,23,278
2024-06-01,VNM,Pulau Pinang,1886,573,1313
2024-06-01,VNM,Sabah,24,4,20
2024-06-01,VNM,Sarawak,296,44,252
2024-06-01,VNM,Selangor,18665,6462,12203
2024-06-01,VNM,W.P. Labuan,3,0,3
2024-06-01,VUT,Johor,40,32,8
2024-06-01,VUT,Pulau Pinang,10,7,3
2024-06-01,VUT,Sabah,2,1,1
2024-06-01,VUT,Selangor,118,103,15
2024-06-01,WSM,Selangor,2,2,0
2024-06-01,XXX,Johor,2,1,1
2024-06-01,XXX,Perlis,1,1,0
2024-06-01,XXX,Sabah,1,0,1
2024-06-01,XXX,Selangor,67,38,29
2024-06-01,YEM,Johor,57,36,21
2024-06-01,YEM,Kedah,7,5,2
2024-06-01,YEM,Melaka,1,1,0
2024-06-01,YEM,Perlis,5,5,0
2024-06-01,YEM,Pulau Pinang,10,6,4
2024-06-01,YEM,Sabah,1,1,0
2024-06-01,YEM,Sarawak,3,2,1
2024-06-01,YEM,Selangor,1731,1065,666
2024-06-01,ZAF,Johor,404,230,174
2024-06-01,ZAF,Kedah,61,30,31
2024-06-01,ZAF,Pahang,9,5,4
2024-06-01,ZAF,Perak,2,1,1
2024-06-01,ZAF,Perlis,25,15,10
2024-06-01,ZAF,Pulau Pinang,84,43,41
2024-06-01,ZAF,Sabah,27,16,11
2024-06-01,ZAF,Sarawak,88,39,49
2024-06-01,ZAF,Selangor,1178,637,541
2024-06-01,ZAF,W.P. Labuan,3,1,2
2024-06-01,ZAR,Selangor,5,3,2
2024-06-01,ZMB,Johor,6,5,1
2024-06-01,ZMB,Pulau Pinang,1,1,0
2024-06-01,ZMB,Selangor,70,33,37
2024-06-01,ZWE,Johor,14,8,6
2024-06-01,ZWE,Pulau Pinang,3,1,2
2024-06-01,ZWE,Selangor,164,82,82
